Date,Country,Lat,Long,Confirmed,Recovered,Deaths,Active
1/1/22,Afghanistan,33.93911,67.709953,158107,0,7356,150751
1/2/22,Afghanistan,33.93911,67.709953,158189,0,7361,150828
1/3/22,Afghanistan,33.93911,67.709953,158183,0,7364,150819
1/4/22,Afghanistan,33.93911,67.709953,158205,0,7365,150840
1/5/22,Afghanistan,33.93911,67.709953,158245,0,7367,150878
1/6/22,Afghanistan,33.93911,67.709953,158275,0,7367,150908
1/7/22,Afghanistan,33.93911,67.709953,158300,0,7368,150932
1/8/22,Afghanistan,33.93911,67.709953,158309,0,7369,150940
1/9/22,Afghanistan,33.93911,67.709953,158381,0,7373,151008
1/10/22,Afghanistan,33.93911,67.709953,158394,0,7373,151021
1/11/22,Afghanistan,33.93911,67.709953,158471,0,7374,151097
1/12/22,Afghanistan,33.93911,67.709953,158511,0,7376,151135
1/13/22,Afghanistan,33.93911,67.709953,158602,0,7376,151226
1/14/22,Afghanistan,33.93911,67.709953,158639,0,7376,151263
1/15/22,Afghanistan,33.93911,67.709953,158678,0,7378,151300
1/16/22,Afghanistan,33.93911,67.709953,158717,0,7379,151338
1/17/22,Afghanistan,33.93911,67.709953,158826,0,7381,151445
1/18/22,Afghanistan,33.93911,67.709953,158974,0,7383,151591
1/19/22,Afghanistan,33.93911,67.709953,159070,0,7386,151684
1/20/22,Afghanistan,33.93911,67.709953,159303,0,7386,151917
1/21/22,Afghanistan,33.93911,67.709953,159516,0,7390,152126
1/22/22,Afghanistan,33.93911,67.709953,159548,0,7390,152158
1/23/22,Afghanistan,33.93911,67.709953,159649,0,7393,152256
1/24/22,Afghanistan,33.93911,67.709953,159896,0,7393,152503
1/25/22,Afghanistan,33.93911,67.709953,160252,0,7397,152855
1/26/22,Afghanistan,33.93911,67.709953,160692,0,7401,153291
1/27/22,Afghanistan,33.93911,67.709953,161004,0,7403,153601
1/28/22,Afghanistan,33.93911,67.709953,161057,0,7403,153654
1/29/22,Afghanistan,33.93911,67.709953,161290,0,7405,153885
1/30/22,Afghanistan,33.93911,67.709953,162111,0,7408,154703
1/31/22,Afghanistan,33.93911,67.709953,162926,0,7414,155512
2/1/22,Afghanistan,33.93911,67.709953,163555,0,7417,156138
2/2/22,Afghanistan,33.93911,67.709953,164190,0,7418,156772
2/3/22,Afghanistan,33.93911,67.709953,164727,0,7420,157307
2/4/22,Afghanistan,33.93911,67.709953,165358,0,7420,157938
2/5/22,Afghanistan,33.93911,67.709953,165711,0,7425,158286
2/6/22,Afghanistan,33.93911,67.709953,166191,0,7432,158759
2/7/22,Afghanistan,33.93911,67.709953,166924,0,7442,159482
2/8/22,Afghanistan,33.93911,67.709953,167739,0,7454,160285
2/9/22,Afghanistan,33.93911,67.709953,168550,0,7465,161085
2/10/22,Afghanistan,33.93911,67.709953,169448,0,7477,161971
2/11/22,Afghanistan,33.93911,67.709953,169940,0,7478,162462
2/12/22,Afghanistan,33.93911,67.709953,170152,0,7488,162664
2/13/22,Afghanistan,33.93911,67.709953,170604,0,7494,163110
2/14/22,Afghanistan,33.93911,67.709953,171246,0,7501,163745
2/15/22,Afghanistan,33.93911,67.709953,171422,0,7504,163918
2/16/22,Afghanistan,33.93911,67.709953,171519,0,7513,164006
2/17/22,Afghanistan,33.93911,67.709953,171673,0,7524,164149
2/18/22,Afghanistan,33.93911,67.709953,171857,0,7526,164331
2/19/22,Afghanistan,33.93911,67.709953,171931,0,7534,164397
2/20/22,Afghanistan,33.93911,67.709953,172205,0,7539,164666
2/21/22,Afghanistan,33.93911,67.709953,172441,0,7549,164892
2/22/22,Afghanistan,33.93911,67.709953,172716,0,7569,165147
2/23/22,Afghanistan,33.93911,67.709953,172901,0,7574,165327
2/24/22,Afghanistan,33.93911,67.709953,173047,0,7578,165469
2/25/22,Afghanistan,33.93911,67.709953,173084,0,7579,165505
2/26/22,Afghanistan,33.93911,67.709953,173146,0,7585,165561
2/27/22,Afghanistan,33.93911,67.709953,173395,0,7593,165802
2/28/22,Afghanistan,33.93911,67.709953,173659,0,7598,166061
3/1/22,Afghanistan,33.93911,67.709953,173879,0,7609,166270
3/2/22,Afghanistan,33.93911,67.709953,174073,0,7617,166456
3/3/22,Afghanistan,33.93911,67.709953,174214,0,7619,166595
3/4/22,Afghanistan,33.93911,67.709953,174214,0,7619,166595
3/5/22,Afghanistan,33.93911,67.709953,174331,0,7622,166709
3/6/22,Afghanistan,33.93911,67.709953,174582,0,7623,166959
3/7/22,Afghanistan,33.93911,67.709953,175000,0,7626,167374
3/8/22,Afghanistan,33.93911,67.709953,175353,0,7630,167723
3/9/22,Afghanistan,33.93911,67.709953,175525,0,7636,167889
3/10/22,Afghanistan,33.93911,67.709953,175893,0,7639,168254
3/11/22,Afghanistan,33.93911,67.709953,175974,0,7640,168334
3/12/22,Afghanistan,33.93911,67.709953,176039,0,7641,168398
3/13/22,Afghanistan,33.93911,67.709953,176201,0,7643,168558
3/14/22,Afghanistan,33.93911,67.709953,176409,0,7645,168764
3/15/22,Afghanistan,33.93911,67.709953,176571,0,7646,168925
3/16/22,Afghanistan,33.93911,67.709953,176743,0,7651,169092
3/17/22,Afghanistan,33.93911,67.709953,176918,0,7651,169267
3/18/22,Afghanistan,33.93911,67.709953,176983,0,7651,169332
3/19/22,Afghanistan,33.93911,67.709953,177039,0,7652,169387
3/20/22,Afghanistan,33.93911,67.709953,177093,0,7654,169439
3/21/22,Afghanistan,33.93911,67.709953,177191,0,7654,169537
3/22/22,Afghanistan,33.93911,67.709953,177255,0,7656,169599
3/23/22,Afghanistan,33.93911,67.709953,177321,0,7657,169664
3/24/22,Afghanistan,33.93911,67.709953,177321,0,7657,169664
3/25/22,Afghanistan,33.93911,67.709953,177321,0,7657,169664
3/26/22,Afghanistan,33.93911,67.709953,177321,0,7657,169664
3/27/22,Afghanistan,33.93911,67.709953,177520,0,7662,169858
3/28/22,Afghanistan,33.93911,67.709953,177602,0,7663,169939
3/29/22,Afghanistan,33.93911,67.709953,177658,0,7665,169993
3/30/22,Afghanistan,33.93911,67.709953,177716,0,7667,170049
3/31/22,Afghanistan,33.93911,67.709953,177747,0,7670,170077
4/1/22,Afghanistan,33.93911,67.709953,177782,0,7670,170112
4/2/22,Afghanistan,33.93911,67.709953,177803,0,7671,170132
4/3/22,Afghanistan,33.93911,67.709953,177827,0,7671,170156
4/4/22,Afghanistan,33.93911,67.709953,177897,0,7671,170226
4/5/22,Afghanistan,33.93911,67.709953,177932,0,7671,170261
4/6/22,Afghanistan,33.93911,67.709953,177974,0,7671,170303
4/7/22,Afghanistan,33.93911,67.709953,177974,0,7671,170303
4/8/22,Afghanistan,33.93911,67.709953,177974,0,7671,170303
4/9/22,Afghanistan,33.93911,67.709953,177974,0,7671,170303
4/10/22,Afghanistan,33.93911,67.709953,177974,0,7671,170303
4/11/22,Afghanistan,33.93911,67.709953,178141,0,7675,170466
4/12/22,Afghanistan,33.93911,67.709953,178257,0,7676,170581
4/13/22,Afghanistan,33.93911,67.709953,178295,0,7676,170619
4/14/22,Afghanistan,33.93911,67.709953,178352,0,7676,170676
4/15/22,Afghanistan,33.93911,67.709953,178373,0,7676,170697
4/16/22,Afghanistan,33.93911,67.709953,178387,0,7676,170711
4/17/22,Afghanistan,33.93911,67.709953,178418,0,7678,170740
4/18/22,Afghanistan,33.93911,67.709953,178457,0,7679,170778
4/19/22,Afghanistan,33.93911,67.709953,178513,0,7680,170833
4/20/22,Afghanistan,33.93911,67.709953,178574,0,7680,170894
4/21/22,Afghanistan,33.93911,67.709953,178611,0,7680,170931
4/22/22,Afghanistan,33.93911,67.709953,178638,0,7680,170958
4/23/22,Afghanistan,33.93911,67.709953,178648,0,7681,170967
4/24/22,Afghanistan,33.93911,67.709953,178689,0,7682,171007
4/25/22,Afghanistan,33.93911,67.709953,178745,0,7683,171062
4/26/22,Afghanistan,33.93911,67.709953,178769,0,7683,171086
4/27/22,Afghanistan,33.93911,67.709953,178809,0,7683,171126
4/28/22,Afghanistan,33.93911,67.709953,178850,0,7683,171167
4/29/22,Afghanistan,33.93911,67.709953,178873,0,7683,171190
4/30/22,Afghanistan,33.93911,67.709953,178879,0,7683,171196
5/1/22,Afghanistan,33.93911,67.709953,178899,0,7683,171216
5/2/22,Afghanistan,33.93911,67.709953,178901,0,7683,171218
5/3/22,Afghanistan,33.93911,67.709953,178901,0,7683,171218
5/4/22,Afghanistan,33.93911,67.709953,178901,0,7683,171218
5/5/22,Afghanistan,33.93911,67.709953,178905,0,7684,171221
5/6/22,Afghanistan,33.93911,67.709953,178919,0,7684,171235
5/7/22,Afghanistan,33.93911,67.709953,178922,0,7684,171238
5/8/22,Afghanistan,33.93911,67.709953,178981,0,7684,171297
5/9/22,Afghanistan,33.93911,67.709953,179010,0,7685,171325
5/10/22,Afghanistan,33.93911,67.709953,179017,0,7685,171332
5/11/22,Afghanistan,33.93911,67.709953,179131,0,7686,171445
5/12/22,Afghanistan,33.93911,67.709953,179169,0,7686,171483
5/13/22,Afghanistan,33.93911,67.709953,179203,0,7686,171517
5/14/22,Afghanistan,33.93911,67.709953,179242,0,7687,171555
5/15/22,Afghanistan,33.93911,67.709953,179267,0,7690,171577
5/16/22,Afghanistan,33.93911,67.709953,179321,0,7691,171630
5/17/22,Afghanistan,33.93911,67.709953,179328,0,7691,171637
5/18/22,Afghanistan,33.93911,67.709953,179477,0,7691,171786
5/19/22,Afghanistan,33.93911,67.709953,179597,0,7695,171902
5/20/22,Afghanistan,33.93911,67.709953,179624,0,7695,171929
5/21/22,Afghanistan,33.93911,67.709953,179674,0,7697,171977
5/22/22,Afghanistan,33.93911,67.709953,179716,0,7698,172018
5/23/22,Afghanistan,33.93911,67.709953,179716,0,7698,172018
5/24/22,Afghanistan,33.93911,67.709953,179771,0,7698,172073
5/25/22,Afghanistan,33.93911,67.709953,179835,0,7699,172136
5/26/22,Afghanistan,33.93911,67.709953,179835,0,7699,172136
5/27/22,Afghanistan,33.93911,67.709953,180086,0,7699,172387
5/28/22,Afghanistan,33.93911,67.709953,180122,0,7701,172421
5/29/22,Afghanistan,33.93911,67.709953,180174,0,7701,172473
5/30/22,Afghanistan,33.93911,67.709953,180259,0,7701,172558
5/31/22,Afghanistan,33.93911,67.709953,180347,0,7705,172642
6/1/22,Afghanistan,33.93911,67.709953,180419,0,7707,172712
6/2/22,Afghanistan,33.93911,67.709953,180520,0,7708,172812
6/3/22,Afghanistan,33.93911,67.709953,180584,0,7708,172876
6/4/22,Afghanistan,33.93911,67.709953,180615,0,7708,172907
6/5/22,Afghanistan,33.93911,67.709953,180615,0,7708,172907
6/6/22,Afghanistan,33.93911,67.709953,180688,0,7709,172979
6/7/22,Afghanistan,33.93911,67.709953,180741,0,7709,173032
6/8/22,Afghanistan,33.93911,67.709953,180784,0,7709,173075
6/9/22,Afghanistan,33.93911,67.709953,180864,0,7709,173155
6/10/22,Afghanistan,33.93911,67.709953,180864,0,7709,173155
6/11/22,Afghanistan,33.93911,67.709953,180864,0,7709,173155
6/12/22,Afghanistan,33.93911,67.709953,180864,0,7709,173155
6/13/22,Afghanistan,33.93911,67.709953,181120,0,7710,173410
6/14/22,Afghanistan,33.93911,67.709953,181178,0,7710,173468
6/15/22,Afghanistan,33.93911,67.709953,181236,0,7710,173526
6/16/22,Afghanistan,33.93911,67.709953,181465,0,7713,173752
6/17/22,Afghanistan,33.93911,67.709953,181534,0,7713,173821
6/18/22,Afghanistan,33.93911,67.709953,181574,0,7713,173861
6/19/22,Afghanistan,33.93911,67.709953,181666,0,7713,173953
6/20/22,Afghanistan,33.93911,67.709953,181725,0,7714,174011
6/21/22,Afghanistan,33.93911,67.709953,181808,0,7715,174093
6/22/22,Afghanistan,33.93911,67.709953,181912,0,7715,174197
6/23/22,Afghanistan,33.93911,67.709953,181987,0,7715,174272
6/24/22,Afghanistan,33.93911,67.709953,182033,0,7717,174316
6/25/22,Afghanistan,33.93911,67.709953,182072,0,7717,174355
6/26/22,Afghanistan,33.93911,67.709953,182149,0,7717,174432
6/27/22,Afghanistan,33.93911,67.709953,182228,0,7720,174508
6/28/22,Afghanistan,33.93911,67.709953,182324,0,7722,174602
6/29/22,Afghanistan,33.93911,67.709953,182403,0,7722,174681
6/30/22,Afghanistan,33.93911,67.709953,182528,0,7723,174805
7/1/22,Afghanistan,33.93911,67.709953,182594,0,7723,174871
7/2/22,Afghanistan,33.93911,67.709953,182643,0,7723,174920
7/3/22,Afghanistan,33.93911,67.709953,182724,0,7724,175000
7/4/22,Afghanistan,33.93911,67.709953,182793,0,7725,175068
7/5/22,Afghanistan,33.93911,67.709953,182793,0,7725,175068
7/6/22,Afghanistan,33.93911,67.709953,182979,0,7725,175254
7/7/22,Afghanistan,33.93911,67.709953,183084,0,7727,175357
7/8/22,Afghanistan,33.93911,67.709953,183221,0,7728,175493
7/9/22,Afghanistan,33.93911,67.709953,183235,0,7728,175507
7/10/22,Afghanistan,33.93911,67.709953,183265,0,7728,175537
7/11/22,Afghanistan,33.93911,67.709953,183268,0,7728,175540
7/12/22,Afghanistan,33.93911,67.709953,183272,0,7728,175544
7/13/22,Afghanistan,33.93911,67.709953,183285,0,7728,175557
7/14/22,Afghanistan,33.93911,67.709953,183358,0,7728,175630
7/15/22,Afghanistan,33.93911,67.709953,183407,0,7729,175678
7/16/22,Afghanistan,33.93911,67.709953,183445,0,7730,175715
7/17/22,Afghanistan,33.93911,67.709953,183572,0,7731,175841
7/18/22,Afghanistan,33.93911,67.709953,183687,0,7733,175954
7/19/22,Afghanistan,33.93911,67.709953,183908,0,7736,176172
7/20/22,Afghanistan,33.93911,67.709953,184038,0,7737,176301
7/21/22,Afghanistan,33.93911,67.709953,184224,0,7738,176486
7/22/22,Afghanistan,33.93911,67.709953,184360,0,7738,176622
7/23/22,Afghanistan,33.93911,67.709953,184473,0,7738,176735
7/24/22,Afghanistan,33.93911,67.709953,184587,0,7738,176849
7/25/22,Afghanistan,33.93911,67.709953,184819,0,7738,177081
7/26/22,Afghanistan,33.93911,67.709953,185086,0,7742,177344
7/27/22,Afghanistan,33.93911,67.709953,185272,0,7743,177529
7/28/22,Afghanistan,33.93911,67.709953,185393,0,7743,177650
7/29/22,Afghanistan,33.93911,67.709953,185481,0,7743,177738
7/30/22,Afghanistan,33.93911,67.709953,185552,0,7745,177807
7/31/22,Afghanistan,33.93911,67.709953,185749,0,7748,178001
8/1/22,Afghanistan,33.93911,67.709953,185930,0,7751,178179
8/2/22,Afghanistan,33.93911,67.709953,186120,0,7751,178369
8/3/22,Afghanistan,33.93911,67.709953,186393,0,7752,178641
8/4/22,Afghanistan,33.93911,67.709953,186697,0,7752,178945
8/5/22,Afghanistan,33.93911,67.709953,187037,0,7752,179285
8/6/22,Afghanistan,33.93911,67.709953,187109,0,7752,179357
8/7/22,Afghanistan,33.93911,67.709953,187442,0,7752,179690
8/8/22,Afghanistan,33.93911,67.709953,187685,0,7753,179932
8/9/22,Afghanistan,33.93911,67.709953,187966,0,7753,180213
8/10/22,Afghanistan,33.93911,67.709953,188202,0,7753,180449
8/11/22,Afghanistan,33.93911,67.709953,188506,0,7755,180751
8/12/22,Afghanistan,33.93911,67.709953,188704,0,7755,180949
8/13/22,Afghanistan,33.93911,67.709953,188820,0,7758,181062
8/14/22,Afghanistan,33.93911,67.709953,189045,0,7758,181287
8/15/22,Afghanistan,33.93911,67.709953,189343,0,7759,181584
8/16/22,Afghanistan,33.93911,67.709953,189477,0,7759,181718
8/17/22,Afghanistan,33.93911,67.709953,189710,0,7759,181951
8/18/22,Afghanistan,33.93911,67.709953,190010,0,7759,182251
8/19/22,Afghanistan,33.93911,67.709953,190254,0,7759,182495
8/20/22,Afghanistan,33.93911,67.709953,190435,0,7759,182676
8/21/22,Afghanistan,33.93911,67.709953,190643,0,7762,182881
8/22/22,Afghanistan,33.93911,67.709953,191040,0,7767,183273
8/23/22,Afghanistan,33.93911,67.709953,191247,0,7768,183479
8/24/22,Afghanistan,33.93911,67.709953,191585,0,7769,183816
8/25/22,Afghanistan,33.93911,67.709953,191967,0,7771,184196
8/26/22,Afghanistan,33.93911,67.709953,191967,0,7771,184196
8/27/22,Afghanistan,33.93911,67.709953,191967,0,7771,184196
8/28/22,Afghanistan,33.93911,67.709953,192463,0,7777,184686
8/29/22,Afghanistan,33.93911,67.709953,192906,0,7777,185129
8/30/22,Afghanistan,33.93911,67.709953,193004,0,7777,185227
8/31/22,Afghanistan,33.93911,67.709953,193250,0,7777,185473
9/1/22,Afghanistan,33.93911,67.709953,193520,0,7778,185742
9/2/22,Afghanistan,33.93911,67.709953,193520,0,7778,185742
9/3/22,Afghanistan,33.93911,67.709953,193912,0,7780,186132
9/4/22,Afghanistan,33.93911,67.709953,194163,0,7782,186381
9/5/22,Afghanistan,33.93911,67.709953,194355,0,7783,186572
9/6/22,Afghanistan,33.93911,67.709953,194614,0,7783,186831
9/7/22,Afghanistan,33.93911,67.709953,195012,0,7785,187227
9/8/22,Afghanistan,33.93911,67.709953,195298,0,7786,187512
9/9/22,Afghanistan,33.93911,67.709953,195471,0,7786,187685
9/10/22,Afghanistan,33.93911,67.709953,195631,0,7787,187844
9/11/22,Afghanistan,33.93911,67.709953,195925,0,7787,188138
9/12/22,Afghanistan,33.93911,67.709953,196182,0,7789,188393
9/13/22,Afghanistan,33.93911,67.709953,196404,0,7791,188613
9/14/22,Afghanistan,33.93911,67.709953,196751,0,7792,188959
9/15/22,Afghanistan,33.93911,67.709953,196870,0,7792,189078
9/16/22,Afghanistan,33.93911,67.709953,196992,0,7794,189198
9/17/22,Afghanistan,33.93911,67.709953,197066,0,7794,189272
9/18/22,Afghanistan,33.93911,67.709953,197240,0,7795,189445
9/19/22,Afghanistan,33.93911,67.709953,197434,0,7796,189638
9/20/22,Afghanistan,33.93911,67.709953,197608,0,7796,189812
9/21/22,Afghanistan,33.93911,67.709953,197788,0,7796,189992
9/22/22,Afghanistan,33.93911,67.709953,198023,0,7796,190227
9/23/22,Afghanistan,33.93911,67.709953,198163,0,7796,190367
9/24/22,Afghanistan,33.93911,67.709953,198244,0,7796,190448
9/25/22,Afghanistan,33.93911,67.709953,198416,0,7796,190620
9/26/22,Afghanistan,33.93911,67.709953,198543,0,7798,190745
9/27/22,Afghanistan,33.93911,67.709953,198750,0,7798,190952
9/28/22,Afghanistan,33.93911,67.709953,198876,0,7799,191077
9/29/22,Afghanistan,33.93911,67.709953,199067,0,7799,191268
9/30/22,Afghanistan,33.93911,67.709953,199188,0,7800,191388
10/1/22,Afghanistan,33.93911,67.709953,199310,0,7800,191510
10/2/22,Afghanistan,33.93911,67.709953,199386,0,7801,191585
10/3/22,Afghanistan,33.93911,67.709953,199545,0,7803,191742
10/4/22,Afghanistan,33.93911,67.709953,199690,0,7803,191887
10/5/22,Afghanistan,33.93911,67.709953,199845,0,7804,192041
10/6/22,Afghanistan,33.93911,67.709953,199994,0,7804,192190
10/7/22,Afghanistan,33.93911,67.709953,200130,0,7804,192326
10/8/22,Afghanistan,33.93911,67.709953,200202,0,7804,192398
10/9/22,Afghanistan,33.93911,67.709953,200372,0,7806,192566
10/10/22,Afghanistan,33.93911,67.709953,200469,0,7807,192662
10/11/22,Afghanistan,33.93911,67.709953,200626,0,7807,192819
10/12/22,Afghanistan,33.93911,67.709953,200729,0,7807,192922
10/13/22,Afghanistan,33.93911,67.709953,200846,0,7809,193037
10/14/22,Afghanistan,33.93911,67.709953,201014,0,7809,193205
10/15/22,Afghanistan,33.93911,67.709953,201096,0,7811,193285
10/16/22,Afghanistan,33.93911,67.709953,201212,0,7811,193401
10/17/22,Afghanistan,33.93911,67.709953,201276,0,7811,193465
10/18/22,Afghanistan,33.93911,67.709953,201503,0,7812,193691
10/19/22,Afghanistan,33.93911,67.709953,201557,0,7812,193745
10/20/22,Afghanistan,33.93911,67.709953,201750,0,7814,193936
10/21/22,Afghanistan,33.93911,67.709953,201949,0,7818,194131
10/22/22,Afghanistan,33.93911,67.709953,202026,0,7818,194208
10/23/22,Afghanistan,33.93911,67.709953,202108,0,7818,194290
10/24/22,Afghanistan,33.93911,67.709953,202199,0,7818,194381
10/25/22,Afghanistan,33.93911,67.709953,202347,0,7820,194527
10/26/22,Afghanistan,33.93911,67.709953,202509,0,7820,194689
10/27/22,Afghanistan,33.93911,67.709953,202608,0,7820,194788
10/28/22,Afghanistan,33.93911,67.709953,202756,0,7820,194936
10/29/22,Afghanistan,33.93911,67.709953,202834,0,7821,195013
10/30/22,Afghanistan,33.93911,67.709953,202966,0,7821,195145
10/31/22,Afghanistan,33.93911,67.709953,203063,0,7822,195241
11/1/22,Afghanistan,33.93911,67.709953,203167,0,7823,195344
11/2/22,Afghanistan,33.93911,67.709953,203265,0,7823,195442
11/3/22,Afghanistan,33.93911,67.709953,203395,0,7825,195570
11/4/22,Afghanistan,33.93911,67.709953,203497,0,7825,195672
11/5/22,Afghanistan,33.93911,67.709953,203574,0,7826,195748
11/6/22,Afghanistan,33.93911,67.709953,203681,0,7826,195855
11/7/22,Afghanistan,33.93911,67.709953,203829,0,7828,196001
11/8/22,Afghanistan,33.93911,67.709953,203942,0,7829,196113
11/9/22,Afghanistan,33.93911,67.709953,204094,0,7829,196265
11/10/22,Afghanistan,33.93911,67.709953,204287,0,7829,196458
11/11/22,Afghanistan,33.93911,67.709953,204392,0,7829,196563
11/12/22,Afghanistan,33.93911,67.709953,204417,0,7829,196588
11/13/22,Afghanistan,33.93911,67.709953,204510,0,7829,196681
11/14/22,Afghanistan,33.93911,67.709953,204610,0,7829,196781
11/15/22,Afghanistan,33.93911,67.709953,204724,0,7829,196895
11/16/22,Afghanistan,33.93911,67.709953,204820,0,7830,196990
11/17/22,Afghanistan,33.93911,67.709953,204982,0,7830,197152
11/18/22,Afghanistan,33.93911,67.709953,205009,0,7830,197179
11/19/22,Afghanistan,33.93911,67.709953,205039,0,7831,197208
11/20/22,Afghanistan,33.93911,67.709953,205146,0,7831,197315
11/21/22,Afghanistan,33.93911,67.709953,205229,0,7832,197397
11/22/22,Afghanistan,33.93911,67.709953,205324,0,7833,197491
11/23/22,Afghanistan,33.93911,67.709953,205391,0,7833,197558
11/24/22,Afghanistan,33.93911,67.709953,205506,0,7833,197673
11/25/22,Afghanistan,33.93911,67.709953,205541,0,7833,197708
11/26/22,Afghanistan,33.93911,67.709953,205612,0,7833,197779
11/27/22,Afghanistan,33.93911,67.709953,205612,0,7833,197779
11/28/22,Afghanistan,33.93911,67.709953,205802,0,7833,197969
11/29/22,Afghanistan,33.93911,67.709953,205830,0,7833,197997
11/30/22,Afghanistan,33.93911,67.709953,205907,0,7833,198074
12/1/22,Afghanistan,33.93911,67.709953,206073,0,7834,198239
12/2/22,Afghanistan,33.93911,67.709953,206133,0,7834,198299
12/3/22,Afghanistan,33.93911,67.709953,206145,0,7834,198311
12/4/22,Afghanistan,33.93911,67.709953,206206,0,7834,198372
12/5/22,Afghanistan,33.93911,67.709953,206273,0,7835,198438
12/6/22,Afghanistan,33.93911,67.709953,206331,0,7835,198496
12/7/22,Afghanistan,33.93911,67.709953,206414,0,7837,198577
12/8/22,Afghanistan,33.93911,67.709953,206465,0,7839,198626
12/9/22,Afghanistan,33.93911,67.709953,206504,0,7839,198665
12/10/22,Afghanistan,33.93911,67.709953,206543,0,7839,198704
12/11/22,Afghanistan,33.93911,67.709953,206603,0,7839,198764
12/12/22,Afghanistan,33.93911,67.709953,206702,0,7840,198862
12/13/22,Afghanistan,33.93911,67.709953,206743,0,7843,198900
12/14/22,Afghanistan,33.93911,67.709953,206788,0,7843,198945
12/15/22,Afghanistan,33.93911,67.709953,206879,0,7843,199036
12/16/22,Afghanistan,33.93911,67.709953,206912,0,7843,199069
12/17/22,Afghanistan,33.93911,67.709953,206943,0,7844,199099
1/1/22,Albania,41.1533,20.1683,210224,0,3217,207007
1/2/22,Albania,41.1533,20.1683,210885,0,3220,207665
1/3/22,Albania,41.1533,20.1683,210885,0,3220,207665
1/4/22,Albania,41.1533,20.1683,212021,0,3224,208797
1/5/22,Albania,41.1533,20.1683,212021,0,3224,208797
1/6/22,Albania,41.1533,20.1683,213257,0,3228,210029
1/7/22,Albania,41.1533,20.1683,214905,0,3233,211672
1/8/22,Albania,41.1533,20.1683,214905,0,3233,211672
1/9/22,Albania,41.1533,20.1683,219694,0,3240,216454
1/10/22,Albania,41.1533,20.1683,220487,0,3241,217246
1/11/22,Albania,41.1533,20.1683,222664,0,3247,219417
1/12/22,Albania,41.1533,20.1683,224569,0,3253,221316
1/13/22,Albania,41.1533,20.1683,226598,0,3255,223343
1/14/22,Albania,41.1533,20.1683,228777,0,3262,225515
1/15/22,Albania,41.1533,20.1683,230940,0,3265,227675
1/16/22,Albania,41.1533,20.1683,232637,0,3269,229368
1/17/22,Albania,41.1533,20.1683,233654,0,3271,230383
1/18/22,Albania,41.1533,20.1683,236486,0,3277,233209
1/19/22,Albania,41.1533,20.1683,239129,0,3283,235846
1/20/22,Albania,41.1533,20.1683,241512,0,3286,238226
1/21/22,Albania,41.1533,20.1683,244182,0,3292,240890
1/22/22,Albania,41.1533,20.1683,246412,0,3297,243115
1/23/22,Albania,41.1533,20.1683,248070,0,3305,244765
1/24/22,Albania,41.1533,20.1683,248070,0,3305,244765
1/25/22,Albania,41.1533,20.1683,248859,0,3312,245547
1/26/22,Albania,41.1533,20.1683,251015,0,3317,247698
1/27/22,Albania,41.1533,20.1683,252577,0,3323,249254
1/28/22,Albania,41.1533,20.1683,254126,0,3329,250797
1/29/22,Albania,41.1533,20.1683,254126,0,3329,250797
1/30/22,Albania,41.1533,20.1683,255741,0,3334,252407
1/31/22,Albania,41.1533,20.1683,258543,0,3346,255197
2/1/22,Albania,41.1533,20.1683,258543,0,3346,255197
2/2/22,Albania,41.1533,20.1683,261240,0,3362,257878
2/3/22,Albania,41.1533,20.1683,261240,0,3362,257878
2/4/22,Albania,41.1533,20.1683,263172,0,3371,259801
2/5/22,Albania,41.1533,20.1683,263172,0,3371,259801
2/6/22,Albania,41.1533,20.1683,264624,0,3380,261244
2/7/22,Albania,41.1533,20.1683,264875,0,3387,261488
2/8/22,Albania,41.1533,20.1683,265716,0,3393,262323
2/9/22,Albania,41.1533,20.1683,266416,0,3399,263017
2/10/22,Albania,41.1533,20.1683,267020,0,3402,263618
2/11/22,Albania,41.1533,20.1683,267020,0,3402,263618
2/12/22,Albania,41.1533,20.1683,267551,0,3407,264144
2/13/22,Albania,41.1533,20.1683,268008,0,3410,264598
2/14/22,Albania,41.1533,20.1683,268304,0,3414,264890
2/15/22,Albania,41.1533,20.1683,268491,0,3420,265071
2/16/22,Albania,41.1533,20.1683,268940,0,3423,265517
2/17/22,Albania,41.1533,20.1683,269301,0,3430,265871
2/18/22,Albania,41.1533,20.1683,269601,0,3432,266169
2/19/22,Albania,41.1533,20.1683,269904,0,3433,266471
2/20/22,Albania,41.1533,20.1683,270164,0,3438,266726
2/21/22,Albania,41.1533,20.1683,270370,0,3445,266925
2/22/22,Albania,41.1533,20.1683,270455,0,3451,267004
2/23/22,Albania,41.1533,20.1683,270734,0,3453,267281
2/24/22,Albania,41.1533,20.1683,270947,0,3457,267490
2/25/22,Albania,41.1533,20.1683,271141,0,3458,267683
2/26/22,Albania,41.1533,20.1683,271141,0,3458,267683
2/27/22,Albania,41.1533,20.1683,271527,0,3464,268063
2/28/22,Albania,41.1533,20.1683,271563,0,3469,268094
3/1/22,Albania,41.1533,20.1683,271702,0,3472,268230
3/2/22,Albania,41.1533,20.1683,271825,0,3474,268351
3/3/22,Albania,41.1533,20.1683,271825,0,3474,268351
3/4/22,Albania,41.1533,20.1683,272030,0,3478,268552
3/5/22,Albania,41.1533,20.1683,272030,0,3478,268552
3/6/22,Albania,41.1533,20.1683,272210,0,3482,268728
3/7/22,Albania,41.1533,20.1683,272250,0,3483,268767
3/8/22,Albania,41.1533,20.1683,272337,0,3483,268854
3/9/22,Albania,41.1533,20.1683,272412,0,3483,268929
3/10/22,Albania,41.1533,20.1683,272479,0,3484,268995
3/11/22,Albania,41.1533,20.1683,272552,0,3485,269067
3/12/22,Albania,41.1533,20.1683,272621,0,3485,269136
3/13/22,Albania,41.1533,20.1683,272663,0,3485,269178
3/14/22,Albania,41.1533,20.1683,272689,0,3485,269204
3/15/22,Albania,41.1533,20.1683,272711,0,3486,269225
3/16/22,Albania,41.1533,20.1683,272804,0,3487,269317
3/17/22,Albania,41.1533,20.1683,272885,0,3487,269398
3/18/22,Albania,41.1533,20.1683,272961,0,3487,269474
3/19/22,Albania,41.1533,20.1683,273040,0,3487,269553
3/20/22,Albania,41.1533,20.1683,273088,0,3487,269601
3/21/22,Albania,41.1533,20.1683,273088,0,3487,269601
3/22/22,Albania,41.1533,20.1683,273146,0,3489,269657
3/23/22,Albania,41.1533,20.1683,273164,0,3489,269675
3/24/22,Albania,41.1533,20.1683,273257,0,3489,269768
3/25/22,Albania,41.1533,20.1683,273318,0,3490,269828
3/26/22,Albania,41.1533,20.1683,273387,0,3491,269896
3/27/22,Albania,41.1533,20.1683,273432,0,3491,269941
3/28/22,Albania,41.1533,20.1683,273432,0,3491,269941
3/29/22,Albania,41.1533,20.1683,273529,0,3492,270037
3/30/22,Albania,41.1533,20.1683,273608,0,3492,270116
3/31/22,Albania,41.1533,20.1683,273677,0,3492,270185
4/1/22,Albania,41.1533,20.1683,273759,0,3492,270267
4/2/22,Albania,41.1533,20.1683,273823,0,3492,270331
4/3/22,Albania,41.1533,20.1683,273870,0,3492,270378
4/4/22,Albania,41.1533,20.1683,273913,0,3492,270421
4/5/22,Albania,41.1533,20.1683,274000,0,3492,270508
4/6/22,Albania,41.1533,20.1683,274055,0,3492,270563
4/7/22,Albania,41.1533,20.1683,274108,0,3492,270616
4/8/22,Albania,41.1533,20.1683,274136,0,3492,270644
4/9/22,Albania,41.1533,20.1683,274191,0,3492,270699
4/10/22,Albania,41.1533,20.1683,274219,0,3493,270726
4/11/22,Albania,41.1533,20.1683,274219,0,3493,270726
4/12/22,Albania,41.1533,20.1683,274272,0,3494,270778
4/13/22,Albania,41.1533,20.1683,274320,0,3494,270826
4/14/22,Albania,41.1533,20.1683,274376,0,3495,270881
4/15/22,Albania,41.1533,20.1683,274429,0,3495,270934
4/16/22,Albania,41.1533,20.1683,274462,0,3496,270966
4/17/22,Albania,41.1533,20.1683,274504,0,3496,271008
4/18/22,Albania,41.1533,20.1683,274520,0,3496,271024
4/19/22,Albania,41.1533,20.1683,274535,0,3496,271039
4/20/22,Albania,41.1533,20.1683,274606,0,3496,271110
4/21/22,Albania,41.1533,20.1683,274606,0,3496,271110
4/22/22,Albania,41.1533,20.1683,274737,0,3496,271241
4/23/22,Albania,41.1533,20.1683,274791,0,3496,271295
4/24/22,Albania,41.1533,20.1683,274828,0,3496,271332
4/25/22,Albania,41.1533,20.1683,274828,0,3496,271332
4/26/22,Albania,41.1533,20.1683,274862,0,3496,271366
4/27/22,Albania,41.1533,20.1683,274929,0,3496,271433
4/28/22,Albania,41.1533,20.1683,275002,0,3496,271506
4/29/22,Albania,41.1533,20.1683,275055,0,3496,271559
4/30/22,Albania,41.1533,20.1683,275107,0,3496,271611
5/1/22,Albania,41.1533,20.1683,275167,0,3496,271671
5/2/22,Albania,41.1533,20.1683,275177,0,3496,271681
5/3/22,Albania,41.1533,20.1683,275191,0,3496,271695
5/4/22,Albania,41.1533,20.1683,275211,0,3496,271715
5/5/22,Albania,41.1533,20.1683,275266,0,3496,271770
5/6/22,Albania,41.1533,20.1683,275310,0,3496,271814
5/7/22,Albania,41.1533,20.1683,275341,0,3496,271845
5/8/22,Albania,41.1533,20.1683,275366,0,3497,271869
5/9/22,Albania,41.1533,20.1683,275372,0,3497,271875
5/10/22,Albania,41.1533,20.1683,275416,0,3497,271919
5/11/22,Albania,41.1533,20.1683,275440,0,3497,271943
5/12/22,Albania,41.1533,20.1683,275485,0,3497,271988
5/13/22,Albania,41.1533,20.1683,275534,0,3497,272037
5/14/22,Albania,41.1533,20.1683,275574,0,3497,272077
5/15/22,Albania,41.1533,20.1683,275615,0,3497,272118
5/16/22,Albania,41.1533,20.1683,275621,0,3497,272124
5/17/22,Albania,41.1533,20.1683,275688,0,3497,272191
5/18/22,Albania,41.1533,20.1683,275732,0,3497,272235
5/19/22,Albania,41.1533,20.1683,275732,0,3497,272235
5/20/22,Albania,41.1533,20.1683,275732,0,3497,272235
5/21/22,Albania,41.1533,20.1683,275838,0,3497,272341
5/22/22,Albania,41.1533,20.1683,275864,0,3497,272367
5/23/22,Albania,41.1533,20.1683,275881,0,3497,272384
5/24/22,Albania,41.1533,20.1683,275939,0,3497,272442
5/25/22,Albania,41.1533,20.1683,275985,0,3497,272488
5/26/22,Albania,41.1533,20.1683,276012,0,3497,272515
5/27/22,Albania,41.1533,20.1683,276048,0,3497,272551
5/28/22,Albania,41.1533,20.1683,276081,0,3497,272584
5/29/22,Albania,41.1533,20.1683,276101,0,3497,272604
5/30/22,Albania,41.1533,20.1683,276101,0,3497,272604
5/31/22,Albania,41.1533,20.1683,276101,0,3497,272604
6/1/22,Albania,41.1533,20.1683,276221,0,3497,272724
6/2/22,Albania,41.1533,20.1683,276221,0,3497,272724
6/3/22,Albania,41.1533,20.1683,276310,0,3497,272813
6/4/22,Albania,41.1533,20.1683,276342,0,3497,272845
6/5/22,Albania,41.1533,20.1683,276401,0,3497,272904
6/6/22,Albania,41.1533,20.1683,276415,0,3497,272918
6/7/22,Albania,41.1533,20.1683,276468,0,3497,272971
6/8/22,Albania,41.1533,20.1683,276518,0,3497,273021
6/9/22,Albania,41.1533,20.1683,276583,0,3497,273086
6/10/22,Albania,41.1533,20.1683,276638,0,3497,273141
6/11/22,Albania,41.1533,20.1683,276690,0,3497,273193
6/12/22,Albania,41.1533,20.1683,276731,0,3497,273234
6/13/22,Albania,41.1533,20.1683,276731,0,3497,273234
6/14/22,Albania,41.1533,20.1683,276821,0,3497,273324
6/15/22,Albania,41.1533,20.1683,276821,0,3497,273324
6/16/22,Albania,41.1533,20.1683,276821,0,3497,273324
6/17/22,Albania,41.1533,20.1683,277141,0,3497,273644
6/18/22,Albania,41.1533,20.1683,277141,0,3497,273644
6/19/22,Albania,41.1533,20.1683,277409,0,3497,273912
6/20/22,Albania,41.1533,20.1683,277444,0,3497,273947
6/21/22,Albania,41.1533,20.1683,277663,0,3497,274166
6/22/22,Albania,41.1533,20.1683,277940,0,3497,274443
6/23/22,Albania,41.1533,20.1683,278211,0,3497,274714
6/24/22,Albania,41.1533,20.1683,278504,0,3497,275007
6/25/22,Albania,41.1533,20.1683,278793,0,3497,275296
6/26/22,Albania,41.1533,20.1683,279077,0,3497,275580
6/27/22,Albania,41.1533,20.1683,279077,0,3497,275580
6/28/22,Albania,41.1533,20.1683,279167,0,3498,275669
6/29/22,Albania,41.1533,20.1683,280298,0,3499,276799
6/30/22,Albania,41.1533,20.1683,280851,0,3500,277351
7/1/22,Albania,41.1533,20.1683,281470,0,3501,277969
7/2/22,Albania,41.1533,20.1683,282141,0,3501,278640
7/3/22,Albania,41.1533,20.1683,282690,0,3502,279188
7/4/22,Albania,41.1533,20.1683,282690,0,3502,279188
7/5/22,Albania,41.1533,20.1683,282690,0,3502,279188
7/6/22,Albania,41.1533,20.1683,283811,0,3506,280305
7/7/22,Albania,41.1533,20.1683,284758,0,3508,281250
7/8/22,Albania,41.1533,20.1683,285731,0,3510,282221
7/9/22,Albania,41.1533,20.1683,286732,0,3512,283220
7/10/22,Albania,41.1533,20.1683,287984,0,3514,284470
7/11/22,Albania,41.1533,20.1683,288176,0,3514,284662
7/12/22,Albania,41.1533,20.1683,289391,0,3516,285875
7/13/22,Albania,41.1533,20.1683,290954,0,3517,287437
7/14/22,Albania,41.1533,20.1683,290954,0,3517,287437
7/15/22,Albania,41.1533,20.1683,293917,0,3517,290400
7/16/22,Albania,41.1533,20.1683,295243,0,3517,291726
7/17/22,Albania,41.1533,20.1683,296305,0,3517,292788
7/18/22,Albania,41.1533,20.1683,296732,0,3518,293214
7/19/22,Albania,41.1533,20.1683,298578,0,3520,295058
7/20/22,Albania,41.1533,20.1683,300058,0,3521,296537
7/21/22,Albania,41.1533,20.1683,301394,0,3521,297873
7/22/22,Albania,41.1533,20.1683,302767,0,3523,299244
7/23/22,Albania,41.1533,20.1683,303925,0,3525,300400
7/24/22,Albania,41.1533,20.1683,304890,0,3527,301363
7/25/22,Albania,41.1533,20.1683,305123,0,3529,301594
7/26/22,Albania,41.1533,20.1683,306789,0,3532,303257
7/27/22,Albania,41.1533,20.1683,308050,0,3535,304515
7/28/22,Albania,41.1533,20.1683,309278,0,3538,305740
7/29/22,Albania,41.1533,20.1683,310362,0,3541,306821
7/30/22,Albania,41.1533,20.1683,311381,0,3543,307838
7/31/22,Albania,41.1533,20.1683,312097,0,3545,308552
8/1/22,Albania,41.1533,20.1683,312375,0,3548,308827
8/2/22,Albania,41.1533,20.1683,313582,0,3550,310032
8/3/22,Albania,41.1533,20.1683,314561,0,3551,311010
8/4/22,Albania,41.1533,20.1683,315337,0,3554,311783
8/5/22,Albania,41.1533,20.1683,316145,0,3557,312588
8/6/22,Albania,41.1533,20.1683,316976,0,3560,313416
8/7/22,Albania,41.1533,20.1683,317514,0,3563,313951
8/8/22,Albania,41.1533,20.1683,317681,0,3566,314115
8/9/22,Albania,41.1533,20.1683,318638,0,3566,315072
8/10/22,Albania,41.1533,20.1683,319444,0,3567,315877
8/11/22,Albania,41.1533,20.1683,320086,0,3568,316518
8/12/22,Albania,41.1533,20.1683,320781,0,3569,317212
8/13/22,Albania,41.1533,20.1683,321345,0,3570,317775
8/14/22,Albania,41.1533,20.1683,321804,0,3571,318233
8/15/22,Albania,41.1533,20.1683,322125,0,3571,318554
8/16/22,Albania,41.1533,20.1683,322837,0,3573,319264
8/17/22,Albania,41.1533,20.1683,323282,0,3574,319708
8/18/22,Albania,41.1533,20.1683,323829,0,3574,320255
8/19/22,Albania,41.1533,20.1683,325241,0,3575,321666
8/20/22,Albania,41.1533,20.1683,325736,0,3576,322160
8/21/22,Albania,41.1533,20.1683,326077,0,3576,322501
8/22/22,Albania,41.1533,20.1683,326181,0,3576,322605
8/23/22,Albania,41.1533,20.1683,326787,0,3577,323210
8/24/22,Albania,41.1533,20.1683,327232,0,3578,323654
8/25/22,Albania,41.1533,20.1683,327607,0,3579,324028
8/26/22,Albania,41.1533,20.1683,327961,0,3580,324381
8/27/22,Albania,41.1533,20.1683,328299,0,3581,324718
8/28/22,Albania,41.1533,20.1683,328515,0,3581,324934
8/29/22,Albania,41.1533,20.1683,328571,0,3581,324990
8/30/22,Albania,41.1533,20.1683,329017,0,3582,325435
8/31/22,Albania,41.1533,20.1683,329352,0,3582,325770
9/1/22,Albania,41.1533,20.1683,329615,0,3583,326032
9/2/22,Albania,41.1533,20.1683,329862,0,3583,326279
9/3/22,Albania,41.1533,20.1683,330062,0,3583,326479
9/4/22,Albania,41.1533,20.1683,330193,0,3583,326610
9/5/22,Albania,41.1533,20.1683,330221,0,3583,326638
9/6/22,Albania,41.1533,20.1683,330283,0,3583,326700
9/7/22,Albania,41.1533,20.1683,330516,0,3584,326932
9/8/22,Albania,41.1533,20.1683,330687,0,3584,327103
9/9/22,Albania,41.1533,20.1683,330842,0,3584,327258
9/10/22,Albania,41.1533,20.1683,330948,0,3584,327364
9/11/22,Albania,41.1533,20.1683,331036,0,3584,327452
9/12/22,Albania,41.1533,20.1683,331053,0,3585,327468
9/13/22,Albania,41.1533,20.1683,331191,0,3586,327605
9/14/22,Albania,41.1533,20.1683,331295,0,3586,327709
9/15/22,Albania,41.1533,20.1683,331384,0,3586,327798
9/16/22,Albania,41.1533,20.1683,331459,0,3586,327873
9/17/22,Albania,41.1533,20.1683,331540,0,3586,327954
9/18/22,Albania,41.1533,20.1683,331583,0,3586,327997
9/19/22,Albania,41.1533,20.1683,331601,0,3588,328013
9/20/22,Albania,41.1533,20.1683,331715,0,3589,328126
9/21/22,Albania,41.1533,20.1683,331810,0,3589,328221
9/22/22,Albania,41.1533,20.1683,331861,0,3589,328272
9/23/22,Albania,41.1533,20.1683,331908,0,3589,328319
9/24/22,Albania,41.1533,20.1683,331953,0,3589,328364
9/25/22,Albania,41.1533,20.1683,331976,0,3589,328387
9/26/22,Albania,41.1533,20.1683,331987,0,3589,328398
9/27/22,Albania,41.1533,20.1683,332066,0,3589,328477
9/28/22,Albania,41.1533,20.1683,332129,0,3589,328540
9/29/22,Albania,41.1533,20.1683,332173,0,3589,328584
9/30/22,Albania,41.1533,20.1683,332221,0,3589,328632
10/1/22,Albania,41.1533,20.1683,332263,0,3589,328674
10/2/22,Albania,41.1533,20.1683,332285,0,3589,328696
10/3/22,Albania,41.1533,20.1683,332290,0,3589,328701
10/4/22,Albania,41.1533,20.1683,332337,0,3589,328748
10/5/22,Albania,41.1533,20.1683,332372,0,3589,328783
10/6/22,Albania,41.1533,20.1683,332410,0,3589,328821
10/7/22,Albania,41.1533,20.1683,332443,0,3589,328854
10/8/22,Albania,41.1533,20.1683,332472,0,3589,328883
10/9/22,Albania,41.1533,20.1683,332494,0,3589,328905
10/10/22,Albania,41.1533,20.1683,332503,0,3589,328914
10/11/22,Albania,41.1533,20.1683,332534,0,3590,328944
10/12/22,Albania,41.1533,20.1683,332555,0,3591,328964
10/13/22,Albania,41.1533,20.1683,332579,0,3591,328988
10/14/22,Albania,41.1533,20.1683,332598,0,3591,329007
10/15/22,Albania,41.1533,20.1683,332619,0,3591,329028
10/16/22,Albania,41.1533,20.1683,332638,0,3591,329047
10/17/22,Albania,41.1533,20.1683,332645,0,3592,329053
10/18/22,Albania,41.1533,20.1683,332673,0,3592,329081
10/19/22,Albania,41.1533,20.1683,332701,0,3592,329109
10/20/22,Albania,41.1533,20.1683,332719,0,3592,329127
10/21/22,Albania,41.1533,20.1683,332739,0,3592,329147
10/22/22,Albania,41.1533,20.1683,332754,0,3592,329162
10/23/22,Albania,41.1533,20.1683,332772,0,3592,329180
10/24/22,Albania,41.1533,20.1683,332776,0,3592,329184
10/25/22,Albania,41.1533,20.1683,332816,0,3592,329224
10/26/22,Albania,41.1533,20.1683,332847,0,3593,329254
10/27/22,Albania,41.1533,20.1683,332889,0,3593,329296
10/28/22,Albania,41.1533,20.1683,332911,0,3593,329318
10/29/22,Albania,41.1533,20.1683,332949,0,3593,329356
10/30/22,Albania,41.1533,20.1683,332966,0,3593,329373
10/31/22,Albania,41.1533,20.1683,332966,0,3593,329373
11/1/22,Albania,41.1533,20.1683,332969,0,3593,329376
11/2/22,Albania,41.1533,20.1683,332996,0,3593,329403
11/3/22,Albania,41.1533,20.1683,332996,0,3593,329403
11/4/22,Albania,41.1533,20.1683,333027,0,3593,329434
11/5/22,Albania,41.1533,20.1683,333046,0,3593,329453
11/6/22,Albania,41.1533,20.1683,333055,0,3593,329462
11/7/22,Albania,41.1533,20.1683,333058,0,3593,329465
11/8/22,Albania,41.1533,20.1683,333071,0,3593,329478
11/9/22,Albania,41.1533,20.1683,333088,0,3593,329495
11/10/22,Albania,41.1533,20.1683,333103,0,3593,329510
11/11/22,Albania,41.1533,20.1683,333125,0,3593,329532
11/12/22,Albania,41.1533,20.1683,333138,0,3593,329545
11/13/22,Albania,41.1533,20.1683,333156,0,3593,329563
11/14/22,Albania,41.1533,20.1683,333161,0,3594,329567
11/15/22,Albania,41.1533,20.1683,333197,0,3594,329603
11/16/22,Albania,41.1533,20.1683,333215,0,3594,329621
11/17/22,Albania,41.1533,20.1683,333233,0,3594,329639
11/18/22,Albania,41.1533,20.1683,333233,0,3594,329639
11/19/22,Albania,41.1533,20.1683,333246,0,3594,329652
11/20/22,Albania,41.1533,20.1683,333256,0,3594,329662
11/21/22,Albania,41.1533,20.1683,333257,0,3594,329663
11/22/22,Albania,41.1533,20.1683,333282,0,3594,329688
11/23/22,Albania,41.1533,20.1683,333293,0,3594,329699
11/24/22,Albania,41.1533,20.1683,333305,0,3594,329711
11/25/22,Albania,41.1533,20.1683,333316,0,3594,329722
11/26/22,Albania,41.1533,20.1683,333322,0,3594,329728
11/27/22,Albania,41.1533,20.1683,333330,0,3594,329736
11/28/22,Albania,41.1533,20.1683,333330,0,3594,329736
11/29/22,Albania,41.1533,20.1683,333338,0,3594,329744
11/30/22,Albania,41.1533,20.1683,333343,0,3594,329749
12/1/22,Albania,41.1533,20.1683,333360,0,3594,329766
12/2/22,Albania,41.1533,20.1683,333381,0,3594,329787
12/3/22,Albania,41.1533,20.1683,333391,0,3594,329797
12/4/22,Albania,41.1533,20.1683,333408,0,3594,329814
12/5/22,Albania,41.1533,20.1683,333413,0,3594,329819
12/6/22,Albania,41.1533,20.1683,333455,0,3594,329861
12/7/22,Albania,41.1533,20.1683,333472,0,3594,329878
12/8/22,Albania,41.1533,20.1683,333490,0,3594,329896
12/9/22,Albania,41.1533,20.1683,333491,0,3594,329897
12/10/22,Albania,41.1533,20.1683,333521,0,3594,329927
12/11/22,Albania,41.1533,20.1683,333533,0,3594,329939
12/12/22,Albania,41.1533,20.1683,333535,0,3594,329941
12/13/22,Albania,41.1533,20.1683,333567,0,3594,329973
12/14/22,Albania,41.1533,20.1683,333591,0,3594,329997
12/15/22,Albania,41.1533,20.1683,333613,0,3594,330019
12/16/22,Albania,41.1533,20.1683,333635,0,3594,330041
12/17/22,Albania,41.1533,20.1683,333635,0,3594,330041
1/1/22,Algeria,28.0339,1.6596,218818,0,6284,212534
1/2/22,Algeria,28.0339,1.6596,219159,0,6291,212868
1/3/22,Algeria,28.0339,1.6596,219532,0,6298,213234
1/4/22,Algeria,28.0339,1.6596,219953,0,6303,213650
1/5/22,Algeria,28.0339,1.6596,220415,0,6310,214105
1/6/22,Algeria,28.0339,1.6596,220825,0,6318,214507
1/7/22,Algeria,28.0339,1.6596,221316,0,6325,214991
1/8/22,Algeria,28.0339,1.6596,221742,0,6330,215412
1/9/22,Algeria,28.0339,1.6596,222157,0,6339,215818
1/10/22,Algeria,28.0339,1.6596,222639,0,6349,216290
1/11/22,Algeria,28.0339,1.6596,223196,0,6363,216833
1/12/22,Algeria,28.0339,1.6596,223806,0,6372,217434
1/13/22,Algeria,28.0339,1.6596,224383,0,6383,218000
1/14/22,Algeria,28.0339,1.6596,224979,0,6393,218586
1/15/22,Algeria,28.0339,1.6596,225484,0,6404,219080
1/16/22,Algeria,28.0339,1.6596,226057,0,6412,219645
1/17/22,Algeria,28.0339,1.6596,226749,0,6423,220326
1/18/22,Algeria,28.0339,1.6596,227559,0,6435,221124
1/19/22,Algeria,28.0339,1.6596,228918,0,6443,222475
1/20/22,Algeria,28.0339,1.6596,230470,0,6453,224017
1/21/22,Algeria,28.0339,1.6596,232325,0,6468,225857
1/22/22,Algeria,28.0339,1.6596,234536,0,6481,228055
1/23/22,Algeria,28.0339,1.6596,236670,0,6495,230175
1/24/22,Algeria,28.0339,1.6596,238885,0,6508,232377
1/25/22,Algeria,28.0339,1.6596,241406,0,6516,234890
1/26/22,Algeria,28.0339,1.6596,243568,0,6526,237042
1/27/22,Algeria,28.0339,1.6596,245698,0,6539,239159
1/28/22,Algeria,28.0339,1.6596,247568,0,6545,241023
1/29/22,Algeria,28.0339,1.6596,249310,0,6555,242755
1/30/22,Algeria,28.0339,1.6596,250774,0,6566,244208
1/31/22,Algeria,28.0339,1.6596,252117,0,6579,245538
2/1/22,Algeria,28.0339,1.6596,253520,0,6593,246927
2/2/22,Algeria,28.0339,1.6596,254885,0,6604,248281
2/3/22,Algeria,28.0339,1.6596,255836,0,6618,249218
2/4/22,Algeria,28.0339,1.6596,256806,0,6631,250175
2/5/22,Algeria,28.0339,1.6596,257598,0,6640,250958
2/6/22,Algeria,28.0339,1.6596,257976,0,6646,251330
2/7/22,Algeria,28.0339,1.6596,258478,0,6654,251824
2/8/22,Algeria,28.0339,1.6596,259088,0,6667,252421
2/9/22,Algeria,28.0339,1.6596,259673,0,6678,252995
2/10/22,Algeria,28.0339,1.6596,260191,0,6690,253501
2/11/22,Algeria,28.0339,1.6596,260723,0,6703,254020
2/12/22,Algeria,28.0339,1.6596,261226,0,6715,254511
2/13/22,Algeria,28.0339,1.6596,261752,0,6729,255023
2/14/22,Algeria,28.0339,1.6596,262165,0,6744,255421
2/15/22,Algeria,28.0339,1.6596,262570,0,6753,255817
2/16/22,Algeria,28.0339,1.6596,262994,0,6762,256232
2/17/22,Algeria,28.0339,1.6596,263369,0,6772,256597
2/18/22,Algeria,28.0339,1.6596,263685,0,6780,256905
2/19/22,Algeria,28.0339,1.6596,263936,0,6787,257149
2/20/22,Algeria,28.0339,1.6596,264054,0,6797,257257
2/21/22,Algeria,28.0339,1.6596,264201,0,6805,257396
2/22/22,Algeria,28.0339,1.6596,264365,0,6812,257553
2/23/22,Algeria,28.0339,1.6596,264488,0,6816,257672
2/24/22,Algeria,28.0339,1.6596,264603,0,6820,257783
2/25/22,Algeria,28.0339,1.6596,264706,0,6823,257883
2/26/22,Algeria,28.0339,1.6596,264778,0,6828,257950
2/27/22,Algeria,28.0339,1.6596,264855,0,6831,258024
2/28/22,Algeria,28.0339,1.6596,264936,0,6835,258101
3/1/22,Algeria,28.0339,1.6596,265010,0,6840,258170
3/2/22,Algeria,28.0339,1.6596,265079,0,6843,258236
3/3/22,Algeria,28.0339,1.6596,265130,0,6848,258282
3/4/22,Algeria,28.0339,1.6596,265186,0,6852,258334
3/5/22,Algeria,28.0339,1.6596,265227,0,6853,258374
3/6/22,Algeria,28.0339,1.6596,265265,0,6855,258410
3/7/22,Algeria,28.0339,1.6596,265297,0,6857,258440
3/8/22,Algeria,28.0339,1.6596,265323,0,6858,258465
3/9/22,Algeria,28.0339,1.6596,265346,0,6860,258486
3/10/22,Algeria,28.0339,1.6596,265366,0,6861,258505
3/11/22,Algeria,28.0339,1.6596,265391,0,6861,258530
3/12/22,Algeria,28.0339,1.6596,265410,0,6862,258548
3/13/22,Algeria,28.0339,1.6596,265432,0,6864,258568
3/14/22,Algeria,28.0339,1.6596,265457,0,6866,258591
3/15/22,Algeria,28.0339,1.6596,265478,0,6868,258610
3/16/22,Algeria,28.0339,1.6596,265496,0,6869,258627
3/17/22,Algeria,28.0339,1.6596,265511,0,6870,258641
3/18/22,Algeria,28.0339,1.6596,265524,0,6871,258653
3/19/22,Algeria,28.0339,1.6596,265539,0,6871,258668
3/20/22,Algeria,28.0339,1.6596,265550,0,6871,258679
3/21/22,Algeria,28.0339,1.6596,265562,0,6872,258690
3/22/22,Algeria,28.0339,1.6596,265573,0,6873,258700
3/23/22,Algeria,28.0339,1.6596,265585,0,6873,258712
3/24/22,Algeria,28.0339,1.6596,265599,0,6873,258726
3/25/22,Algeria,28.0339,1.6596,265612,0,6873,258739
3/26/22,Algeria,28.0339,1.6596,265621,0,6873,258748
3/27/22,Algeria,28.0339,1.6596,265629,0,6873,258756
3/28/22,Algeria,28.0339,1.6596,265641,0,6873,258768
3/29/22,Algeria,28.0339,1.6596,265651,0,6874,258777
3/30/22,Algeria,28.0339,1.6596,265662,0,6874,258788
3/31/22,Algeria,28.0339,1.6596,265671,0,6874,258797
4/1/22,Algeria,28.0339,1.6596,265679,0,6874,258805
4/2/22,Algeria,28.0339,1.6596,265684,0,6874,258810
4/3/22,Algeria,28.0339,1.6596,265691,0,6874,258817
4/4/22,Algeria,28.0339,1.6596,265694,0,6874,258820
4/5/22,Algeria,28.0339,1.6596,265699,0,6874,258825
4/6/22,Algeria,28.0339,1.6596,265705,0,6874,258831
4/7/22,Algeria,28.0339,1.6596,265707,0,6874,258833
4/8/22,Algeria,28.0339,1.6596,265714,0,6874,258840
4/9/22,Algeria,28.0339,1.6596,265720,0,6874,258846
4/10/22,Algeria,28.0339,1.6596,265724,0,6874,258850
4/11/22,Algeria,28.0339,1.6596,265727,0,6874,258853
4/12/22,Algeria,28.0339,1.6596,265730,0,6874,258856
4/13/22,Algeria,28.0339,1.6596,265731,0,6874,258857
4/14/22,Algeria,28.0339,1.6596,265733,0,6874,258859
4/15/22,Algeria,28.0339,1.6596,265738,0,6874,258864
4/16/22,Algeria,28.0339,1.6596,265739,0,6874,258865
4/17/22,Algeria,28.0339,1.6596,265739,0,6874,258865
4/18/22,Algeria,28.0339,1.6596,265741,0,6874,258867
4/19/22,Algeria,28.0339,1.6596,265746,0,6874,258872
4/20/22,Algeria,28.0339,1.6596,265746,0,6874,258872
4/21/22,Algeria,28.0339,1.6596,265754,0,6874,258880
4/22/22,Algeria,28.0339,1.6596,265761,0,6874,258887
4/23/22,Algeria,28.0339,1.6596,265761,0,6874,258887
4/24/22,Algeria,28.0339,1.6596,265767,0,6875,258892
4/25/22,Algeria,28.0339,1.6596,265771,0,6875,258896
4/26/22,Algeria,28.0339,1.6596,265772,0,6875,258897
4/27/22,Algeria,28.0339,1.6596,265773,0,6875,258898
4/28/22,Algeria,28.0339,1.6596,265776,0,6875,258901
4/29/22,Algeria,28.0339,1.6596,265779,0,6875,258904
4/30/22,Algeria,28.0339,1.6596,265780,0,6875,258905
5/1/22,Algeria,28.0339,1.6596,265782,0,6875,258907
5/2/22,Algeria,28.0339,1.6596,265782,0,6875,258907
5/3/22,Algeria,28.0339,1.6596,265782,0,6875,258907
5/4/22,Algeria,28.0339,1.6596,265782,0,6875,258907
5/5/22,Algeria,28.0339,1.6596,265786,0,6875,258911
5/6/22,Algeria,28.0339,1.6596,265791,0,6875,258916
5/7/22,Algeria,28.0339,1.6596,265794,0,6875,258919
5/8/22,Algeria,28.0339,1.6596,265798,0,6875,258923
5/9/22,Algeria,28.0339,1.6596,265800,0,6875,258925
5/10/22,Algeria,28.0339,1.6596,265804,0,6875,258929
5/11/22,Algeria,28.0339,1.6596,265806,0,6875,258931
5/12/22,Algeria,28.0339,1.6596,265808,0,6875,258933
5/13/22,Algeria,28.0339,1.6596,265814,0,6875,258939
5/14/22,Algeria,28.0339,1.6596,265816,0,6875,258941
5/15/22,Algeria,28.0339,1.6596,265818,0,6875,258943
5/16/22,Algeria,28.0339,1.6596,265823,0,6875,258948
5/17/22,Algeria,28.0339,1.6596,265828,0,6875,258953
5/18/22,Algeria,28.0339,1.6596,265834,0,6875,258959
5/19/22,Algeria,28.0339,1.6596,265841,0,6875,258966
5/20/22,Algeria,28.0339,1.6596,265847,0,6875,258972
5/21/22,Algeria,28.0339,1.6596,265851,0,6875,258976
5/22/22,Algeria,28.0339,1.6596,265854,0,6875,258979
5/23/22,Algeria,28.0339,1.6596,265855,0,6875,258980
5/24/22,Algeria,28.0339,1.6596,265860,0,6875,258985
5/25/22,Algeria,28.0339,1.6596,265862,0,6875,258987
5/26/22,Algeria,28.0339,1.6596,265864,0,6875,258989
5/27/22,Algeria,28.0339,1.6596,265870,0,6875,258995
5/28/22,Algeria,28.0339,1.6596,265873,0,6875,258998
5/29/22,Algeria,28.0339,1.6596,265873,0,6875,258998
5/30/22,Algeria,28.0339,1.6596,265877,0,6875,259002
5/31/22,Algeria,28.0339,1.6596,265884,0,6875,259009
6/1/22,Algeria,28.0339,1.6596,265887,0,6875,259012
6/2/22,Algeria,28.0339,1.6596,265889,0,6875,259014
6/3/22,Algeria,28.0339,1.6596,265889,0,6875,259014
6/4/22,Algeria,28.0339,1.6596,265889,0,6875,259014
6/5/22,Algeria,28.0339,1.6596,265897,0,6875,259022
6/6/22,Algeria,28.0339,1.6596,265900,0,6875,259025
6/7/22,Algeria,28.0339,1.6596,265904,0,6875,259029
6/8/22,Algeria,28.0339,1.6596,265909,0,6875,259034
6/9/22,Algeria,28.0339,1.6596,265920,0,6875,259045
6/10/22,Algeria,28.0339,1.6596,265925,0,6875,259050
6/11/22,Algeria,28.0339,1.6596,265925,0,6875,259050
6/12/22,Algeria,28.0339,1.6596,265927,0,6875,259052
6/13/22,Algeria,28.0339,1.6596,265937,0,6875,259062
6/14/22,Algeria,28.0339,1.6596,265943,0,6875,259068
6/15/22,Algeria,28.0339,1.6596,265952,0,6875,259077
6/16/22,Algeria,28.0339,1.6596,265964,0,6875,259089
6/17/22,Algeria,28.0339,1.6596,265968,0,6875,259093
6/18/22,Algeria,28.0339,1.6596,265971,0,6875,259096
6/19/22,Algeria,28.0339,1.6596,265975,0,6875,259100
6/20/22,Algeria,28.0339,1.6596,265985,0,6875,259110
6/21/22,Algeria,28.0339,1.6596,265993,0,6875,259118
6/22/22,Algeria,28.0339,1.6596,266006,0,6875,259131
6/23/22,Algeria,28.0339,1.6596,266015,0,6875,259140
6/24/22,Algeria,28.0339,1.6596,266025,0,6875,259150
6/25/22,Algeria,28.0339,1.6596,266030,0,6875,259155
6/26/22,Algeria,28.0339,1.6596,266038,0,6875,259163
6/27/22,Algeria,28.0339,1.6596,266049,0,6875,259174
6/28/22,Algeria,28.0339,1.6596,266062,0,6875,259187
6/29/22,Algeria,28.0339,1.6596,266073,0,6875,259198
6/30/22,Algeria,28.0339,1.6596,266087,0,6875,259212
7/1/22,Algeria,28.0339,1.6596,266105,0,6875,259230
7/2/22,Algeria,28.0339,1.6596,266115,0,6875,259240
7/3/22,Algeria,28.0339,1.6596,266128,0,6875,259253
7/4/22,Algeria,28.0339,1.6596,266173,0,6875,259298
7/5/22,Algeria,28.0339,1.6596,266173,0,6875,259298
7/6/22,Algeria,28.0339,1.6596,266181,0,6875,259306
7/7/22,Algeria,28.0339,1.6596,266202,0,6875,259327
7/8/22,Algeria,28.0339,1.6596,266228,0,6875,259353
7/9/22,Algeria,28.0339,1.6596,266246,0,6875,259371
7/10/22,Algeria,28.0339,1.6596,266257,0,6875,259382
7/11/22,Algeria,28.0339,1.6596,266274,0,6875,259399
7/12/22,Algeria,28.0339,1.6596,266303,0,6875,259428
7/13/22,Algeria,28.0339,1.6596,266328,0,6875,259453
7/14/22,Algeria,28.0339,1.6596,266356,0,6875,259481
7/15/22,Algeria,28.0339,1.6596,266392,0,6875,259517
7/16/22,Algeria,28.0339,1.6596,266424,0,6875,259549
7/17/22,Algeria,28.0339,1.6596,266445,0,6875,259570
7/18/22,Algeria,28.0339,1.6596,266487,0,6875,259612
7/19/22,Algeria,28.0339,1.6596,266542,0,6875,259667
7/20/22,Algeria,28.0339,1.6596,266591,0,6875,259716
7/21/22,Algeria,28.0339,1.6596,266654,0,6875,259779
7/22/22,Algeria,28.0339,1.6596,266700,0,6875,259825
7/23/22,Algeria,28.0339,1.6596,266772,0,6875,259897
7/24/22,Algeria,28.0339,1.6596,266839,0,6876,259963
7/25/22,Algeria,28.0339,1.6596,266916,0,6876,260040
7/26/22,Algeria,28.0339,1.6596,267010,0,6876,260134
7/27/22,Algeria,28.0339,1.6596,267096,0,6876,260220
7/28/22,Algeria,28.0339,1.6596,267194,0,6876,260318
7/29/22,Algeria,28.0339,1.6596,267287,0,6876,260411
7/30/22,Algeria,28.0339,1.6596,267374,0,6876,260498
7/31/22,Algeria,28.0339,1.6596,267454,0,6876,260578
8/1/22,Algeria,28.0339,1.6596,267546,0,6876,260670
8/2/22,Algeria,28.0339,1.6596,267657,0,6876,260781
8/3/22,Algeria,28.0339,1.6596,267777,0,6876,260901
8/4/22,Algeria,28.0339,1.6596,267902,0,6877,261025
8/5/22,Algeria,28.0339,1.6596,268033,0,6878,261155
8/6/22,Algeria,28.0339,1.6596,268141,0,6878,261263
8/7/22,Algeria,28.0339,1.6596,268254,0,6878,261376
8/8/22,Algeria,28.0339,1.6596,268356,0,6878,261478
8/9/22,Algeria,28.0339,1.6596,268478,0,6878,261600
8/10/22,Algeria,28.0339,1.6596,268584,0,6878,261706
8/11/22,Algeria,28.0339,1.6596,268718,0,6878,261840
8/12/22,Algeria,28.0339,1.6596,268866,0,6878,261988
8/13/22,Algeria,28.0339,1.6596,269008,0,6878,262130
8/14/22,Algeria,28.0339,1.6596,269141,0,6878,262263
8/15/22,Algeria,28.0339,1.6596,269269,0,6878,262391
8/16/22,Algeria,28.0339,1.6596,269381,0,6878,262503
8/17/22,Algeria,28.0339,1.6596,269473,0,6878,262595
8/18/22,Algeria,28.0339,1.6596,269556,0,6878,262678
8/19/22,Algeria,28.0339,1.6596,269650,0,6878,262772
8/20/22,Algeria,28.0339,1.6596,269731,0,6878,262853
8/21/22,Algeria,28.0339,1.6596,269805,0,6878,262927
8/22/22,Algeria,28.0339,1.6596,269894,0,6878,263016
8/23/22,Algeria,28.0339,1.6596,269971,0,6878,263093
8/24/22,Algeria,28.0339,1.6596,270043,0,6878,263165
8/25/22,Algeria,28.0339,1.6596,270097,0,6878,263219
8/26/22,Algeria,28.0339,1.6596,270145,0,6878,263267
8/27/22,Algeria,28.0339,1.6596,270175,0,6878,263297
8/28/22,Algeria,28.0339,1.6596,270194,0,6878,263316
8/29/22,Algeria,28.0339,1.6596,270235,0,6878,263357
8/30/22,Algeria,28.0339,1.6596,270272,0,6878,263394
8/31/22,Algeria,28.0339,1.6596,270304,0,6878,263426
9/1/22,Algeria,28.0339,1.6596,270359,0,6878,263481
9/2/22,Algeria,28.0339,1.6596,270405,0,6878,263527
9/3/22,Algeria,28.0339,1.6596,270426,0,6878,263548
9/4/22,Algeria,28.0339,1.6596,270443,0,6879,263564
9/5/22,Algeria,28.0339,1.6596,270461,0,6879,263582
9/6/22,Algeria,28.0339,1.6596,270476,0,6879,263597
9/7/22,Algeria,28.0339,1.6596,270489,0,6879,263610
9/8/22,Algeria,28.0339,1.6596,270507,0,6879,263628
9/9/22,Algeria,28.0339,1.6596,270522,0,6879,263643
9/10/22,Algeria,28.0339,1.6596,270532,0,6879,263653
9/11/22,Algeria,28.0339,1.6596,270539,0,6879,263660
9/12/22,Algeria,28.0339,1.6596,270551,0,6879,263672
9/13/22,Algeria,28.0339,1.6596,270551,0,6879,263672
9/14/22,Algeria,28.0339,1.6596,270570,0,6879,263691
9/15/22,Algeria,28.0339,1.6596,270584,0,6879,263705
9/16/22,Algeria,28.0339,1.6596,270599,0,6879,263720
9/17/22,Algeria,28.0339,1.6596,270606,0,6879,263727
9/18/22,Algeria,28.0339,1.6596,270609,0,6879,263730
9/19/22,Algeria,28.0339,1.6596,270612,0,6879,263733
9/20/22,Algeria,28.0339,1.6596,270612,0,6879,263733
9/21/22,Algeria,28.0339,1.6596,270619,0,6879,263740
9/22/22,Algeria,28.0339,1.6596,270625,0,6879,263746
9/23/22,Algeria,28.0339,1.6596,270631,0,6879,263752
9/24/22,Algeria,28.0339,1.6596,270637,0,6879,263758
9/25/22,Algeria,28.0339,1.6596,270641,0,6879,263762
9/26/22,Algeria,28.0339,1.6596,270649,0,6879,263770
9/27/22,Algeria,28.0339,1.6596,270654,0,6879,263775
9/28/22,Algeria,28.0339,1.6596,270662,0,6879,263783
9/29/22,Algeria,28.0339,1.6596,270668,0,6879,263789
9/30/22,Algeria,28.0339,1.6596,270673,0,6879,263794
10/1/22,Algeria,28.0339,1.6596,270676,0,6879,263797
10/2/22,Algeria,28.0339,1.6596,270679,0,6879,263800
10/3/22,Algeria,28.0339,1.6596,270682,0,6879,263803
10/4/22,Algeria,28.0339,1.6596,270690,0,6879,263811
10/5/22,Algeria,28.0339,1.6596,270693,0,6879,263814
10/6/22,Algeria,28.0339,1.6596,270697,0,6881,263816
10/7/22,Algeria,28.0339,1.6596,270701,0,6881,263820
10/8/22,Algeria,28.0339,1.6596,270701,0,6881,263820
10/9/22,Algeria,28.0339,1.6596,270707,0,6881,263826
10/10/22,Algeria,28.0339,1.6596,270713,0,6881,263832
10/11/22,Algeria,28.0339,1.6596,270716,0,6881,263835
10/12/22,Algeria,28.0339,1.6596,270722,0,6881,263841
10/13/22,Algeria,28.0339,1.6596,270722,0,6881,263841
10/14/22,Algeria,28.0339,1.6596,270734,0,6881,263853
10/15/22,Algeria,28.0339,1.6596,270734,0,6881,263853
10/16/22,Algeria,28.0339,1.6596,270740,0,6881,263859
10/17/22,Algeria,28.0339,1.6596,270757,0,6881,263876
10/18/22,Algeria,28.0339,1.6596,270766,0,6881,263885
10/19/22,Algeria,28.0339,1.6596,270768,0,6881,263887
10/20/22,Algeria,28.0339,1.6596,270769,0,6881,263888
10/21/22,Algeria,28.0339,1.6596,270771,0,6881,263890
10/22/22,Algeria,28.0339,1.6596,270771,0,6881,263890
10/23/22,Algeria,28.0339,1.6596,270783,0,6881,263902
10/24/22,Algeria,28.0339,1.6596,270788,0,6881,263907
10/25/22,Algeria,28.0339,1.6596,270800,0,6881,263919
10/26/22,Algeria,28.0339,1.6596,270810,0,6881,263929
10/27/22,Algeria,28.0339,1.6596,270817,0,6881,263936
10/28/22,Algeria,28.0339,1.6596,270826,0,6881,263945
10/29/22,Algeria,28.0339,1.6596,270829,0,6881,263948
10/30/22,Algeria,28.0339,1.6596,270836,0,6881,263955
10/31/22,Algeria,28.0339,1.6596,270838,0,6881,263957
11/1/22,Algeria,28.0339,1.6596,270839,0,6881,263958
11/2/22,Algeria,28.0339,1.6596,270840,0,6881,263959
11/3/22,Algeria,28.0339,1.6596,270847,0,6881,263966
11/4/22,Algeria,28.0339,1.6596,270856,0,6881,263975
11/5/22,Algeria,28.0339,1.6596,270862,0,6881,263981
11/6/22,Algeria,28.0339,1.6596,270873,0,6881,263992
11/7/22,Algeria,28.0339,1.6596,270881,0,6881,264000
11/8/22,Algeria,28.0339,1.6596,270891,0,6881,264010
11/9/22,Algeria,28.0339,1.6596,270906,0,6881,264025
11/10/22,Algeria,28.0339,1.6596,270917,0,6881,264036
11/11/22,Algeria,28.0339,1.6596,270924,0,6881,264043
11/12/22,Algeria,28.0339,1.6596,270929,0,6881,264048
11/13/22,Algeria,28.0339,1.6596,270939,0,6881,264058
11/14/22,Algeria,28.0339,1.6596,270952,0,6881,264071
11/15/22,Algeria,28.0339,1.6596,270969,0,6881,264088
11/16/22,Algeria,28.0339,1.6596,270981,0,6881,264100
11/17/22,Algeria,28.0339,1.6596,270996,0,6881,264115
11/18/22,Algeria,28.0339,1.6596,270996,0,6881,264115
11/19/22,Algeria,28.0339,1.6596,271011,0,6881,264130
11/20/22,Algeria,28.0339,1.6596,271023,0,6881,264142
11/21/22,Algeria,28.0339,1.6596,271028,0,6881,264147
11/22/22,Algeria,28.0339,1.6596,271035,0,6881,264154
11/23/22,Algeria,28.0339,1.6596,271041,0,6881,264160
11/24/22,Algeria,28.0339,1.6596,271050,0,6881,264169
11/25/22,Algeria,28.0339,1.6596,271057,0,6881,264176
11/26/22,Algeria,28.0339,1.6596,271061,0,6881,264180
11/27/22,Algeria,28.0339,1.6596,271061,0,6881,264180
11/28/22,Algeria,28.0339,1.6596,271079,0,6881,264198
11/29/22,Algeria,28.0339,1.6596,271082,0,6881,264201
11/30/22,Algeria,28.0339,1.6596,271090,0,6881,264209
12/1/22,Algeria,28.0339,1.6596,271096,0,6881,264215
12/2/22,Algeria,28.0339,1.6596,271100,0,6881,264219
12/3/22,Algeria,28.0339,1.6596,271102,0,6881,264221
12/4/22,Algeria,28.0339,1.6596,271107,0,6881,264226
12/5/22,Algeria,28.0339,1.6596,271113,0,6881,264232
12/6/22,Algeria,28.0339,1.6596,271122,0,6881,264241
12/7/22,Algeria,28.0339,1.6596,271128,0,6881,264247
12/8/22,Algeria,28.0339,1.6596,271135,0,6881,264254
12/9/22,Algeria,28.0339,1.6596,271140,0,6881,264259
12/10/22,Algeria,28.0339,1.6596,271146,0,6881,264265
12/11/22,Algeria,28.0339,1.6596,271146,0,6881,264265
12/12/22,Algeria,28.0339,1.6596,271147,0,6881,264266
12/13/22,Algeria,28.0339,1.6596,271149,0,6881,264268
12/14/22,Algeria,28.0339,1.6596,271156,0,6881,264275
12/15/22,Algeria,28.0339,1.6596,271156,0,6881,264275
12/16/22,Algeria,28.0339,1.6596,271156,0,6881,264275
12/17/22,Algeria,28.0339,1.6596,271168,0,6881,264287
1/1/22,Andorra,42.5063,1.5218,23740,0,140,23600
1/2/22,Andorra,42.5063,1.5218,23740,0,140,23600
1/3/22,Andorra,42.5063,1.5218,24502,0,140,24362
1/4/22,Andorra,42.5063,1.5218,24802,0,141,24661
1/5/22,Andorra,42.5063,1.5218,25289,0,141,25148
1/6/22,Andorra,42.5063,1.5218,25289,0,141,25148
1/7/22,Andorra,42.5063,1.5218,26408,0,141,26267
1/8/22,Andorra,42.5063,1.5218,26408,0,141,26267
1/9/22,Andorra,42.5063,1.5218,26408,0,141,26267
1/10/22,Andorra,42.5063,1.5218,27983,0,141,27842
1/11/22,Andorra,42.5063,1.5218,28542,0,141,28401
1/12/22,Andorra,42.5063,1.5218,28899,0,141,28758
1/13/22,Andorra,42.5063,1.5218,28899,0,141,28758
1/14/22,Andorra,42.5063,1.5218,29888,0,142,29746
1/15/22,Andorra,42.5063,1.5218,29888,0,142,29746
1/16/22,Andorra,42.5063,1.5218,29888,0,142,29746
1/17/22,Andorra,42.5063,1.5218,29888,0,142,29746
1/18/22,Andorra,42.5063,1.5218,29888,0,142,29746
1/19/22,Andorra,42.5063,1.5218,29888,0,142,29746
1/20/22,Andorra,42.5063,1.5218,32201,0,144,32057
1/21/22,Andorra,42.5063,1.5218,33025,0,144,32881
1/22/22,Andorra,42.5063,1.5218,33025,0,144,32881
1/23/22,Andorra,42.5063,1.5218,33025,0,144,32881
1/24/22,Andorra,42.5063,1.5218,33025,0,144,32881
1/25/22,Andorra,42.5063,1.5218,34701,0,145,34556
1/26/22,Andorra,42.5063,1.5218,35028,0,145,34883
1/27/22,Andorra,42.5063,1.5218,35028,0,145,34883
1/28/22,Andorra,42.5063,1.5218,35556,0,145,35411
1/29/22,Andorra,42.5063,1.5218,35556,0,145,35411
1/30/22,Andorra,42.5063,1.5218,35556,0,145,35411
1/31/22,Andorra,42.5063,1.5218,35958,0,145,35813
2/1/22,Andorra,42.5063,1.5218,35958,0,145,35813
2/2/22,Andorra,42.5063,1.5218,36315,0,146,36169
2/3/22,Andorra,42.5063,1.5218,36470,0,147,36323
2/4/22,Andorra,42.5063,1.5218,36599,0,147,36452
2/5/22,Andorra,42.5063,1.5218,36599,0,147,36452
2/6/22,Andorra,42.5063,1.5218,36599,0,147,36452
2/7/22,Andorra,42.5063,1.5218,36808,0,147,36661
2/8/22,Andorra,42.5063,1.5218,36808,0,147,36661
2/9/22,Andorra,42.5063,1.5218,36989,0,148,36841
2/10/22,Andorra,42.5063,1.5218,37074,0,148,36926
2/11/22,Andorra,42.5063,1.5218,37140,0,148,36992
2/12/22,Andorra,42.5063,1.5218,37140,0,148,36992
2/13/22,Andorra,42.5063,1.5218,37140,0,148,36992
2/14/22,Andorra,42.5063,1.5218,37277,0,149,37128
2/15/22,Andorra,42.5063,1.5218,37361,0,150,37211
2/16/22,Andorra,42.5063,1.5218,37452,0,150,37302
2/17/22,Andorra,42.5063,1.5218,37522,0,150,37372
2/18/22,Andorra,42.5063,1.5218,37589,0,150,37439
2/19/22,Andorra,42.5063,1.5218,37589,0,150,37439
2/20/22,Andorra,42.5063,1.5218,37589,0,150,37439
2/21/22,Andorra,42.5063,1.5218,37589,0,150,37439
2/22/22,Andorra,42.5063,1.5218,37820,0,151,37669
2/23/22,Andorra,42.5063,1.5218,37901,0,151,37750
2/24/22,Andorra,42.5063,1.5218,37958,0,151,37807
2/25/22,Andorra,42.5063,1.5218,37999,0,151,37848
2/26/22,Andorra,42.5063,1.5218,37999,0,151,37848
2/27/22,Andorra,42.5063,1.5218,37999,0,151,37848
2/28/22,Andorra,42.5063,1.5218,37999,0,151,37848
3/1/22,Andorra,42.5063,1.5218,38165,0,151,38014
3/2/22,Andorra,42.5063,1.5218,38249,0,151,38098
3/3/22,Andorra,42.5063,1.5218,38342,0,151,38191
3/4/22,Andorra,42.5063,1.5218,38434,0,151,38283
3/5/22,Andorra,42.5063,1.5218,38434,0,151,38283
3/6/22,Andorra,42.5063,1.5218,38434,0,151,38283
3/7/22,Andorra,42.5063,1.5218,38620,0,151,38469
3/8/22,Andorra,42.5063,1.5218,38710,0,152,38558
3/9/22,Andorra,42.5063,1.5218,38794,0,152,38642
3/10/22,Andorra,42.5063,1.5218,38794,0,152,38642
3/11/22,Andorra,42.5063,1.5218,38794,0,152,38642
3/12/22,Andorra,42.5063,1.5218,38794,0,152,38642
3/13/22,Andorra,42.5063,1.5218,38794,0,152,38642
3/14/22,Andorra,42.5063,1.5218,38794,0,152,38642
3/15/22,Andorra,42.5063,1.5218,38794,0,152,38642
3/16/22,Andorra,42.5063,1.5218,38794,0,152,38642
3/17/22,Andorra,42.5063,1.5218,39234,0,153,39081
3/18/22,Andorra,42.5063,1.5218,39234,0,153,39081
3/19/22,Andorra,42.5063,1.5218,39234,0,153,39081
3/20/22,Andorra,42.5063,1.5218,39234,0,153,39081
3/21/22,Andorra,42.5063,1.5218,39234,0,153,39081
3/22/22,Andorra,42.5063,1.5218,39234,0,153,39081
3/23/22,Andorra,42.5063,1.5218,39713,0,153,39560
3/24/22,Andorra,42.5063,1.5218,39713,0,155,39558
3/25/22,Andorra,42.5063,1.5218,39713,0,153,39560
3/26/22,Andorra,42.5063,1.5218,39713,0,153,39560
3/27/22,Andorra,42.5063,1.5218,39713,0,153,39560
3/28/22,Andorra,42.5063,1.5218,39713,0,153,39560
3/29/22,Andorra,42.5063,1.5218,39713,0,153,39560
3/30/22,Andorra,42.5063,1.5218,40024,0,153,39871
3/31/22,Andorra,42.5063,1.5218,40024,0,153,39871
4/1/22,Andorra,42.5063,1.5218,40024,0,153,39871
4/2/22,Andorra,42.5063,1.5218,40024,0,153,39871
4/3/22,Andorra,42.5063,1.5218,40024,0,153,39871
4/4/22,Andorra,42.5063,1.5218,40024,0,153,39871
4/5/22,Andorra,42.5063,1.5218,40024,0,153,39871
4/6/22,Andorra,42.5063,1.5218,40024,0,153,39871
4/7/22,Andorra,42.5063,1.5218,40328,0,153,40175
4/8/22,Andorra,42.5063,1.5218,40328,0,153,40175
4/9/22,Andorra,42.5063,1.5218,40328,0,153,40175
4/10/22,Andorra,42.5063,1.5218,40328,0,153,40175
4/11/22,Andorra,42.5063,1.5218,40328,0,153,40175
4/12/22,Andorra,42.5063,1.5218,40328,0,153,40175
4/13/22,Andorra,42.5063,1.5218,40709,0,153,40556
4/14/22,Andorra,42.5063,1.5218,40709,0,153,40556
4/15/22,Andorra,42.5063,1.5218,40709,0,153,40556
4/16/22,Andorra,42.5063,1.5218,40709,0,153,40556
4/17/22,Andorra,42.5063,1.5218,40709,0,153,40556
4/18/22,Andorra,42.5063,1.5218,40709,0,153,40556
4/19/22,Andorra,42.5063,1.5218,40709,0,153,40556
4/20/22,Andorra,42.5063,1.5218,41013,0,153,40860
4/21/22,Andorra,42.5063,1.5218,41013,0,153,40860
4/22/22,Andorra,42.5063,1.5218,41013,0,153,40860
4/23/22,Andorra,42.5063,1.5218,41013,0,153,40860
4/24/22,Andorra,42.5063,1.5218,41013,0,153,40860
4/25/22,Andorra,42.5063,1.5218,41013,0,153,40860
4/26/22,Andorra,42.5063,1.5218,41013,0,153,40860
4/27/22,Andorra,42.5063,1.5218,41013,0,153,40860
4/28/22,Andorra,42.5063,1.5218,41349,0,153,41196
4/29/22,Andorra,42.5063,1.5218,41349,0,153,41196
4/30/22,Andorra,42.5063,1.5218,41349,0,153,41196
5/1/22,Andorra,42.5063,1.5218,41349,0,153,41196
5/2/22,Andorra,42.5063,1.5218,41349,0,153,41196
5/3/22,Andorra,42.5063,1.5218,41349,0,153,41196
5/4/22,Andorra,42.5063,1.5218,41717,0,153,41564
5/5/22,Andorra,42.5063,1.5218,41717,0,153,41564
5/6/22,Andorra,42.5063,1.5218,41717,0,153,41564
5/7/22,Andorra,42.5063,1.5218,41717,0,153,41564
5/8/22,Andorra,42.5063,1.5218,41717,0,153,41564
5/9/22,Andorra,42.5063,1.5218,41717,0,153,41564
5/10/22,Andorra,42.5063,1.5218,41717,0,153,41564
5/11/22,Andorra,42.5063,1.5218,41717,0,153,41564
5/12/22,Andorra,42.5063,1.5218,42156,0,153,42003
5/13/22,Andorra,42.5063,1.5218,42156,0,153,42003
5/14/22,Andorra,42.5063,1.5218,42156,0,153,42003
5/15/22,Andorra,42.5063,1.5218,42156,0,153,42003
5/16/22,Andorra,42.5063,1.5218,42156,0,153,42003
5/17/22,Andorra,42.5063,1.5218,42156,0,153,42003
5/18/22,Andorra,42.5063,1.5218,42572,0,153,42419
5/19/22,Andorra,42.5063,1.5218,42572,0,153,42419
5/20/22,Andorra,42.5063,1.5218,42572,0,153,42419
5/21/22,Andorra,42.5063,1.5218,42572,0,153,42419
5/22/22,Andorra,42.5063,1.5218,42572,0,153,42419
5/23/22,Andorra,42.5063,1.5218,42572,0,153,42419
5/24/22,Andorra,42.5063,1.5218,42572,0,153,42419
5/25/22,Andorra,42.5063,1.5218,42894,0,153,42741
5/26/22,Andorra,42.5063,1.5218,42894,0,153,42741
5/27/22,Andorra,42.5063,1.5218,42894,0,153,42741
5/28/22,Andorra,42.5063,1.5218,42894,0,153,42741
5/29/22,Andorra,42.5063,1.5218,42894,0,153,42741
5/30/22,Andorra,42.5063,1.5218,42894,0,153,42741
5/31/22,Andorra,42.5063,1.5218,42894,0,153,42741
6/1/22,Andorra,42.5063,1.5218,42894,0,153,42741
6/2/22,Andorra,42.5063,1.5218,42894,0,153,42741
6/3/22,Andorra,42.5063,1.5218,43067,0,153,42914
6/4/22,Andorra,42.5063,1.5218,43067,0,153,42914
6/5/22,Andorra,42.5063,1.5218,43067,0,153,42914
6/6/22,Andorra,42.5063,1.5218,43067,0,153,42914
6/7/22,Andorra,42.5063,1.5218,43067,0,153,42914
6/8/22,Andorra,42.5063,1.5218,43224,0,153,43071
6/9/22,Andorra,42.5063,1.5218,43224,0,153,43071
6/10/22,Andorra,42.5063,1.5218,43224,0,153,43071
6/11/22,Andorra,42.5063,1.5218,43224,0,153,43071
6/12/22,Andorra,42.5063,1.5218,43224,0,153,43071
6/13/22,Andorra,42.5063,1.5218,43224,0,153,43071
6/14/22,Andorra,42.5063,1.5218,43224,0,153,43071
6/15/22,Andorra,42.5063,1.5218,43449,0,153,43296
6/16/22,Andorra,42.5063,1.5218,43449,0,153,43296
6/17/22,Andorra,42.5063,1.5218,43449,0,153,43296
6/18/22,Andorra,42.5063,1.5218,43449,0,153,43296
6/19/22,Andorra,42.5063,1.5218,43449,0,153,43296
6/20/22,Andorra,42.5063,1.5218,43449,0,153,43296
6/21/22,Andorra,42.5063,1.5218,43449,0,153,43296
6/22/22,Andorra,42.5063,1.5218,43774,0,153,43621
6/23/22,Andorra,42.5063,1.5218,43774,0,153,43621
6/24/22,Andorra,42.5063,1.5218,43774,0,153,43621
6/25/22,Andorra,42.5063,1.5218,43774,0,153,43621
6/26/22,Andorra,42.5063,1.5218,43774,0,153,43621
6/27/22,Andorra,42.5063,1.5218,43774,0,153,43621
6/28/22,Andorra,42.5063,1.5218,43774,0,153,43621
6/29/22,Andorra,42.5063,1.5218,43774,0,153,43621
6/30/22,Andorra,42.5063,1.5218,43774,0,153,43621
7/1/22,Andorra,42.5063,1.5218,44177,0,153,44024
7/2/22,Andorra,42.5063,1.5218,44177,0,153,44024
7/3/22,Andorra,42.5063,1.5218,44177,0,153,44024
7/4/22,Andorra,42.5063,1.5218,44177,0,153,44024
7/5/22,Andorra,42.5063,1.5218,44177,0,153,44024
7/6/22,Andorra,42.5063,1.5218,44671,0,153,44518
7/7/22,Andorra,42.5063,1.5218,44671,0,153,44518
7/8/22,Andorra,42.5063,1.5218,44671,0,153,44518
7/9/22,Andorra,42.5063,1.5218,44671,0,153,44518
7/10/22,Andorra,42.5063,1.5218,44671,0,153,44518
7/11/22,Andorra,42.5063,1.5218,44671,0,153,44518
7/12/22,Andorra,42.5063,1.5218,44671,0,153,44518
7/13/22,Andorra,42.5063,1.5218,44671,0,153,44518
7/14/22,Andorra,42.5063,1.5218,44671,0,153,44518
7/15/22,Andorra,42.5063,1.5218,44671,0,153,44518
7/16/22,Andorra,42.5063,1.5218,44671,0,153,44518
7/17/22,Andorra,42.5063,1.5218,44671,0,153,44518
7/18/22,Andorra,42.5063,1.5218,45061,0,153,44908
7/19/22,Andorra,42.5063,1.5218,45061,0,153,44908
7/20/22,Andorra,42.5063,1.5218,45061,0,153,44908
7/21/22,Andorra,42.5063,1.5218,45326,0,153,45173
7/22/22,Andorra,42.5063,1.5218,45326,0,153,45173
7/23/22,Andorra,42.5063,1.5218,45326,0,153,45173
7/24/22,Andorra,42.5063,1.5218,45326,0,153,45173
7/25/22,Andorra,42.5063,1.5218,45326,0,153,45173
7/26/22,Andorra,42.5063,1.5218,45326,0,153,45173
7/27/22,Andorra,42.5063,1.5218,45326,0,153,45173
7/28/22,Andorra,42.5063,1.5218,45508,0,153,45355
7/29/22,Andorra,42.5063,1.5218,45508,0,153,45355
7/30/22,Andorra,42.5063,1.5218,45508,0,153,45355
7/31/22,Andorra,42.5063,1.5218,45508,0,153,45355
8/1/22,Andorra,42.5063,1.5218,45508,0,153,45355
8/2/22,Andorra,42.5063,1.5218,45508,0,153,45355
8/3/22,Andorra,42.5063,1.5218,45793,0,154,45639
8/4/22,Andorra,42.5063,1.5218,45793,0,154,45639
8/5/22,Andorra,42.5063,1.5218,45793,0,154,45639
8/6/22,Andorra,42.5063,1.5218,45793,0,154,45639
8/7/22,Andorra,42.5063,1.5218,45793,0,154,45639
8/8/22,Andorra,42.5063,1.5218,45793,0,154,45639
8/9/22,Andorra,42.5063,1.5218,45793,0,154,45639
8/10/22,Andorra,42.5063,1.5218,45899,0,154,45745
8/11/22,Andorra,42.5063,1.5218,45899,0,154,45745
8/12/22,Andorra,42.5063,1.5218,45899,0,154,45745
8/13/22,Andorra,42.5063,1.5218,45899,0,154,45745
8/14/22,Andorra,42.5063,1.5218,45899,0,154,45745
8/15/22,Andorra,42.5063,1.5218,45899,0,154,45745
8/16/22,Andorra,42.5063,1.5218,45899,0,154,45745
8/17/22,Andorra,42.5063,1.5218,45975,0,154,45821
8/18/22,Andorra,42.5063,1.5218,45975,0,154,45821
8/19/22,Andorra,42.5063,1.5218,45975,0,154,45821
8/20/22,Andorra,42.5063,1.5218,45975,0,154,45821
8/21/22,Andorra,42.5063,1.5218,45975,0,154,45821
8/22/22,Andorra,42.5063,1.5218,45975,0,154,45821
8/23/22,Andorra,42.5063,1.5218,45975,0,154,45821
8/24/22,Andorra,42.5063,1.5218,46027,0,154,45873
8/25/22,Andorra,42.5063,1.5218,46027,0,154,45873
8/26/22,Andorra,42.5063,1.5218,46027,0,154,45873
8/27/22,Andorra,42.5063,1.5218,46027,0,154,45873
8/28/22,Andorra,42.5063,1.5218,46027,0,154,45873
8/29/22,Andorra,42.5063,1.5218,46027,0,154,45873
8/30/22,Andorra,42.5063,1.5218,46027,0,154,45873
8/31/22,Andorra,42.5063,1.5218,46027,0,154,45873
9/1/22,Andorra,42.5063,1.5218,46027,0,154,45873
9/2/22,Andorra,42.5063,1.5218,46027,0,154,45873
9/3/22,Andorra,42.5063,1.5218,46027,0,154,45873
9/4/22,Andorra,42.5063,1.5218,46027,0,154,45873
9/5/22,Andorra,42.5063,1.5218,46027,0,154,45873
9/6/22,Andorra,42.5063,1.5218,46027,0,154,45873
9/7/22,Andorra,42.5063,1.5218,46113,0,155,45958
9/8/22,Andorra,42.5063,1.5218,46113,0,155,45958
9/9/22,Andorra,42.5063,1.5218,46113,0,155,45958
9/10/22,Andorra,42.5063,1.5218,46113,0,155,45958
9/11/22,Andorra,42.5063,1.5218,46113,0,155,45958
9/12/22,Andorra,42.5063,1.5218,46113,0,155,45958
9/13/22,Andorra,42.5063,1.5218,46113,0,155,45958
9/14/22,Andorra,42.5063,1.5218,46147,0,155,45992
9/15/22,Andorra,42.5063,1.5218,46147,0,155,45992
9/16/22,Andorra,42.5063,1.5218,46147,0,155,45992
9/17/22,Andorra,42.5063,1.5218,46147,0,155,45992
9/18/22,Andorra,42.5063,1.5218,46147,0,155,45992
9/19/22,Andorra,42.5063,1.5218,46147,0,155,45992
9/20/22,Andorra,42.5063,1.5218,46147,0,155,45992
9/21/22,Andorra,42.5063,1.5218,46147,0,155,45992
9/22/22,Andorra,42.5063,1.5218,46147,0,155,45992
9/23/22,Andorra,42.5063,1.5218,46147,0,155,45992
9/24/22,Andorra,42.5063,1.5218,46147,0,155,45992
9/25/22,Andorra,42.5063,1.5218,46147,0,155,45992
9/26/22,Andorra,42.5063,1.5218,46147,0,155,45992
9/27/22,Andorra,42.5063,1.5218,46147,0,155,45992
9/28/22,Andorra,42.5063,1.5218,46227,0,155,46072
9/29/22,Andorra,42.5063,1.5218,46227,0,155,46072
9/30/22,Andorra,42.5063,1.5218,46227,0,155,46072
10/1/22,Andorra,42.5063,1.5218,46227,0,155,46072
10/2/22,Andorra,42.5063,1.5218,46227,0,155,46072
10/3/22,Andorra,42.5063,1.5218,46227,0,155,46072
10/4/22,Andorra,42.5063,1.5218,46227,0,155,46072
10/5/22,Andorra,42.5063,1.5218,46227,0,155,46072
10/6/22,Andorra,42.5063,1.5218,46275,0,155,46120
10/7/22,Andorra,42.5063,1.5218,46275,0,155,46120
10/8/22,Andorra,42.5063,1.5218,46275,0,155,46120
10/9/22,Andorra,42.5063,1.5218,46275,0,155,46120
10/10/22,Andorra,42.5063,1.5218,46275,0,155,46120
10/11/22,Andorra,42.5063,1.5218,46275,0,155,46120
10/12/22,Andorra,42.5063,1.5218,46366,0,155,46211
10/13/22,Andorra,42.5063,1.5218,46366,0,155,46211
10/14/22,Andorra,42.5063,1.5218,46366,0,155,46211
10/15/22,Andorra,42.5063,1.5218,46366,0,155,46211
10/16/22,Andorra,42.5063,1.5218,46366,0,155,46211
10/17/22,Andorra,42.5063,1.5218,46366,0,155,46211
10/18/22,Andorra,42.5063,1.5218,46366,0,155,46211
10/19/22,Andorra,42.5063,1.5218,46449,0,155,46294
10/20/22,Andorra,42.5063,1.5218,46449,0,155,46294
10/21/22,Andorra,42.5063,1.5218,46449,0,155,46294
10/22/22,Andorra,42.5063,1.5218,46449,0,155,46294
10/23/22,Andorra,42.5063,1.5218,46449,0,155,46294
10/24/22,Andorra,42.5063,1.5218,46449,0,155,46294
10/25/22,Andorra,42.5063,1.5218,46449,0,155,46294
10/26/22,Andorra,42.5063,1.5218,46535,0,155,46380
10/27/22,Andorra,42.5063,1.5218,46535,0,155,46380
10/28/22,Andorra,42.5063,1.5218,46535,0,155,46380
10/29/22,Andorra,42.5063,1.5218,46535,0,155,46380
10/30/22,Andorra,42.5063,1.5218,46535,0,155,46380
10/31/22,Andorra,42.5063,1.5218,46535,0,155,46380
11/1/22,Andorra,42.5063,1.5218,46535,0,155,46380
11/2/22,Andorra,42.5063,1.5218,46588,0,155,46433
11/3/22,Andorra,42.5063,1.5218,46588,0,155,46433
11/4/22,Andorra,42.5063,1.5218,46588,0,155,46433
11/5/22,Andorra,42.5063,1.5218,46588,0,155,46433
11/6/22,Andorra,42.5063,1.5218,46588,0,155,46433
11/7/22,Andorra,42.5063,1.5218,46588,0,155,46433
11/8/22,Andorra,42.5063,1.5218,46588,0,155,46433
11/9/22,Andorra,42.5063,1.5218,46664,0,155,46509
11/10/22,Andorra,42.5063,1.5218,46664,0,155,46509
11/11/22,Andorra,42.5063,1.5218,46664,0,155,46509
11/12/22,Andorra,42.5063,1.5218,46664,0,155,46509
11/13/22,Andorra,42.5063,1.5218,46664,0,155,46509
11/14/22,Andorra,42.5063,1.5218,46664,0,155,46509
11/15/22,Andorra,42.5063,1.5218,46664,0,155,46509
11/16/22,Andorra,42.5063,1.5218,46824,0,156,46668
11/17/22,Andorra,42.5063,1.5218,46824,0,156,46668
11/18/22,Andorra,42.5063,1.5218,46824,0,156,46668
11/19/22,Andorra,42.5063,1.5218,46824,0,156,46668
11/20/22,Andorra,42.5063,1.5218,46824,0,156,46668
11/21/22,Andorra,42.5063,1.5218,46824,0,156,46668
11/22/22,Andorra,42.5063,1.5218,46824,0,156,46668
11/23/22,Andorra,42.5063,1.5218,46824,0,156,46668
11/24/22,Andorra,42.5063,1.5218,46824,0,156,46668
11/25/22,Andorra,42.5063,1.5218,46824,0,156,46668
11/26/22,Andorra,42.5063,1.5218,46824,0,156,46668
11/27/22,Andorra,42.5063,1.5218,46824,0,156,46668
11/28/22,Andorra,42.5063,1.5218,46824,0,156,46668
11/29/22,Andorra,42.5063,1.5218,46824,0,156,46668
11/30/22,Andorra,42.5063,1.5218,47219,0,157,47062
12/1/22,Andorra,42.5063,1.5218,47219,0,157,47062
12/2/22,Andorra,42.5063,1.5218,47219,0,157,47062
12/3/22,Andorra,42.5063,1.5218,47219,0,157,47062
12/4/22,Andorra,42.5063,1.5218,47219,0,157,47062
12/5/22,Andorra,42.5063,1.5218,47219,0,157,47062
12/6/22,Andorra,42.5063,1.5218,47219,0,157,47062
12/7/22,Andorra,42.5063,1.5218,47446,0,158,47288
12/8/22,Andorra,42.5063,1.5218,47446,0,158,47288
12/9/22,Andorra,42.5063,1.5218,47446,0,158,47288
12/10/22,Andorra,42.5063,1.5218,47446,0,158,47288
12/11/22,Andorra,42.5063,1.5218,47446,0,158,47288
12/12/22,Andorra,42.5063,1.5218,47446,0,158,47288
12/13/22,Andorra,42.5063,1.5218,47446,0,158,47288
12/14/22,Andorra,42.5063,1.5218,47606,0,158,47448
12/15/22,Andorra,42.5063,1.5218,47606,0,158,47448
12/16/22,Andorra,42.5063,1.5218,47606,0,158,47448
12/17/22,Andorra,42.5063,1.5218,47606,0,158,47448
1/1/22,Angola,-11.2027,17.8739,82398,0,1772,80626
1/2/22,Angola,-11.2027,17.8739,82920,0,1772,81148
1/3/22,Angola,-11.2027,17.8739,83764,0,1775,81989
1/4/22,Angola,-11.2027,17.8739,84666,0,1778,82888
1/5/22,Angola,-11.2027,17.8739,86636,0,1789,84847
1/6/22,Angola,-11.2027,17.8739,87625,0,1799,85826
1/7/22,Angola,-11.2027,17.8739,88775,0,1809,86966
1/8/22,Angola,-11.2027,17.8739,89251,0,1819,87432
1/9/22,Angola,-11.2027,17.8739,89718,0,1826,87892
1/10/22,Angola,-11.2027,17.8739,90316,0,1832,88484
1/11/22,Angola,-11.2027,17.8739,91148,0,1840,89308
1/12/22,Angola,-11.2027,17.8739,91907,0,1842,90065
1/13/22,Angola,-11.2027,17.8739,92581,0,1847,90734
1/14/22,Angola,-11.2027,17.8739,93302,0,1852,91450
1/15/22,Angola,-11.2027,17.8739,93524,0,1857,91667
1/16/22,Angola,-11.2027,17.8739,93694,0,1863,91831
1/17/22,Angola,-11.2027,17.8739,93974,0,1866,92108
1/18/22,Angola,-11.2027,17.8739,94275,0,1870,92405
1/19/22,Angola,-11.2027,17.8739,94779,0,1877,92902
1/20/22,Angola,-11.2027,17.8739,95220,0,1881,93339
1/21/22,Angola,-11.2027,17.8739,95676,0,1884,93792
1/22/22,Angola,-11.2027,17.8739,95902,0,1886,94016
1/23/22,Angola,-11.2027,17.8739,96582,0,1888,94694
1/24/22,Angola,-11.2027,17.8739,97263,0,1888,95375
1/25/22,Angola,-11.2027,17.8739,97594,0,1891,95703
1/26/22,Angola,-11.2027,17.8739,97812,0,1892,95920
1/27/22,Angola,-11.2027,17.8739,97901,0,1893,96008
1/28/22,Angola,-11.2027,17.8739,98029,0,1893,96136
1/29/22,Angola,-11.2027,17.8739,98057,0,1894,96163
1/30/22,Angola,-11.2027,17.8739,98076,0,1895,96181
1/31/22,Angola,-11.2027,17.8739,98116,0,1895,96221
2/1/22,Angola,-11.2027,17.8739,98226,0,1895,96331
2/2/22,Angola,-11.2027,17.8739,98267,0,1895,96372
2/3/22,Angola,-11.2027,17.8739,98319,0,1896,96423
2/4/22,Angola,-11.2027,17.8739,98340,0,1896,96444
2/5/22,Angola,-11.2027,17.8739,98351,0,1896,96455
2/6/22,Angola,-11.2027,17.8739,98364,0,1896,96468
2/7/22,Angola,-11.2027,17.8739,98409,0,1896,96513
2/8/22,Angola,-11.2027,17.8739,98424,0,1896,96528
2/9/22,Angola,-11.2027,17.8739,98453,0,1896,96557
2/10/22,Angola,-11.2027,17.8739,98474,0,1897,96577
2/11/22,Angola,-11.2027,17.8739,98501,0,1898,96603
2/12/22,Angola,-11.2027,17.8739,98514,0,1898,96616
2/13/22,Angola,-11.2027,17.8739,98514,0,1898,96616
2/14/22,Angola,-11.2027,17.8739,98514,0,1898,96616
2/15/22,Angola,-11.2027,17.8739,98555,0,1899,96656
2/16/22,Angola,-11.2027,17.8739,98568,0,1899,96669
2/17/22,Angola,-11.2027,17.8739,98585,0,1899,96686
2/18/22,Angola,-11.2027,17.8739,98605,0,1899,96706
2/19/22,Angola,-11.2027,17.8739,98617,0,1899,96718
2/20/22,Angola,-11.2027,17.8739,98638,0,1899,96739
2/21/22,Angola,-11.2027,17.8739,98658,0,1899,96759
2/22/22,Angola,-11.2027,17.8739,98671,0,1899,96772
2/23/22,Angola,-11.2027,17.8739,98698,0,1899,96799
2/24/22,Angola,-11.2027,17.8739,98701,0,1899,96802
2/25/22,Angola,-11.2027,17.8739,98701,0,1899,96802
2/26/22,Angola,-11.2027,17.8739,98701,0,1899,96802
2/27/22,Angola,-11.2027,17.8739,98701,0,1899,96802
2/28/22,Angola,-11.2027,17.8739,98741,0,1900,96841
3/1/22,Angola,-11.2027,17.8739,98746,0,1900,96846
3/2/22,Angola,-11.2027,17.8739,98746,0,1900,96846
3/3/22,Angola,-11.2027,17.8739,98746,0,1900,96846
3/4/22,Angola,-11.2027,17.8739,98796,0,1900,96896
3/5/22,Angola,-11.2027,17.8739,98796,0,1900,96896
3/6/22,Angola,-11.2027,17.8739,98806,0,1900,96906
3/7/22,Angola,-11.2027,17.8739,98806,0,1900,96906
3/8/22,Angola,-11.2027,17.8739,98829,0,1900,96929
3/9/22,Angola,-11.2027,17.8739,98855,0,1900,96955
3/10/22,Angola,-11.2027,17.8739,98855,0,1900,96955
3/11/22,Angola,-11.2027,17.8739,98855,0,1900,96955
3/12/22,Angola,-11.2027,17.8739,98909,0,1900,97009
3/13/22,Angola,-11.2027,17.8739,98927,0,1900,97027
3/14/22,Angola,-11.2027,17.8739,98931,0,1900,97031
3/15/22,Angola,-11.2027,17.8739,98956,0,1900,97056
3/16/22,Angola,-11.2027,17.8739,98985,0,1900,97085
3/17/22,Angola,-11.2027,17.8739,99003,0,1900,97103
3/18/22,Angola,-11.2027,17.8739,99003,0,1900,97103
3/19/22,Angola,-11.2027,17.8739,99003,0,1900,97103
3/20/22,Angola,-11.2027,17.8739,99003,0,1900,97103
3/21/22,Angola,-11.2027,17.8739,99010,0,1900,97110
3/22/22,Angola,-11.2027,17.8739,99058,0,1900,97158
3/23/22,Angola,-11.2027,17.8739,99058,0,1900,97158
3/24/22,Angola,-11.2027,17.8739,99081,0,1900,97181
3/25/22,Angola,-11.2027,17.8739,99102,0,1900,97202
3/26/22,Angola,-11.2027,17.8739,99106,0,1900,97206
3/27/22,Angola,-11.2027,17.8739,99115,0,1900,97215
3/28/22,Angola,-11.2027,17.8739,99115,0,1900,97215
3/29/22,Angola,-11.2027,17.8739,99138,0,1900,97238
3/30/22,Angola,-11.2027,17.8739,99138,0,1900,97238
3/31/22,Angola,-11.2027,17.8739,99169,0,1900,97269
4/1/22,Angola,-11.2027,17.8739,99194,0,1900,97294
4/2/22,Angola,-11.2027,17.8739,99194,0,1900,97294
4/3/22,Angola,-11.2027,17.8739,99194,0,1900,97294
4/4/22,Angola,-11.2027,17.8739,99194,0,1900,97294
4/5/22,Angola,-11.2027,17.8739,99194,0,1900,97294
4/6/22,Angola,-11.2027,17.8739,99194,0,1900,97294
4/7/22,Angola,-11.2027,17.8739,99194,0,1900,97294
4/8/22,Angola,-11.2027,17.8739,99194,0,1900,97294
4/9/22,Angola,-11.2027,17.8739,99194,0,1900,97294
4/10/22,Angola,-11.2027,17.8739,99194,0,1900,97294
4/11/22,Angola,-11.2027,17.8739,99194,0,1900,97294
4/12/22,Angola,-11.2027,17.8739,99194,0,1900,97294
4/13/22,Angola,-11.2027,17.8739,99194,0,1900,97294
4/14/22,Angola,-11.2027,17.8739,99194,0,1900,97294
4/15/22,Angola,-11.2027,17.8739,99194,0,1900,97294
4/16/22,Angola,-11.2027,17.8739,99194,0,1900,97294
4/17/22,Angola,-11.2027,17.8739,99194,0,1900,97294
4/18/22,Angola,-11.2027,17.8739,99194,0,1900,97294
4/19/22,Angola,-11.2027,17.8739,99287,0,1900,97387
4/20/22,Angola,-11.2027,17.8739,99287,0,1900,97387
4/21/22,Angola,-11.2027,17.8739,99287,0,1900,97387
4/22/22,Angola,-11.2027,17.8739,99287,0,1900,97387
4/23/22,Angola,-11.2027,17.8739,99287,0,1900,97387
4/24/22,Angola,-11.2027,17.8739,99287,0,1900,97387
4/25/22,Angola,-11.2027,17.8739,99287,0,1900,97387
4/26/22,Angola,-11.2027,17.8739,99287,0,1900,97387
4/27/22,Angola,-11.2027,17.8739,99287,0,1900,97387
4/28/22,Angola,-11.2027,17.8739,99287,0,1900,97387
4/29/22,Angola,-11.2027,17.8739,99287,0,1900,97387
4/30/22,Angola,-11.2027,17.8739,99287,0,1900,97387
5/1/22,Angola,-11.2027,17.8739,99287,0,1900,97387
5/2/22,Angola,-11.2027,17.8739,99287,0,1900,97387
5/3/22,Angola,-11.2027,17.8739,99287,0,1900,97387
5/4/22,Angola,-11.2027,17.8739,99287,0,1900,97387
5/5/22,Angola,-11.2027,17.8739,99287,0,1900,97387
5/6/22,Angola,-11.2027,17.8739,99287,0,1900,97387
5/7/22,Angola,-11.2027,17.8739,99287,0,1900,97387
5/8/22,Angola,-11.2027,17.8739,99287,0,1900,97387
5/9/22,Angola,-11.2027,17.8739,99287,0,1900,97387
5/10/22,Angola,-11.2027,17.8739,99287,0,1900,97387
5/11/22,Angola,-11.2027,17.8739,99287,0,1900,97387
5/12/22,Angola,-11.2027,17.8739,99287,0,1900,97387
5/13/22,Angola,-11.2027,17.8739,99287,0,1900,97387
5/14/22,Angola,-11.2027,17.8739,99287,0,1900,97387
5/15/22,Angola,-11.2027,17.8739,99287,0,1900,97387
5/16/22,Angola,-11.2027,17.8739,99287,0,1900,97387
5/17/22,Angola,-11.2027,17.8739,99287,0,1900,97387
5/18/22,Angola,-11.2027,17.8739,99287,0,1900,97387
5/19/22,Angola,-11.2027,17.8739,99287,0,1900,97387
5/20/22,Angola,-11.2027,17.8739,99287,0,1900,97387
5/21/22,Angola,-11.2027,17.8739,99287,0,1900,97387
5/22/22,Angola,-11.2027,17.8739,99287,0,1900,97387
5/23/22,Angola,-11.2027,17.8739,99287,0,1900,97387
5/24/22,Angola,-11.2027,17.8739,99433,0,1900,97533
5/25/22,Angola,-11.2027,17.8739,99527,0,1900,97627
5/26/22,Angola,-11.2027,17.8739,99527,0,1900,97627
5/27/22,Angola,-11.2027,17.8739,99527,0,1900,97627
5/28/22,Angola,-11.2027,17.8739,99527,0,1900,97627
5/29/22,Angola,-11.2027,17.8739,99527,0,1900,97627
5/30/22,Angola,-11.2027,17.8739,99761,0,1900,97861
5/31/22,Angola,-11.2027,17.8739,99761,0,1900,97861
6/1/22,Angola,-11.2027,17.8739,99761,0,1900,97861
6/2/22,Angola,-11.2027,17.8739,99761,0,1900,97861
6/3/22,Angola,-11.2027,17.8739,99761,0,1900,97861
6/4/22,Angola,-11.2027,17.8739,99761,0,1900,97861
6/5/22,Angola,-11.2027,17.8739,99761,0,1900,97861
6/6/22,Angola,-11.2027,17.8739,99761,0,1900,97861
6/7/22,Angola,-11.2027,17.8739,99761,0,1900,97861
6/8/22,Angola,-11.2027,17.8739,99761,0,1900,97861
6/9/22,Angola,-11.2027,17.8739,99761,0,1900,97861
6/10/22,Angola,-11.2027,17.8739,99761,0,1900,97861
6/11/22,Angola,-11.2027,17.8739,99761,0,1900,97861
6/12/22,Angola,-11.2027,17.8739,99761,0,1900,97861
6/13/22,Angola,-11.2027,17.8739,99761,0,1900,97861
6/14/22,Angola,-11.2027,17.8739,99761,0,1900,97861
6/15/22,Angola,-11.2027,17.8739,99761,0,1900,97861
6/16/22,Angola,-11.2027,17.8739,99761,0,1900,97861
6/17/22,Angola,-11.2027,17.8739,99761,0,1900,97861
6/18/22,Angola,-11.2027,17.8739,99761,0,1900,97861
6/19/22,Angola,-11.2027,17.8739,99761,0,1900,97861
6/20/22,Angola,-11.2027,17.8739,99761,0,1900,97861
6/21/22,Angola,-11.2027,17.8739,99761,0,1900,97861
6/22/22,Angola,-11.2027,17.8739,99761,0,1900,97861
6/23/22,Angola,-11.2027,17.8739,99761,0,1900,97861
6/24/22,Angola,-11.2027,17.8739,99761,0,1900,97861
6/25/22,Angola,-11.2027,17.8739,99761,0,1900,97861
6/26/22,Angola,-11.2027,17.8739,99761,0,1900,97861
6/27/22,Angola,-11.2027,17.8739,99761,0,1900,97861
6/28/22,Angola,-11.2027,17.8739,101320,0,1900,99420
6/29/22,Angola,-11.2027,17.8739,101320,0,1900,99420
6/30/22,Angola,-11.2027,17.8739,101320,0,1900,99420
7/1/22,Angola,-11.2027,17.8739,101320,0,1900,99420
7/2/22,Angola,-11.2027,17.8739,101320,0,1900,99420
7/3/22,Angola,-11.2027,17.8739,101320,0,1900,99420
7/4/22,Angola,-11.2027,17.8739,101320,0,1900,99420
7/5/22,Angola,-11.2027,17.8739,101320,0,1900,99420
7/6/22,Angola,-11.2027,17.8739,101320,0,1900,99420
7/7/22,Angola,-11.2027,17.8739,101320,0,1900,99420
7/8/22,Angola,-11.2027,17.8739,101320,0,1900,99420
7/9/22,Angola,-11.2027,17.8739,101320,0,1900,99420
7/10/22,Angola,-11.2027,17.8739,101320,0,1900,99420
7/11/22,Angola,-11.2027,17.8739,101320,0,1900,99420
7/12/22,Angola,-11.2027,17.8739,101320,0,1900,99420
7/13/22,Angola,-11.2027,17.8739,101320,0,1900,99420
7/14/22,Angola,-11.2027,17.8739,101600,0,1900,99700
7/15/22,Angola,-11.2027,17.8739,101901,0,1909,99992
7/16/22,Angola,-11.2027,17.8739,101901,0,1909,99992
7/17/22,Angola,-11.2027,17.8739,101901,0,1909,99992
7/18/22,Angola,-11.2027,17.8739,102209,0,1912,100297
7/19/22,Angola,-11.2027,17.8739,102209,0,1912,100297
7/20/22,Angola,-11.2027,17.8739,102209,0,1912,100297
7/21/22,Angola,-11.2027,17.8739,102209,0,1912,100297
7/22/22,Angola,-11.2027,17.8739,102301,0,1912,100389
7/23/22,Angola,-11.2027,17.8739,102301,0,1912,100389
7/24/22,Angola,-11.2027,17.8739,102301,0,1912,100389
7/25/22,Angola,-11.2027,17.8739,102301,0,1912,100389
7/26/22,Angola,-11.2027,17.8739,102301,0,1912,100389
7/27/22,Angola,-11.2027,17.8739,102301,0,1912,100389
7/28/22,Angola,-11.2027,17.8739,102301,0,1912,100389
7/29/22,Angola,-11.2027,17.8739,102301,0,1912,100389
7/30/22,Angola,-11.2027,17.8739,102301,0,1912,100389
7/31/22,Angola,-11.2027,17.8739,102301,0,1912,100389
8/1/22,Angola,-11.2027,17.8739,102301,0,1912,100389
8/2/22,Angola,-11.2027,17.8739,102301,0,1912,100389
8/3/22,Angola,-11.2027,17.8739,102301,0,1912,100389
8/4/22,Angola,-11.2027,17.8739,102301,0,1912,100389
8/5/22,Angola,-11.2027,17.8739,102636,0,1917,100719
8/6/22,Angola,-11.2027,17.8739,102636,0,1917,100719
8/7/22,Angola,-11.2027,17.8739,102636,0,1917,100719
8/8/22,Angola,-11.2027,17.8739,102636,0,1917,100719
8/9/22,Angola,-11.2027,17.8739,102636,0,1917,100719
8/10/22,Angola,-11.2027,17.8739,102636,0,1917,100719
8/11/22,Angola,-11.2027,17.8739,102636,0,1917,100719
8/12/22,Angola,-11.2027,17.8739,102636,0,1917,100719
8/13/22,Angola,-11.2027,17.8739,102636,0,1917,100719
8/14/22,Angola,-11.2027,17.8739,102636,0,1917,100719
8/15/22,Angola,-11.2027,17.8739,102636,0,1917,100719
8/16/22,Angola,-11.2027,17.8739,102636,0,1917,100719
8/17/22,Angola,-11.2027,17.8739,102636,0,1917,100719
8/18/22,Angola,-11.2027,17.8739,102636,0,1917,100719
8/19/22,Angola,-11.2027,17.8739,102636,0,1917,100719
8/20/22,Angola,-11.2027,17.8739,102636,0,1917,100719
8/21/22,Angola,-11.2027,17.8739,102636,0,1917,100719
8/22/22,Angola,-11.2027,17.8739,102636,0,1917,100719
8/23/22,Angola,-11.2027,17.8739,102636,0,1917,100719
8/24/22,Angola,-11.2027,17.8739,102636,0,1917,100719
8/25/22,Angola,-11.2027,17.8739,102636,0,1917,100719
8/26/22,Angola,-11.2027,17.8739,102636,0,1917,100719
8/27/22,Angola,-11.2027,17.8739,102636,0,1917,100719
8/28/22,Angola,-11.2027,17.8739,102636,0,1917,100719
8/29/22,Angola,-11.2027,17.8739,102636,0,1917,100719
8/30/22,Angola,-11.2027,17.8739,102636,0,1917,100719
8/31/22,Angola,-11.2027,17.8739,102636,0,1917,100719
9/1/22,Angola,-11.2027,17.8739,102636,0,1917,100719
9/2/22,Angola,-11.2027,17.8739,102636,0,1917,100719
9/3/22,Angola,-11.2027,17.8739,102636,0,1917,100719
9/4/22,Angola,-11.2027,17.8739,102636,0,1917,100719
9/5/22,Angola,-11.2027,17.8739,102636,0,1917,100719
9/6/22,Angola,-11.2027,17.8739,102636,0,1917,100719
9/7/22,Angola,-11.2027,17.8739,102636,0,1917,100719
9/8/22,Angola,-11.2027,17.8739,102636,0,1917,100719
9/9/22,Angola,-11.2027,17.8739,103131,0,1917,101214
9/10/22,Angola,-11.2027,17.8739,103131,0,1917,101214
9/11/22,Angola,-11.2027,17.8739,103131,0,1917,101214
9/12/22,Angola,-11.2027,17.8739,103131,0,1917,101214
9/13/22,Angola,-11.2027,17.8739,103131,0,1917,101214
9/14/22,Angola,-11.2027,17.8739,103131,0,1917,101214
9/15/22,Angola,-11.2027,17.8739,103131,0,1917,101214
9/16/22,Angola,-11.2027,17.8739,103131,0,1917,101214
9/17/22,Angola,-11.2027,17.8739,103131,0,1917,101214
9/18/22,Angola,-11.2027,17.8739,103131,0,1917,101214
9/19/22,Angola,-11.2027,17.8739,103131,0,1917,101214
9/20/22,Angola,-11.2027,17.8739,103131,0,1917,101214
9/21/22,Angola,-11.2027,17.8739,103131,0,1917,101214
9/22/22,Angola,-11.2027,17.8739,103131,0,1917,101214
9/23/22,Angola,-11.2027,17.8739,103131,0,1917,101214
9/24/22,Angola,-11.2027,17.8739,103131,0,1917,101214
9/25/22,Angola,-11.2027,17.8739,103131,0,1917,101214
9/26/22,Angola,-11.2027,17.8739,103131,0,1917,101214
9/27/22,Angola,-11.2027,17.8739,103131,0,1917,101214
9/28/22,Angola,-11.2027,17.8739,103131,0,1917,101214
9/29/22,Angola,-11.2027,17.8739,103131,0,1917,101214
9/30/22,Angola,-11.2027,17.8739,103131,0,1917,101214
10/1/22,Angola,-11.2027,17.8739,103131,0,1917,101214
10/2/22,Angola,-11.2027,17.8739,103131,0,1917,101214
10/3/22,Angola,-11.2027,17.8739,103131,0,1917,101214
10/4/22,Angola,-11.2027,17.8739,103131,0,1917,101214
10/5/22,Angola,-11.2027,17.8739,103131,0,1917,101214
10/6/22,Angola,-11.2027,17.8739,103131,0,1917,101214
10/7/22,Angola,-11.2027,17.8739,103131,0,1917,101214
10/8/22,Angola,-11.2027,17.8739,103131,0,1917,101214
10/9/22,Angola,-11.2027,17.8739,103131,0,1917,101214
10/10/22,Angola,-11.2027,17.8739,103131,0,1917,101214
10/11/22,Angola,-11.2027,17.8739,103131,0,1917,101214
10/12/22,Angola,-11.2027,17.8739,103131,0,1917,101214
10/13/22,Angola,-11.2027,17.8739,103131,0,1917,101214
10/14/22,Angola,-11.2027,17.8739,103131,0,1917,101214
10/15/22,Angola,-11.2027,17.8739,103131,0,1917,101214
10/16/22,Angola,-11.2027,17.8739,103131,0,1917,101214
10/17/22,Angola,-11.2027,17.8739,103131,0,1917,101214
10/18/22,Angola,-11.2027,17.8739,103131,0,1917,101214
10/19/22,Angola,-11.2027,17.8739,103131,0,1917,101214
10/20/22,Angola,-11.2027,17.8739,103131,0,1917,101214
10/21/22,Angola,-11.2027,17.8739,103131,0,1917,101214
10/22/22,Angola,-11.2027,17.8739,103131,0,1917,101214
10/23/22,Angola,-11.2027,17.8739,103131,0,1917,101214
10/24/22,Angola,-11.2027,17.8739,103131,0,1917,101214
10/25/22,Angola,-11.2027,17.8739,103131,0,1917,101214
10/26/22,Angola,-11.2027,17.8739,103131,0,1917,101214
10/27/22,Angola,-11.2027,17.8739,103131,0,1917,101214
10/28/22,Angola,-11.2027,17.8739,103131,0,1917,101214
10/29/22,Angola,-11.2027,17.8739,103131,0,1917,101214
10/30/22,Angola,-11.2027,17.8739,103131,0,1917,101214
10/31/22,Angola,-11.2027,17.8739,103131,0,1917,101214
11/1/22,Angola,-11.2027,17.8739,103131,0,1917,101214
11/2/22,Angola,-11.2027,17.8739,103131,0,1917,101214
11/3/22,Angola,-11.2027,17.8739,103131,0,1917,101214
11/4/22,Angola,-11.2027,17.8739,103131,0,1917,101214
11/5/22,Angola,-11.2027,17.8739,103131,0,1917,101214
11/6/22,Angola,-11.2027,17.8739,103131,0,1917,101214
11/7/22,Angola,-11.2027,17.8739,103131,0,1917,101214
11/8/22,Angola,-11.2027,17.8739,103131,0,1917,101214
11/9/22,Angola,-11.2027,17.8739,103131,0,1917,101214
11/10/22,Angola,-11.2027,17.8739,103131,0,1917,101214
11/11/22,Angola,-11.2027,17.8739,103131,0,1917,101214
11/12/22,Angola,-11.2027,17.8739,103131,0,1917,101214
11/13/22,Angola,-11.2027,17.8739,103131,0,1917,101214
11/14/22,Angola,-11.2027,17.8739,103131,0,1917,101214
11/15/22,Angola,-11.2027,17.8739,103131,0,1917,101214
11/16/22,Angola,-11.2027,17.8739,103131,0,1917,101214
11/17/22,Angola,-11.2027,17.8739,103131,0,1917,101214
11/18/22,Angola,-11.2027,17.8739,103131,0,1917,101214
11/19/22,Angola,-11.2027,17.8739,103131,0,1917,101214
11/20/22,Angola,-11.2027,17.8739,103131,0,1917,101214
11/21/22,Angola,-11.2027,17.8739,103131,0,1917,101214
11/22/22,Angola,-11.2027,17.8739,103131,0,1917,101214
11/23/22,Angola,-11.2027,17.8739,104491,0,1923,102568
11/24/22,Angola,-11.2027,17.8739,104491,0,1923,102568
11/25/22,Angola,-11.2027,17.8739,104491,0,1923,102568
11/26/22,Angola,-11.2027,17.8739,104491,0,1923,102568
11/27/22,Angola,-11.2027,17.8739,104491,0,1923,102568
11/28/22,Angola,-11.2027,17.8739,104491,0,1923,102568
11/29/22,Angola,-11.2027,17.8739,104491,0,1923,102568
11/30/22,Angola,-11.2027,17.8739,104676,0,1924,102752
12/1/22,Angola,-11.2027,17.8739,104676,0,1924,102752
12/2/22,Angola,-11.2027,17.8739,104676,0,1924,102752
12/3/22,Angola,-11.2027,17.8739,104676,0,1924,102752
12/4/22,Angola,-11.2027,17.8739,104676,0,1924,102752
12/5/22,Angola,-11.2027,17.8739,104750,0,1925,102825
12/6/22,Angola,-11.2027,17.8739,104750,0,1925,102825
12/7/22,Angola,-11.2027,17.8739,104808,0,1925,102883
12/8/22,Angola,-11.2027,17.8739,104808,0,1925,102883
12/9/22,Angola,-11.2027,17.8739,104808,0,1925,102883
12/10/22,Angola,-11.2027,17.8739,104808,0,1925,102883
12/11/22,Angola,-11.2027,17.8739,104808,0,1925,102883
12/12/22,Angola,-11.2027,17.8739,104808,0,1925,102883
12/13/22,Angola,-11.2027,17.8739,104808,0,1925,102883
12/14/22,Angola,-11.2027,17.8739,104946,0,1928,103018
12/15/22,Angola,-11.2027,17.8739,104946,0,1928,103018
12/16/22,Angola,-11.2027,17.8739,104946,0,1928,103018
12/17/22,Angola,-11.2027,17.8739,104946,0,1928,103018
1/1/22,Antarctica,-71.9499,23.347,11,0,0,11
1/2/22,Antarctica,-71.9499,23.347,11,0,0,11
1/3/22,Antarctica,-71.9499,23.347,11,0,0,11
1/4/22,Antarctica,-71.9499,23.347,11,0,0,11
1/5/22,Antarctica,-71.9499,23.347,11,0,0,11
1/6/22,Antarctica,-71.9499,23.347,11,0,0,11
1/7/22,Antarctica,-71.9499,23.347,11,0,0,11
1/8/22,Antarctica,-71.9499,23.347,11,0,0,11
1/9/22,Antarctica,-71.9499,23.347,11,0,0,11
1/10/22,Antarctica,-71.9499,23.347,11,0,0,11
1/11/22,Antarctica,-71.9499,23.347,11,0,0,11
1/12/22,Antarctica,-71.9499,23.347,11,0,0,11
1/13/22,Antarctica,-71.9499,23.347,11,0,0,11
1/14/22,Antarctica,-71.9499,23.347,11,0,0,11
1/15/22,Antarctica,-71.9499,23.347,11,0,0,11
1/16/22,Antarctica,-71.9499,23.347,11,0,0,11
1/17/22,Antarctica,-71.9499,23.347,11,0,0,11
1/18/22,Antarctica,-71.9499,23.347,11,0,0,11
1/19/22,Antarctica,-71.9499,23.347,11,0,0,11
1/20/22,Antarctica,-71.9499,23.347,11,0,0,11
1/21/22,Antarctica,-71.9499,23.347,11,0,0,11
1/22/22,Antarctica,-71.9499,23.347,11,0,0,11
1/23/22,Antarctica,-71.9499,23.347,11,0,0,11
1/24/22,Antarctica,-71.9499,23.347,11,0,0,11
1/25/22,Antarctica,-71.9499,23.347,11,0,0,11
1/26/22,Antarctica,-71.9499,23.347,11,0,0,11
1/27/22,Antarctica,-71.9499,23.347,11,0,0,11
1/28/22,Antarctica,-71.9499,23.347,11,0,0,11
1/29/22,Antarctica,-71.9499,23.347,11,0,0,11
1/30/22,Antarctica,-71.9499,23.347,11,0,0,11
1/31/22,Antarctica,-71.9499,23.347,11,0,0,11
2/1/22,Antarctica,-71.9499,23.347,11,0,0,11
2/2/22,Antarctica,-71.9499,23.347,11,0,0,11
2/3/22,Antarctica,-71.9499,23.347,11,0,0,11
2/4/22,Antarctica,-71.9499,23.347,11,0,0,11
2/5/22,Antarctica,-71.9499,23.347,11,0,0,11
2/6/22,Antarctica,-71.9499,23.347,11,0,0,11
2/7/22,Antarctica,-71.9499,23.347,11,0,0,11
2/8/22,Antarctica,-71.9499,23.347,11,0,0,11
2/9/22,Antarctica,-71.9499,23.347,11,0,0,11
2/10/22,Antarctica,-71.9499,23.347,11,0,0,11
2/11/22,Antarctica,-71.9499,23.347,11,0,0,11
2/12/22,Antarctica,-71.9499,23.347,11,0,0,11
2/13/22,Antarctica,-71.9499,23.347,11,0,0,11
2/14/22,Antarctica,-71.9499,23.347,11,0,0,11
2/15/22,Antarctica,-71.9499,23.347,11,0,0,11
2/16/22,Antarctica,-71.9499,23.347,11,0,0,11
2/17/22,Antarctica,-71.9499,23.347,11,0,0,11
2/18/22,Antarctica,-71.9499,23.347,11,0,0,11
2/19/22,Antarctica,-71.9499,23.347,11,0,0,11
2/20/22,Antarctica,-71.9499,23.347,11,0,0,11
2/21/22,Antarctica,-71.9499,23.347,11,0,0,11
2/22/22,Antarctica,-71.9499,23.347,11,0,0,11
2/23/22,Antarctica,-71.9499,23.347,11,0,0,11
2/24/22,Antarctica,-71.9499,23.347,11,0,0,11
2/25/22,Antarctica,-71.9499,23.347,11,0,0,11
2/26/22,Antarctica,-71.9499,23.347,11,0,0,11
2/27/22,Antarctica,-71.9499,23.347,11,0,0,11
2/28/22,Antarctica,-71.9499,23.347,11,0,0,11
3/1/22,Antarctica,-71.9499,23.347,11,0,0,11
3/2/22,Antarctica,-71.9499,23.347,11,0,0,11
3/3/22,Antarctica,-71.9499,23.347,11,0,0,11
3/4/22,Antarctica,-71.9499,23.347,11,0,0,11
3/5/22,Antarctica,-71.9499,23.347,11,0,0,11
3/6/22,Antarctica,-71.9499,23.347,11,0,0,11
3/7/22,Antarctica,-71.9499,23.347,11,0,0,11
3/8/22,Antarctica,-71.9499,23.347,11,0,0,11
3/9/22,Antarctica,-71.9499,23.347,11,0,0,11
3/10/22,Antarctica,-71.9499,23.347,11,0,0,11
3/11/22,Antarctica,-71.9499,23.347,11,0,0,11
3/12/22,Antarctica,-71.9499,23.347,11,0,0,11
3/13/22,Antarctica,-71.9499,23.347,11,0,0,11
3/14/22,Antarctica,-71.9499,23.347,11,0,0,11
3/15/22,Antarctica,-71.9499,23.347,11,0,0,11
3/16/22,Antarctica,-71.9499,23.347,11,0,0,11
3/17/22,Antarctica,-71.9499,23.347,11,0,0,11
3/18/22,Antarctica,-71.9499,23.347,11,0,0,11
3/19/22,Antarctica,-71.9499,23.347,11,0,0,11
3/20/22,Antarctica,-71.9499,23.347,11,0,0,11
3/21/22,Antarctica,-71.9499,23.347,11,0,0,11
3/22/22,Antarctica,-71.9499,23.347,11,0,0,11
3/23/22,Antarctica,-71.9499,23.347,11,0,0,11
3/24/22,Antarctica,-71.9499,23.347,11,0,0,11
3/25/22,Antarctica,-71.9499,23.347,11,0,0,11
3/26/22,Antarctica,-71.9499,23.347,11,0,0,11
3/27/22,Antarctica,-71.9499,23.347,11,0,0,11
3/28/22,Antarctica,-71.9499,23.347,11,0,0,11
3/29/22,Antarctica,-71.9499,23.347,11,0,0,11
3/30/22,Antarctica,-71.9499,23.347,11,0,0,11
3/31/22,Antarctica,-71.9499,23.347,11,0,0,11
4/1/22,Antarctica,-71.9499,23.347,11,0,0,11
4/2/22,Antarctica,-71.9499,23.347,11,0,0,11
4/3/22,Antarctica,-71.9499,23.347,11,0,0,11
4/4/22,Antarctica,-71.9499,23.347,11,0,0,11
4/5/22,Antarctica,-71.9499,23.347,11,0,0,11
4/6/22,Antarctica,-71.9499,23.347,11,0,0,11
4/7/22,Antarctica,-71.9499,23.347,11,0,0,11
4/8/22,Antarctica,-71.9499,23.347,11,0,0,11
4/9/22,Antarctica,-71.9499,23.347,11,0,0,11
4/10/22,Antarctica,-71.9499,23.347,11,0,0,11
4/11/22,Antarctica,-71.9499,23.347,11,0,0,11
4/12/22,Antarctica,-71.9499,23.347,11,0,0,11
4/13/22,Antarctica,-71.9499,23.347,11,0,0,11
4/14/22,Antarctica,-71.9499,23.347,11,0,0,11
4/15/22,Antarctica,-71.9499,23.347,11,0,0,11
4/16/22,Antarctica,-71.9499,23.347,11,0,0,11
4/17/22,Antarctica,-71.9499,23.347,11,0,0,11
4/18/22,Antarctica,-71.9499,23.347,11,0,0,11
4/19/22,Antarctica,-71.9499,23.347,11,0,0,11
4/20/22,Antarctica,-71.9499,23.347,11,0,0,11
4/21/22,Antarctica,-71.9499,23.347,11,0,0,11
4/22/22,Antarctica,-71.9499,23.347,11,0,0,11
4/23/22,Antarctica,-71.9499,23.347,11,0,0,11
4/24/22,Antarctica,-71.9499,23.347,11,0,0,11
4/25/22,Antarctica,-71.9499,23.347,11,0,0,11
4/26/22,Antarctica,-71.9499,23.347,11,0,0,11
4/27/22,Antarctica,-71.9499,23.347,11,0,0,11
4/28/22,Antarctica,-71.9499,23.347,11,0,0,11
4/29/22,Antarctica,-71.9499,23.347,11,0,0,11
4/30/22,Antarctica,-71.9499,23.347,11,0,0,11
5/1/22,Antarctica,-71.9499,23.347,11,0,0,11
5/2/22,Antarctica,-71.9499,23.347,11,0,0,11
5/3/22,Antarctica,-71.9499,23.347,11,0,0,11
5/4/22,Antarctica,-71.9499,23.347,11,0,0,11
5/5/22,Antarctica,-71.9499,23.347,11,0,0,11
5/6/22,Antarctica,-71.9499,23.347,11,0,0,11
5/7/22,Antarctica,-71.9499,23.347,11,0,0,11
5/8/22,Antarctica,-71.9499,23.347,11,0,0,11
5/9/22,Antarctica,-71.9499,23.347,11,0,0,11
5/10/22,Antarctica,-71.9499,23.347,11,0,0,11
5/11/22,Antarctica,-71.9499,23.347,11,0,0,11
5/12/22,Antarctica,-71.9499,23.347,11,0,0,11
5/13/22,Antarctica,-71.9499,23.347,11,0,0,11
5/14/22,Antarctica,-71.9499,23.347,11,0,0,11
5/15/22,Antarctica,-71.9499,23.347,11,0,0,11
5/16/22,Antarctica,-71.9499,23.347,11,0,0,11
5/17/22,Antarctica,-71.9499,23.347,11,0,0,11
5/18/22,Antarctica,-71.9499,23.347,11,0,0,11
5/19/22,Antarctica,-71.9499,23.347,11,0,0,11
5/20/22,Antarctica,-71.9499,23.347,11,0,0,11
5/21/22,Antarctica,-71.9499,23.347,11,0,0,11
5/22/22,Antarctica,-71.9499,23.347,11,0,0,11
5/23/22,Antarctica,-71.9499,23.347,11,0,0,11
5/24/22,Antarctica,-71.9499,23.347,11,0,0,11
5/25/22,Antarctica,-71.9499,23.347,11,0,0,11
5/26/22,Antarctica,-71.9499,23.347,11,0,0,11
5/27/22,Antarctica,-71.9499,23.347,11,0,0,11
5/28/22,Antarctica,-71.9499,23.347,11,0,0,11
5/29/22,Antarctica,-71.9499,23.347,11,0,0,11
5/30/22,Antarctica,-71.9499,23.347,11,0,0,11
5/31/22,Antarctica,-71.9499,23.347,11,0,0,11
6/1/22,Antarctica,-71.9499,23.347,11,0,0,11
6/2/22,Antarctica,-71.9499,23.347,11,0,0,11
6/3/22,Antarctica,-71.9499,23.347,11,0,0,11
6/4/22,Antarctica,-71.9499,23.347,11,0,0,11
6/5/22,Antarctica,-71.9499,23.347,11,0,0,11
6/6/22,Antarctica,-71.9499,23.347,11,0,0,11
6/7/22,Antarctica,-71.9499,23.347,11,0,0,11
6/8/22,Antarctica,-71.9499,23.347,11,0,0,11
6/9/22,Antarctica,-71.9499,23.347,11,0,0,11
6/10/22,Antarctica,-71.9499,23.347,11,0,0,11
6/11/22,Antarctica,-71.9499,23.347,11,0,0,11
6/12/22,Antarctica,-71.9499,23.347,11,0,0,11
6/13/22,Antarctica,-71.9499,23.347,11,0,0,11
6/14/22,Antarctica,-71.9499,23.347,11,0,0,11
6/15/22,Antarctica,-71.9499,23.347,11,0,0,11
6/16/22,Antarctica,-71.9499,23.347,11,0,0,11
6/17/22,Antarctica,-71.9499,23.347,11,0,0,11
6/18/22,Antarctica,-71.9499,23.347,11,0,0,11
6/19/22,Antarctica,-71.9499,23.347,11,0,0,11
6/20/22,Antarctica,-71.9499,23.347,11,0,0,11
6/21/22,Antarctica,-71.9499,23.347,11,0,0,11
6/22/22,Antarctica,-71.9499,23.347,11,0,0,11
6/23/22,Antarctica,-71.9499,23.347,11,0,0,11
6/24/22,Antarctica,-71.9499,23.347,11,0,0,11
6/25/22,Antarctica,-71.9499,23.347,11,0,0,11
6/26/22,Antarctica,-71.9499,23.347,11,0,0,11
6/27/22,Antarctica,-71.9499,23.347,11,0,0,11
6/28/22,Antarctica,-71.9499,23.347,11,0,0,11
6/29/22,Antarctica,-71.9499,23.347,11,0,0,11
6/30/22,Antarctica,-71.9499,23.347,11,0,0,11
7/1/22,Antarctica,-71.9499,23.347,11,0,0,11
7/2/22,Antarctica,-71.9499,23.347,11,0,0,11
7/3/22,Antarctica,-71.9499,23.347,11,0,0,11
7/4/22,Antarctica,-71.9499,23.347,11,0,0,11
7/5/22,Antarctica,-71.9499,23.347,11,0,0,11
7/6/22,Antarctica,-71.9499,23.347,11,0,0,11
7/7/22,Antarctica,-71.9499,23.347,11,0,0,11
7/8/22,Antarctica,-71.9499,23.347,11,0,0,11
7/9/22,Antarctica,-71.9499,23.347,11,0,0,11
7/10/22,Antarctica,-71.9499,23.347,11,0,0,11
7/11/22,Antarctica,-71.9499,23.347,11,0,0,11
7/12/22,Antarctica,-71.9499,23.347,11,0,0,11
7/13/22,Antarctica,-71.9499,23.347,11,0,0,11
7/14/22,Antarctica,-71.9499,23.347,11,0,0,11
7/15/22,Antarctica,-71.9499,23.347,11,0,0,11
7/16/22,Antarctica,-71.9499,23.347,11,0,0,11
7/17/22,Antarctica,-71.9499,23.347,11,0,0,11
7/18/22,Antarctica,-71.9499,23.347,11,0,0,11
7/19/22,Antarctica,-71.9499,23.347,11,0,0,11
7/20/22,Antarctica,-71.9499,23.347,11,0,0,11
7/21/22,Antarctica,-71.9499,23.347,11,0,0,11
7/22/22,Antarctica,-71.9499,23.347,11,0,0,11
7/23/22,Antarctica,-71.9499,23.347,11,0,0,11
7/24/22,Antarctica,-71.9499,23.347,11,0,0,11
7/25/22,Antarctica,-71.9499,23.347,11,0,0,11
7/26/22,Antarctica,-71.9499,23.347,11,0,0,11
7/27/22,Antarctica,-71.9499,23.347,11,0,0,11
7/28/22,Antarctica,-71.9499,23.347,11,0,0,11
7/29/22,Antarctica,-71.9499,23.347,11,0,0,11
7/30/22,Antarctica,-71.9499,23.347,11,0,0,11
7/31/22,Antarctica,-71.9499,23.347,11,0,0,11
8/1/22,Antarctica,-71.9499,23.347,11,0,0,11
8/2/22,Antarctica,-71.9499,23.347,11,0,0,11
8/3/22,Antarctica,-71.9499,23.347,11,0,0,11
8/4/22,Antarctica,-71.9499,23.347,11,0,0,11
8/5/22,Antarctica,-71.9499,23.347,11,0,0,11
8/6/22,Antarctica,-71.9499,23.347,11,0,0,11
8/7/22,Antarctica,-71.9499,23.347,11,0,0,11
8/8/22,Antarctica,-71.9499,23.347,11,0,0,11
8/9/22,Antarctica,-71.9499,23.347,11,0,0,11
8/10/22,Antarctica,-71.9499,23.347,11,0,0,11
8/11/22,Antarctica,-71.9499,23.347,11,0,0,11
8/12/22,Antarctica,-71.9499,23.347,11,0,0,11
8/13/22,Antarctica,-71.9499,23.347,11,0,0,11
8/14/22,Antarctica,-71.9499,23.347,11,0,0,11
8/15/22,Antarctica,-71.9499,23.347,11,0,0,11
8/16/22,Antarctica,-71.9499,23.347,11,0,0,11
8/17/22,Antarctica,-71.9499,23.347,11,0,0,11
8/18/22,Antarctica,-71.9499,23.347,11,0,0,11
8/19/22,Antarctica,-71.9499,23.347,11,0,0,11
8/20/22,Antarctica,-71.9499,23.347,11,0,0,11
8/21/22,Antarctica,-71.9499,23.347,11,0,0,11
8/22/22,Antarctica,-71.9499,23.347,11,0,0,11
8/23/22,Antarctica,-71.9499,23.347,11,0,0,11
8/24/22,Antarctica,-71.9499,23.347,11,0,0,11
8/25/22,Antarctica,-71.9499,23.347,11,0,0,11
8/26/22,Antarctica,-71.9499,23.347,11,0,0,11
8/27/22,Antarctica,-71.9499,23.347,11,0,0,11
8/28/22,Antarctica,-71.9499,23.347,11,0,0,11
8/29/22,Antarctica,-71.9499,23.347,11,0,0,11
8/30/22,Antarctica,-71.9499,23.347,11,0,0,11
8/31/22,Antarctica,-71.9499,23.347,11,0,0,11
9/1/22,Antarctica,-71.9499,23.347,11,0,0,11
9/2/22,Antarctica,-71.9499,23.347,11,0,0,11
9/3/22,Antarctica,-71.9499,23.347,11,0,0,11
9/4/22,Antarctica,-71.9499,23.347,11,0,0,11
9/5/22,Antarctica,-71.9499,23.347,11,0,0,11
9/6/22,Antarctica,-71.9499,23.347,11,0,0,11
9/7/22,Antarctica,-71.9499,23.347,11,0,0,11
9/8/22,Antarctica,-71.9499,23.347,11,0,0,11
9/9/22,Antarctica,-71.9499,23.347,11,0,0,11
9/10/22,Antarctica,-71.9499,23.347,11,0,0,11
9/11/22,Antarctica,-71.9499,23.347,11,0,0,11
9/12/22,Antarctica,-71.9499,23.347,11,0,0,11
9/13/22,Antarctica,-71.9499,23.347,11,0,0,11
9/14/22,Antarctica,-71.9499,23.347,11,0,0,11
9/15/22,Antarctica,-71.9499,23.347,11,0,0,11
9/16/22,Antarctica,-71.9499,23.347,11,0,0,11
9/17/22,Antarctica,-71.9499,23.347,11,0,0,11
9/18/22,Antarctica,-71.9499,23.347,11,0,0,11
9/19/22,Antarctica,-71.9499,23.347,11,0,0,11
9/20/22,Antarctica,-71.9499,23.347,11,0,0,11
9/21/22,Antarctica,-71.9499,23.347,11,0,0,11
9/22/22,Antarctica,-71.9499,23.347,11,0,0,11
9/23/22,Antarctica,-71.9499,23.347,11,0,0,11
9/24/22,Antarctica,-71.9499,23.347,11,0,0,11
9/25/22,Antarctica,-71.9499,23.347,11,0,0,11
9/26/22,Antarctica,-71.9499,23.347,11,0,0,11
9/27/22,Antarctica,-71.9499,23.347,11,0,0,11
9/28/22,Antarctica,-71.9499,23.347,11,0,0,11
9/29/22,Antarctica,-71.9499,23.347,11,0,0,11
9/30/22,Antarctica,-71.9499,23.347,11,0,0,11
10/1/22,Antarctica,-71.9499,23.347,11,0,0,11
10/2/22,Antarctica,-71.9499,23.347,11,0,0,11
10/3/22,Antarctica,-71.9499,23.347,11,0,0,11
10/4/22,Antarctica,-71.9499,23.347,11,0,0,11
10/5/22,Antarctica,-71.9499,23.347,11,0,0,11
10/6/22,Antarctica,-71.9499,23.347,11,0,0,11
10/7/22,Antarctica,-71.9499,23.347,11,0,0,11
10/8/22,Antarctica,-71.9499,23.347,11,0,0,11
10/9/22,Antarctica,-71.9499,23.347,11,0,0,11
10/10/22,Antarctica,-71.9499,23.347,11,0,0,11
10/11/22,Antarctica,-71.9499,23.347,11,0,0,11
10/12/22,Antarctica,-71.9499,23.347,11,0,0,11
10/13/22,Antarctica,-71.9499,23.347,11,0,0,11
10/14/22,Antarctica,-71.9499,23.347,11,0,0,11
10/15/22,Antarctica,-71.9499,23.347,11,0,0,11
10/16/22,Antarctica,-71.9499,23.347,11,0,0,11
10/17/22,Antarctica,-71.9499,23.347,11,0,0,11
10/18/22,Antarctica,-71.9499,23.347,11,0,0,11
10/19/22,Antarctica,-71.9499,23.347,11,0,0,11
10/20/22,Antarctica,-71.9499,23.347,11,0,0,11
10/21/22,Antarctica,-71.9499,23.347,11,0,0,11
10/22/22,Antarctica,-71.9499,23.347,11,0,0,11
10/23/22,Antarctica,-71.9499,23.347,11,0,0,11
10/24/22,Antarctica,-71.9499,23.347,11,0,0,11
10/25/22,Antarctica,-71.9499,23.347,11,0,0,11
10/26/22,Antarctica,-71.9499,23.347,11,0,0,11
10/27/22,Antarctica,-71.9499,23.347,11,0,0,11
10/28/22,Antarctica,-71.9499,23.347,11,0,0,11
10/29/22,Antarctica,-71.9499,23.347,11,0,0,11
10/30/22,Antarctica,-71.9499,23.347,11,0,0,11
10/31/22,Antarctica,-71.9499,23.347,11,0,0,11
11/1/22,Antarctica,-71.9499,23.347,11,0,0,11
11/2/22,Antarctica,-71.9499,23.347,11,0,0,11
11/3/22,Antarctica,-71.9499,23.347,11,0,0,11
11/4/22,Antarctica,-71.9499,23.347,11,0,0,11
11/5/22,Antarctica,-71.9499,23.347,11,0,0,11
11/6/22,Antarctica,-71.9499,23.347,11,0,0,11
11/7/22,Antarctica,-71.9499,23.347,11,0,0,11
11/8/22,Antarctica,-71.9499,23.347,11,0,0,11
11/9/22,Antarctica,-71.9499,23.347,11,0,0,11
11/10/22,Antarctica,-71.9499,23.347,11,0,0,11
11/11/22,Antarctica,-71.9499,23.347,11,0,0,11
11/12/22,Antarctica,-71.9499,23.347,11,0,0,11
11/13/22,Antarctica,-71.9499,23.347,11,0,0,11
11/14/22,Antarctica,-71.9499,23.347,11,0,0,11
11/15/22,Antarctica,-71.9499,23.347,11,0,0,11
11/16/22,Antarctica,-71.9499,23.347,11,0,0,11
11/17/22,Antarctica,-71.9499,23.347,11,0,0,11
11/18/22,Antarctica,-71.9499,23.347,11,0,0,11
11/19/22,Antarctica,-71.9499,23.347,11,0,0,11
11/20/22,Antarctica,-71.9499,23.347,11,0,0,11
11/21/22,Antarctica,-71.9499,23.347,11,0,0,11
11/22/22,Antarctica,-71.9499,23.347,11,0,0,11
11/23/22,Antarctica,-71.9499,23.347,11,0,0,11
11/24/22,Antarctica,-71.9499,23.347,11,0,0,11
11/25/22,Antarctica,-71.9499,23.347,11,0,0,11
11/26/22,Antarctica,-71.9499,23.347,11,0,0,11
11/27/22,Antarctica,-71.9499,23.347,11,0,0,11
11/28/22,Antarctica,-71.9499,23.347,11,0,0,11
11/29/22,Antarctica,-71.9499,23.347,11,0,0,11
11/30/22,Antarctica,-71.9499,23.347,11,0,0,11
12/1/22,Antarctica,-71.9499,23.347,11,0,0,11
12/2/22,Antarctica,-71.9499,23.347,11,0,0,11
12/3/22,Antarctica,-71.9499,23.347,11,0,0,11
12/4/22,Antarctica,-71.9499,23.347,11,0,0,11
12/5/22,Antarctica,-71.9499,23.347,11,0,0,11
12/6/22,Antarctica,-71.9499,23.347,11,0,0,11
12/7/22,Antarctica,-71.9499,23.347,11,0,0,11
12/8/22,Antarctica,-71.9499,23.347,11,0,0,11
12/9/22,Antarctica,-71.9499,23.347,11,0,0,11
12/10/22,Antarctica,-71.9499,23.347,11,0,0,11
12/11/22,Antarctica,-71.9499,23.347,11,0,0,11
12/12/22,Antarctica,-71.9499,23.347,11,0,0,11
12/13/22,Antarctica,-71.9499,23.347,11,0,0,11
12/14/22,Antarctica,-71.9499,23.347,11,0,0,11
12/15/22,Antarctica,-71.9499,23.347,11,0,0,11
12/16/22,Antarctica,-71.9499,23.347,11,0,0,11
12/17/22,Antarctica,-71.9499,23.347,11,0,0,11
1/1/22,Antigua and Barbuda,17.0608,-61.7964,4283,0,119,4164
1/2/22,Antigua and Barbuda,17.0608,-61.7964,4283,0,119,4164
1/3/22,Antigua and Barbuda,17.0608,-61.7964,4283,0,119,4164
1/4/22,Antigua and Barbuda,17.0608,-61.7964,4486,0,119,4367
1/5/22,Antigua and Barbuda,17.0608,-61.7964,4486,0,119,4367
1/6/22,Antigua and Barbuda,17.0608,-61.7964,4715,0,119,4596
1/7/22,Antigua and Barbuda,17.0608,-61.7964,4715,0,119,4596
1/8/22,Antigua and Barbuda,17.0608,-61.7964,4844,0,119,4725
1/9/22,Antigua and Barbuda,17.0608,-61.7964,5058,0,120,4938
1/10/22,Antigua and Barbuda,17.0608,-61.7964,5058,0,120,4938
1/11/22,Antigua and Barbuda,17.0608,-61.7964,5058,0,120,4938
1/12/22,Antigua and Barbuda,17.0608,-61.7964,5214,0,120,5094
1/13/22,Antigua and Barbuda,17.0608,-61.7964,5214,0,120,5094
1/14/22,Antigua and Barbuda,17.0608,-61.7964,5246,0,120,5126
1/15/22,Antigua and Barbuda,17.0608,-61.7964,5321,0,120,5201
1/16/22,Antigua and Barbuda,17.0608,-61.7964,5321,0,120,5201
1/17/22,Antigua and Barbuda,17.0608,-61.7964,5321,0,120,5201
1/18/22,Antigua and Barbuda,17.0608,-61.7964,5346,0,121,5225
1/19/22,Antigua and Barbuda,17.0608,-61.7964,5741,0,121,5620
1/20/22,Antigua and Barbuda,17.0608,-61.7964,5741,0,121,5620
1/21/22,Antigua and Barbuda,17.0608,-61.7964,5815,0,122,5693
1/22/22,Antigua and Barbuda,17.0608,-61.7964,5931,0,122,5809
1/23/22,Antigua and Barbuda,17.0608,-61.7964,5931,0,122,5809
1/24/22,Antigua and Barbuda,17.0608,-61.7964,6023,0,122,5901
1/25/22,Antigua and Barbuda,17.0608,-61.7964,6023,0,122,5901
1/26/22,Antigua and Barbuda,17.0608,-61.7964,6442,0,126,6316
1/27/22,Antigua and Barbuda,17.0608,-61.7964,6524,0,127,6397
1/28/22,Antigua and Barbuda,17.0608,-61.7964,6558,0,127,6431
1/29/22,Antigua and Barbuda,17.0608,-61.7964,6558,0,127,6431
1/30/22,Antigua and Barbuda,17.0608,-61.7964,6558,0,127,6431
1/31/22,Antigua and Barbuda,17.0608,-61.7964,6627,0,127,6500
2/1/22,Antigua and Barbuda,17.0608,-61.7964,6627,0,127,6500
2/2/22,Antigua and Barbuda,17.0608,-61.7964,6732,0,127,6605
2/3/22,Antigua and Barbuda,17.0608,-61.7964,6732,0,127,6605
2/4/22,Antigua and Barbuda,17.0608,-61.7964,6732,0,127,6605
2/5/22,Antigua and Barbuda,17.0608,-61.7964,6732,0,127,6605
2/6/22,Antigua and Barbuda,17.0608,-61.7964,6853,0,131,6722
2/7/22,Antigua and Barbuda,17.0608,-61.7964,6853,0,131,6722
2/8/22,Antigua and Barbuda,17.0608,-61.7964,6853,0,131,6722
2/9/22,Antigua and Barbuda,17.0608,-61.7964,6853,0,131,6722
2/10/22,Antigua and Barbuda,17.0608,-61.7964,7321,0,134,7187
2/11/22,Antigua and Barbuda,17.0608,-61.7964,7331,0,134,7197
2/12/22,Antigua and Barbuda,17.0608,-61.7964,7331,0,134,7197
2/13/22,Antigua and Barbuda,17.0608,-61.7964,7331,0,134,7197
2/14/22,Antigua and Barbuda,17.0608,-61.7964,7331,0,134,7197
2/15/22,Antigua and Barbuda,17.0608,-61.7964,7342,0,134,7208
2/16/22,Antigua and Barbuda,17.0608,-61.7964,7395,0,135,7260
2/17/22,Antigua and Barbuda,17.0608,-61.7964,7395,0,135,7260
2/18/22,Antigua and Barbuda,17.0608,-61.7964,7400,0,135,7265
2/19/22,Antigua and Barbuda,17.0608,-61.7964,7408,0,135,7273
2/20/22,Antigua and Barbuda,17.0608,-61.7964,7408,0,135,7273
2/21/22,Antigua and Barbuda,17.0608,-61.7964,7408,0,135,7273
2/22/22,Antigua and Barbuda,17.0608,-61.7964,7408,0,135,7273
2/23/22,Antigua and Barbuda,17.0608,-61.7964,7429,0,135,7294
2/24/22,Antigua and Barbuda,17.0608,-61.7964,7435,0,135,7300
2/25/22,Antigua and Barbuda,17.0608,-61.7964,7437,0,135,7302
2/26/22,Antigua and Barbuda,17.0608,-61.7964,7437,0,135,7302
2/27/22,Antigua and Barbuda,17.0608,-61.7964,7437,0,135,7302
2/28/22,Antigua and Barbuda,17.0608,-61.7964,7437,0,135,7302
3/1/22,Antigua and Barbuda,17.0608,-61.7964,7447,0,135,7312
3/2/22,Antigua and Barbuda,17.0608,-61.7964,7449,0,135,7314
3/3/22,Antigua and Barbuda,17.0608,-61.7964,7449,0,135,7314
3/4/22,Antigua and Barbuda,17.0608,-61.7964,7449,0,135,7314
3/5/22,Antigua and Barbuda,17.0608,-61.7964,7455,0,135,7320
3/6/22,Antigua and Barbuda,17.0608,-61.7964,7455,0,135,7320
3/7/22,Antigua and Barbuda,17.0608,-61.7964,7455,0,135,7320
3/8/22,Antigua and Barbuda,17.0608,-61.7964,7455,0,135,7320
3/9/22,Antigua and Barbuda,17.0608,-61.7964,7461,0,135,7326
3/10/22,Antigua and Barbuda,17.0608,-61.7964,7461,0,135,7326
3/11/22,Antigua and Barbuda,17.0608,-61.7964,7466,0,135,7331
3/12/22,Antigua and Barbuda,17.0608,-61.7964,7466,0,135,7331
3/13/22,Antigua and Barbuda,17.0608,-61.7964,7466,0,135,7331
3/14/22,Antigua and Barbuda,17.0608,-61.7964,7466,0,135,7331
3/15/22,Antigua and Barbuda,17.0608,-61.7964,7470,0,135,7335
3/16/22,Antigua and Barbuda,17.0608,-61.7964,7470,0,135,7335
3/17/22,Antigua and Barbuda,17.0608,-61.7964,7470,0,135,7335
3/18/22,Antigua and Barbuda,17.0608,-61.7964,7470,0,135,7335
3/19/22,Antigua and Barbuda,17.0608,-61.7964,7473,0,135,7338
3/20/22,Antigua and Barbuda,17.0608,-61.7964,7473,0,135,7338
3/21/22,Antigua and Barbuda,17.0608,-61.7964,7473,0,135,7338
3/22/22,Antigua and Barbuda,17.0608,-61.7964,7473,0,135,7338
3/23/22,Antigua and Barbuda,17.0608,-61.7964,7482,0,135,7347
3/24/22,Antigua and Barbuda,17.0608,-61.7964,7482,0,135,7347
3/25/22,Antigua and Barbuda,17.0608,-61.7964,7482,0,135,7347
3/26/22,Antigua and Barbuda,17.0608,-61.7964,7482,0,135,7347
3/27/22,Antigua and Barbuda,17.0608,-61.7964,7485,0,135,7350
3/28/22,Antigua and Barbuda,17.0608,-61.7964,7491,0,135,7356
3/29/22,Antigua and Barbuda,17.0608,-61.7964,7491,0,135,7356
3/30/22,Antigua and Barbuda,17.0608,-61.7964,7491,0,135,7356
3/31/22,Antigua and Barbuda,17.0608,-61.7964,7491,0,135,7356
4/1/22,Antigua and Barbuda,17.0608,-61.7964,7493,0,135,7358
4/2/22,Antigua and Barbuda,17.0608,-61.7964,7493,0,135,7358
4/3/22,Antigua and Barbuda,17.0608,-61.7964,7493,0,135,7358
4/4/22,Antigua and Barbuda,17.0608,-61.7964,7493,0,135,7358
4/5/22,Antigua and Barbuda,17.0608,-61.7964,7493,0,135,7358
4/6/22,Antigua and Barbuda,17.0608,-61.7964,7493,0,135,7358
4/7/22,Antigua and Barbuda,17.0608,-61.7964,7511,0,135,7376
4/8/22,Antigua and Barbuda,17.0608,-61.7964,7511,0,135,7376
4/9/22,Antigua and Barbuda,17.0608,-61.7964,7511,0,135,7376
4/10/22,Antigua and Barbuda,17.0608,-61.7964,7511,0,135,7376
4/11/22,Antigua and Barbuda,17.0608,-61.7964,7511,0,135,7376
4/12/22,Antigua and Barbuda,17.0608,-61.7964,7523,0,135,7388
4/13/22,Antigua and Barbuda,17.0608,-61.7964,7523,0,135,7388
4/14/22,Antigua and Barbuda,17.0608,-61.7964,7535,0,135,7400
4/15/22,Antigua and Barbuda,17.0608,-61.7964,7535,0,135,7400
4/16/22,Antigua and Barbuda,17.0608,-61.7964,7535,0,135,7400
4/17/22,Antigua and Barbuda,17.0608,-61.7964,7539,0,135,7404
4/18/22,Antigua and Barbuda,17.0608,-61.7964,7539,0,135,7404
4/19/22,Antigua and Barbuda,17.0608,-61.7964,7539,0,135,7404
4/20/22,Antigua and Barbuda,17.0608,-61.7964,7567,0,135,7432
4/21/22,Antigua and Barbuda,17.0608,-61.7964,7567,0,135,7432
4/22/22,Antigua and Barbuda,17.0608,-61.7964,7571,0,135,7436
4/23/22,Antigua and Barbuda,17.0608,-61.7964,7571,0,135,7436
4/24/22,Antigua and Barbuda,17.0608,-61.7964,7571,0,135,7436
4/25/22,Antigua and Barbuda,17.0608,-61.7964,7571,0,135,7436
4/26/22,Antigua and Barbuda,17.0608,-61.7964,7571,0,135,7436
4/27/22,Antigua and Barbuda,17.0608,-61.7964,7571,0,135,7436
4/28/22,Antigua and Barbuda,17.0608,-61.7964,7604,0,136,7468
4/29/22,Antigua and Barbuda,17.0608,-61.7964,7626,0,136,7490
4/30/22,Antigua and Barbuda,17.0608,-61.7964,7626,0,136,7490
5/1/22,Antigua and Barbuda,17.0608,-61.7964,7626,0,136,7490
5/2/22,Antigua and Barbuda,17.0608,-61.7964,7626,0,136,7490
5/3/22,Antigua and Barbuda,17.0608,-61.7964,7626,0,136,7490
5/4/22,Antigua and Barbuda,17.0608,-61.7964,7654,0,137,7517
5/5/22,Antigua and Barbuda,17.0608,-61.7964,7663,0,137,7526
5/6/22,Antigua and Barbuda,17.0608,-61.7964,7663,0,137,7526
5/7/22,Antigua and Barbuda,17.0608,-61.7964,7663,0,137,7526
5/8/22,Antigua and Barbuda,17.0608,-61.7964,7663,0,137,7526
5/9/22,Antigua and Barbuda,17.0608,-61.7964,7663,0,137,7526
5/10/22,Antigua and Barbuda,17.0608,-61.7964,7663,0,137,7526
5/11/22,Antigua and Barbuda,17.0608,-61.7964,7721,0,137,7584
5/12/22,Antigua and Barbuda,17.0608,-61.7964,7721,0,137,7584
5/13/22,Antigua and Barbuda,17.0608,-61.7964,7721,0,137,7584
5/14/22,Antigua and Barbuda,17.0608,-61.7964,7721,0,137,7584
5/15/22,Antigua and Barbuda,17.0608,-61.7964,7721,0,137,7584
5/16/22,Antigua and Barbuda,17.0608,-61.7964,7795,0,137,7658
5/17/22,Antigua and Barbuda,17.0608,-61.7964,7795,0,137,7658
5/18/22,Antigua and Barbuda,17.0608,-61.7964,7855,0,138,7717
5/19/22,Antigua and Barbuda,17.0608,-61.7964,7910,0,138,7772
5/20/22,Antigua and Barbuda,17.0608,-61.7964,7910,0,138,7772
5/21/22,Antigua and Barbuda,17.0608,-61.7964,7942,0,138,7804
5/22/22,Antigua and Barbuda,17.0608,-61.7964,7942,0,138,7804
5/23/22,Antigua and Barbuda,17.0608,-61.7964,7982,0,138,7844
5/24/22,Antigua and Barbuda,17.0608,-61.7964,7982,0,138,7844
5/25/22,Antigua and Barbuda,17.0608,-61.7964,8062,0,138,7924
5/26/22,Antigua and Barbuda,17.0608,-61.7964,8119,0,138,7981
5/27/22,Antigua and Barbuda,17.0608,-61.7964,8119,0,138,7981
5/28/22,Antigua and Barbuda,17.0608,-61.7964,8119,0,138,7981
5/29/22,Antigua and Barbuda,17.0608,-61.7964,8119,0,138,7981
5/30/22,Antigua and Barbuda,17.0608,-61.7964,8163,0,138,8025
5/31/22,Antigua and Barbuda,17.0608,-61.7964,8253,0,138,8115
6/1/22,Antigua and Barbuda,17.0608,-61.7964,8253,0,138,8115
6/2/22,Antigua and Barbuda,17.0608,-61.7964,8295,0,138,8157
6/3/22,Antigua and Barbuda,17.0608,-61.7964,8295,0,138,8157
6/4/22,Antigua and Barbuda,17.0608,-61.7964,8378,0,138,8240
6/5/22,Antigua and Barbuda,17.0608,-61.7964,8378,0,138,8240
6/6/22,Antigua and Barbuda,17.0608,-61.7964,8378,0,138,8240
6/7/22,Antigua and Barbuda,17.0608,-61.7964,8378,0,138,8240
6/8/22,Antigua and Barbuda,17.0608,-61.7964,8378,0,138,8240
6/9/22,Antigua and Barbuda,17.0608,-61.7964,8406,0,139,8267
6/10/22,Antigua and Barbuda,17.0608,-61.7964,8479,0,140,8339
6/11/22,Antigua and Barbuda,17.0608,-61.7964,8479,0,140,8339
6/12/22,Antigua and Barbuda,17.0608,-61.7964,8492,0,140,8352
6/13/22,Antigua and Barbuda,17.0608,-61.7964,8531,0,140,8391
6/14/22,Antigua and Barbuda,17.0608,-61.7964,8537,0,140,8397
6/15/22,Antigua and Barbuda,17.0608,-61.7964,8537,0,140,8397
6/16/22,Antigua and Barbuda,17.0608,-61.7964,8537,0,140,8397
6/17/22,Antigua and Barbuda,17.0608,-61.7964,8555,0,140,8415
6/18/22,Antigua and Barbuda,17.0608,-61.7964,8581,0,140,8441
6/19/22,Antigua and Barbuda,17.0608,-61.7964,8581,0,140,8441
6/20/22,Antigua and Barbuda,17.0608,-61.7964,8581,0,140,8441
6/21/22,Antigua and Barbuda,17.0608,-61.7964,8581,0,140,8441
6/22/22,Antigua and Barbuda,17.0608,-61.7964,8590,0,141,8449
6/23/22,Antigua and Barbuda,17.0608,-61.7964,8590,0,141,8449
6/24/22,Antigua and Barbuda,17.0608,-61.7964,8625,0,141,8484
6/25/22,Antigua and Barbuda,17.0608,-61.7964,8625,0,141,8484
6/26/22,Antigua and Barbuda,17.0608,-61.7964,8625,0,141,8484
6/27/22,Antigua and Barbuda,17.0608,-61.7964,8625,0,141,8484
6/28/22,Antigua and Barbuda,17.0608,-61.7964,8625,0,141,8484
6/29/22,Antigua and Barbuda,17.0608,-61.7964,8625,0,141,8484
6/30/22,Antigua and Barbuda,17.0608,-61.7964,8641,0,141,8500
7/1/22,Antigua and Barbuda,17.0608,-61.7964,8656,0,141,8515
7/2/22,Antigua and Barbuda,17.0608,-61.7964,8665,0,141,8524
7/3/22,Antigua and Barbuda,17.0608,-61.7964,8665,0,141,8524
7/4/22,Antigua and Barbuda,17.0608,-61.7964,8665,0,141,8524
7/5/22,Antigua and Barbuda,17.0608,-61.7964,8665,0,141,8524
7/6/22,Antigua and Barbuda,17.0608,-61.7964,8668,0,141,8527
7/7/22,Antigua and Barbuda,17.0608,-61.7964,8681,0,142,8539
7/8/22,Antigua and Barbuda,17.0608,-61.7964,8686,0,143,8543
7/9/22,Antigua and Barbuda,17.0608,-61.7964,8686,0,143,8543
7/10/22,Antigua and Barbuda,17.0608,-61.7964,8686,0,143,8543
7/11/22,Antigua and Barbuda,17.0608,-61.7964,8686,0,143,8543
7/12/22,Antigua and Barbuda,17.0608,-61.7964,8686,0,143,8543
7/13/22,Antigua and Barbuda,17.0608,-61.7964,8686,0,143,8543
7/14/22,Antigua and Barbuda,17.0608,-61.7964,8704,0,143,8561
7/15/22,Antigua and Barbuda,17.0608,-61.7964,8704,0,143,8561
7/16/22,Antigua and Barbuda,17.0608,-61.7964,8712,0,144,8568
7/17/22,Antigua and Barbuda,17.0608,-61.7964,8712,0,144,8568
7/18/22,Antigua and Barbuda,17.0608,-61.7964,8712,0,144,8568
7/19/22,Antigua and Barbuda,17.0608,-61.7964,8712,0,144,8568
7/20/22,Antigua and Barbuda,17.0608,-61.7964,8712,0,144,8568
7/21/22,Antigua and Barbuda,17.0608,-61.7964,8712,0,144,8568
7/22/22,Antigua and Barbuda,17.0608,-61.7964,8736,0,144,8592
7/23/22,Antigua and Barbuda,17.0608,-61.7964,8736,0,144,8592
7/24/22,Antigua and Barbuda,17.0608,-61.7964,8736,0,144,8592
7/25/22,Antigua and Barbuda,17.0608,-61.7964,8736,0,144,8592
7/26/22,Antigua and Barbuda,17.0608,-61.7964,8741,0,144,8597
7/27/22,Antigua and Barbuda,17.0608,-61.7964,8741,0,144,8597
7/28/22,Antigua and Barbuda,17.0608,-61.7964,8741,0,144,8597
7/29/22,Antigua and Barbuda,17.0608,-61.7964,8741,0,144,8597
7/30/22,Antigua and Barbuda,17.0608,-61.7964,8773,0,144,8629
7/31/22,Antigua and Barbuda,17.0608,-61.7964,8773,0,144,8629
8/1/22,Antigua and Barbuda,17.0608,-61.7964,8773,0,144,8629
8/2/22,Antigua and Barbuda,17.0608,-61.7964,8773,0,144,8629
8/3/22,Antigua and Barbuda,17.0608,-61.7964,8773,0,144,8629
8/4/22,Antigua and Barbuda,17.0608,-61.7964,8773,0,144,8629
8/5/22,Antigua and Barbuda,17.0608,-61.7964,8773,0,144,8629
8/6/22,Antigua and Barbuda,17.0608,-61.7964,8773,0,144,8629
8/7/22,Antigua and Barbuda,17.0608,-61.7964,8787,0,144,8643
8/8/22,Antigua and Barbuda,17.0608,-61.7964,8809,0,144,8665
8/9/22,Antigua and Barbuda,17.0608,-61.7964,8809,0,144,8665
8/10/22,Antigua and Barbuda,17.0608,-61.7964,8809,0,144,8665
8/11/22,Antigua and Barbuda,17.0608,-61.7964,8809,0,144,8665
8/12/22,Antigua and Barbuda,17.0608,-61.7964,8820,0,144,8676
8/13/22,Antigua and Barbuda,17.0608,-61.7964,8820,0,144,8676
8/14/22,Antigua and Barbuda,17.0608,-61.7964,8820,0,144,8676
8/15/22,Antigua and Barbuda,17.0608,-61.7964,8851,0,144,8707
8/16/22,Antigua and Barbuda,17.0608,-61.7964,8851,0,144,8707
8/17/22,Antigua and Barbuda,17.0608,-61.7964,8851,0,144,8707
8/18/22,Antigua and Barbuda,17.0608,-61.7964,8895,0,144,8751
8/19/22,Antigua and Barbuda,17.0608,-61.7964,8895,0,144,8751
8/20/22,Antigua and Barbuda,17.0608,-61.7964,8895,0,144,8751
8/21/22,Antigua and Barbuda,17.0608,-61.7964,8895,0,144,8751
8/22/22,Antigua and Barbuda,17.0608,-61.7964,8895,0,144,8751
8/23/22,Antigua and Barbuda,17.0608,-61.7964,8895,0,144,8751
8/24/22,Antigua and Barbuda,17.0608,-61.7964,8949,0,145,8804
8/25/22,Antigua and Barbuda,17.0608,-61.7964,8949,0,145,8804
8/26/22,Antigua and Barbuda,17.0608,-61.7964,8949,0,145,8804
8/27/22,Antigua and Barbuda,17.0608,-61.7964,8949,0,145,8804
8/28/22,Antigua and Barbuda,17.0608,-61.7964,8949,0,145,8804
8/29/22,Antigua and Barbuda,17.0608,-61.7964,8949,0,145,8804
8/30/22,Antigua and Barbuda,17.0608,-61.7964,8974,0,145,8829
8/31/22,Antigua and Barbuda,17.0608,-61.7964,8974,0,145,8829
9/1/22,Antigua and Barbuda,17.0608,-61.7964,8974,0,145,8829
9/2/22,Antigua and Barbuda,17.0608,-61.7964,8974,0,145,8829
9/3/22,Antigua and Barbuda,17.0608,-61.7964,8974,0,145,8829
9/4/22,Antigua and Barbuda,17.0608,-61.7964,8974,0,145,8829
9/5/22,Antigua and Barbuda,17.0608,-61.7964,8974,0,145,8829
9/6/22,Antigua and Barbuda,17.0608,-61.7964,8974,0,145,8829
9/7/22,Antigua and Barbuda,17.0608,-61.7964,8974,0,145,8829
9/8/22,Antigua and Barbuda,17.0608,-61.7964,8974,0,145,8829
9/9/22,Antigua and Barbuda,17.0608,-61.7964,8974,0,145,8829
9/10/22,Antigua and Barbuda,17.0608,-61.7964,8974,0,145,8829
9/11/22,Antigua and Barbuda,17.0608,-61.7964,8974,0,145,8829
9/12/22,Antigua and Barbuda,17.0608,-61.7964,8974,0,145,8829
9/13/22,Antigua and Barbuda,17.0608,-61.7964,8974,0,145,8829
9/14/22,Antigua and Barbuda,17.0608,-61.7964,9008,0,145,8863
9/15/22,Antigua and Barbuda,17.0608,-61.7964,9008,0,145,8863
9/16/22,Antigua and Barbuda,17.0608,-61.7964,9008,0,145,8863
9/17/22,Antigua and Barbuda,17.0608,-61.7964,9008,0,145,8863
9/18/22,Antigua and Barbuda,17.0608,-61.7964,9008,0,145,8863
9/19/22,Antigua and Barbuda,17.0608,-61.7964,9008,0,145,8863
9/20/22,Antigua and Barbuda,17.0608,-61.7964,9008,0,145,8863
9/21/22,Antigua and Barbuda,17.0608,-61.7964,9008,0,145,8863
9/22/22,Antigua and Barbuda,17.0608,-61.7964,9008,0,145,8863
9/23/22,Antigua and Barbuda,17.0608,-61.7964,9008,0,145,8863
9/24/22,Antigua and Barbuda,17.0608,-61.7964,9008,0,145,8863
9/25/22,Antigua and Barbuda,17.0608,-61.7964,9008,0,145,8863
9/26/22,Antigua and Barbuda,17.0608,-61.7964,9089,0,146,8943
9/27/22,Antigua and Barbuda,17.0608,-61.7964,9089,0,146,8943
9/28/22,Antigua and Barbuda,17.0608,-61.7964,9089,0,146,8943
9/29/22,Antigua and Barbuda,17.0608,-61.7964,9098,0,146,8952
9/30/22,Antigua and Barbuda,17.0608,-61.7964,9098,0,146,8952
10/1/22,Antigua and Barbuda,17.0608,-61.7964,9098,0,146,8952
10/2/22,Antigua and Barbuda,17.0608,-61.7964,9098,0,146,8952
10/3/22,Antigua and Barbuda,17.0608,-61.7964,9098,0,146,8952
10/4/22,Antigua and Barbuda,17.0608,-61.7964,9098,0,146,8952
10/5/22,Antigua and Barbuda,17.0608,-61.7964,9098,0,146,8952
10/6/22,Antigua and Barbuda,17.0608,-61.7964,9098,0,146,8952
10/7/22,Antigua and Barbuda,17.0608,-61.7964,9098,0,146,8952
10/8/22,Antigua and Barbuda,17.0608,-61.7964,9098,0,146,8952
10/9/22,Antigua and Barbuda,17.0608,-61.7964,9098,0,146,8952
10/10/22,Antigua and Barbuda,17.0608,-61.7964,9098,0,146,8952
10/11/22,Antigua and Barbuda,17.0608,-61.7964,9098,0,146,8952
10/12/22,Antigua and Barbuda,17.0608,-61.7964,9106,0,146,8960
10/13/22,Antigua and Barbuda,17.0608,-61.7964,9106,0,146,8960
10/14/22,Antigua and Barbuda,17.0608,-61.7964,9106,0,146,8960
10/15/22,Antigua and Barbuda,17.0608,-61.7964,9106,0,146,8960
10/16/22,Antigua and Barbuda,17.0608,-61.7964,9106,0,146,8960
10/17/22,Antigua and Barbuda,17.0608,-61.7964,9106,0,146,8960
10/18/22,Antigua and Barbuda,17.0608,-61.7964,9106,0,146,8960
10/19/22,Antigua and Barbuda,17.0608,-61.7964,9106,0,146,8960
10/20/22,Antigua and Barbuda,17.0608,-61.7964,9106,0,146,8960
10/21/22,Antigua and Barbuda,17.0608,-61.7964,9106,0,146,8960
10/22/22,Antigua and Barbuda,17.0608,-61.7964,9106,0,146,8960
10/23/22,Antigua and Barbuda,17.0608,-61.7964,9106,0,146,8960
10/24/22,Antigua and Barbuda,17.0608,-61.7964,9106,0,146,8960
10/25/22,Antigua and Barbuda,17.0608,-61.7964,9106,0,146,8960
10/26/22,Antigua and Barbuda,17.0608,-61.7964,9106,0,146,8960
10/27/22,Antigua and Barbuda,17.0608,-61.7964,9106,0,146,8960
10/28/22,Antigua and Barbuda,17.0608,-61.7964,9106,0,146,8960
10/29/22,Antigua and Barbuda,17.0608,-61.7964,9106,0,146,8960
10/30/22,Antigua and Barbuda,17.0608,-61.7964,9106,0,146,8960
10/31/22,Antigua and Barbuda,17.0608,-61.7964,9106,0,146,8960
11/1/22,Antigua and Barbuda,17.0608,-61.7964,9106,0,146,8960
11/2/22,Antigua and Barbuda,17.0608,-61.7964,9106,0,146,8960
11/3/22,Antigua and Barbuda,17.0608,-61.7964,9106,0,146,8960
11/4/22,Antigua and Barbuda,17.0608,-61.7964,9106,0,146,8960
11/5/22,Antigua and Barbuda,17.0608,-61.7964,9106,0,146,8960
11/6/22,Antigua and Barbuda,17.0608,-61.7964,9106,0,146,8960
11/7/22,Antigua and Barbuda,17.0608,-61.7964,9106,0,146,8960
11/8/22,Antigua and Barbuda,17.0608,-61.7964,9106,0,146,8960
11/9/22,Antigua and Barbuda,17.0608,-61.7964,9106,0,146,8960
11/10/22,Antigua and Barbuda,17.0608,-61.7964,9106,0,146,8960
11/11/22,Antigua and Barbuda,17.0608,-61.7964,9106,0,146,8960
11/12/22,Antigua and Barbuda,17.0608,-61.7964,9106,0,146,8960
11/13/22,Antigua and Barbuda,17.0608,-61.7964,9106,0,146,8960
11/14/22,Antigua and Barbuda,17.0608,-61.7964,9106,0,146,8960
11/15/22,Antigua and Barbuda,17.0608,-61.7964,9106,0,146,8960
11/16/22,Antigua and Barbuda,17.0608,-61.7964,9106,0,146,8960
11/17/22,Antigua and Barbuda,17.0608,-61.7964,9106,0,146,8960
11/18/22,Antigua and Barbuda,17.0608,-61.7964,9106,0,146,8960
11/19/22,Antigua and Barbuda,17.0608,-61.7964,9106,0,146,8960
11/20/22,Antigua and Barbuda,17.0608,-61.7964,9106,0,146,8960
11/21/22,Antigua and Barbuda,17.0608,-61.7964,9106,0,146,8960
11/22/22,Antigua and Barbuda,17.0608,-61.7964,9106,0,146,8960
11/23/22,Antigua and Barbuda,17.0608,-61.7964,9106,0,146,8960
11/24/22,Antigua and Barbuda,17.0608,-61.7964,9106,0,146,8960
11/25/22,Antigua and Barbuda,17.0608,-61.7964,9106,0,146,8960
11/26/22,Antigua and Barbuda,17.0608,-61.7964,9106,0,146,8960
11/27/22,Antigua and Barbuda,17.0608,-61.7964,9106,0,146,8960
11/28/22,Antigua and Barbuda,17.0608,-61.7964,9106,0,146,8960
11/29/22,Antigua and Barbuda,17.0608,-61.7964,9106,0,146,8960
11/30/22,Antigua and Barbuda,17.0608,-61.7964,9106,0,146,8960
12/1/22,Antigua and Barbuda,17.0608,-61.7964,9106,0,146,8960
12/2/22,Antigua and Barbuda,17.0608,-61.7964,9106,0,146,8960
12/3/22,Antigua and Barbuda,17.0608,-61.7964,9106,0,146,8960
12/4/22,Antigua and Barbuda,17.0608,-61.7964,9106,0,146,8960
12/5/22,Antigua and Barbuda,17.0608,-61.7964,9106,0,146,8960
12/6/22,Antigua and Barbuda,17.0608,-61.7964,9106,0,146,8960
12/7/22,Antigua and Barbuda,17.0608,-61.7964,9106,0,146,8960
12/8/22,Antigua and Barbuda,17.0608,-61.7964,9106,0,146,8960
12/9/22,Antigua and Barbuda,17.0608,-61.7964,9106,0,146,8960
12/10/22,Antigua and Barbuda,17.0608,-61.7964,9106,0,146,8960
12/11/22,Antigua and Barbuda,17.0608,-61.7964,9106,0,146,8960
12/12/22,Antigua and Barbuda,17.0608,-61.7964,9106,0,146,8960
12/13/22,Antigua and Barbuda,17.0608,-61.7964,9106,0,146,8960
12/14/22,Antigua and Barbuda,17.0608,-61.7964,9106,0,146,8960
12/15/22,Antigua and Barbuda,17.0608,-61.7964,9106,0,146,8960
12/16/22,Antigua and Barbuda,17.0608,-61.7964,9106,0,146,8960
12/17/22,Antigua and Barbuda,17.0608,-61.7964,9106,0,146,8960
1/1/22,Argentina,-38.4161,-63.6167,5674428,0,117181,5557247
1/2/22,Argentina,-38.4161,-63.6167,5694930,0,117204,5577726
1/3/22,Argentina,-38.4161,-63.6167,5739326,0,117245,5622081
1/4/22,Argentina,-38.4161,-63.6167,5820536,0,117294,5703242
1/5/22,Argentina,-38.4161,-63.6167,5915695,0,117346,5798349
1/6/22,Argentina,-38.4161,-63.6167,6025303,0,117386,5907917
1/7/22,Argentina,-38.4161,-63.6167,6135836,0,117428,6018408
1/8/22,Argentina,-38.4161,-63.6167,6237525,0,117465,6120060
1/9/22,Argentina,-38.4161,-63.6167,6310844,0,117492,6193352
1/10/22,Argentina,-38.4161,-63.6167,6399196,0,117543,6281653
1/11/22,Argentina,-38.4161,-63.6167,6533635,0,117595,6416040
1/12/22,Argentina,-38.4161,-63.6167,6664717,0,117670,6547047
1/13/22,Argentina,-38.4161,-63.6167,6793119,0,117808,6675311
1/14/22,Argentina,-38.4161,-63.6167,6932972,0,117901,6815071
1/15/22,Argentina,-38.4161,-63.6167,7029624,0,117989,6911635
1/16/22,Argentina,-38.4161,-63.6167,7094865,0,118040,6976825
1/17/22,Argentina,-38.4161,-63.6167,7197323,0,118231,7079092
1/18/22,Argentina,-38.4161,-63.6167,7318305,0,118420,7199885
1/19/22,Argentina,-38.4161,-63.6167,7446626,0,118628,7327998
1/20/22,Argentina,-38.4161,-63.6167,7576335,0,118809,7457526
1/21/22,Argentina,-38.4161,-63.6167,7694506,0,118969,7575537
1/22/22,Argentina,-38.4161,-63.6167,7792652,0,119103,7673549
1/23/22,Argentina,-38.4161,-63.6167,7862536,0,119168,7743368
1/24/22,Argentina,-38.4161,-63.6167,7940657,0,119444,7821213
1/25/22,Argentina,-38.4161,-63.6167,8041520,0,119703,7921817
1/26/22,Argentina,-38.4161,-63.6167,8130023,0,120019,8010004
1/27/22,Argentina,-38.4161,-63.6167,8207752,0,120352,8087400
1/28/22,Argentina,-38.4161,-63.6167,8271636,0,120657,8150979
1/29/22,Argentina,-38.4161,-63.6167,8313614,0,120836,8192778
1/30/22,Argentina,-38.4161,-63.6167,8335184,0,120988,8214196
1/31/22,Argentina,-38.4161,-63.6167,8378656,0,121273,8257383
2/1/22,Argentina,-38.4161,-63.6167,8427778,0,121513,8306265
2/2/22,Argentina,-38.4161,-63.6167,8472848,0,121834,8351014
2/3/22,Argentina,-38.4161,-63.6167,8515285,0,122152,8393133
2/4/22,Argentina,-38.4161,-63.6167,8555379,0,122439,8432940
2/5/22,Argentina,-38.4161,-63.6167,8577215,0,122584,8454631
2/6/22,Argentina,-38.4161,-63.6167,8589879,0,122684,8467195
2/7/22,Argentina,-38.4161,-63.6167,8615285,0,122943,8492342
2/8/22,Argentina,-38.4161,-63.6167,8648075,0,123227,8524848
2/9/22,Argentina,-38.4161,-63.6167,8675327,0,123444,8551883
2/10/22,Argentina,-38.4161,-63.6167,8700437,0,123707,8576730
2/11/22,Argentina,-38.4161,-63.6167,8716940,0,123859,8593081
2/12/22,Argentina,-38.4161,-63.6167,8728262,0,123987,8604275
2/13/22,Argentina,-38.4161,-63.6167,8734551,0,124081,8610470
2/14/22,Argentina,-38.4161,-63.6167,8747601,0,124349,8623252
2/15/22,Argentina,-38.4161,-63.6167,8766174,0,124585,8641589
2/16/22,Argentina,-38.4161,-63.6167,8783208,0,124765,8658443
2/17/22,Argentina,-38.4161,-63.6167,8799858,0,124924,8674934
2/18/22,Argentina,-38.4161,-63.6167,8815247,0,125062,8690185
2/19/22,Argentina,-38.4161,-63.6167,8823054,0,125185,8697869
2/20/22,Argentina,-38.4161,-63.6167,8827504,0,125278,8702226
2/21/22,Argentina,-38.4161,-63.6167,8838674,0,125451,8713223
2/22/22,Argentina,-38.4161,-63.6167,8855624,0,125618,8730006
2/23/22,Argentina,-38.4161,-63.6167,8868188,0,125775,8742413
2/24/22,Argentina,-38.4161,-63.6167,8878486,0,125872,8752614
2/25/22,Argentina,-38.4161,-63.6167,8887973,0,125958,8762015
2/26/22,Argentina,-38.4161,-63.6167,8893568,0,126048,8767520
2/27/22,Argentina,-38.4161,-63.6167,8897178,0,126120,8771058
2/28/22,Argentina,-38.4161,-63.6167,8900656,0,126152,8774504
3/1/22,Argentina,-38.4161,-63.6167,8904176,0,126257,8777919
3/2/22,Argentina,-38.4161,-63.6167,8912317,0,126390,8785927
3/3/22,Argentina,-38.4161,-63.6167,8921536,0,126531,8795005
3/4/22,Argentina,-38.4161,-63.6167,8929898,0,126624,8803274
3/5/22,Argentina,-38.4161,-63.6167,8934328,0,126708,8807620
3/6/22,Argentina,-38.4161,-63.6167,8936602,0,126768,8809834
3/7/22,Argentina,-38.4161,-63.6167,8942888,0,126842,8816046
3/8/22,Argentina,-38.4161,-63.6167,8949362,0,126901,8822461
3/9/22,Argentina,-38.4161,-63.6167,8955458,0,126955,8828503
3/10/22,Argentina,-38.4161,-63.6167,8961595,0,127009,8834586
3/11/22,Argentina,-38.4161,-63.6167,8967210,0,127051,8840159
3/12/22,Argentina,-38.4161,-63.6167,8970196,0,127122,8843074
3/13/22,Argentina,-38.4161,-63.6167,8971432,0,127187,8844245
3/14/22,Argentina,-38.4161,-63.6167,8976079,0,127257,8848822
3/15/22,Argentina,-38.4161,-63.6167,8981155,0,127295,8853860
3/16/22,Argentina,-38.4161,-63.6167,8985836,0,127334,8858502
3/17/22,Argentina,-38.4161,-63.6167,8990413,0,127363,8863050
3/18/22,Argentina,-38.4161,-63.6167,9004829,0,127439,8877390
3/19/22,Argentina,-38.4161,-63.6167,9006526,0,127483,8879043
3/20/22,Argentina,-38.4161,-63.6167,9007753,0,127494,8880259
3/21/22,Argentina,-38.4161,-63.6167,9011367,0,127599,8883768
3/22/22,Argentina,-38.4161,-63.6167,9016057,0,127675,8888382
3/23/22,Argentina,-38.4161,-63.6167,9019660,0,127752,8891908
3/24/22,Argentina,-38.4161,-63.6167,9021240,0,127780,8893460
3/25/22,Argentina,-38.4161,-63.6167,9023812,0,127846,8895966
3/26/22,Argentina,-38.4161,-63.6167,9025257,0,127904,8897353
3/27/22,Argentina,-38.4161,-63.6167,9026075,0,127909,8898166
3/28/22,Argentina,-38.4161,-63.6167,9028730,0,127943,8900787
3/29/22,Argentina,-38.4161,-63.6167,9032162,0,127970,8904192
3/30/22,Argentina,-38.4161,-63.6167,9035127,0,127997,8907130
3/31/22,Argentina,-38.4161,-63.6167,9037911,0,128019,8909892
4/1/22,Argentina,-38.4161,-63.6167,9039838,0,128052,8911786
4/2/22,Argentina,-38.4161,-63.6167,9040640,0,128059,8912581
4/3/22,Argentina,-38.4161,-63.6167,9041124,0,128065,8913059
4/4/22,Argentina,-38.4161,-63.6167,9043098,0,128086,8915012
4/5/22,Argentina,-38.4161,-63.6167,9045326,0,128106,8917220
4/6/22,Argentina,-38.4161,-63.6167,9047408,0,128144,8919264
4/7/22,Argentina,-38.4161,-63.6167,9049250,0,128158,8921092
4/8/22,Argentina,-38.4161,-63.6167,9051243,0,128194,8923049
4/9/22,Argentina,-38.4161,-63.6167,9052083,0,128197,8923886
4/10/22,Argentina,-38.4161,-63.6167,9052536,0,128198,8924338
4/11/22,Argentina,-38.4161,-63.6167,9054126,0,128233,8925893
4/12/22,Argentina,-38.4161,-63.6167,9056203,0,128268,8927935
4/13/22,Argentina,-38.4161,-63.6167,9057923,0,128285,8929638
4/14/22,Argentina,-38.4161,-63.6167,9059351,0,128306,8931045
4/15/22,Argentina,-38.4161,-63.6167,9059944,0,128327,8931617
4/16/22,Argentina,-38.4161,-63.6167,9060495,0,128344,8932151
4/17/22,Argentina,-38.4161,-63.6167,9060923,0,128344,8932579
4/18/22,Argentina,-38.4161,-63.6167,9060923,0,128344,8932579
4/19/22,Argentina,-38.4161,-63.6167,9060923,0,128344,8932579
4/20/22,Argentina,-38.4161,-63.6167,9060923,0,128344,8932579
4/21/22,Argentina,-38.4161,-63.6167,9060923,0,128344,8932579
4/22/22,Argentina,-38.4161,-63.6167,9060923,0,128344,8932579
4/23/22,Argentina,-38.4161,-63.6167,9060923,0,128344,8932579
4/24/22,Argentina,-38.4161,-63.6167,9060923,0,128344,8932579
4/25/22,Argentina,-38.4161,-63.6167,9072230,0,128542,8943688
4/26/22,Argentina,-38.4161,-63.6167,9072230,0,128542,8943688
4/27/22,Argentina,-38.4161,-63.6167,9072230,0,128542,8943688
4/28/22,Argentina,-38.4161,-63.6167,9072230,0,128542,8943688
4/29/22,Argentina,-38.4161,-63.6167,9072230,0,128542,8943688
4/30/22,Argentina,-38.4161,-63.6167,9072230,0,128542,8943688
5/1/22,Argentina,-38.4161,-63.6167,9083673,0,128653,8955020
5/2/22,Argentina,-38.4161,-63.6167,9083673,0,128653,8955020
5/3/22,Argentina,-38.4161,-63.6167,9083673,0,128653,8955020
5/4/22,Argentina,-38.4161,-63.6167,9083673,0,128653,8955020
5/5/22,Argentina,-38.4161,-63.6167,9083673,0,128653,8955020
5/6/22,Argentina,-38.4161,-63.6167,9083673,0,128653,8955020
5/7/22,Argentina,-38.4161,-63.6167,9083673,0,128653,8955020
5/8/22,Argentina,-38.4161,-63.6167,9101319,0,128729,8972590
5/9/22,Argentina,-38.4161,-63.6167,9101319,0,128729,8972590
5/10/22,Argentina,-38.4161,-63.6167,9101319,0,128729,8972590
5/11/22,Argentina,-38.4161,-63.6167,9101319,0,128729,8972590
5/12/22,Argentina,-38.4161,-63.6167,9101319,0,128729,8972590
5/13/22,Argentina,-38.4161,-63.6167,9101319,0,128729,8972590
5/14/22,Argentina,-38.4161,-63.6167,9101319,0,128729,8972590
5/15/22,Argentina,-38.4161,-63.6167,9135308,0,128776,9006532
5/16/22,Argentina,-38.4161,-63.6167,9135308,0,128776,9006532
5/17/22,Argentina,-38.4161,-63.6167,9135308,0,128776,9006532
5/18/22,Argentina,-38.4161,-63.6167,9135308,0,128776,9006532
5/19/22,Argentina,-38.4161,-63.6167,9135308,0,128776,9006532
5/20/22,Argentina,-38.4161,-63.6167,9135308,0,128776,9006532
5/21/22,Argentina,-38.4161,-63.6167,9135308,0,128776,9006532
5/22/22,Argentina,-38.4161,-63.6167,9178795,0,128825,9049970
5/23/22,Argentina,-38.4161,-63.6167,9178795,0,128825,9049970
5/24/22,Argentina,-38.4161,-63.6167,9178795,0,128825,9049970
5/25/22,Argentina,-38.4161,-63.6167,9178795,0,128825,9049970
5/26/22,Argentina,-38.4161,-63.6167,9178795,0,128825,9049970
5/27/22,Argentina,-38.4161,-63.6167,9178795,0,128825,9049970
5/28/22,Argentina,-38.4161,-63.6167,9178795,0,128825,9049970
5/29/22,Argentina,-38.4161,-63.6167,9230573,0,128889,9101684
5/30/22,Argentina,-38.4161,-63.6167,9230573,0,128889,9101684
5/31/22,Argentina,-38.4161,-63.6167,9230573,0,128889,9101684
6/1/22,Argentina,-38.4161,-63.6167,9230573,0,128889,9101684
6/2/22,Argentina,-38.4161,-63.6167,9230573,0,128889,9101684
6/3/22,Argentina,-38.4161,-63.6167,9230573,0,128889,9101684
6/4/22,Argentina,-38.4161,-63.6167,9230573,0,128889,9101684
6/5/22,Argentina,-38.4161,-63.6167,9276618,0,128973,9147645
6/6/22,Argentina,-38.4161,-63.6167,9276618,0,128973,9147645
6/7/22,Argentina,-38.4161,-63.6167,9276618,0,128973,9147645
6/8/22,Argentina,-38.4161,-63.6167,9276618,0,128973,9147645
6/9/22,Argentina,-38.4161,-63.6167,9276618,0,128973,9147645
6/10/22,Argentina,-38.4161,-63.6167,9276618,0,128973,9147645
6/11/22,Argentina,-38.4161,-63.6167,9276618,0,128973,9147645
6/12/22,Argentina,-38.4161,-63.6167,9276618,0,128973,9147645
6/13/22,Argentina,-38.4161,-63.6167,9276618,0,128973,9147645
6/14/22,Argentina,-38.4161,-63.6167,9313453,0,128994,9184459
6/15/22,Argentina,-38.4161,-63.6167,9313453,0,128994,9184459
6/16/22,Argentina,-38.4161,-63.6167,9313453,0,128994,9184459
6/17/22,Argentina,-38.4161,-63.6167,9313453,0,128994,9184459
6/18/22,Argentina,-38.4161,-63.6167,9313453,0,128994,9184459
6/19/22,Argentina,-38.4161,-63.6167,9341492,0,129016,9212476
6/20/22,Argentina,-38.4161,-63.6167,9341492,0,129016,9212476
6/21/22,Argentina,-38.4161,-63.6167,9341492,0,129016,9212476
6/22/22,Argentina,-38.4161,-63.6167,9341492,0,129016,9212476
6/23/22,Argentina,-38.4161,-63.6167,9341492,0,129016,9212476
6/24/22,Argentina,-38.4161,-63.6167,9341492,0,129016,9212476
6/25/22,Argentina,-38.4161,-63.6167,9341492,0,129016,9212476
6/26/22,Argentina,-38.4161,-63.6167,9367172,0,129070,9238102
6/27/22,Argentina,-38.4161,-63.6167,9367172,0,129070,9238102
6/28/22,Argentina,-38.4161,-63.6167,9367172,0,129070,9238102
6/29/22,Argentina,-38.4161,-63.6167,9367172,0,129070,9238102
6/30/22,Argentina,-38.4161,-63.6167,9367172,0,129070,9238102
7/1/22,Argentina,-38.4161,-63.6167,9367172,0,129070,9238102
7/2/22,Argentina,-38.4161,-63.6167,9367172,0,129070,9238102
7/3/22,Argentina,-38.4161,-63.6167,9394326,0,129109,9265217
7/4/22,Argentina,-38.4161,-63.6167,9394326,0,129109,9265217
7/5/22,Argentina,-38.4161,-63.6167,9394326,0,129109,9265217
7/6/22,Argentina,-38.4161,-63.6167,9394326,0,129109,9265217
7/7/22,Argentina,-38.4161,-63.6167,9394326,0,129109,9265217
7/8/22,Argentina,-38.4161,-63.6167,9394326,0,129109,9265217
7/9/22,Argentina,-38.4161,-63.6167,9394326,0,129109,9265217
7/10/22,Argentina,-38.4161,-63.6167,9426171,0,129145,9297026
7/11/22,Argentina,-38.4161,-63.6167,9426171,0,129145,9297026
7/12/22,Argentina,-38.4161,-63.6167,9426171,0,129145,9297026
7/13/22,Argentina,-38.4161,-63.6167,9426171,0,129145,9297026
7/14/22,Argentina,-38.4161,-63.6167,9426171,0,129145,9297026
7/15/22,Argentina,-38.4161,-63.6167,9426171,0,129145,9297026
7/16/22,Argentina,-38.4161,-63.6167,9426171,0,129145,9297026
7/17/22,Argentina,-38.4161,-63.6167,9465827,0,129202,9336625
7/18/22,Argentina,-38.4161,-63.6167,9465827,0,129202,9336625
7/19/22,Argentina,-38.4161,-63.6167,9465827,0,129202,9336625
7/20/22,Argentina,-38.4161,-63.6167,9465827,0,129202,9336625
7/21/22,Argentina,-38.4161,-63.6167,9465827,0,129202,9336625
7/22/22,Argentina,-38.4161,-63.6167,9465827,0,129202,9336625
7/23/22,Argentina,-38.4161,-63.6167,9465827,0,129202,9336625
7/24/22,Argentina,-38.4161,-63.6167,9507562,0,129278,9378284
7/25/22,Argentina,-38.4161,-63.6167,9507562,0,129278,9378284
7/26/22,Argentina,-38.4161,-63.6167,9507562,0,129278,9378284
7/27/22,Argentina,-38.4161,-63.6167,9507562,0,129278,9378284
7/28/22,Argentina,-38.4161,-63.6167,9507562,0,129278,9378284
7/29/22,Argentina,-38.4161,-63.6167,9507562,0,129278,9378284
7/30/22,Argentina,-38.4161,-63.6167,9507562,0,129278,9378284
7/31/22,Argentina,-38.4161,-63.6167,9560307,0,129369,9430938
8/1/22,Argentina,-38.4161,-63.6167,9560307,0,129369,9430938
8/2/22,Argentina,-38.4161,-63.6167,9560307,0,129369,9430938
8/3/22,Argentina,-38.4161,-63.6167,9560307,0,129369,9430938
8/4/22,Argentina,-38.4161,-63.6167,9560307,0,129369,9430938
8/5/22,Argentina,-38.4161,-63.6167,9560307,0,129369,9430938
8/6/22,Argentina,-38.4161,-63.6167,9560307,0,129369,9430938
8/7/22,Argentina,-38.4161,-63.6167,9602534,0,129440,9473094
8/8/22,Argentina,-38.4161,-63.6167,9602534,0,129440,9473094
8/9/22,Argentina,-38.4161,-63.6167,9602534,0,129440,9473094
8/10/22,Argentina,-38.4161,-63.6167,9602534,0,129440,9473094
8/11/22,Argentina,-38.4161,-63.6167,9602534,0,129440,9473094
8/12/22,Argentina,-38.4161,-63.6167,9602534,0,129440,9473094
8/13/22,Argentina,-38.4161,-63.6167,9602534,0,129440,9473094
8/14/22,Argentina,-38.4161,-63.6167,9633732,0,129566,9504166
8/15/22,Argentina,-38.4161,-63.6167,9633732,0,129566,9504166
8/16/22,Argentina,-38.4161,-63.6167,9633732,0,129566,9504166
8/17/22,Argentina,-38.4161,-63.6167,9633732,0,129566,9504166
8/18/22,Argentina,-38.4161,-63.6167,9633732,0,129566,9504166
8/19/22,Argentina,-38.4161,-63.6167,9633732,0,129566,9504166
8/20/22,Argentina,-38.4161,-63.6167,9633732,0,129566,9504166
8/21/22,Argentina,-38.4161,-63.6167,9658391,0,129646,9528745
8/22/22,Argentina,-38.4161,-63.6167,9658391,0,129646,9528745
8/23/22,Argentina,-38.4161,-63.6167,9658391,0,129646,9528745
8/24/22,Argentina,-38.4161,-63.6167,9658391,0,129646,9528745
8/25/22,Argentina,-38.4161,-63.6167,9658391,0,129646,9528745
8/26/22,Argentina,-38.4161,-63.6167,9658391,0,129646,9528745
8/27/22,Argentina,-38.4161,-63.6167,9658391,0,129646,9528745
8/28/22,Argentina,-38.4161,-63.6167,9678225,0,129711,9548514
8/29/22,Argentina,-38.4161,-63.6167,9678225,0,129711,9548514
8/30/22,Argentina,-38.4161,-63.6167,9678225,0,129711,9548514
8/31/22,Argentina,-38.4161,-63.6167,9678225,0,129711,9548514
9/1/22,Argentina,-38.4161,-63.6167,9678225,0,129711,9548514
9/2/22,Argentina,-38.4161,-63.6167,9678225,0,129711,9548514
9/3/22,Argentina,-38.4161,-63.6167,9678225,0,129711,9548514
9/4/22,Argentina,-38.4161,-63.6167,9689861,0,129769,9560092
9/5/22,Argentina,-38.4161,-63.6167,9689861,0,129769,9560092
9/6/22,Argentina,-38.4161,-63.6167,9689861,0,129769,9560092
9/7/22,Argentina,-38.4161,-63.6167,9689861,0,129769,9560092
9/8/22,Argentina,-38.4161,-63.6167,9689861,0,129769,9560092
9/9/22,Argentina,-38.4161,-63.6167,9689861,0,129769,9560092
9/10/22,Argentina,-38.4161,-63.6167,9689861,0,129769,9560092
9/11/22,Argentina,-38.4161,-63.6167,9697763,0,129830,9567933
9/12/22,Argentina,-38.4161,-63.6167,9697763,0,129830,9567933
9/13/22,Argentina,-38.4161,-63.6167,9697763,0,129830,9567933
9/14/22,Argentina,-38.4161,-63.6167,9697763,0,129830,9567933
9/15/22,Argentina,-38.4161,-63.6167,9697763,0,129830,9567933
9/16/22,Argentina,-38.4161,-63.6167,9697763,0,129830,9567933
9/17/22,Argentina,-38.4161,-63.6167,9697763,0,129830,9567933
9/18/22,Argentina,-38.4161,-63.6167,9703938,0,129855,9574083
9/19/22,Argentina,-38.4161,-63.6167,9703938,0,129855,9574083
9/20/22,Argentina,-38.4161,-63.6167,9703938,0,129855,9574083
9/21/22,Argentina,-38.4161,-63.6167,9703938,0,129855,9574083
9/22/22,Argentina,-38.4161,-63.6167,9703938,0,129855,9574083
9/23/22,Argentina,-38.4161,-63.6167,9703938,0,129855,9574083
9/24/22,Argentina,-38.4161,-63.6167,9703938,0,129855,9574083
9/25/22,Argentina,-38.4161,-63.6167,9708420,0,129897,9578523
9/26/22,Argentina,-38.4161,-63.6167,9708420,0,129897,9578523
9/27/22,Argentina,-38.4161,-63.6167,9708420,0,129897,9578523
9/28/22,Argentina,-38.4161,-63.6167,9708420,0,129897,9578523
9/29/22,Argentina,-38.4161,-63.6167,9708420,0,129897,9578523
9/30/22,Argentina,-38.4161,-63.6167,9708420,0,129897,9578523
10/1/22,Argentina,-38.4161,-63.6167,9708420,0,129897,9578523
10/2/22,Argentina,-38.4161,-63.6167,9711355,0,129937,9581418
10/3/22,Argentina,-38.4161,-63.6167,9711355,0,129937,9581418
10/4/22,Argentina,-38.4161,-63.6167,9711355,0,129937,9581418
10/5/22,Argentina,-38.4161,-63.6167,9711355,0,129937,9581418
10/6/22,Argentina,-38.4161,-63.6167,9711355,0,129937,9581418
10/7/22,Argentina,-38.4161,-63.6167,9711355,0,129937,9581418
10/8/22,Argentina,-38.4161,-63.6167,9711355,0,129937,9581418
10/9/22,Argentina,-38.4161,-63.6167,9713594,0,129958,9583636
10/10/22,Argentina,-38.4161,-63.6167,9713594,0,129958,9583636
10/11/22,Argentina,-38.4161,-63.6167,9713594,0,129958,9583636
10/12/22,Argentina,-38.4161,-63.6167,9713594,0,129958,9583636
10/13/22,Argentina,-38.4161,-63.6167,9713594,0,129958,9583636
10/14/22,Argentina,-38.4161,-63.6167,9713594,0,129958,9583636
10/15/22,Argentina,-38.4161,-63.6167,9713594,0,129958,9583636
10/16/22,Argentina,-38.4161,-63.6167,9715464,0,129970,9585494
10/17/22,Argentina,-38.4161,-63.6167,9715464,0,129970,9585494
10/18/22,Argentina,-38.4161,-63.6167,9715464,0,129970,9585494
10/19/22,Argentina,-38.4161,-63.6167,9715464,0,129970,9585494
10/20/22,Argentina,-38.4161,-63.6167,9715464,0,129970,9585494
10/21/22,Argentina,-38.4161,-63.6167,9715464,0,129970,9585494
10/22/22,Argentina,-38.4161,-63.6167,9715464,0,129970,9585494
10/23/22,Argentina,-38.4161,-63.6167,9717546,0,129979,9587567
10/24/22,Argentina,-38.4161,-63.6167,9717546,0,129979,9587567
10/25/22,Argentina,-38.4161,-63.6167,9717546,0,129979,9587567
10/26/22,Argentina,-38.4161,-63.6167,9717546,0,129979,9587567
10/27/22,Argentina,-38.4161,-63.6167,9717546,0,129979,9587567
10/28/22,Argentina,-38.4161,-63.6167,9717546,0,129979,9587567
10/29/22,Argentina,-38.4161,-63.6167,9717546,0,129979,9587567
10/30/22,Argentina,-38.4161,-63.6167,9718875,0,129991,9588884
10/31/22,Argentina,-38.4161,-63.6167,9718875,0,129991,9588884
11/1/22,Argentina,-38.4161,-63.6167,9718875,0,129991,9588884
11/2/22,Argentina,-38.4161,-63.6167,9718875,0,129991,9588884
11/3/22,Argentina,-38.4161,-63.6167,9718875,0,129991,9588884
11/4/22,Argentina,-38.4161,-63.6167,9718875,0,129991,9588884
11/5/22,Argentina,-38.4161,-63.6167,9718875,0,129991,9588884
11/6/22,Argentina,-38.4161,-63.6167,9720232,0,130003,9590229
11/7/22,Argentina,-38.4161,-63.6167,9720232,0,130003,9590229
11/8/22,Argentina,-38.4161,-63.6167,9720232,0,130003,9590229
11/9/22,Argentina,-38.4161,-63.6167,9720232,0,130003,9590229
11/10/22,Argentina,-38.4161,-63.6167,9720232,0,130003,9590229
11/11/22,Argentina,-38.4161,-63.6167,9720232,0,130003,9590229
11/12/22,Argentina,-38.4161,-63.6167,9720232,0,130003,9590229
11/13/22,Argentina,-38.4161,-63.6167,9721718,0,130011,9591707
11/14/22,Argentina,-38.4161,-63.6167,9721718,0,130011,9591707
11/15/22,Argentina,-38.4161,-63.6167,9721718,0,130011,9591707
11/16/22,Argentina,-38.4161,-63.6167,9721718,0,130011,9591707
11/17/22,Argentina,-38.4161,-63.6167,9721718,0,130011,9591707
11/18/22,Argentina,-38.4161,-63.6167,9721718,0,130011,9591707
11/19/22,Argentina,-38.4161,-63.6167,9721718,0,130011,9591707
11/20/22,Argentina,-38.4161,-63.6167,9723924,0,130017,9593907
11/21/22,Argentina,-38.4161,-63.6167,9723924,0,130017,9593907
11/22/22,Argentina,-38.4161,-63.6167,9723924,0,130017,9593907
11/23/22,Argentina,-38.4161,-63.6167,9723924,0,130017,9593907
11/24/22,Argentina,-38.4161,-63.6167,9723924,0,130017,9593907
11/25/22,Argentina,-38.4161,-63.6167,9723924,0,130017,9593907
11/26/22,Argentina,-38.4161,-63.6167,9723924,0,130017,9593907
11/27/22,Argentina,-38.4161,-63.6167,9727247,0,130025,9597222
11/28/22,Argentina,-38.4161,-63.6167,9727247,0,130025,9597222
11/29/22,Argentina,-38.4161,-63.6167,9727247,0,130025,9597222
11/30/22,Argentina,-38.4161,-63.6167,9727247,0,130025,9597222
12/1/22,Argentina,-38.4161,-63.6167,9727247,0,130025,9597222
12/2/22,Argentina,-38.4161,-63.6167,9727247,0,130025,9597222
12/3/22,Argentina,-38.4161,-63.6167,9727247,0,130025,9597222
12/4/22,Argentina,-38.4161,-63.6167,9739856,0,130034,9609822
12/5/22,Argentina,-38.4161,-63.6167,9739856,0,130034,9609822
12/6/22,Argentina,-38.4161,-63.6167,9739856,0,130034,9609822
12/7/22,Argentina,-38.4161,-63.6167,9739856,0,130034,9609822
12/8/22,Argentina,-38.4161,-63.6167,9739856,0,130034,9609822
12/9/22,Argentina,-38.4161,-63.6167,9739856,0,130034,9609822
12/10/22,Argentina,-38.4161,-63.6167,9739856,0,130034,9609822
12/11/22,Argentina,-38.4161,-63.6167,9766975,0,130041,9636934
12/12/22,Argentina,-38.4161,-63.6167,9766975,0,130041,9636934
12/13/22,Argentina,-38.4161,-63.6167,9766975,0,130041,9636934
12/14/22,Argentina,-38.4161,-63.6167,9766975,0,130041,9636934
12/15/22,Argentina,-38.4161,-63.6167,9766975,0,130041,9636934
12/16/22,Argentina,-38.4161,-63.6167,9766975,0,130041,9636934
12/17/22,Argentina,-38.4161,-63.6167,9766975,0,130041,9636934
1/1/22,Armenia,40.0691,45.0382,344980,0,7975,337005
1/2/22,Armenia,40.0691,45.0382,345007,0,7977,337030
1/3/22,Armenia,40.0691,45.0382,345036,0,7983,337053
1/4/22,Armenia,40.0691,45.0382,345126,0,7986,337140
1/5/22,Armenia,40.0691,45.0382,345255,0,7989,337266
1/6/22,Armenia,40.0691,45.0382,345389,0,7993,337396
1/7/22,Armenia,40.0691,45.0382,345518,0,7997,337521
1/8/22,Armenia,40.0691,45.0382,345713,0,7999,337714
1/9/22,Armenia,40.0691,45.0382,345855,0,8001,337854
1/10/22,Armenia,40.0691,45.0382,345981,0,8004,337977
1/11/22,Armenia,40.0691,45.0382,346224,0,8006,338218
1/12/22,Armenia,40.0691,45.0382,346811,0,8014,338797
1/13/22,Armenia,40.0691,45.0382,346811,0,8014,338797
1/14/22,Armenia,40.0691,45.0382,347084,0,8015,339069
1/15/22,Armenia,40.0691,45.0382,347377,0,8018,339359
1/16/22,Armenia,40.0691,45.0382,347617,0,8019,339598
1/17/22,Armenia,40.0691,45.0382,347785,0,8020,339765
1/18/22,Armenia,40.0691,45.0382,348145,0,8022,340123
1/19/22,Armenia,40.0691,45.0382,348708,0,8025,340683
1/20/22,Armenia,40.0691,45.0382,349329,0,8026,341303
1/21/22,Armenia,40.0691,45.0382,349957,0,8026,341931
1/22/22,Armenia,40.0691,45.0382,350897,0,8026,342871
1/23/22,Armenia,40.0691,45.0382,351711,0,8028,343683
1/24/22,Armenia,40.0691,45.0382,352399,0,8028,344371
1/25/22,Armenia,40.0691,45.0382,353731,0,8032,345699
1/26/22,Armenia,40.0691,45.0382,355662,0,8033,347629
1/27/22,Armenia,40.0691,45.0382,358218,0,8035,350183
1/28/22,Armenia,40.0691,45.0382,361754,0,8035,353719
1/29/22,Armenia,40.0691,45.0382,364348,0,8041,356307
1/30/22,Armenia,40.0691,45.0382,366433,0,8046,358387
1/31/22,Armenia,40.0691,45.0382,367795,0,8053,359742
2/1/22,Armenia,40.0691,45.0382,370922,0,8056,362866
2/2/22,Armenia,40.0691,45.0382,374878,0,8060,366818
2/3/22,Armenia,40.0691,45.0382,379266,0,8065,371201
2/4/22,Armenia,40.0691,45.0382,383458,0,8075,375383
2/5/22,Armenia,40.0691,45.0382,387490,0,8081,379409
2/6/22,Armenia,40.0691,45.0382,389957,0,8086,381871
2/7/22,Armenia,40.0691,45.0382,391588,0,8097,383491
2/8/22,Armenia,40.0691,45.0382,394074,0,8102,385972
2/9/22,Armenia,40.0691,45.0382,396885,0,8108,388777
2/10/22,Armenia,40.0691,45.0382,399727,0,8123,391604
2/11/22,Armenia,40.0691,45.0382,402403,0,8145,394258
2/12/22,Armenia,40.0691,45.0382,404805,0,8157,396648
2/13/22,Armenia,40.0691,45.0382,406379,0,8167,398212
2/14/22,Armenia,40.0691,45.0382,407074,0,8186,398888
2/15/22,Armenia,40.0691,45.0382,408381,0,8201,400180
2/16/22,Armenia,40.0691,45.0382,410155,0,8229,401926
2/17/22,Armenia,40.0691,45.0382,411878,0,8253,403625
2/18/22,Armenia,40.0691,45.0382,413295,0,8278,405017
2/19/22,Armenia,40.0691,45.0382,414764,0,8308,406456
2/20/22,Armenia,40.0691,45.0382,415464,0,8322,407142
2/21/22,Armenia,40.0691,45.0382,415757,0,8338,407419
2/22/22,Armenia,40.0691,45.0382,416510,0,8354,408156
2/23/22,Armenia,40.0691,45.0382,417456,0,8378,409078
2/24/22,Armenia,40.0691,45.0382,418220,0,8392,409828
2/25/22,Armenia,40.0691,45.0382,418792,0,8413,410379
2/26/22,Armenia,40.0691,45.0382,419423,0,8433,410990
2/27/22,Armenia,40.0691,45.0382,419693,0,8449,411244
2/28/22,Armenia,40.0691,45.0382,419832,0,8461,411371
3/1/22,Armenia,40.0691,45.0382,420156,0,8478,411678
3/2/22,Armenia,40.0691,45.0382,420498,0,8493,412005
3/3/22,Armenia,40.0691,45.0382,420757,0,8505,412252
3/4/22,Armenia,40.0691,45.0382,421008,0,8516,412492
3/5/22,Armenia,40.0691,45.0382,421226,0,8528,412698
3/6/22,Armenia,40.0691,45.0382,421341,0,8536,412805
3/7/22,Armenia,40.0691,45.0382,421401,0,8548,412853
3/8/22,Armenia,40.0691,45.0382,421541,0,8552,412989
3/9/22,Armenia,40.0691,45.0382,421592,0,8560,413032
3/10/22,Armenia,40.0691,45.0382,421714,0,8563,413151
3/11/22,Armenia,40.0691,45.0382,421842,0,8568,413274
3/12/22,Armenia,40.0691,45.0382,421953,0,8570,413383
3/13/22,Armenia,40.0691,45.0382,422004,0,8572,413432
3/14/22,Armenia,40.0691,45.0382,422021,0,8576,413445
3/15/22,Armenia,40.0691,45.0382,422076,0,8579,413497
3/16/22,Armenia,40.0691,45.0382,422155,0,8587,413568
3/17/22,Armenia,40.0691,45.0382,422202,0,8589,413613
3/18/22,Armenia,40.0691,45.0382,422254,0,8592,413662
3/19/22,Armenia,40.0691,45.0382,422286,0,8593,413693
3/20/22,Armenia,40.0691,45.0382,422307,0,8595,413712
3/21/22,Armenia,40.0691,45.0382,422328,0,8598,413730
3/22/22,Armenia,40.0691,45.0382,422354,0,8601,413753
3/23/22,Armenia,40.0691,45.0382,422382,0,8603,413779
3/24/22,Armenia,40.0691,45.0382,422401,0,8604,413797
3/25/22,Armenia,40.0691,45.0382,422423,0,8607,413816
3/26/22,Armenia,40.0691,45.0382,422444,0,8608,413836
3/27/22,Armenia,40.0691,45.0382,422458,0,8610,413848
3/28/22,Armenia,40.0691,45.0382,422468,0,8610,413858
3/29/22,Armenia,40.0691,45.0382,422484,0,8611,413873
3/30/22,Armenia,40.0691,45.0382,422498,0,8611,413887
3/31/22,Armenia,40.0691,45.0382,422519,0,8613,413906
4/1/22,Armenia,40.0691,45.0382,422540,0,8616,413924
4/2/22,Armenia,40.0691,45.0382,422563,0,8616,413947
4/3/22,Armenia,40.0691,45.0382,422574,0,8617,413957
4/4/22,Armenia,40.0691,45.0382,422581,0,8617,413964
4/5/22,Armenia,40.0691,45.0382,422594,0,8619,413975
4/6/22,Armenia,40.0691,45.0382,422610,0,8619,413991
4/7/22,Armenia,40.0691,45.0382,422629,0,8619,414010
4/8/22,Armenia,40.0691,45.0382,422643,0,8619,414024
4/9/22,Armenia,40.0691,45.0382,422662,0,8620,414042
4/10/22,Armenia,40.0691,45.0382,422677,0,8620,414057
4/11/22,Armenia,40.0691,45.0382,422678,0,8621,414057
4/12/22,Armenia,40.0691,45.0382,422691,0,8621,414070
4/13/22,Armenia,40.0691,45.0382,422711,0,8621,414090
4/14/22,Armenia,40.0691,45.0382,422721,0,8621,414100
4/15/22,Armenia,40.0691,45.0382,422729,0,8621,414108
4/16/22,Armenia,40.0691,45.0382,422747,0,8621,414126
4/17/22,Armenia,40.0691,45.0382,422762,0,8621,414141
4/18/22,Armenia,40.0691,45.0382,422770,0,8622,414148
4/19/22,Armenia,40.0691,45.0382,422784,0,8622,414162
4/20/22,Armenia,40.0691,45.0382,422799,0,8622,414177
4/21/22,Armenia,40.0691,45.0382,422805,0,8622,414183
4/22/22,Armenia,40.0691,45.0382,422814,0,8622,414192
4/23/22,Armenia,40.0691,45.0382,422822,0,8622,414200
4/24/22,Armenia,40.0691,45.0382,422825,0,8622,414203
4/25/22,Armenia,40.0691,45.0382,422828,0,8622,414206
4/26/22,Armenia,40.0691,45.0382,422838,0,8622,414216
4/27/22,Armenia,40.0691,45.0382,422855,0,8622,414233
4/28/22,Armenia,40.0691,45.0382,422858,0,8622,414236
4/29/22,Armenia,40.0691,45.0382,422865,0,8622,414243
4/30/22,Armenia,40.0691,45.0382,422867,0,8622,414245
5/1/22,Armenia,40.0691,45.0382,422871,0,8622,414249
5/2/22,Armenia,40.0691,45.0382,422874,0,8622,414252
5/3/22,Armenia,40.0691,45.0382,422874,0,8622,414252
5/4/22,Armenia,40.0691,45.0382,422877,0,8622,414255
5/5/22,Armenia,40.0691,45.0382,422877,0,8622,414255
5/6/22,Armenia,40.0691,45.0382,422877,0,8622,414255
5/7/22,Armenia,40.0691,45.0382,422877,0,8622,414255
5/8/22,Armenia,40.0691,45.0382,422877,0,8622,414255
5/9/22,Armenia,40.0691,45.0382,422896,0,8623,414273
5/10/22,Armenia,40.0691,45.0382,422896,0,8623,414273
5/11/22,Armenia,40.0691,45.0382,422900,0,8623,414277
5/12/22,Armenia,40.0691,45.0382,422900,0,8623,414277
5/13/22,Armenia,40.0691,45.0382,422900,0,8623,414277
5/14/22,Armenia,40.0691,45.0382,422900,0,8623,414277
5/15/22,Armenia,40.0691,45.0382,422900,0,8623,414277
5/16/22,Armenia,40.0691,45.0382,422917,0,8623,414294
5/17/22,Armenia,40.0691,45.0382,422917,0,8623,414294
5/18/22,Armenia,40.0691,45.0382,422917,0,8623,414294
5/19/22,Armenia,40.0691,45.0382,422917,0,8623,414294
5/20/22,Armenia,40.0691,45.0382,422917,0,8623,414294
5/21/22,Armenia,40.0691,45.0382,422917,0,8623,414294
5/22/22,Armenia,40.0691,45.0382,422917,0,8623,414294
5/23/22,Armenia,40.0691,45.0382,422939,0,8624,414315
5/24/22,Armenia,40.0691,45.0382,422939,0,8624,414315
5/25/22,Armenia,40.0691,45.0382,422939,0,8624,414315
5/26/22,Armenia,40.0691,45.0382,422939,0,8624,414315
5/27/22,Armenia,40.0691,45.0382,422939,0,8624,414315
5/28/22,Armenia,40.0691,45.0382,422939,0,8624,414315
5/29/22,Armenia,40.0691,45.0382,422939,0,8624,414315
5/30/22,Armenia,40.0691,45.0382,422963,0,8625,414338
5/31/22,Armenia,40.0691,45.0382,422963,0,8625,414338
6/1/22,Armenia,40.0691,45.0382,422963,0,8625,414338
6/2/22,Armenia,40.0691,45.0382,422963,0,8625,414338
6/3/22,Armenia,40.0691,45.0382,422963,0,8625,414338
6/4/22,Armenia,40.0691,45.0382,422963,0,8625,414338
6/5/22,Armenia,40.0691,45.0382,422963,0,8625,414338
6/6/22,Armenia,40.0691,45.0382,423006,0,8629,414377
6/7/22,Armenia,40.0691,45.0382,423006,0,8629,414377
6/8/22,Armenia,40.0691,45.0382,423006,0,8629,414377
6/9/22,Armenia,40.0691,45.0382,423006,0,8629,414377
6/10/22,Armenia,40.0691,45.0382,423006,0,8629,414377
6/11/22,Armenia,40.0691,45.0382,423006,0,8629,414377
6/12/22,Armenia,40.0691,45.0382,423006,0,8629,414377
6/13/22,Armenia,40.0691,45.0382,423006,0,8629,414377
6/14/22,Armenia,40.0691,45.0382,423044,0,8629,414415
6/15/22,Armenia,40.0691,45.0382,423044,0,8629,414415
6/16/22,Armenia,40.0691,45.0382,423044,0,8629,414415
6/17/22,Armenia,40.0691,45.0382,423044,0,8629,414415
6/18/22,Armenia,40.0691,45.0382,423044,0,8629,414415
6/19/22,Armenia,40.0691,45.0382,423044,0,8629,414415
6/20/22,Armenia,40.0691,45.0382,423104,0,8629,414475
6/21/22,Armenia,40.0691,45.0382,423104,0,8629,414475
6/22/22,Armenia,40.0691,45.0382,423104,0,8629,414475
6/23/22,Armenia,40.0691,45.0382,423104,0,8629,414475
6/24/22,Armenia,40.0691,45.0382,423104,0,8629,414475
6/25/22,Armenia,40.0691,45.0382,423104,0,8629,414475
6/26/22,Armenia,40.0691,45.0382,423104,0,8629,414475
6/27/22,Armenia,40.0691,45.0382,423243,0,8629,414614
6/28/22,Armenia,40.0691,45.0382,423243,0,8629,414614
6/29/22,Armenia,40.0691,45.0382,423243,0,8629,414614
6/30/22,Armenia,40.0691,45.0382,423243,0,8629,414614
7/1/22,Armenia,40.0691,45.0382,423243,0,8629,414614
7/2/22,Armenia,40.0691,45.0382,423243,0,8629,414614
7/3/22,Armenia,40.0691,45.0382,423243,0,8629,414614
7/4/22,Armenia,40.0691,45.0382,423417,0,8629,414788
7/5/22,Armenia,40.0691,45.0382,423417,0,8629,414788
7/6/22,Armenia,40.0691,45.0382,423417,0,8629,414788
7/7/22,Armenia,40.0691,45.0382,423417,0,8629,414788
7/8/22,Armenia,40.0691,45.0382,423417,0,8629,414788
7/9/22,Armenia,40.0691,45.0382,423417,0,8629,414788
7/10/22,Armenia,40.0691,45.0382,423417,0,8629,414788
7/11/22,Armenia,40.0691,45.0382,423771,0,8629,415142
7/12/22,Armenia,40.0691,45.0382,423771,0,8629,415142
7/13/22,Armenia,40.0691,45.0382,423771,0,8629,415142
7/14/22,Armenia,40.0691,45.0382,423771,0,8629,415142
7/15/22,Armenia,40.0691,45.0382,423771,0,8629,415142
7/16/22,Armenia,40.0691,45.0382,423771,0,8629,415142
7/17/22,Armenia,40.0691,45.0382,423771,0,8629,415142
7/18/22,Armenia,40.0691,45.0382,424400,0,8629,415771
7/19/22,Armenia,40.0691,45.0382,424400,0,8629,415771
7/20/22,Armenia,40.0691,45.0382,424400,0,8629,415771
7/21/22,Armenia,40.0691,45.0382,424400,0,8629,415771
7/22/22,Armenia,40.0691,45.0382,424400,0,8629,415771
7/23/22,Armenia,40.0691,45.0382,424400,0,8629,415771
7/24/22,Armenia,40.0691,45.0382,424400,0,8629,415771
7/25/22,Armenia,40.0691,45.0382,425365,0,8633,416732
7/26/22,Armenia,40.0691,45.0382,425365,0,8633,416732
7/27/22,Armenia,40.0691,45.0382,425365,0,8633,416732
7/28/22,Armenia,40.0691,45.0382,425365,0,8633,416732
7/29/22,Armenia,40.0691,45.0382,425365,0,8633,416732
7/30/22,Armenia,40.0691,45.0382,425365,0,8633,416732
7/31/22,Armenia,40.0691,45.0382,425365,0,8633,416732
8/1/22,Armenia,40.0691,45.0382,425365,0,8633,416732
8/2/22,Armenia,40.0691,45.0382,426799,0,8635,418164
8/3/22,Armenia,40.0691,45.0382,426799,0,8635,418164
8/4/22,Armenia,40.0691,45.0382,426799,0,8635,418164
8/5/22,Armenia,40.0691,45.0382,426799,0,8635,418164
8/6/22,Armenia,40.0691,45.0382,426799,0,8635,418164
8/7/22,Armenia,40.0691,45.0382,426799,0,8635,418164
8/8/22,Armenia,40.0691,45.0382,428648,0,8637,420011
8/9/22,Armenia,40.0691,45.0382,428648,0,8637,420011
8/10/22,Armenia,40.0691,45.0382,428648,0,8637,420011
8/11/22,Armenia,40.0691,45.0382,428648,0,8637,420011
8/12/22,Armenia,40.0691,45.0382,428648,0,8637,420011
8/13/22,Armenia,40.0691,45.0382,428648,0,8637,420011
8/14/22,Armenia,40.0691,45.0382,428648,0,8637,420011
8/15/22,Armenia,40.0691,45.0382,430361,0,8643,421718
8/16/22,Armenia,40.0691,45.0382,430361,0,8643,421718
8/17/22,Armenia,40.0691,45.0382,430361,0,8643,421718
8/18/22,Armenia,40.0691,45.0382,430361,0,8643,421718
8/19/22,Armenia,40.0691,45.0382,430361,0,8643,421718
8/20/22,Armenia,40.0691,45.0382,430361,0,8643,421718
8/21/22,Armenia,40.0691,45.0382,430361,0,8643,421718
8/22/22,Armenia,40.0691,45.0382,432274,0,8648,423626
8/23/22,Armenia,40.0691,45.0382,432274,0,8648,423626
8/24/22,Armenia,40.0691,45.0382,432274,0,8648,423626
8/25/22,Armenia,40.0691,45.0382,432274,0,8648,423626
8/26/22,Armenia,40.0691,45.0382,432274,0,8648,423626
8/27/22,Armenia,40.0691,45.0382,432274,0,8648,423626
8/28/22,Armenia,40.0691,45.0382,432274,0,8648,423626
8/29/22,Armenia,40.0691,45.0382,434398,0,8655,425743
8/30/22,Armenia,40.0691,45.0382,434398,0,8655,425743
8/31/22,Armenia,40.0691,45.0382,434398,0,8655,425743
9/1/22,Armenia,40.0691,45.0382,434398,0,8655,425743
9/2/22,Armenia,40.0691,45.0382,434398,0,8655,425743
9/3/22,Armenia,40.0691,45.0382,434398,0,8655,425743
9/4/22,Armenia,40.0691,45.0382,434398,0,8655,425743
9/5/22,Armenia,40.0691,45.0382,436727,0,8662,428065
9/6/22,Armenia,40.0691,45.0382,436727,0,8662,428065
9/7/22,Armenia,40.0691,45.0382,436727,0,8662,428065
9/8/22,Armenia,40.0691,45.0382,436727,0,8662,428065
9/9/22,Armenia,40.0691,45.0382,436727,0,8662,428065
9/10/22,Armenia,40.0691,45.0382,436727,0,8662,428065
9/11/22,Armenia,40.0691,45.0382,436727,0,8662,428065
9/12/22,Armenia,40.0691,45.0382,439302,0,8669,430633
9/13/22,Armenia,40.0691,45.0382,439302,0,8669,430633
9/14/22,Armenia,40.0691,45.0382,439302,0,8669,430633
9/15/22,Armenia,40.0691,45.0382,439302,0,8669,430633
9/16/22,Armenia,40.0691,45.0382,439302,0,8669,430633
9/17/22,Armenia,40.0691,45.0382,439302,0,8669,430633
9/18/22,Armenia,40.0691,45.0382,439302,0,8669,430633
9/19/22,Armenia,40.0691,45.0382,441444,0,8679,432765
9/20/22,Armenia,40.0691,45.0382,441444,0,8679,432765
9/21/22,Armenia,40.0691,45.0382,441444,0,8679,432765
9/22/22,Armenia,40.0691,45.0382,441444,0,8679,432765
9/23/22,Armenia,40.0691,45.0382,441444,0,8679,432765
9/24/22,Armenia,40.0691,45.0382,441444,0,8679,432765
9/25/22,Armenia,40.0691,45.0382,441444,0,8679,432765
9/26/22,Armenia,40.0691,45.0382,442875,0,8683,434192
9/27/22,Armenia,40.0691,45.0382,442875,0,8683,434192
9/28/22,Armenia,40.0691,45.0382,442875,0,8683,434192
9/29/22,Armenia,40.0691,45.0382,442875,0,8683,434192
9/30/22,Armenia,40.0691,45.0382,442875,0,8683,434192
10/1/22,Armenia,40.0691,45.0382,442875,0,8683,434192
10/2/22,Armenia,40.0691,45.0382,442875,0,8683,434192
10/3/22,Armenia,40.0691,45.0382,443785,0,8691,435094
10/4/22,Armenia,40.0691,45.0382,443785,0,8691,435094
10/5/22,Armenia,40.0691,45.0382,443785,0,8691,435094
10/6/22,Armenia,40.0691,45.0382,443785,0,8691,435094
10/7/22,Armenia,40.0691,45.0382,443785,0,8691,435094
10/8/22,Armenia,40.0691,45.0382,443785,0,8691,435094
10/9/22,Armenia,40.0691,45.0382,443785,0,8691,435094
10/10/22,Armenia,40.0691,45.0382,444482,0,8700,435782
10/11/22,Armenia,40.0691,45.0382,444482,0,8700,435782
10/12/22,Armenia,40.0691,45.0382,444482,0,8700,435782
10/13/22,Armenia,40.0691,45.0382,444482,0,8700,435782
10/14/22,Armenia,40.0691,45.0382,444482,0,8700,435782
10/15/22,Armenia,40.0691,45.0382,444482,0,8700,435782
10/16/22,Armenia,40.0691,45.0382,444482,0,8700,435782
10/17/22,Armenia,40.0691,45.0382,444869,0,8706,436163
10/18/22,Armenia,40.0691,45.0382,444869,0,8706,436163
10/19/22,Armenia,40.0691,45.0382,444869,0,8706,436163
10/20/22,Armenia,40.0691,45.0382,444869,0,8706,436163
10/21/22,Armenia,40.0691,45.0382,444869,0,8706,436163
10/22/22,Armenia,40.0691,45.0382,444869,0,8706,436163
10/23/22,Armenia,40.0691,45.0382,444869,0,8706,436163
10/24/22,Armenia,40.0691,45.0382,445100,0,8706,436394
10/25/22,Armenia,40.0691,45.0382,445100,0,8706,436394
10/26/22,Armenia,40.0691,45.0382,445100,0,8706,436394
10/27/22,Armenia,40.0691,45.0382,445100,0,8706,436394
10/28/22,Armenia,40.0691,45.0382,445100,0,8706,436394
10/29/22,Armenia,40.0691,45.0382,445100,0,8706,436394
10/30/22,Armenia,40.0691,45.0382,445100,0,8706,436394
10/31/22,Armenia,40.0691,45.0382,445242,0,8709,436533
11/1/22,Armenia,40.0691,45.0382,445242,0,8709,436533
11/2/22,Armenia,40.0691,45.0382,445242,0,8709,436533
11/3/22,Armenia,40.0691,45.0382,445242,0,8709,436533
11/4/22,Armenia,40.0691,45.0382,445242,0,8709,436533
11/5/22,Armenia,40.0691,45.0382,445242,0,8709,436533
11/6/22,Armenia,40.0691,45.0382,445242,0,8709,436533
11/7/22,Armenia,40.0691,45.0382,445397,0,8709,436688
11/8/22,Armenia,40.0691,45.0382,445397,0,8709,436688
11/9/22,Armenia,40.0691,45.0382,445397,0,8709,436688
11/10/22,Armenia,40.0691,45.0382,445397,0,8709,436688
11/11/22,Armenia,40.0691,45.0382,445397,0,8709,436688
11/12/22,Armenia,40.0691,45.0382,445397,0,8709,436688
11/13/22,Armenia,40.0691,45.0382,445397,0,8709,436688
11/14/22,Armenia,40.0691,45.0382,445513,0,8709,436804
11/15/22,Armenia,40.0691,45.0382,445513,0,8709,436804
11/16/22,Armenia,40.0691,45.0382,445513,0,8709,436804
11/17/22,Armenia,40.0691,45.0382,445513,0,8709,436804
11/18/22,Armenia,40.0691,45.0382,445513,0,8709,436804
11/19/22,Armenia,40.0691,45.0382,445513,0,8709,436804
11/20/22,Armenia,40.0691,45.0382,445513,0,8709,436804
11/21/22,Armenia,40.0691,45.0382,445631,0,8709,436922
11/22/22,Armenia,40.0691,45.0382,445631,0,8709,436922
11/23/22,Armenia,40.0691,45.0382,445631,0,8709,436922
11/24/22,Armenia,40.0691,45.0382,445631,0,8709,436922
11/25/22,Armenia,40.0691,45.0382,445631,0,8709,436922
11/26/22,Armenia,40.0691,45.0382,445631,0,8709,436922
11/27/22,Armenia,40.0691,45.0382,445631,0,8709,436922
11/28/22,Armenia,40.0691,45.0382,445737,0,8710,437027
11/29/22,Armenia,40.0691,45.0382,445737,0,8710,437027
11/30/22,Armenia,40.0691,45.0382,445737,0,8710,437027
12/1/22,Armenia,40.0691,45.0382,445737,0,8710,437027
12/2/22,Armenia,40.0691,45.0382,445737,0,8710,437027
12/3/22,Armenia,40.0691,45.0382,445737,0,8710,437027
12/4/22,Armenia,40.0691,45.0382,445737,0,8710,437027
12/5/22,Armenia,40.0691,45.0382,445828,0,8712,437116
12/6/22,Armenia,40.0691,45.0382,445828,0,8712,437116
12/7/22,Armenia,40.0691,45.0382,445828,0,8712,437116
12/8/22,Armenia,40.0691,45.0382,445828,0,8712,437116
12/9/22,Armenia,40.0691,45.0382,445828,0,8712,437116
12/10/22,Armenia,40.0691,45.0382,445828,0,8712,437116
12/11/22,Armenia,40.0691,45.0382,445828,0,8712,437116
12/12/22,Armenia,40.0691,45.0382,445881,0,8712,437169
12/13/22,Armenia,40.0691,45.0382,445881,0,8712,437169
12/14/22,Armenia,40.0691,45.0382,445881,0,8712,437169
12/15/22,Armenia,40.0691,45.0382,445881,0,8712,437169
12/16/22,Armenia,40.0691,45.0382,445881,0,8712,437169
12/17/22,Armenia,40.0691,45.0382,445881,0,8712,437169
1/1/22,Australia,-32.106275000000004,141.3554875,462955,0,2257,460698
1/2/22,Australia,-32.106275000000004,141.3554875,492563,0,2266,490297
1/3/22,Australia,-32.106275000000004,141.3554875,537308,0,2270,535038
1/4/22,Australia,-32.106275000000004,141.3554875,608803,0,2290,606513
1/5/22,Australia,-32.106275000000004,141.3554875,684229,0,2302,681927
1/6/22,Australia,-32.106275000000004,141.3554875,762458,0,2321,760137
1/7/22,Australia,-32.106275000000004,141.3554875,860550,0,2337,858213
1/8/22,Australia,-32.106275000000004,141.3554875,972457,0,2366,970091
1/9/22,Australia,-32.106275000000004,141.3554875,1045291,0,2387,1042904
1/10/22,Australia,-32.106275000000004,141.3554875,1139097,0,2415,1136682
1/11/22,Australia,-32.106275000000004,141.3554875,1223505,0,2465,1221040
1/12/22,Australia,-32.106275000000004,141.3554875,1398776,0,2522,1396254
1/13/22,Australia,-32.106275000000004,141.3554875,1526961,0,2572,1524389
1/14/22,Australia,-32.106275000000004,141.3554875,1613249,0,2621,1610628
1/15/22,Australia,-32.106275000000004,141.3554875,1726116,0,2673,1723443
1/16/22,Australia,-32.106275000000004,141.3554875,1786007,0,2692,1783315
1/17/22,Australia,-32.106275000000004,141.3554875,1870362,0,2773,1867589
1/18/22,Australia,-32.106275000000004,141.3554875,1954977,0,2843,1952134
1/19/22,Australia,-32.106275000000004,141.3554875,2022581,0,2890,2019691
1/20/22,Australia,-32.106275000000004,141.3554875,2086522,0,2978,2083544
1/21/22,Australia,-32.106275000000004,141.3554875,2129688,0,3043,2126645
1/22/22,Australia,-32.106275000000004,141.3554875,2196870,0,3121,2193749
1/23/22,Australia,-32.106275000000004,141.3554875,2229104,0,3148,2225956
1/24/22,Australia,-32.106275000000004,141.3554875,2287126,0,3230,2283896
1/25/22,Australia,-32.106275000000004,141.3554875,2340046,0,3299,2336747
1/26/22,Australia,-32.106275000000004,141.3554875,2391062,0,3390,2387672
1/27/22,Australia,-32.106275000000004,141.3554875,2457285,0,3477,2453808
1/28/22,Australia,-32.106275000000004,141.3554875,2523265,0,3632,2519633
1/29/22,Australia,-32.106275000000004,141.3554875,2570523,0,3718,2566805
1/30/22,Australia,-32.106275000000004,141.3554875,2607242,0,3760,2603482
1/31/22,Australia,-32.106275000000004,141.3554875,2580386,0,3835,2576551
2/1/22,Australia,-32.106275000000004,141.3554875,2620532,0,3905,2616627
2/2/22,Australia,-32.106275000000004,141.3554875,2644760,0,3987,2640773
2/3/22,Australia,-32.106275000000004,141.3554875,2676939,0,4073,2672866
2/4/22,Australia,-32.106275000000004,141.3554875,2704275,0,4154,2700121
2/5/22,Australia,-32.106275000000004,141.3554875,2727260,0,4200,2723060
2/6/22,Australia,-32.106275000000004,141.3554875,2752507,0,4248,2748259
2/7/22,Australia,-32.106275000000004,141.3554875,2779880,0,4302,2775578
2/8/22,Australia,-32.106275000000004,141.3554875,2811390,0,4373,2807017
2/9/22,Australia,-32.106275000000004,141.3554875,2822873,0,4422,2818451
2/10/22,Australia,-32.106275000000004,141.3554875,2854123,0,4479,2849644
2/11/22,Australia,-32.106275000000004,141.3554875,2876687,0,4543,2872144
2/12/22,Australia,-32.106275000000004,141.3554875,2902294,0,4593,2897701
2/13/22,Australia,-32.106275000000004,141.3554875,2914583,0,4604,2909979
2/14/22,Australia,-32.106275000000004,141.3554875,2945496,0,4664,2940832
2/15/22,Australia,-32.106275000000004,141.3554875,2969890,0,4726,2965164
2/16/22,Australia,-32.106275000000004,141.3554875,2967316,0,4797,2962519
2/17/22,Australia,-32.106275000000004,141.3554875,2990045,0,4833,2985212
2/18/22,Australia,-32.106275000000004,141.3554875,3013262,0,4878,3008384
2/19/22,Australia,-32.106275000000004,141.3554875,3030638,0,4912,3025726
2/20/22,Australia,-32.106275000000004,141.3554875,3048857,0,4929,3043928
2/21/22,Australia,-32.106275000000004,141.3554875,3074020,0,4966,3069054
2/22/22,Australia,-32.106275000000004,141.3554875,3099249,0,5025,3094224
2/23/22,Australia,-32.106275000000004,141.3554875,3124101,0,5062,3119039
2/24/22,Australia,-32.106275000000004,141.3554875,3150771,0,5095,3145676
2/25/22,Australia,-32.106275000000004,141.3554875,3170574,0,5131,3165443
2/26/22,Australia,-32.106275000000004,141.3554875,3188117,0,5157,3182960
2/27/22,Australia,-32.106275000000004,141.3554875,3209599,0,5171,3204428
2/28/22,Australia,-32.106275000000004,141.3554875,3235017,0,5210,3229807
3/1/22,Australia,-32.106275000000004,141.3554875,3256772,0,5269,3251503
3/2/22,Australia,-32.106275000000004,141.3554875,3296784,0,5316,3291468
3/3/22,Australia,-32.106275000000004,141.3554875,3321943,0,5354,3316589
3/4/22,Australia,-32.106275000000004,141.3554875,3344659,0,5402,3339257
3/5/22,Australia,-32.106275000000004,141.3554875,3362035,0,5416,3356619
3/6/22,Australia,-32.106275000000004,141.3554875,3384217,0,5425,3378792
3/7/22,Australia,-32.106275000000004,141.3554875,3429179,0,5464,3423715
3/8/22,Australia,-32.106275000000004,141.3554875,3459870,0,5495,3454375
3/9/22,Australia,-32.106275000000004,141.3554875,3496205,0,5520,3490685
3/10/22,Australia,-32.106275000000004,141.3554875,3527894,0,5550,3522344
3/11/22,Australia,-32.106275000000004,141.3554875,3562971,0,5571,3557400
3/12/22,Australia,-32.106275000000004,141.3554875,3596466,0,5587,3590879
3/13/22,Australia,-32.106275000000004,141.3554875,3622906,0,5590,3617316
3/14/22,Australia,-32.106275000000004,141.3554875,3651709,0,5615,3646094
3/15/22,Australia,-32.106275000000004,141.3554875,3706018,0,5638,3700380
3/16/22,Australia,-32.106275000000004,141.3554875,3763166,0,5662,3757504
3/17/22,Australia,-32.106275000000004,141.3554875,3812332,0,5691,3806641
3/18/22,Australia,-32.106275000000004,141.3554875,3859284,0,5722,3853562
3/19/22,Australia,-32.106275000000004,141.3554875,3900138,0,5725,3894413
3/20/22,Australia,-32.106275000000004,141.3554875,3943368,0,5736,3937632
3/21/22,Australia,-32.106275000000004,141.3554875,3996431,0,5763,3990668
3/22/22,Australia,-32.106275000000004,141.3554875,4053987,0,5786,4048201
3/23/22,Australia,-32.106275000000004,141.3554875,4113691,0,5817,4107874
3/24/22,Australia,-32.106275000000004,141.3554875,4180473,0,5850,4174623
3/25/22,Australia,-32.106275000000004,141.3554875,4228461,0,5875,4222586
3/26/22,Australia,-32.106275000000004,141.3554875,4275210,0,5893,4269317
3/27/22,Australia,-32.106275000000004,141.3554875,4326181,0,5897,4320284
3/28/22,Australia,-32.106275000000004,141.3554875,4381919,0,5926,4375993
3/29/22,Australia,-32.106275000000004,141.3554875,4447442,0,5959,4441483
3/30/22,Australia,-32.106275000000004,141.3554875,4507681,0,5993,4501688
3/31/22,Australia,-32.106275000000004,141.3554875,4573066,0,6008,4567058
4/1/22,Australia,-32.106275000000004,141.3554875,4628163,0,6365,4621798
4/2/22,Australia,-32.106275000000004,141.3554875,4676260,0,6383,4669877
4/3/22,Australia,-32.106275000000004,141.3554875,4716870,0,6392,4710478
4/4/22,Australia,-32.106275000000004,141.3554875,4772414,0,6425,4765989
4/5/22,Australia,-32.106275000000004,141.3554875,4848211,0,6462,4841749
4/6/22,Australia,-32.106275000000004,141.3554875,4910819,0,6495,4904324
4/7/22,Australia,-32.106275000000004,141.3554875,4971300,0,6526,4964774
4/8/22,Australia,-32.106275000000004,141.3554875,5020617,0,6550,5014067
4/9/22,Australia,-32.106275000000004,141.3554875,5059642,0,6562,5053080
4/10/22,Australia,-32.106275000000004,141.3554875,5108366,0,6569,5101797
4/11/22,Australia,-32.106275000000004,141.3554875,5154633,0,6609,5148024
4/12/22,Australia,-32.106275000000004,141.3554875,5207650,0,6648,5201002
4/13/22,Australia,-32.106275000000004,141.3554875,5262359,0,6693,5255666
4/14/22,Australia,-32.106275000000004,141.3554875,5308858,0,6727,5302131
4/15/22,Australia,-32.106275000000004,141.3554875,5345438,0,6755,5338683
4/16/22,Australia,-32.106275000000004,141.3554875,5384615,0,6779,5377836
4/17/22,Australia,-32.106275000000004,141.3554875,5416980,0,6787,5410193
4/18/22,Australia,-32.106275000000004,141.3554875,5459012,0,6804,5452208
4/19/22,Australia,-32.106275000000004,141.3554875,5509592,0,6845,5502747
4/20/22,Australia,-32.106275000000004,141.3554875,5563493,0,6891,5556602
4/21/22,Australia,-32.106275000000004,141.3554875,5613341,0,6939,5606402
4/22/22,Australia,-32.106275000000004,141.3554875,5650550,0,6978,5643572
4/23/22,Australia,-32.106275000000004,141.3554875,5685602,0,6983,5678619
4/24/22,Australia,-32.106275000000004,141.3554875,5719311,0,7006,5712305
4/25/22,Australia,-32.106275000000004,141.3554875,5756791,0,7052,5749739
4/26/22,Australia,-32.106275000000004,141.3554875,5796700,0,7112,5789588
4/27/22,Australia,-32.106275000000004,141.3554875,5847576,0,7164,5840412
4/28/22,Australia,-32.106275000000004,141.3554875,5889356,0,7187,5882169
4/29/22,Australia,-32.106275000000004,141.3554875,5927528,0,7236,5920292
4/30/22,Australia,-32.106275000000004,141.3554875,5953142,0,7250,5945892
5/1/22,Australia,-32.106275000000004,141.3554875,5992359,0,7244,5985115
5/2/22,Australia,-32.106275000000004,141.3554875,6030240,0,7310,6022930
5/3/22,Australia,-32.106275000000004,141.3554875,6072564,0,7355,6065209
5/4/22,Australia,-32.106275000000004,141.3554875,6130822,0,7423,6123399
5/5/22,Australia,-32.106275000000004,141.3554875,6171633,0,7453,6164180
5/6/22,Australia,-32.106275000000004,141.3554875,6207668,0,7495,6200173
5/7/22,Australia,-32.106275000000004,141.3554875,6246474,0,7509,6238965
5/8/22,Australia,-32.106275000000004,141.3554875,6286931,0,7516,6279415
5/9/22,Australia,-32.106275000000004,141.3554875,6334964,0,7559,6327405
5/10/22,Australia,-32.106275000000004,141.3554875,6392018,0,7616,6384402
5/11/22,Australia,-32.106275000000004,141.3554875,6449366,0,7668,6441698
5/12/22,Australia,-32.106275000000004,141.3554875,6496882,0,7718,6489164
5/13/22,Australia,-32.106275000000004,141.3554875,6548368,0,7769,6540599
5/14/22,Australia,-32.106275000000004,141.3554875,6590066,0,7794,6582272
5/15/22,Australia,-32.106275000000004,141.3554875,6635840,0,7807,6628033
5/16/22,Australia,-32.106275000000004,141.3554875,6703295,0,7872,6695423
5/17/22,Australia,-32.106275000000004,141.3554875,6759756,0,7926,6751830
5/18/22,Australia,-32.106275000000004,141.3554875,6813741,0,7977,6805764
5/19/22,Australia,-32.106275000000004,141.3554875,6863970,0,8028,6855942
5/20/22,Australia,-32.106275000000004,141.3554875,6910455,0,8076,6902379
5/21/22,Australia,-32.106275000000004,141.3554875,6948967,0,8097,6940870
5/22/22,Australia,-32.106275000000004,141.3554875,6983054,0,8109,6974945
5/23/22,Australia,-32.106275000000004,141.3554875,7025922,0,8178,7017744
5/24/22,Australia,-32.106275000000004,141.3554875,7071714,0,8218,7063496
5/25/22,Australia,-32.106275000000004,141.3554875,7117742,0,8335,7109407
5/26/22,Australia,-32.106275000000004,141.3554875,7157305,0,8367,7148938
5/27/22,Australia,-32.106275000000004,141.3554875,7189926,0,8432,7181494
5/28/22,Australia,-32.106275000000004,141.3554875,7216803,0,8460,7208343
5/29/22,Australia,-32.106275000000004,141.3554875,7242719,0,8470,7234249
5/30/22,Australia,-32.106275000000004,141.3554875,7276695,0,8525,7268170
5/31/22,Australia,-32.106275000000004,141.3554875,7312408,0,8558,7303850
6/1/22,Australia,-32.106275000000004,141.3554875,7346124,0,8601,7337523
6/2/22,Australia,-32.106275000000004,141.3554875,7378021,0,8662,7369359
6/3/22,Australia,-32.106275000000004,141.3554875,7405542,0,8722,7396820
6/4/22,Australia,-32.106275000000004,141.3554875,7425669,0,8749,7416920
6/5/22,Australia,-32.106275000000004,141.3554875,7448922,0,8771,7440151
6/6/22,Australia,-32.106275000000004,141.3554875,7476425,0,8802,7467623
6/7/22,Australia,-32.106275000000004,141.3554875,7509648,0,8860,7500788
6/8/22,Australia,-32.106275000000004,141.3554875,7542081,0,8919,7533162
6/9/22,Australia,-32.106275000000004,141.3554875,7571629,0,8959,7562670
6/10/22,Australia,-32.106275000000004,141.3554875,7597714,0,9024,7588690
6/11/22,Australia,-32.106275000000004,141.3554875,7614107,0,9048,7605059
6/12/22,Australia,-32.106275000000004,141.3554875,7634987,0,9058,7625929
6/13/22,Australia,-32.106275000000004,141.3554875,7660750,0,9089,7651661
6/14/22,Australia,-32.106275000000004,141.3554875,7691710,0,9146,7682564
6/15/22,Australia,-32.106275000000004,141.3554875,7724035,0,9218,7714817
6/16/22,Australia,-32.106275000000004,141.3554875,7753800,0,9269,7744531
6/17/22,Australia,-32.106275000000004,141.3554875,7778643,0,9332,7769311
6/18/22,Australia,-32.106275000000004,141.3554875,7801241,0,9372,7791869
6/19/22,Australia,-32.106275000000004,141.3554875,7825659,0,9387,7816272
6/20/22,Australia,-32.106275000000004,141.3554875,7854915,0,9445,7845470
6/21/22,Australia,-32.106275000000004,141.3554875,7887810,0,9507,7878303
6/22/22,Australia,-32.106275000000004,141.3554875,7919844,0,9559,7910285
6/23/22,Australia,-32.106275000000004,141.3554875,7945726,0,9603,7936123
6/24/22,Australia,-32.106275000000004,141.3554875,7978875,0,9655,7969220
6/25/22,Australia,-32.106275000000004,141.3554875,8000312,0,9682,7990630
6/26/22,Australia,-32.106275000000004,141.3554875,8026309,0,9705,8016604
6/27/22,Australia,-32.106275000000004,141.3554875,8057729,0,9758,8047971
6/28/22,Australia,-32.106275000000004,141.3554875,8081866,0,9813,8072053
6/29/22,Australia,-32.106275000000004,141.3554875,8130927,0,9897,8121030
6/30/22,Australia,-32.106275000000004,141.3554875,8164673,0,9930,8154743
7/1/22,Australia,-32.106275000000004,141.3554875,8194909,0,9984,8184925
7/2/22,Australia,-32.106275000000004,141.3554875,8225124,0,10014,8215110
7/3/22,Australia,-32.106275000000004,141.3554875,8254847,0,10040,8244807
7/4/22,Australia,-32.106275000000004,141.3554875,8291399,0,10085,8281314
7/5/22,Australia,-32.106275000000004,141.3554875,8334802,0,10130,8324672
7/6/22,Australia,-32.106275000000004,141.3554875,8377932,0,10191,8367741
7/7/22,Australia,-32.106275000000004,141.3554875,8419675,0,10225,8409450
7/8/22,Australia,-32.106275000000004,141.3554875,8453587,0,10298,8443289
7/9/22,Australia,-32.106275000000004,141.3554875,8488317,0,10314,8478003
7/10/22,Australia,-32.106275000000004,141.3554875,8516847,0,10326,8506521
7/11/22,Australia,-32.106275000000004,141.3554875,8561571,0,10384,8551187
7/12/22,Australia,-32.106275000000004,141.3554875,8605986,0,10442,8595544
7/13/22,Australia,-32.106275000000004,141.3554875,8653081,0,10515,8642566
7/14/22,Australia,-32.106275000000004,141.3554875,8691850,0,10578,8681272
7/15/22,Australia,-32.106275000000004,141.3554875,8734573,0,10659,8723914
7/16/22,Australia,-32.106275000000004,141.3554875,8773487,0,10689,8762798
7/17/22,Australia,-32.106275000000004,141.3554875,8811274,0,10715,8800559
7/18/22,Australia,-32.106275000000004,141.3554875,8863247,0,10794,8852453
7/19/22,Australia,-32.106275000000004,141.3554875,8912149,0,10884,8901265
7/20/22,Australia,-32.106275000000004,141.3554875,8967138,0,10968,8956170
7/21/22,Australia,-32.106275000000004,141.3554875,9018965,0,11028,9007937
7/22/22,Australia,-32.106275000000004,141.3554875,9065275,0,11134,9054141
7/23/22,Australia,-32.106275000000004,141.3554875,9103321,0,11172,9092149
7/24/22,Australia,-32.106275000000004,141.3554875,9136110,0,11185,9124925
7/25/22,Australia,-32.106275000000004,141.3554875,9185736,0,11300,9174436
7/26/22,Australia,-32.106275000000004,141.3554875,9235196,0,11386,9223810
7/27/22,Australia,-32.106275000000004,141.3554875,9282271,0,11512,9270759
7/28/22,Australia,-32.106275000000004,141.3554875,9326441,0,11669,9314772
7/29/22,Australia,-32.106275000000004,141.3554875,9376483,0,11804,9364679
7/30/22,Australia,-32.106275000000004,141.3554875,9408329,0,11846,9396483
7/31/22,Australia,-32.106275000000004,141.3554875,9435839,0,11865,9423974
8/1/22,Australia,-32.106275000000004,141.3554875,9473282,0,11957,9461325
8/2/22,Australia,-32.106275000000004,141.3554875,9517224,0,12026,9505198
8/3/22,Australia,-32.106275000000004,141.3554875,9554438,0,12111,9542327
8/4/22,Australia,-32.106275000000004,141.3554875,9586984,0,12201,9574783
8/5/22,Australia,-32.106275000000004,141.3554875,9615463,0,12289,9603174
8/6/22,Australia,-32.106275000000004,141.3554875,9638079,0,12321,9625758
8/7/22,Australia,-32.106275000000004,141.3554875,9656089,0,12335,9643754
8/8/22,Australia,-32.106275000000004,141.3554875,9684693,0,12439,9672254
8/9/22,Australia,-32.106275000000004,141.3554875,9709717,0,12560,9697157
8/10/22,Australia,-32.106275000000004,141.3554875,9729634,0,12617,9717017
8/11/22,Australia,-32.106275000000004,141.3554875,9760161,0,12739,9747422
8/12/22,Australia,-32.106275000000004,141.3554875,9778840,0,12820,9766020
8/13/22,Australia,-32.106275000000004,141.3554875,9794953,0,12862,9782091
8/14/22,Australia,-32.106275000000004,141.3554875,9810496,0,12886,9797610
8/15/22,Australia,-32.106275000000004,141.3554875,9828745,0,12954,9815791
8/16/22,Australia,-32.106275000000004,141.3554875,9849574,0,13024,9836550
8/17/22,Australia,-32.106275000000004,141.3554875,9870588,0,13153,9857435
8/18/22,Australia,-32.106275000000004,141.3554875,9887674,0,13229,9874445
8/19/22,Australia,-32.106275000000004,141.3554875,9902669,0,13325,9889344
8/20/22,Australia,-32.106275000000004,141.3554875,9911819,0,13360,9898459
8/21/22,Australia,-32.106275000000004,141.3554875,9922249,0,13369,9908880
8/22/22,Australia,-32.106275000000004,141.3554875,9933888,0,13456,9920432
8/23/22,Australia,-32.106275000000004,141.3554875,9948913,0,13517,9935396
8/24/22,Australia,-32.106275000000004,141.3554875,9960539,0,13534,9947005
8/25/22,Australia,-32.106275000000004,141.3554875,9976736,0,13647,9963089
8/26/22,Australia,-32.106275000000004,141.3554875,9987913,0,13734,9974179
8/27/22,Australia,-32.106275000000004,141.3554875,9997168,0,13749,9983419
8/28/22,Australia,-32.106275000000004,141.3554875,10005856,0,13760,9992096
8/29/22,Australia,-32.106275000000004,141.3554875,10018037,0,13834,10004203
8/30/22,Australia,-32.106275000000004,141.3554875,10030575,0,13900,10016675
8/31/22,Australia,-32.106275000000004,141.3554875,10042081,0,13961,10028120
9/1/22,Australia,-32.106275000000004,141.3554875,10051647,0,13999,10037648
9/2/22,Australia,-32.106275000000004,141.3554875,10060794,0,14053,10046741
9/3/22,Australia,-32.106275000000004,141.3554875,10066729,0,14067,10052662
9/4/22,Australia,-32.106275000000004,141.3554875,10072887,0,14077,10058810
9/5/22,Australia,-32.106275000000004,141.3554875,10083201,0,14145,10069056
9/6/22,Australia,-32.106275000000004,141.3554875,10095000,0,14214,10080786
9/7/22,Australia,-32.106275000000004,141.3554875,10103268,0,14275,10088993
9/8/22,Australia,-32.106275000000004,141.3554875,10111190,0,14359,10096831
9/9/22,Australia,-32.106275000000004,141.3554875,10111728,0,14421,10097307
9/10/22,Australia,-32.106275000000004,141.3554875,10114810,0,14426,10100384
9/11/22,Australia,-32.106275000000004,141.3554875,10119203,0,14432,10104771
9/12/22,Australia,-32.106275000000004,141.3554875,10121004,0,14457,10106547
9/13/22,Australia,-32.106275000000004,141.3554875,10122875,0,14458,10108417
9/14/22,Australia,-32.106275000000004,141.3554875,10122875,0,14458,10108417
9/15/22,Australia,-32.106275000000004,141.3554875,10150636,0,14624,10136012
9/16/22,Australia,-32.106275000000004,141.3554875,10157316,0,14749,10142567
9/17/22,Australia,-32.106275000000004,141.3554875,10158445,0,14759,10143686
9/18/22,Australia,-32.106275000000004,141.3554875,10159613,0,14763,10144850
9/19/22,Australia,-32.106275000000004,141.3554875,10161241,0,14783,10146458
9/20/22,Australia,-32.106275000000004,141.3554875,10162809,0,14787,10148022
9/21/22,Australia,-32.106275000000004,141.3554875,10164301,0,14820,10149481
9/22/22,Australia,-32.106275000000004,141.3554875,10199774,0,14924,10184850
9/23/22,Australia,-32.106275000000004,141.3554875,10201791,0,14925,10186866
9/24/22,Australia,-32.106275000000004,141.3554875,10201791,0,14925,10186866
9/25/22,Australia,-32.106275000000004,141.3554875,10204195,0,14928,10189267
9/26/22,Australia,-32.106275000000004,141.3554875,10205957,0,14950,10191007
9/27/22,Australia,-32.106275000000004,141.3554875,10207587,0,14963,10192624
9/28/22,Australia,-32.106275000000004,141.3554875,10209239,0,14984,10194255
9/29/22,Australia,-32.106275000000004,141.3554875,10238422,0,15171,10223251
9/30/22,Australia,-32.106275000000004,141.3554875,10239653,0,15221,10224432
10/1/22,Australia,-32.106275000000004,141.3554875,10240631,0,15221,10225410
10/2/22,Australia,-32.106275000000004,141.3554875,10241739,0,15221,10226518
10/3/22,Australia,-32.106275000000004,141.3554875,10243195,0,15228,10227967
10/4/22,Australia,-32.106275000000004,141.3554875,10244727,0,15234,10229493
10/5/22,Australia,-32.106275000000004,141.3554875,10246170,0,15249,10230921
10/6/22,Australia,-32.106275000000004,141.3554875,10275165,0,15330,10259835
10/7/22,Australia,-32.106275000000004,141.3554875,10275681,0,15369,10260312
10/8/22,Australia,-32.106275000000004,141.3554875,10276500,0,15369,10261131
10/9/22,Australia,-32.106275000000004,141.3554875,10277539,0,15369,10262170
10/10/22,Australia,-32.106275000000004,141.3554875,10278831,0,15383,10263448
10/11/22,Australia,-32.106275000000004,141.3554875,10280150,0,15389,10264761
10/12/22,Australia,-32.106275000000004,141.3554875,10281387,0,15399,10265988
10/13/22,Australia,-32.106275000000004,141.3554875,10308233,0,15446,10292787
10/14/22,Australia,-32.106275000000004,141.3554875,10309104,0,15475,10293629
10/15/22,Australia,-32.106275000000004,141.3554875,10309725,0,15475,10294250
10/16/22,Australia,-32.106275000000004,141.3554875,10310525,0,15475,10295050
10/17/22,Australia,-32.106275000000004,141.3554875,10311612,0,15487,10296125
10/18/22,Australia,-32.106275000000004,141.3554875,10312818,0,15490,10297328
10/19/22,Australia,-32.106275000000004,141.3554875,10313911,0,15496,10298415
10/20/22,Australia,-32.106275000000004,141.3554875,10341058,0,15530,10325528
10/21/22,Australia,-32.106275000000004,141.3554875,10341878,0,15569,10326309
10/22/22,Australia,-32.106275000000004,141.3554875,10342827,0,15569,10327258
10/23/22,Australia,-32.106275000000004,141.3554875,10343747,0,15569,10328178
10/24/22,Australia,-32.106275000000004,141.3554875,10345256,0,15580,10329676
10/25/22,Australia,-32.106275000000004,141.3554875,10346805,0,15586,10331219
10/26/22,Australia,-32.106275000000004,141.3554875,10348288,0,15589,10332699
10/27/22,Australia,-32.106275000000004,141.3554875,10364635,0,15636,10348999
10/28/22,Australia,-32.106275000000004,141.3554875,10375475,0,15660,10359815
10/29/22,Australia,-32.106275000000004,141.3554875,10376653,0,15660,10360993
10/30/22,Australia,-32.106275000000004,141.3554875,10377788,0,15660,10362128
10/31/22,Australia,-32.106275000000004,141.3554875,10379442,0,15665,10363777
11/1/22,Australia,-32.106275000000004,141.3554875,10381125,0,15665,10365460
11/2/22,Australia,-32.106275000000004,141.3554875,10383005,0,15678,10367327
11/3/22,Australia,-32.106275000000004,141.3554875,10402713,0,15721,10386992
11/4/22,Australia,-32.106275000000004,141.3554875,10417273,0,15786,10401487
11/5/22,Australia,-32.106275000000004,141.3554875,10418986,0,15786,10403200
11/6/22,Australia,-32.106275000000004,141.3554875,10420857,0,15786,10405071
11/7/22,Australia,-32.106275000000004,141.3554875,10423566,0,15792,10407774
11/8/22,Australia,-32.106275000000004,141.3554875,10426939,0,15808,10411131
11/9/22,Australia,-32.106275000000004,141.3554875,10429996,0,15817,10414179
11/10/22,Australia,-32.106275000000004,141.3554875,10458954,0,15855,10443099
11/11/22,Australia,-32.106275000000004,141.3554875,10472100,0,15873,10456227
11/12/22,Australia,-32.106275000000004,141.3554875,10479214,0,15870,10463344
11/13/22,Australia,-32.106275000000004,141.3554875,10484025,0,15870,10468155
11/14/22,Australia,-32.106275000000004,141.3554875,10487217,0,15881,10471336
11/15/22,Australia,-32.106275000000004,141.3554875,10490669,0,15891,10474778
11/16/22,Australia,-32.106275000000004,141.3554875,10493919,0,15899,10478020
11/17/22,Australia,-32.106275000000004,141.3554875,10553237,0,15976,10537261
11/18/22,Australia,-32.106275000000004,141.3554875,10555312,0,15980,10539332
11/19/22,Australia,-32.106275000000004,141.3554875,10557719,0,15980,10541739
11/20/22,Australia,-32.106275000000004,141.3554875,10560280,0,15980,10544300
11/21/22,Australia,-32.106275000000004,141.3554875,10564087,0,16007,10548080
11/22/22,Australia,-32.106275000000004,141.3554875,10567948,0,16014,10551934
11/23/22,Australia,-32.106275000000004,141.3554875,10571788,0,16026,10555762
11/24/22,Australia,-32.106275000000004,141.3554875,10627363,0,16075,10611288
11/25/22,Australia,-32.106275000000004,141.3554875,10643169,0,16100,10627069
11/26/22,Australia,-32.106275000000004,141.3554875,10646596,0,16100,10630496
11/27/22,Australia,-32.106275000000004,141.3554875,10649747,0,16100,10633647
11/28/22,Australia,-32.106275000000004,141.3554875,10653896,0,16119,10637777
11/29/22,Australia,-32.106275000000004,141.3554875,10655596,0,16124,10639472
11/30/22,Australia,-32.106275000000004,141.3554875,10659898,0,16137,10643761
12/1/22,Australia,-32.106275000000004,141.3554875,10742127,0,16203,10725924
12/2/22,Australia,-32.106275000000004,141.3554875,10748145,0,16244,10731901
12/3/22,Australia,-32.106275000000004,141.3554875,10751318,0,16244,10735074
12/4/22,Australia,-32.106275000000004,141.3554875,10754429,0,16244,10738185
12/5/22,Australia,-32.106275000000004,141.3554875,10759272,0,16264,10743008
12/6/22,Australia,-32.106275000000004,141.3554875,10763649,0,16284,10747365
12/7/22,Australia,-32.106275000000004,141.3554875,10767933,0,16304,10751629
12/8/22,Australia,-32.106275000000004,141.3554875,10850567,0,16438,10834129
12/9/22,Australia,-32.106275000000004,141.3554875,10856941,0,16462,10840479
12/10/22,Australia,-32.106275000000004,141.3554875,10859627,0,16462,10843165
12/11/22,Australia,-32.106275000000004,141.3554875,10862500,0,16462,10846038
12/12/22,Australia,-32.106275000000004,141.3554875,10866876,0,16482,10850394
12/13/22,Australia,-32.106275000000004,141.3554875,10870758,0,16492,10854266
12/14/22,Australia,-32.106275000000004,141.3554875,10874967,0,16512,10858455
12/15/22,Australia,-32.106275000000004,141.3554875,10950647,0,16651,10933996
12/16/22,Australia,-32.106275000000004,141.3554875,10969578,0,16692,10952886
12/17/22,Australia,-32.106275000000004,141.3554875,10969578,0,16692,10952886
1/1/22,Austria,47.5162,14.5501,1274628,0,16845,1257783
1/2/22,Austria,47.5162,14.5501,1278327,0,16859,1261468
1/3/22,Austria,47.5162,14.5501,1281328,0,16867,1264461
1/4/22,Austria,47.5162,14.5501,1284811,0,16879,1267932
1/5/22,Austria,47.5162,14.5501,1290817,0,16900,1273917
1/6/22,Austria,47.5162,14.5501,1300899,0,16912,1283987
1/7/22,Austria,47.5162,14.5501,1309691,0,16922,1292769
1/8/22,Austria,47.5162,14.5501,1318582,0,16931,1301651
1/9/22,Austria,47.5162,14.5501,1325632,0,16945,1308687
1/10/22,Austria,47.5162,14.5501,1336348,0,16953,1319395
1/11/22,Austria,47.5162,14.5501,1347274,0,16966,1330308
1/12/22,Austria,47.5162,14.5501,1359957,0,16978,1342979
1/13/22,Austria,47.5162,14.5501,1376504,0,16988,1359516
1/14/22,Austria,47.5162,14.5501,1393335,0,16997,1376338
1/15/22,Austria,47.5162,14.5501,1410269,0,17006,1393263
1/16/22,Austria,47.5162,14.5501,1427326,0,17018,1410308
1/17/22,Austria,47.5162,14.5501,1442182,0,17026,1425156
1/18/22,Austria,47.5162,14.5501,1458292,0,17037,1441255
1/19/22,Austria,47.5162,14.5501,1476626,0,17045,1459581
1/20/22,Austria,47.5162,14.5501,1504720,0,17053,1487667
1/21/22,Austria,47.5162,14.5501,1529850,0,17065,1512785
1/22/22,Austria,47.5162,14.5501,1559478,0,17073,1542405
1/23/22,Austria,47.5162,14.5501,1586146,0,17089,1569057
1/24/22,Austria,47.5162,14.5501,1609498,0,17100,1592398
1/25/22,Austria,47.5162,14.5501,1634631,0,17116,1617515
1/26/22,Austria,47.5162,14.5501,1661328,0,17129,1644199
1/27/22,Austria,47.5162,14.5501,1699469,0,17144,1682325
1/28/22,Austria,47.5162,14.5501,1735230,0,17154,1718076
1/29/22,Austria,47.5162,14.5501,1773059,0,17172,1755887
1/30/22,Austria,47.5162,14.5501,1806650,0,17192,1789458
1/31/22,Austria,47.5162,14.5501,1835602,0,17207,1818395
2/1/22,Austria,47.5162,14.5501,1861707,0,17223,1844484
2/2/22,Austria,47.5162,14.5501,1889437,0,17236,1872201
2/3/22,Austria,47.5162,14.5501,1933415,0,17252,1916163
2/4/22,Austria,47.5162,14.5501,1967057,0,17273,1949784
2/5/22,Austria,47.5162,14.5501,2003905,0,17297,1986608
2/6/22,Austria,47.5162,14.5501,2037105,0,17314,2019791
2/7/22,Austria,47.5162,14.5501,2067085,0,17339,2049746
2/8/22,Austria,47.5162,14.5501,2093012,0,17358,2075654
2/9/22,Austria,47.5162,14.5501,2122068,0,17384,2104684
2/10/22,Austria,47.5162,14.5501,2162487,0,17400,2145087
2/11/22,Austria,47.5162,14.5501,2197838,0,17419,2180419
2/12/22,Austria,47.5162,14.5501,2231218,0,17447,2213771
2/13/22,Austria,47.5162,14.5501,2261101,0,17479,2243622
2/14/22,Austria,47.5162,14.5501,2286139,0,17511,2268628
2/15/22,Austria,47.5162,14.5501,2310227,0,17534,2292693
2/16/22,Austria,47.5162,14.5501,2336753,0,17570,2319183
2/17/22,Austria,47.5162,14.5501,2375594,0,17601,2357993
2/18/22,Austria,47.5162,14.5501,2406524,0,17626,2388898
2/19/22,Austria,47.5162,14.5501,2437153,0,17656,2419497
2/20/22,Austria,47.5162,14.5501,2462981,0,17676,2445305
2/21/22,Austria,47.5162,14.5501,2484817,0,17704,2467113
2/22/22,Austria,47.5162,14.5501,2506243,0,17727,2488516
2/23/22,Austria,47.5162,14.5501,2530015,0,17756,2512259
2/24/22,Austria,47.5162,14.5501,2565399,0,17786,2547613
2/25/22,Austria,47.5162,14.5501,2594032,0,17811,2576221
2/26/22,Austria,47.5162,14.5501,2623952,0,17844,2606108
2/27/22,Austria,47.5162,14.5501,2649152,0,17881,2631271
2/28/22,Austria,47.5162,14.5501,2671323,0,17911,2653412
3/1/22,Austria,47.5162,14.5501,2692641,0,17940,2674701
3/2/22,Austria,47.5162,14.5501,2720094,0,17971,2702123
3/3/22,Austria,47.5162,14.5501,2761187,0,18010,2743177
3/4/22,Austria,47.5162,14.5501,2793028,0,18041,2774987
3/5/22,Austria,47.5162,14.5501,2825103,0,18074,2807029
3/6/22,Austria,47.5162,14.5501,2856781,0,18107,2838674
3/7/22,Austria,47.5162,14.5501,2884518,0,18139,2866379
3/8/22,Austria,47.5162,14.5501,2911180,0,18162,2893018
3/9/22,Austria,47.5162,14.5501,2945417,0,18195,2927222
3/10/22,Austria,47.5162,14.5501,2996765,0,18221,2978544
3/11/22,Austria,47.5162,14.5501,3047014,0,18246,3028768
3/12/22,Austria,47.5162,14.5501,3096646,0,18271,3078375
3/13/22,Austria,47.5162,14.5501,3140407,0,18300,3122107
3/14/22,Austria,47.5162,14.5501,3178040,0,18328,3159712
3/15/22,Austria,47.5162,14.5501,3212569,0,18355,3194214
3/16/22,Austria,47.5162,14.5501,3252815,0,18384,3234431
3/17/22,Austria,47.5162,14.5501,3316853,0,18418,3298435
3/18/22,Austria,47.5162,14.5501,3368804,0,18445,3350359
3/19/22,Austria,47.5162,14.5501,3419788,0,18484,3401304
3/20/22,Austria,47.5162,14.5501,3462110,0,18525,3443585
3/21/22,Austria,47.5162,14.5501,3499819,0,18559,3481260
3/22/22,Austria,47.5162,14.5501,3531163,0,18595,3512568
3/23/22,Austria,47.5162,14.5501,3568258,0,18634,3549624
3/24/22,Austria,47.5162,14.5501,3623157,0,18669,3604488
3/25/22,Austria,47.5162,14.5501,3664438,0,18718,3645720
3/26/22,Austria,47.5162,14.5501,3701790,0,18759,3683031
3/27/22,Austria,47.5162,14.5501,3734990,0,18805,3716185
3/28/22,Austria,47.5162,14.5501,3760649,0,18845,3741804
3/29/22,Austria,47.5162,14.5501,3781719,0,18878,3762841
3/30/22,Austria,47.5162,14.5501,3807856,0,18914,3788942
3/31/22,Austria,47.5162,14.5501,3842048,0,18952,3823096
4/1/22,Austria,47.5162,14.5501,3868236,0,19001,3849235
4/2/22,Austria,47.5162,14.5501,3890531,0,19045,3871486
4/3/22,Austria,47.5162,14.5501,3909523,0,19095,3890428
4/4/22,Austria,47.5162,14.5501,3923533,0,19124,3904409
4/5/22,Austria,47.5162,14.5501,3935083,0,19164,3915919
4/6/22,Austria,47.5162,14.5501,3950434,0,19191,3931243
4/7/22,Austria,47.5162,14.5501,3971481,0,19226,3952255
4/8/22,Austria,47.5162,14.5501,3987872,0,19264,3968608
4/9/22,Austria,47.5162,14.5501,4001802,0,19295,3982507
4/10/22,Austria,47.5162,14.5501,4014829,0,19322,3995507
4/11/22,Austria,47.5162,14.5501,4025499,0,19352,4006147
4/12/22,Austria,47.5162,14.5501,4032839,0,19378,4013461
4/13/22,Austria,47.5162,14.5501,4042363,0,19407,4022956
4/14/22,Austria,47.5162,14.5501,4054989,0,19440,4035549
4/15/22,Austria,47.5162,14.5501,4065438,0,19464,4045974
4/16/22,Austria,47.5162,14.5501,4075415,0,19480,4055935
4/17/22,Austria,47.5162,14.5501,4084222,0,19501,4064721
4/18/22,Austria,47.5162,14.5501,4091716,0,19523,4072193
4/19/22,Austria,47.5162,14.5501,4097345,0,19543,4077802
4/20/22,Austria,47.5162,14.5501,4103119,0,19559,4083560
4/21/22,Austria,47.5162,14.5501,4111720,0,19577,4092143
4/22/22,Austria,47.5162,14.5501,4122722,0,19591,4103131
4/23/22,Austria,47.5162,14.5501,4130862,0,19617,4111245
4/24/22,Austria,47.5162,14.5501,4137436,0,19640,4117796
4/25/22,Austria,47.5162,14.5501,4142983,0,19657,4123326
4/26/22,Austria,47.5162,14.5501,4147453,0,19669,4127784
4/27/22,Austria,47.5162,14.5501,4153702,0,19684,4134018
4/28/22,Austria,47.5162,14.5501,4162015,0,19698,4142317
4/29/22,Austria,47.5162,14.5501,4168617,0,19713,4148904
4/30/22,Austria,47.5162,14.5501,4174744,0,19726,4155018
5/1/22,Austria,47.5162,14.5501,4180075,0,19735,4160340
5/2/22,Austria,47.5162,14.5501,4184588,0,19741,4164847
5/3/22,Austria,47.5162,14.5501,4188558,0,19752,4168806
5/4/22,Austria,47.5162,14.5501,4194237,0,19765,4174472
5/5/22,Austria,47.5162,14.5501,4201452,0,19777,4181675
5/6/22,Austria,47.5162,14.5501,4207472,0,19786,4187686
5/7/22,Austria,47.5162,14.5501,4213621,0,19791,4193830
5/8/22,Austria,47.5162,14.5501,4218785,0,19795,4198990
5/9/22,Austria,47.5162,14.5501,4222306,0,19798,4202508
5/10/22,Austria,47.5162,14.5501,4226263,0,19813,4206450
5/11/22,Austria,47.5162,14.5501,4231050,0,19816,4211234
5/12/22,Austria,47.5162,14.5501,4236215,0,19816,4216399
5/13/22,Austria,47.5162,14.5501,4241469,0,19821,4221648
5/14/22,Austria,47.5162,14.5501,4246432,0,19826,4226606
5/15/22,Austria,47.5162,14.5501,4250291,0,19827,4230464
5/16/22,Austria,47.5162,14.5501,4253741,0,19827,4233914
5/17/22,Austria,47.5162,14.5501,4255897,0,19832,4236065
5/18/22,Austria,47.5162,14.5501,4258734,0,19840,4238894
5/19/22,Austria,47.5162,14.5501,4263160,0,19848,4243312
5/20/22,Austria,47.5162,14.5501,4266462,0,19855,4246607
5/21/22,Austria,47.5162,14.5501,4266462,0,19855,4246607
5/22/22,Austria,47.5162,14.5501,4266462,0,19855,4246607
5/23/22,Austria,47.5162,14.5501,4273888,0,19865,4254023
5/24/22,Austria,47.5162,14.5501,4274095,0,19874,4254221
5/25/22,Austria,47.5162,14.5501,4276334,0,19876,4256458
5/26/22,Austria,47.5162,14.5501,4278954,0,19887,4259067
5/27/22,Austria,47.5162,14.5501,4281585,0,19895,4261690
5/28/22,Austria,47.5162,14.5501,4281585,0,19895,4261690
5/29/22,Austria,47.5162,14.5501,4281585,0,19895,4261690
5/30/22,Austria,47.5162,14.5501,4286885,0,19921,4266964
5/31/22,Austria,47.5162,14.5501,4288153,0,19927,4268226
6/1/22,Austria,47.5162,14.5501,4289988,0,19931,4270057
6/2/22,Austria,47.5162,14.5501,4293027,0,19937,4273090
6/3/22,Austria,47.5162,14.5501,4295818,0,19938,4275880
6/4/22,Austria,47.5162,14.5501,4295818,0,19938,4275880
6/5/22,Austria,47.5162,14.5501,4295818,0,19938,4275880
6/6/22,Austria,47.5162,14.5501,4304326,0,19946,4284380
6/7/22,Austria,47.5162,14.5501,4306509,0,19950,4286559
6/8/22,Austria,47.5162,14.5501,4308082,0,19953,4288129
6/9/22,Austria,47.5162,14.5501,4311116,0,19960,4291156
6/10/22,Austria,47.5162,14.5501,4316435,0,19963,4296472
6/11/22,Austria,47.5162,14.5501,4316435,0,19963,4296472
6/12/22,Austria,47.5162,14.5501,4316435,0,19963,4296472
6/13/22,Austria,47.5162,14.5501,4327840,0,19969,4307871
6/14/22,Austria,47.5162,14.5501,4330667,0,19973,4310694
6/15/22,Austria,47.5162,14.5501,4335007,0,19975,4315032
6/16/22,Austria,47.5162,14.5501,4342311,0,19983,4322328
6/17/22,Austria,47.5162,14.5501,4349916,0,19984,4329932
6/18/22,Austria,47.5162,14.5501,4349916,0,19984,4329932
6/19/22,Austria,47.5162,14.5501,4349916,0,19984,4329932
6/20/22,Austria,47.5162,14.5501,4367190,0,19993,4347197
6/21/22,Austria,47.5162,14.5501,4372423,0,19998,4352425
6/22/22,Austria,47.5162,14.5501,4379778,0,20010,4359768
6/23/22,Austria,47.5162,14.5501,4391150,0,20011,4371139
6/24/22,Austria,47.5162,14.5501,4400566,0,20015,4380551
6/25/22,Austria,47.5162,14.5501,4400566,0,20015,4380551
6/26/22,Austria,47.5162,14.5501,4400566,0,20015,4380551
6/27/22,Austria,47.5162,14.5501,4425837,0,20023,4405814
6/28/22,Austria,47.5162,14.5501,4432922,0,20029,4412893
6/29/22,Austria,47.5162,14.5501,4447278,0,20037,4427241
6/30/22,Austria,47.5162,14.5501,4459767,0,20048,4439719
7/1/22,Austria,47.5162,14.5501,4471152,0,20057,4451095
7/2/22,Austria,47.5162,14.5501,4471152,0,20057,4451095
7/3/22,Austria,47.5162,14.5501,4471152,0,20057,4451095
7/4/22,Austria,47.5162,14.5501,4499570,0,20068,4479502
7/5/22,Austria,47.5162,14.5501,4506979,0,20070,4486909
7/6/22,Austria,47.5162,14.5501,4517003,0,20082,4496921
7/7/22,Austria,47.5162,14.5501,4529939,0,20093,4509846
7/8/22,Austria,47.5162,14.5501,4542028,0,20099,4521929
7/9/22,Austria,47.5162,14.5501,4542028,0,20099,4521929
7/10/22,Austria,47.5162,14.5501,4542028,0,20099,4521929
7/11/22,Austria,47.5162,14.5501,4573219,0,20120,4553099
7/12/22,Austria,47.5162,14.5501,4579384,0,20135,4559249
7/13/22,Austria,47.5162,14.5501,4591009,0,20152,4570857
7/14/22,Austria,47.5162,14.5501,4606092,0,20156,4585936
7/15/22,Austria,47.5162,14.5501,4618853,0,20163,4598690
7/16/22,Austria,47.5162,14.5501,4618853,0,20163,4598690
7/17/22,Austria,47.5162,14.5501,4618853,0,20163,4598690
7/18/22,Austria,47.5162,14.5501,4655677,0,20176,4635501
7/19/22,Austria,47.5162,14.5501,4663725,0,20183,4643542
7/20/22,Austria,47.5162,14.5501,4675532,0,20198,4655334
7/21/22,Austria,47.5162,14.5501,4691948,0,20217,4671731
7/22/22,Austria,47.5162,14.5501,4704616,0,20226,4684390
7/23/22,Austria,47.5162,14.5501,4704616,0,20226,4684390
7/24/22,Austria,47.5162,14.5501,4704616,0,20226,4684390
7/25/22,Austria,47.5162,14.5501,4734005,0,20254,4713751
7/26/22,Austria,47.5162,14.5501,4743620,0,20263,4723357
7/27/22,Austria,47.5162,14.5501,4753092,0,20278,4732814
7/28/22,Austria,47.5162,14.5501,4764902,0,20310,4744592
7/29/22,Austria,47.5162,14.5501,4774043,0,20317,4753726
7/30/22,Austria,47.5162,14.5501,4774043,0,20317,4753726
7/31/22,Austria,47.5162,14.5501,4774043,0,20317,4753726
8/1/22,Austria,47.5162,14.5501,4774043,0,20317,4753726
8/2/22,Austria,47.5162,14.5501,4799326,0,20366,4778960
8/3/22,Austria,47.5162,14.5501,4807205,0,20390,4786815
8/4/22,Austria,47.5162,14.5501,4815584,0,20396,4795188
8/5/22,Austria,47.5162,14.5501,4821763,0,20411,4801352
8/6/22,Austria,47.5162,14.5501,4821763,0,20411,4801352
8/7/22,Austria,47.5162,14.5501,4821763,0,20411,4801352
8/8/22,Austria,47.5162,14.5501,4838882,0,20435,4818447
8/9/22,Austria,47.5162,14.5501,4842843,0,20441,4822402
8/10/22,Austria,47.5162,14.5501,4848736,0,20460,4828276
8/11/22,Austria,47.5162,14.5501,4855498,0,20472,4835026
8/12/22,Austria,47.5162,14.5501,4861952,0,20485,4841467
8/13/22,Austria,47.5162,14.5501,4861952,0,20485,4841467
8/14/22,Austria,47.5162,14.5501,4861952,0,20485,4841467
8/15/22,Austria,47.5162,14.5501,4878113,0,20507,4857606
8/16/22,Austria,47.5162,14.5501,4881155,0,20509,4860646
8/17/22,Austria,47.5162,14.5501,4885051,0,20512,4864539
8/18/22,Austria,47.5162,14.5501,4891298,0,20530,4870768
8/19/22,Austria,47.5162,14.5501,4898954,0,20546,4878408
8/20/22,Austria,47.5162,14.5501,4898954,0,20546,4878408
8/21/22,Austria,47.5162,14.5501,4898954,0,20546,4878408
8/22/22,Austria,47.5162,14.5501,4915074,0,20573,4894501
8/23/22,Austria,47.5162,14.5501,4918238,0,20578,4897660
8/24/22,Austria,47.5162,14.5501,4923446,0,20593,4902853
8/25/22,Austria,47.5162,14.5501,4929134,0,20604,4908530
8/26/22,Austria,47.5162,14.5501,4934634,0,20613,4914021
8/27/22,Austria,47.5162,14.5501,4934634,0,20613,4914021
8/28/22,Austria,47.5162,14.5501,4934634,0,20613,4914021
8/29/22,Austria,47.5162,14.5501,4934634,0,20613,4914021
8/30/22,Austria,47.5162,14.5501,4951660,0,20628,4931032
8/31/22,Austria,47.5162,14.5501,4956010,0,20639,4935371
9/1/22,Austria,47.5162,14.5501,4961354,0,20648,4940706
9/2/22,Austria,47.5162,14.5501,4966009,0,20659,4945350
9/3/22,Austria,47.5162,14.5501,4966009,0,20659,4945350
9/4/22,Austria,47.5162,14.5501,4966009,0,20659,4945350
9/5/22,Austria,47.5162,14.5501,4977837,0,20668,4957169
9/6/22,Austria,47.5162,14.5501,4980628,0,20671,4959957
9/7/22,Austria,47.5162,14.5501,4984809,0,20678,4964131
9/8/22,Austria,47.5162,14.5501,4984809,0,20678,4964131
9/9/22,Austria,47.5162,14.5501,4984809,0,20678,4964131
9/10/22,Austria,47.5162,14.5501,4984809,0,20678,4964131
9/11/22,Austria,47.5162,14.5501,4984809,0,20678,4964131
9/12/22,Austria,47.5162,14.5501,5006893,0,20711,4986182
9/13/22,Austria,47.5162,14.5501,5009501,0,20712,4988789
9/14/22,Austria,47.5162,14.5501,4996567,0,20656,4975911
9/15/22,Austria,47.5162,14.5501,5002850,0,20661,4982189
9/16/22,Austria,47.5162,14.5501,5008515,0,20664,4987851
9/17/22,Austria,47.5162,14.5501,5013900,0,20670,4993230
9/18/22,Austria,47.5162,14.5501,5024113,0,20677,5003436
9/19/22,Austria,47.5162,14.5501,5027739,0,20677,5007062
9/20/22,Austria,47.5162,14.5501,5033797,0,20683,5013114
9/21/22,Austria,47.5162,14.5501,5042307,0,20690,5021617
9/22/22,Austria,47.5162,14.5501,5050233,0,20700,5029533
9/23/22,Austria,47.5162,14.5501,5058191,0,20707,5037484
9/24/22,Austria,47.5162,14.5501,5066790,0,20712,5046078
9/25/22,Austria,47.5162,14.5501,5073706,0,20712,5052994
9/26/22,Austria,47.5162,14.5501,5079700,0,20713,5058987
9/27/22,Austria,47.5162,14.5501,5090354,0,20723,5069631
9/28/22,Austria,47.5162,14.5501,5105202,0,20734,5084468
9/29/22,Austria,47.5162,14.5501,5118512,0,20738,5097774
9/30/22,Austria,47.5162,14.5501,5131527,0,20743,5110784
10/1/22,Austria,47.5162,14.5501,5144116,0,20754,5123362
10/2/22,Austria,47.5162,14.5501,5154447,0,20756,5133691
10/3/22,Austria,47.5162,14.5501,5162934,0,20758,5142176
10/4/22,Austria,47.5162,14.5501,5176787,0,20767,5156020
10/5/22,Austria,47.5162,14.5501,5195408,0,20779,5174629
10/6/22,Austria,47.5162,14.5501,5210285,0,20794,5189491
10/7/22,Austria,47.5162,14.5501,5226219,0,20809,5205410
10/8/22,Austria,47.5162,14.5501,5239883,0,20823,5219060
10/9/22,Austria,47.5162,14.5501,5252058,0,20824,5231234
10/10/22,Austria,47.5162,14.5501,5260762,0,20825,5239937
10/11/22,Austria,47.5162,14.5501,5273660,0,20857,5252803
10/12/22,Austria,47.5162,14.5501,5292125,0,20880,5271245
10/13/22,Austria,47.5162,14.5501,5306372,0,20895,5285477
10/14/22,Austria,47.5162,14.5501,5319474,0,20912,5298562
10/15/22,Austria,47.5162,14.5501,5331324,0,20922,5310402
10/16/22,Austria,47.5162,14.5501,5340548,0,20926,5319622
10/17/22,Austria,47.5162,14.5501,5346939,0,20928,5326011
10/18/22,Austria,47.5162,14.5501,5356174,0,20943,5335231
10/19/22,Austria,47.5162,14.5501,5369885,0,20953,5348932
10/20/22,Austria,47.5162,14.5501,5379734,0,20971,5358763
10/21/22,Austria,47.5162,14.5501,5387830,0,20980,5366850
10/22/22,Austria,47.5162,14.5501,5387830,0,20980,5366850
10/23/22,Austria,47.5162,14.5501,5387830,0,20980,5366850
10/24/22,Austria,47.5162,14.5501,5402162,0,20899,5381263
10/25/22,Austria,47.5162,14.5501,5408648,0,20922,5387726
10/26/22,Austria,47.5162,14.5501,5416866,0,20943,5395923
10/27/22,Austria,47.5162,14.5501,5421306,0,20946,5400360
10/28/22,Austria,47.5162,14.5501,5426408,0,20963,5405445
10/29/22,Austria,47.5162,14.5501,5432162,0,20976,5411186
10/30/22,Austria,47.5162,14.5501,5436721,0,20979,5415742
10/31/22,Austria,47.5162,14.5501,5439567,0,20981,5418586
11/1/22,Austria,47.5162,14.5501,5443883,0,20990,5422893
11/2/22,Austria,47.5162,14.5501,5448375,0,20990,5427385
11/3/22,Austria,47.5162,14.5501,5453038,0,21012,5432026
11/4/22,Austria,47.5162,14.5501,5458604,0,21029,5437575
11/5/22,Austria,47.5162,14.5501,5462911,0,21036,5441875
11/6/22,Austria,47.5162,14.5501,5466250,0,21037,5445213
11/7/22,Austria,47.5162,14.5501,5468967,0,21040,5447927
11/8/22,Austria,47.5162,14.5501,5472671,0,21049,5451622
11/9/22,Austria,47.5162,14.5501,5477350,0,21059,5456291
11/10/22,Austria,47.5162,14.5501,5481274,0,21069,5460205
11/11/22,Austria,47.5162,14.5501,5484553,0,21082,5463471
11/12/22,Austria,47.5162,14.5501,5488376,0,21090,5467286
11/13/22,Austria,47.5162,14.5501,5491252,0,21093,5470159
11/14/22,Austria,47.5162,14.5501,5493469,0,21094,5472375
11/15/22,Austria,47.5162,14.5501,5497145,0,21105,5476040
11/16/22,Austria,47.5162,14.5501,5502186,0,21116,5481070
11/17/22,Austria,47.5162,14.5501,5506697,0,21124,5485573
11/18/22,Austria,47.5162,14.5501,5510919,0,21134,5489785
11/19/22,Austria,47.5162,14.5501,5514701,0,21143,5493558
11/20/22,Austria,47.5162,14.5501,5517893,0,21144,5496749
11/21/22,Austria,47.5162,14.5501,5520300,0,21144,5499156
11/22/22,Austria,47.5162,14.5501,5524683,0,21149,5503534
11/23/22,Austria,47.5162,14.5501,5530456,0,21159,5509297
11/24/22,Austria,47.5162,14.5501,5535259,0,21165,5514094
11/25/22,Austria,47.5162,14.5501,5539629,0,21179,5518450
11/26/22,Austria,47.5162,14.5501,5544112,0,21187,5522925
11/27/22,Austria,47.5162,14.5501,5547582,0,21187,5526395
11/28/22,Austria,47.5162,14.5501,5550575,0,21189,5529386
11/29/22,Austria,47.5162,14.5501,5554975,0,21202,5533773
11/30/22,Austria,47.5162,14.5501,5561633,0,21210,5540423
12/1/22,Austria,47.5162,14.5501,5566947,0,21216,5545731
12/2/22,Austria,47.5162,14.5501,5572289,0,21225,5551064
12/3/22,Austria,47.5162,14.5501,5576700,0,21231,5555469
12/4/22,Austria,47.5162,14.5501,5576695,0,21232,5555463
12/5/22,Austria,47.5162,14.5501,5583979,0,21232,5562747
12/6/22,Austria,47.5162,14.5501,5588468,0,21242,5567226
12/7/22,Austria,47.5162,14.5501,5595286,0,21247,5574039
12/8/22,Austria,47.5162,14.5501,5600568,0,21257,5579311
12/9/22,Austria,47.5162,14.5501,5604611,0,21257,5583354
12/10/22,Austria,47.5162,14.5501,5608411,0,21265,5587146
12/11/22,Austria,47.5162,14.5501,5613343,0,21265,5592078
12/12/22,Austria,47.5162,14.5501,5616644,0,21265,5595379
12/13/22,Austria,47.5162,14.5501,5622037,0,21272,5600765
12/14/22,Austria,47.5162,14.5501,5629173,0,21286,5607887
12/15/22,Austria,47.5162,14.5501,5634944,0,21291,5613653
12/16/22,Austria,47.5162,14.5501,5639992,0,21306,5618686
12/17/22,Austria,47.5162,14.5501,5644634,0,21316,5623318
1/1/22,Azerbaijan,40.1431,47.5769,617311,0,8365,608946
1/2/22,Azerbaijan,40.1431,47.5769,617679,0,8375,609304
1/3/22,Azerbaijan,40.1431,47.5769,617952,0,8383,609569
1/4/22,Azerbaijan,40.1431,47.5769,618365,0,8398,609967
1/5/22,Azerbaijan,40.1431,47.5769,618918,0,8409,610509
1/6/22,Azerbaijan,40.1431,47.5769,619502,0,8422,611080
1/7/22,Azerbaijan,40.1431,47.5769,620049,0,8431,611618
1/8/22,Azerbaijan,40.1431,47.5769,620679,0,8437,612242
1/9/22,Azerbaijan,40.1431,47.5769,621234,0,8445,612789
1/10/22,Azerbaijan,40.1431,47.5769,621563,0,8457,613106
1/11/22,Azerbaijan,40.1431,47.5769,622236,0,8471,613765
1/12/22,Azerbaijan,40.1431,47.5769,622881,0,8480,614401
1/13/22,Azerbaijan,40.1431,47.5769,623555,0,8490,615065
1/14/22,Azerbaijan,40.1431,47.5769,624208,0,8497,615711
1/15/22,Azerbaijan,40.1431,47.5769,624918,0,8510,616408
1/16/22,Azerbaijan,40.1431,47.5769,625726,0,8521,617205
1/17/22,Azerbaijan,40.1431,47.5769,626085,0,8529,617556
1/18/22,Azerbaijan,40.1431,47.5769,627015,0,8541,618474
1/19/22,Azerbaijan,40.1431,47.5769,628166,0,8550,619616
1/20/22,Azerbaijan,40.1431,47.5769,629352,0,8564,620788
1/21/22,Azerbaijan,40.1431,47.5769,630420,0,8581,621839
1/22/22,Azerbaijan,40.1431,47.5769,632034,0,8597,623437
1/23/22,Azerbaijan,40.1431,47.5769,633731,0,8610,625121
1/24/22,Azerbaijan,40.1431,47.5769,634488,0,8619,625869
1/25/22,Azerbaijan,40.1431,47.5769,636956,0,8632,628324
1/26/22,Azerbaijan,40.1431,47.5769,640148,0,8650,631498
1/27/22,Azerbaijan,40.1431,47.5769,643509,0,8664,634845
1/28/22,Azerbaijan,40.1431,47.5769,647073,0,8683,638390
1/29/22,Azerbaijan,40.1431,47.5769,651341,0,8700,642641
1/30/22,Azerbaijan,40.1431,47.5769,656284,0,8720,647564
1/31/22,Azerbaijan,40.1431,47.5769,658470,0,8734,649736
2/1/22,Azerbaijan,40.1431,47.5769,663693,0,8755,654938
2/2/22,Azerbaijan,40.1431,47.5769,670313,0,8779,661534
2/3/22,Azerbaijan,40.1431,47.5769,676426,0,8797,667629
2/4/22,Azerbaijan,40.1431,47.5769,683476,0,8823,674653
2/5/22,Azerbaijan,40.1431,47.5769,691180,0,8846,682334
2/6/22,Azerbaijan,40.1431,47.5769,698654,0,8871,689783
2/7/22,Azerbaijan,40.1431,47.5769,703334,0,8898,694436
2/8/22,Azerbaijan,40.1431,47.5769,710366,0,8920,701446
2/9/22,Azerbaijan,40.1431,47.5769,718145,0,8948,709197
2/10/22,Azerbaijan,40.1431,47.5769,725777,0,8972,716805
2/11/22,Azerbaijan,40.1431,47.5769,732380,0,8998,723382
2/12/22,Azerbaijan,40.1431,47.5769,738328,0,9027,729301
2/13/22,Azerbaijan,40.1431,47.5769,745169,0,9050,736119
2/14/22,Azerbaijan,40.1431,47.5769,747918,0,9077,738841
2/15/22,Azerbaijan,40.1431,47.5769,752605,0,9105,743500
2/16/22,Azerbaijan,40.1431,47.5769,759753,0,9127,750626
2/17/22,Azerbaijan,40.1431,47.5769,764202,0,9157,755045
2/18/22,Azerbaijan,40.1431,47.5769,768019,0,9182,758837
2/19/22,Azerbaijan,40.1431,47.5769,771709,0,9211,762498
2/20/22,Azerbaijan,40.1431,47.5769,774394,0,9235,765159
2/21/22,Azerbaijan,40.1431,47.5769,775432,0,9261,766171
2/22/22,Azerbaijan,40.1431,47.5769,777804,0,9280,768524
2/23/22,Azerbaijan,40.1431,47.5769,779783,0,9307,770476
2/24/22,Azerbaijan,40.1431,47.5769,781538,0,9330,772208
2/25/22,Azerbaijan,40.1431,47.5769,782748,0,9358,773390
2/26/22,Azerbaijan,40.1431,47.5769,782748,0,9358,773390
2/27/22,Azerbaijan,40.1431,47.5769,785301,0,9400,775901
2/28/22,Azerbaijan,40.1431,47.5769,785670,0,9417,776253
3/1/22,Azerbaijan,40.1431,47.5769,786502,0,9438,777064
3/2/22,Azerbaijan,40.1431,47.5769,787367,0,9454,777913
3/3/22,Azerbaijan,40.1431,47.5769,787937,0,9473,778464
3/4/22,Azerbaijan,40.1431,47.5769,788525,0,9488,779037
3/5/22,Azerbaijan,40.1431,47.5769,788958,0,9500,779458
3/6/22,Azerbaijan,40.1431,47.5769,789332,0,9518,779814
3/7/22,Azerbaijan,40.1431,47.5769,789481,0,9531,779950
3/8/22,Azerbaijan,40.1431,47.5769,789757,0,9547,780210
3/9/22,Azerbaijan,40.1431,47.5769,789883,0,9558,780325
3/10/22,Azerbaijan,40.1431,47.5769,790153,0,9575,780578
3/11/22,Azerbaijan,40.1431,47.5769,790378,0,9589,780789
3/12/22,Azerbaijan,40.1431,47.5769,790575,0,9599,780976
3/13/22,Azerbaijan,40.1431,47.5769,790767,0,9611,781156
3/14/22,Azerbaijan,40.1431,47.5769,790820,0,9618,781202
3/15/22,Azerbaijan,40.1431,47.5769,790962,0,9627,781335
3/16/22,Azerbaijan,40.1431,47.5769,791077,0,9633,781444
3/17/22,Azerbaijan,40.1431,47.5769,791077,0,9633,781444
3/18/22,Azerbaijan,40.1431,47.5769,791288,0,9647,781641
3/19/22,Azerbaijan,40.1431,47.5769,791404,0,9651,781753
3/20/22,Azerbaijan,40.1431,47.5769,791482,0,9656,781826
3/21/22,Azerbaijan,40.1431,47.5769,791511,0,9659,781852
3/22/22,Azerbaijan,40.1431,47.5769,791545,0,9666,781879
3/23/22,Azerbaijan,40.1431,47.5769,791583,0,9670,781913
3/24/22,Azerbaijan,40.1431,47.5769,791604,0,9672,781932
3/25/22,Azerbaijan,40.1431,47.5769,791654,0,9675,781979
3/26/22,Azerbaijan,40.1431,47.5769,791695,0,9679,782016
3/27/22,Azerbaijan,40.1431,47.5769,791750,0,9681,782069
3/28/22,Azerbaijan,40.1431,47.5769,791766,0,9684,782082
3/29/22,Azerbaijan,40.1431,47.5769,791814,0,9687,782127
3/30/22,Azerbaijan,40.1431,47.5769,791876,0,9691,782185
3/31/22,Azerbaijan,40.1431,47.5769,791932,0,9692,782240
4/1/22,Azerbaijan,40.1431,47.5769,791979,0,9694,782285
4/2/22,Azerbaijan,40.1431,47.5769,792019,0,9697,782322
4/3/22,Azerbaijan,40.1431,47.5769,792061,0,9697,782364
4/4/22,Azerbaijan,40.1431,47.5769,792067,0,9698,782369
4/5/22,Azerbaijan,40.1431,47.5769,792103,0,9700,782403
4/6/22,Azerbaijan,40.1431,47.5769,792141,0,9701,782440
4/7/22,Azerbaijan,40.1431,47.5769,792166,0,9703,782463
4/8/22,Azerbaijan,40.1431,47.5769,792188,0,9703,782485
4/9/22,Azerbaijan,40.1431,47.5769,792216,0,9703,782513
4/10/22,Azerbaijan,40.1431,47.5769,792237,0,9703,782534
4/11/22,Azerbaijan,40.1431,47.5769,792253,0,9703,782550
4/12/22,Azerbaijan,40.1431,47.5769,792289,0,9703,782586
4/13/22,Azerbaijan,40.1431,47.5769,792305,0,9704,782601
4/14/22,Azerbaijan,40.1431,47.5769,792320,0,9705,782615
4/15/22,Azerbaijan,40.1431,47.5769,792320,0,9705,782615
4/16/22,Azerbaijan,40.1431,47.5769,792349,0,9705,782644
4/17/22,Azerbaijan,40.1431,47.5769,792362,0,9706,782656
4/18/22,Azerbaijan,40.1431,47.5769,792365,0,9706,782659
4/19/22,Azerbaijan,40.1431,47.5769,792391,0,9706,782685
4/20/22,Azerbaijan,40.1431,47.5769,792412,0,9706,782706
4/21/22,Azerbaijan,40.1431,47.5769,792445,0,9707,782738
4/22/22,Azerbaijan,40.1431,47.5769,792457,0,9707,782750
4/23/22,Azerbaijan,40.1431,47.5769,792476,0,9707,782769
4/24/22,Azerbaijan,40.1431,47.5769,792496,0,9707,782789
4/25/22,Azerbaijan,40.1431,47.5769,792496,0,9707,782789
4/26/22,Azerbaijan,40.1431,47.5769,792502,0,9707,782795
4/27/22,Azerbaijan,40.1431,47.5769,792521,0,9707,782814
4/28/22,Azerbaijan,40.1431,47.5769,792496,0,9707,782789
4/29/22,Azerbaijan,40.1431,47.5769,792558,0,9709,782849
4/30/22,Azerbaijan,40.1431,47.5769,792562,0,9709,782853
5/1/22,Azerbaijan,40.1431,47.5769,792578,0,9709,782869
5/2/22,Azerbaijan,40.1431,47.5769,792579,0,9709,782870
5/3/22,Azerbaijan,40.1431,47.5769,792585,0,9709,782876
5/4/22,Azerbaijan,40.1431,47.5769,792585,0,9709,782876
5/5/22,Azerbaijan,40.1431,47.5769,792599,0,9709,782890
5/6/22,Azerbaijan,40.1431,47.5769,792607,0,9709,782898
5/7/22,Azerbaijan,40.1431,47.5769,792618,0,9709,782909
5/8/22,Azerbaijan,40.1431,47.5769,792630,0,9709,782921
5/9/22,Azerbaijan,40.1431,47.5769,792632,0,9709,782923
5/10/22,Azerbaijan,40.1431,47.5769,792638,0,9709,782929
5/11/22,Azerbaijan,40.1431,47.5769,792638,0,9709,782929
5/12/22,Azerbaijan,40.1431,47.5769,792638,0,9709,782929
5/13/22,Azerbaijan,40.1431,47.5769,792638,0,9709,782929
5/14/22,Azerbaijan,40.1431,47.5769,792638,0,9709,782929
5/15/22,Azerbaijan,40.1431,47.5769,792638,0,9709,782929
5/16/22,Azerbaijan,40.1431,47.5769,792638,0,9709,782929
5/17/22,Azerbaijan,40.1431,47.5769,792680,0,9709,782971
5/18/22,Azerbaijan,40.1431,47.5769,792685,0,9709,782976
5/19/22,Azerbaijan,40.1431,47.5769,792695,0,9710,782985
5/20/22,Azerbaijan,40.1431,47.5769,792707,0,9710,782997
5/21/22,Azerbaijan,40.1431,47.5769,792708,0,9710,782998
5/22/22,Azerbaijan,40.1431,47.5769,792712,0,9710,783002
5/23/22,Azerbaijan,40.1431,47.5769,792714,0,9710,783004
5/24/22,Azerbaijan,40.1431,47.5769,792714,0,9710,783004
5/25/22,Azerbaijan,40.1431,47.5769,792714,0,9710,783004
5/26/22,Azerbaijan,40.1431,47.5769,792714,0,9710,783004
5/27/22,Azerbaijan,40.1431,47.5769,792746,0,9712,783034
5/28/22,Azerbaijan,40.1431,47.5769,792757,0,9712,783045
5/29/22,Azerbaijan,40.1431,47.5769,792758,0,9713,783045
5/30/22,Azerbaijan,40.1431,47.5769,792759,0,9713,783046
5/31/22,Azerbaijan,40.1431,47.5769,792767,0,9713,783054
6/1/22,Azerbaijan,40.1431,47.5769,792778,0,9713,783065
6/2/22,Azerbaijan,40.1431,47.5769,792785,0,9713,783072
6/3/22,Azerbaijan,40.1431,47.5769,792785,0,9713,783072
6/4/22,Azerbaijan,40.1431,47.5769,792785,0,9713,783072
6/5/22,Azerbaijan,40.1431,47.5769,792785,0,9713,783072
6/6/22,Azerbaijan,40.1431,47.5769,792785,0,9713,783072
6/7/22,Azerbaijan,40.1431,47.5769,792785,0,9713,783072
6/8/22,Azerbaijan,40.1431,47.5769,792785,0,9713,783072
6/9/22,Azerbaijan,40.1431,47.5769,792785,0,9713,783072
6/10/22,Azerbaijan,40.1431,47.5769,792785,0,9713,783072
6/11/22,Azerbaijan,40.1431,47.5769,792785,0,9713,783072
6/12/22,Azerbaijan,40.1431,47.5769,792785,0,9713,783072
6/13/22,Azerbaijan,40.1431,47.5769,792785,0,9713,783072
6/14/22,Azerbaijan,40.1431,47.5769,792785,0,9713,783072
6/15/22,Azerbaijan,40.1431,47.5769,792785,0,9713,783072
6/16/22,Azerbaijan,40.1431,47.5769,792785,0,9713,783072
6/17/22,Azerbaijan,40.1431,47.5769,792959,0,9715,783244
6/18/22,Azerbaijan,40.1431,47.5769,792985,0,9716,783269
6/19/22,Azerbaijan,40.1431,47.5769,793010,0,9716,783294
6/20/22,Azerbaijan,40.1431,47.5769,793015,0,9716,783299
6/21/22,Azerbaijan,40.1431,47.5769,793036,0,9716,783320
6/22/22,Azerbaijan,40.1431,47.5769,793063,0,9716,783347
6/23/22,Azerbaijan,40.1431,47.5769,793089,0,9716,783373
6/24/22,Azerbaijan,40.1431,47.5769,793106,0,9717,783389
6/25/22,Azerbaijan,40.1431,47.5769,793140,0,9717,783423
6/26/22,Azerbaijan,40.1431,47.5769,793164,0,9717,783447
6/27/22,Azerbaijan,40.1431,47.5769,793176,0,9717,783459
6/28/22,Azerbaijan,40.1431,47.5769,793176,0,9717,783459
6/29/22,Azerbaijan,40.1431,47.5769,793176,0,9717,783459
6/30/22,Azerbaijan,40.1431,47.5769,793176,0,9717,783459
7/1/22,Azerbaijan,40.1431,47.5769,793302,0,9717,783585
7/2/22,Azerbaijan,40.1431,47.5769,793335,0,9717,783618
7/3/22,Azerbaijan,40.1431,47.5769,793371,0,9717,783654
7/4/22,Azerbaijan,40.1431,47.5769,793388,0,9717,783671
7/5/22,Azerbaijan,40.1431,47.5769,793388,0,9717,783671
7/6/22,Azerbaijan,40.1431,47.5769,793388,0,9717,783671
7/7/22,Azerbaijan,40.1431,47.5769,793388,0,9717,783671
7/8/22,Azerbaijan,40.1431,47.5769,793388,0,9717,783671
7/9/22,Azerbaijan,40.1431,47.5769,793388,0,9717,783671
7/10/22,Azerbaijan,40.1431,47.5769,793388,0,9717,783671
7/11/22,Azerbaijan,40.1431,47.5769,793388,0,9717,783671
7/12/22,Azerbaijan,40.1431,47.5769,793388,0,9717,783671
7/13/22,Azerbaijan,40.1431,47.5769,793388,0,9717,783671
7/14/22,Azerbaijan,40.1431,47.5769,793388,0,9717,783671
7/15/22,Azerbaijan,40.1431,47.5769,793388,0,9717,783671
7/16/22,Azerbaijan,40.1431,47.5769,793388,0,9717,783671
7/17/22,Azerbaijan,40.1431,47.5769,793388,0,9717,783671
7/18/22,Azerbaijan,40.1431,47.5769,794656,0,9723,784933
7/19/22,Azerbaijan,40.1431,47.5769,794913,0,9727,785186
7/20/22,Azerbaijan,40.1431,47.5769,795190,0,9727,785463
7/21/22,Azerbaijan,40.1431,47.5769,795495,0,9729,785766
7/22/22,Azerbaijan,40.1431,47.5769,795832,0,9733,786099
7/23/22,Azerbaijan,40.1431,47.5769,796141,0,9735,786406
7/24/22,Azerbaijan,40.1431,47.5769,796474,0,9735,786739
7/25/22,Azerbaijan,40.1431,47.5769,796576,0,9735,786841
7/26/22,Azerbaijan,40.1431,47.5769,796882,0,9739,787143
7/27/22,Azerbaijan,40.1431,47.5769,797281,0,9741,787540
7/28/22,Azerbaijan,40.1431,47.5769,797638,0,9744,787894
7/29/22,Azerbaijan,40.1431,47.5769,798011,0,9746,788265
7/30/22,Azerbaijan,40.1431,47.5769,798404,0,9747,788657
7/31/22,Azerbaijan,40.1431,47.5769,798838,0,9748,789090
8/1/22,Azerbaijan,40.1431,47.5769,798940,0,9748,789192
8/2/22,Azerbaijan,40.1431,47.5769,799471,0,9752,789719
8/3/22,Azerbaijan,40.1431,47.5769,799983,0,9752,790231
8/4/22,Azerbaijan,40.1431,47.5769,800478,0,9755,790723
8/5/22,Azerbaijan,40.1431,47.5769,801018,0,9755,791263
8/6/22,Azerbaijan,40.1431,47.5769,801470,0,9760,791710
8/7/22,Azerbaijan,40.1431,47.5769,801939,0,9760,792179
8/8/22,Azerbaijan,40.1431,47.5769,802060,0,9761,792299
8/9/22,Azerbaijan,40.1431,47.5769,802060,0,9761,792299
8/10/22,Azerbaijan,40.1431,47.5769,803157,0,9768,793389
8/11/22,Azerbaijan,40.1431,47.5769,803645,0,9768,793877
8/12/22,Azerbaijan,40.1431,47.5769,804165,0,9768,794397
8/13/22,Azerbaijan,40.1431,47.5769,804585,0,9773,794812
8/14/22,Azerbaijan,40.1431,47.5769,805103,0,9773,795330
8/15/22,Azerbaijan,40.1431,47.5769,805213,0,9777,795436
8/16/22,Azerbaijan,40.1431,47.5769,805762,0,9777,795985
8/17/22,Azerbaijan,40.1431,47.5769,806472,0,9777,796695
8/18/22,Azerbaijan,40.1431,47.5769,807017,0,9784,797233
8/19/22,Azerbaijan,40.1431,47.5769,807516,0,9784,797732
8/20/22,Azerbaijan,40.1431,47.5769,807984,0,9784,798200
8/21/22,Azerbaijan,40.1431,47.5769,808569,0,9785,798784
8/22/22,Azerbaijan,40.1431,47.5769,808713,0,9793,798920
8/23/22,Azerbaijan,40.1431,47.5769,808713,0,9793,798920
8/24/22,Azerbaijan,40.1431,47.5769,809988,0,9795,800193
8/25/22,Azerbaijan,40.1431,47.5769,810589,0,9795,800794
8/26/22,Azerbaijan,40.1431,47.5769,811131,0,9796,801335
8/27/22,Azerbaijan,40.1431,47.5769,811559,0,9805,801754
8/28/22,Azerbaijan,40.1431,47.5769,812116,0,9805,802311
8/29/22,Azerbaijan,40.1431,47.5769,812248,0,9805,802443
8/30/22,Azerbaijan,40.1431,47.5769,812816,0,9805,803011
8/31/22,Azerbaijan,40.1431,47.5769,813437,0,9805,803632
9/1/22,Azerbaijan,40.1431,47.5769,813998,0,9805,804193
9/2/22,Azerbaijan,40.1431,47.5769,814435,0,9813,804622
9/3/22,Azerbaijan,40.1431,47.5769,815047,0,9822,805225
9/4/22,Azerbaijan,40.1431,47.5769,815523,0,9825,805698
9/5/22,Azerbaijan,40.1431,47.5769,815523,0,9825,805698
9/6/22,Azerbaijan,40.1431,47.5769,816087,0,9831,806256
9/7/22,Azerbaijan,40.1431,47.5769,816589,0,9838,806751
9/8/22,Azerbaijan,40.1431,47.5769,816985,0,9843,807142
9/9/22,Azerbaijan,40.1431,47.5769,817322,0,9849,807473
9/10/22,Azerbaijan,40.1431,47.5769,817596,0,9852,807744
9/11/22,Azerbaijan,40.1431,47.5769,817862,0,9854,808008
9/12/22,Azerbaijan,40.1431,47.5769,817938,0,9857,808081
9/13/22,Azerbaijan,40.1431,47.5769,818263,0,9864,808399
9/14/22,Azerbaijan,40.1431,47.5769,818634,0,9873,808761
9/15/22,Azerbaijan,40.1431,47.5769,818890,0,9876,809014
9/16/22,Azerbaijan,40.1431,47.5769,819124,0,9881,809243
9/17/22,Azerbaijan,40.1431,47.5769,819338,0,9884,809454
9/18/22,Azerbaijan,40.1431,47.5769,819518,0,9886,809632
9/19/22,Azerbaijan,40.1431,47.5769,819588,0,9886,809702
9/20/22,Azerbaijan,40.1431,47.5769,819847,0,9893,809954
9/21/22,Azerbaijan,40.1431,47.5769,820098,0,9897,810201
9/22/22,Azerbaijan,40.1431,47.5769,820299,0,9900,810399
9/23/22,Azerbaijan,40.1431,47.5769,820513,0,9902,810611
9/24/22,Azerbaijan,40.1431,47.5769,820662,0,9903,810759
9/25/22,Azerbaijan,40.1431,47.5769,820823,0,9903,810920
9/26/22,Azerbaijan,40.1431,47.5769,820858,0,9903,810955
9/27/22,Azerbaijan,40.1431,47.5769,820998,0,9907,811091
9/28/22,Azerbaijan,40.1431,47.5769,821162,0,9910,811252
9/29/22,Azerbaijan,40.1431,47.5769,821311,0,9913,811398
9/30/22,Azerbaijan,40.1431,47.5769,821440,0,9917,811523
10/1/22,Azerbaijan,40.1431,47.5769,821532,0,9919,811613
10/2/22,Azerbaijan,40.1431,47.5769,821635,0,9919,811716
10/3/22,Azerbaijan,40.1431,47.5769,821661,0,9919,811742
10/4/22,Azerbaijan,40.1431,47.5769,821757,0,9921,811836
10/5/22,Azerbaijan,40.1431,47.5769,821865,0,9925,811940
10/6/22,Azerbaijan,40.1431,47.5769,821937,0,9927,812010
10/7/22,Azerbaijan,40.1431,47.5769,822027,0,9927,812100
10/8/22,Azerbaijan,40.1431,47.5769,822104,0,9927,812177
10/9/22,Azerbaijan,40.1431,47.5769,822171,0,9927,812244
10/10/22,Azerbaijan,40.1431,47.5769,822186,0,9928,812258
10/11/22,Azerbaijan,40.1431,47.5769,822278,0,9931,812347
10/12/22,Azerbaijan,40.1431,47.5769,822346,0,9931,812415
10/13/22,Azerbaijan,40.1431,47.5769,822427,0,9931,812496
10/14/22,Azerbaijan,40.1431,47.5769,822485,0,9931,812554
10/15/22,Azerbaijan,40.1431,47.5769,822538,0,9931,812607
10/16/22,Azerbaijan,40.1431,47.5769,822599,0,9932,812667
10/17/22,Azerbaijan,40.1431,47.5769,822617,0,9932,812685
10/18/22,Azerbaijan,40.1431,47.5769,822686,0,9935,812751
10/19/22,Azerbaijan,40.1431,47.5769,822751,0,9935,812816
10/20/22,Azerbaijan,40.1431,47.5769,822805,0,9935,812870
10/21/22,Azerbaijan,40.1431,47.5769,822852,0,9935,812917
10/22/22,Azerbaijan,40.1431,47.5769,822908,0,9937,812971
10/23/22,Azerbaijan,40.1431,47.5769,822954,0,9937,813017
10/24/22,Azerbaijan,40.1431,47.5769,822959,0,9937,813022
10/25/22,Azerbaijan,40.1431,47.5769,823023,0,9940,813083
10/26/22,Azerbaijan,40.1431,47.5769,823064,0,9941,813123
10/27/22,Azerbaijan,40.1431,47.5769,823100,0,9942,813158
10/28/22,Azerbaijan,40.1431,47.5769,823149,0,9943,813206
10/29/22,Azerbaijan,40.1431,47.5769,823202,0,9944,813258
10/30/22,Azerbaijan,40.1431,47.5769,823247,0,9944,813303
10/31/22,Azerbaijan,40.1431,47.5769,823258,0,9944,813314
11/1/22,Azerbaijan,40.1431,47.5769,823318,0,9948,813370
11/2/22,Azerbaijan,40.1431,47.5769,823369,0,9951,813418
11/3/22,Azerbaijan,40.1431,47.5769,823418,0,9951,813467
11/4/22,Azerbaijan,40.1431,47.5769,823469,0,9953,813516
11/5/22,Azerbaijan,40.1431,47.5769,823496,0,9955,813541
11/6/22,Azerbaijan,40.1431,47.5769,823533,0,9957,813576
11/7/22,Azerbaijan,40.1431,47.5769,823539,0,9957,813582
11/8/22,Azerbaijan,40.1431,47.5769,823577,0,9957,813620
11/9/22,Azerbaijan,40.1431,47.5769,823584,0,9957,813627
11/10/22,Azerbaijan,40.1431,47.5769,823592,0,9957,813635
11/11/22,Azerbaijan,40.1431,47.5769,823636,0,9959,813677
11/12/22,Azerbaijan,40.1431,47.5769,823688,0,9961,813727
11/13/22,Azerbaijan,40.1431,47.5769,823721,0,9963,813758
11/14/22,Azerbaijan,40.1431,47.5769,823725,0,9964,813761
11/15/22,Azerbaijan,40.1431,47.5769,823761,0,9965,813796
11/16/22,Azerbaijan,40.1431,47.5769,823805,0,9967,813838
11/17/22,Azerbaijan,40.1431,47.5769,823849,0,9968,813881
11/18/22,Azerbaijan,40.1431,47.5769,823889,0,9969,813920
11/19/22,Azerbaijan,40.1431,47.5769,823923,0,9972,813951
11/20/22,Azerbaijan,40.1431,47.5769,823954,0,9972,813982
11/21/22,Azerbaijan,40.1431,47.5769,823975,0,9973,814002
11/22/22,Azerbaijan,40.1431,47.5769,824033,0,9975,814058
11/23/22,Azerbaijan,40.1431,47.5769,824082,0,9975,814107
11/24/22,Azerbaijan,40.1431,47.5769,824127,0,9975,814152
11/25/22,Azerbaijan,40.1431,47.5769,824168,0,9975,814193
11/26/22,Azerbaijan,40.1431,47.5769,824193,0,9976,814217
11/27/22,Azerbaijan,40.1431,47.5769,824232,0,9976,814256
11/28/22,Azerbaijan,40.1431,47.5769,824245,0,9976,814269
11/29/22,Azerbaijan,40.1431,47.5769,824288,0,9978,814310
11/30/22,Azerbaijan,40.1431,47.5769,824337,0,9980,814357
12/1/22,Azerbaijan,40.1431,47.5769,824385,0,9981,814404
12/2/22,Azerbaijan,40.1431,47.5769,824431,0,9983,814448
12/3/22,Azerbaijan,40.1431,47.5769,824452,0,9983,814469
12/4/22,Azerbaijan,40.1431,47.5769,824499,0,9983,814516
12/5/22,Azerbaijan,40.1431,47.5769,824512,0,9983,814529
12/6/22,Azerbaijan,40.1431,47.5769,824574,0,9984,814590
12/7/22,Azerbaijan,40.1431,47.5769,824641,0,9984,814657
12/8/22,Azerbaijan,40.1431,47.5769,824691,0,9984,814707
12/9/22,Azerbaijan,40.1431,47.5769,824749,0,9984,814765
12/10/22,Azerbaijan,40.1431,47.5769,824802,0,9986,814816
12/11/22,Azerbaijan,40.1431,47.5769,824870,0,9986,814884
12/12/22,Azerbaijan,40.1431,47.5769,824879,0,9987,814892
12/13/22,Azerbaijan,40.1431,47.5769,824943,0,9989,814954
12/14/22,Azerbaijan,40.1431,47.5769,825035,0,9989,815046
12/15/22,Azerbaijan,40.1431,47.5769,825150,0,9989,815161
12/16/22,Azerbaijan,40.1431,47.5769,825231,0,9989,815242
12/17/22,Azerbaijan,40.1431,47.5769,825337,0,9993,815344
1/1/22,Bahamas,25.025885,-78.035889,24476,0,717,23759
1/2/22,Bahamas,25.025885,-78.035889,25285,0,717,24568
1/3/22,Bahamas,25.025885,-78.035889,25534,0,717,24817
1/4/22,Bahamas,25.025885,-78.035889,26011,0,717,25294
1/5/22,Bahamas,25.025885,-78.035889,26326,0,717,25609
1/6/22,Bahamas,25.025885,-78.035889,26701,0,717,25984
1/7/22,Bahamas,25.025885,-78.035889,27122,0,717,26405
1/8/22,Bahamas,25.025885,-78.035889,27122,0,717,26405
1/9/22,Bahamas,25.025885,-78.035889,28619,0,717,27902
1/10/22,Bahamas,25.025885,-78.035889,28968,0,717,28251
1/11/22,Bahamas,25.025885,-78.035889,29489,0,717,28772
1/12/22,Bahamas,25.025885,-78.035889,29730,0,717,29013
1/13/22,Bahamas,25.025885,-78.035889,29908,0,719,29189
1/14/22,Bahamas,25.025885,-78.035889,29908,0,719,29189
1/15/22,Bahamas,25.025885,-78.035889,30655,0,719,29936
1/16/22,Bahamas,25.025885,-78.035889,30850,0,719,30131
1/17/22,Bahamas,25.025885,-78.035889,30850,0,719,30131
1/18/22,Bahamas,25.025885,-78.035889,31105,0,719,30386
1/19/22,Bahamas,25.025885,-78.035889,31549,0,719,30830
1/20/22,Bahamas,25.025885,-78.035889,31693,0,726,30967
1/21/22,Bahamas,25.025885,-78.035889,31915,0,726,31189
1/22/22,Bahamas,25.025885,-78.035889,31999,0,729,31270
1/23/22,Bahamas,25.025885,-78.035889,32068,0,729,31339
1/24/22,Bahamas,25.025885,-78.035889,32137,0,729,31408
1/25/22,Bahamas,25.025885,-78.035889,32238,0,731,31507
1/26/22,Bahamas,25.025885,-78.035889,32282,0,731,31551
1/27/22,Bahamas,25.025885,-78.035889,32376,0,735,31641
1/28/22,Bahamas,25.025885,-78.035889,32419,0,739,31680
1/29/22,Bahamas,25.025885,-78.035889,32486,0,745,31741
1/30/22,Bahamas,25.025885,-78.035889,32512,0,746,31766
1/31/22,Bahamas,25.025885,-78.035889,32562,0,746,31816
2/1/22,Bahamas,25.025885,-78.035889,32606,0,746,31860
2/2/22,Bahamas,25.025885,-78.035889,32645,0,748,31897
2/3/22,Bahamas,25.025885,-78.035889,32680,0,748,31932
2/4/22,Bahamas,25.025885,-78.035889,32680,0,748,31932
2/5/22,Bahamas,25.025885,-78.035889,32715,0,749,31966
2/6/22,Bahamas,25.025885,-78.035889,32773,0,753,32020
2/7/22,Bahamas,25.025885,-78.035889,32802,0,753,32049
2/8/22,Bahamas,25.025885,-78.035889,32833,0,753,32080
2/9/22,Bahamas,25.025885,-78.035889,32833,0,753,32080
2/10/22,Bahamas,25.025885,-78.035889,32871,0,756,32115
2/11/22,Bahamas,25.025885,-78.035889,32903,0,757,32146
2/12/22,Bahamas,25.025885,-78.035889,32925,0,757,32168
2/13/22,Bahamas,25.025885,-78.035889,32931,0,766,32165
2/14/22,Bahamas,25.025885,-78.035889,32950,0,766,32184
2/15/22,Bahamas,25.025885,-78.035889,32972,0,766,32206
2/16/22,Bahamas,25.025885,-78.035889,33005,0,768,32237
2/17/22,Bahamas,25.025885,-78.035889,33005,0,768,32237
2/18/22,Bahamas,25.025885,-78.035889,33018,0,768,32250
2/19/22,Bahamas,25.025885,-78.035889,33024,0,768,32256
2/20/22,Bahamas,25.025885,-78.035889,33052,0,770,32282
2/21/22,Bahamas,25.025885,-78.035889,33068,0,770,32298
2/22/22,Bahamas,25.025885,-78.035889,33081,0,770,32311
2/23/22,Bahamas,25.025885,-78.035889,33081,0,770,32311
2/24/22,Bahamas,25.025885,-78.035889,33105,0,771,32334
2/25/22,Bahamas,25.025885,-78.035889,33108,0,771,32337
2/26/22,Bahamas,25.025885,-78.035889,33108,0,771,32337
2/27/22,Bahamas,25.025885,-78.035889,33129,0,771,32358
2/28/22,Bahamas,25.025885,-78.035889,33135,0,771,32364
3/1/22,Bahamas,25.025885,-78.035889,33146,0,771,32375
3/2/22,Bahamas,25.025885,-78.035889,33150,0,771,32379
3/3/22,Bahamas,25.025885,-78.035889,33152,0,771,32381
3/4/22,Bahamas,25.025885,-78.035889,33169,0,771,32398
3/5/22,Bahamas,25.025885,-78.035889,33169,0,771,32398
3/6/22,Bahamas,25.025885,-78.035889,33171,0,771,32400
3/7/22,Bahamas,25.025885,-78.035889,33176,0,771,32405
3/8/22,Bahamas,25.025885,-78.035889,33180,0,771,32409
3/9/22,Bahamas,25.025885,-78.035889,33180,0,771,32409
3/10/22,Bahamas,25.025885,-78.035889,33188,0,771,32417
3/11/22,Bahamas,25.025885,-78.035889,33191,0,771,32420
3/12/22,Bahamas,25.025885,-78.035889,33194,0,771,32423
3/13/22,Bahamas,25.025885,-78.035889,33194,0,771,32423
3/14/22,Bahamas,25.025885,-78.035889,33198,0,773,32425
3/15/22,Bahamas,25.025885,-78.035889,33198,0,773,32425
3/16/22,Bahamas,25.025885,-78.035889,33206,0,773,32433
3/17/22,Bahamas,25.025885,-78.035889,33206,0,773,32433
3/18/22,Bahamas,25.025885,-78.035889,33211,0,777,32434
3/19/22,Bahamas,25.025885,-78.035889,33211,0,777,32434
3/20/22,Bahamas,25.025885,-78.035889,33221,0,787,32434
3/21/22,Bahamas,25.025885,-78.035889,33230,0,787,32443
3/22/22,Bahamas,25.025885,-78.035889,33235,0,787,32448
3/23/22,Bahamas,25.025885,-78.035889,33238,0,787,32451
3/24/22,Bahamas,25.025885,-78.035889,33242,0,787,32455
3/25/22,Bahamas,25.025885,-78.035889,33242,0,788,32454
3/26/22,Bahamas,25.025885,-78.035889,33249,0,788,32461
3/27/22,Bahamas,25.025885,-78.035889,33256,0,788,32468
3/28/22,Bahamas,25.025885,-78.035889,33257,0,788,32469
3/29/22,Bahamas,25.025885,-78.035889,33258,0,788,32470
3/30/22,Bahamas,25.025885,-78.035889,33258,0,788,32470
3/31/22,Bahamas,25.025885,-78.035889,33283,0,788,32495
4/1/22,Bahamas,25.025885,-78.035889,33291,0,788,32503
4/2/22,Bahamas,25.025885,-78.035889,33295,0,788,32507
4/3/22,Bahamas,25.025885,-78.035889,33295,0,788,32507
4/4/22,Bahamas,25.025885,-78.035889,33313,0,788,32525
4/5/22,Bahamas,25.025885,-78.035889,33314,0,788,32526
4/6/22,Bahamas,25.025885,-78.035889,33315,0,788,32527
4/7/22,Bahamas,25.025885,-78.035889,33330,0,788,32542
4/8/22,Bahamas,25.025885,-78.035889,33340,0,789,32551
4/9/22,Bahamas,25.025885,-78.035889,33346,0,789,32557
4/10/22,Bahamas,25.025885,-78.035889,33358,0,789,32569
4/11/22,Bahamas,25.025885,-78.035889,33360,0,789,32571
4/12/22,Bahamas,25.025885,-78.035889,33366,0,789,32577
4/13/22,Bahamas,25.025885,-78.035889,33368,0,789,32579
4/14/22,Bahamas,25.025885,-78.035889,33372,0,789,32583
4/15/22,Bahamas,25.025885,-78.035889,33388,0,789,32599
4/16/22,Bahamas,25.025885,-78.035889,33391,0,789,32602
4/17/22,Bahamas,25.025885,-78.035889,33391,0,789,32602
4/18/22,Bahamas,25.025885,-78.035889,33411,0,789,32622
4/19/22,Bahamas,25.025885,-78.035889,33411,0,789,32622
4/20/22,Bahamas,25.025885,-78.035889,33421,0,789,32632
4/21/22,Bahamas,25.025885,-78.035889,33430,0,789,32641
4/22/22,Bahamas,25.025885,-78.035889,33446,0,789,32657
4/23/22,Bahamas,25.025885,-78.035889,33463,0,789,32674
4/24/22,Bahamas,25.025885,-78.035889,33483,0,789,32694
4/25/22,Bahamas,25.025885,-78.035889,33488,0,789,32699
4/26/22,Bahamas,25.025885,-78.035889,33498,0,789,32709
4/27/22,Bahamas,25.025885,-78.035889,33511,0,789,32722
4/28/22,Bahamas,25.025885,-78.035889,33527,0,789,32738
4/29/22,Bahamas,25.025885,-78.035889,33541,0,789,32752
4/30/22,Bahamas,25.025885,-78.035889,33558,0,798,32760
5/1/22,Bahamas,25.025885,-78.035889,33578,0,798,32780
5/2/22,Bahamas,25.025885,-78.035889,33582,0,798,32784
5/3/22,Bahamas,25.025885,-78.035889,33601,0,798,32803
5/4/22,Bahamas,25.025885,-78.035889,33626,0,798,32828
5/5/22,Bahamas,25.025885,-78.035889,33655,0,798,32857
5/6/22,Bahamas,25.025885,-78.035889,33672,0,798,32874
5/7/22,Bahamas,25.025885,-78.035889,33695,0,798,32897
5/8/22,Bahamas,25.025885,-78.035889,33695,0,798,32897
5/9/22,Bahamas,25.025885,-78.035889,33748,0,798,32950
5/10/22,Bahamas,25.025885,-78.035889,33779,0,798,32981
5/11/22,Bahamas,25.025885,-78.035889,33803,0,798,33005
5/12/22,Bahamas,25.025885,-78.035889,33830,0,800,33030
5/13/22,Bahamas,25.025885,-78.035889,33830,0,800,33030
5/14/22,Bahamas,25.025885,-78.035889,33871,0,801,33070
5/15/22,Bahamas,25.025885,-78.035889,33934,0,801,33133
5/16/22,Bahamas,25.025885,-78.035889,33957,0,801,33156
5/17/22,Bahamas,25.025885,-78.035889,33989,0,801,33188
5/18/22,Bahamas,25.025885,-78.035889,34011,0,801,33210
5/19/22,Bahamas,25.025885,-78.035889,34060,0,810,33250
5/20/22,Bahamas,25.025885,-78.035889,34148,0,810,33338
5/21/22,Bahamas,25.025885,-78.035889,34212,0,810,33402
5/22/22,Bahamas,25.025885,-78.035889,34274,0,810,33464
5/23/22,Bahamas,25.025885,-78.035889,34303,0,810,33493
5/24/22,Bahamas,25.025885,-78.035889,34355,0,810,33545
5/25/22,Bahamas,25.025885,-78.035889,34355,0,810,33545
5/26/22,Bahamas,25.025885,-78.035889,34481,0,810,33671
5/27/22,Bahamas,25.025885,-78.035889,34572,0,810,33762
5/28/22,Bahamas,25.025885,-78.035889,34572,0,810,33762
5/29/22,Bahamas,25.025885,-78.035889,34672,0,810,33862
5/30/22,Bahamas,25.025885,-78.035889,34713,0,810,33903
5/31/22,Bahamas,25.025885,-78.035889,34759,0,810,33949
6/1/22,Bahamas,25.025885,-78.035889,34861,0,810,34051
6/2/22,Bahamas,25.025885,-78.035889,34861,0,810,34051
6/3/22,Bahamas,25.025885,-78.035889,34931,0,810,34121
6/4/22,Bahamas,25.025885,-78.035889,34982,0,810,34172
6/5/22,Bahamas,25.025885,-78.035889,35070,0,810,34260
6/6/22,Bahamas,25.025885,-78.035889,35079,0,810,34269
6/7/22,Bahamas,25.025885,-78.035889,35099,0,811,34288
6/8/22,Bahamas,25.025885,-78.035889,35132,0,811,34321
6/9/22,Bahamas,25.025885,-78.035889,35163,0,811,34352
6/10/22,Bahamas,25.025885,-78.035889,35218,0,812,34406
6/11/22,Bahamas,25.025885,-78.035889,35286,0,812,34474
6/12/22,Bahamas,25.025885,-78.035889,35332,0,812,34520
6/13/22,Bahamas,25.025885,-78.035889,35351,0,812,34539
6/14/22,Bahamas,25.025885,-78.035889,35351,0,812,34539
6/15/22,Bahamas,25.025885,-78.035889,35464,0,815,34649
6/16/22,Bahamas,25.025885,-78.035889,35516,0,815,34701
6/17/22,Bahamas,25.025885,-78.035889,35564,0,815,34749
6/18/22,Bahamas,25.025885,-78.035889,35603,0,815,34788
6/19/22,Bahamas,25.025885,-78.035889,35644,0,815,34829
6/20/22,Bahamas,25.025885,-78.035889,35644,0,815,34829
6/21/22,Bahamas,25.025885,-78.035889,35678,0,815,34863
6/22/22,Bahamas,25.025885,-78.035889,35703,0,816,34887
6/23/22,Bahamas,25.025885,-78.035889,35755,0,816,34939
6/24/22,Bahamas,25.025885,-78.035889,35810,0,816,34994
6/25/22,Bahamas,25.025885,-78.035889,35814,0,816,34998
6/26/22,Bahamas,25.025885,-78.035889,35835,0,817,35018
6/27/22,Bahamas,25.025885,-78.035889,35881,0,817,35064
6/28/22,Bahamas,25.025885,-78.035889,35902,0,817,35085
6/29/22,Bahamas,25.025885,-78.035889,35902,0,817,35085
6/30/22,Bahamas,25.025885,-78.035889,35975,0,817,35158
7/1/22,Bahamas,25.025885,-78.035889,35975,0,817,35158
7/2/22,Bahamas,25.025885,-78.035889,35994,0,818,35176
7/3/22,Bahamas,25.025885,-78.035889,36029,0,818,35211
7/4/22,Bahamas,25.025885,-78.035889,36101,0,820,35281
7/5/22,Bahamas,25.025885,-78.035889,36114,0,820,35294
7/6/22,Bahamas,25.025885,-78.035889,36133,0,821,35312
7/7/22,Bahamas,25.025885,-78.035889,36133,0,821,35312
7/8/22,Bahamas,25.025885,-78.035889,36159,0,822,35337
7/9/22,Bahamas,25.025885,-78.035889,36245,0,822,35423
7/10/22,Bahamas,25.025885,-78.035889,36245,0,822,35423
7/11/22,Bahamas,25.025885,-78.035889,36287,0,822,35465
7/12/22,Bahamas,25.025885,-78.035889,36299,0,822,35477
7/13/22,Bahamas,25.025885,-78.035889,36299,0,822,35477
7/14/22,Bahamas,25.025885,-78.035889,36354,0,822,35532
7/15/22,Bahamas,25.025885,-78.035889,36354,0,822,35532
7/16/22,Bahamas,25.025885,-78.035889,36354,0,822,35532
7/17/22,Bahamas,25.025885,-78.035889,36435,0,822,35613
7/18/22,Bahamas,25.025885,-78.035889,36435,0,822,35613
7/19/22,Bahamas,25.025885,-78.035889,36454,0,822,35632
7/20/22,Bahamas,25.025885,-78.035889,36502,0,822,35680
7/21/22,Bahamas,25.025885,-78.035889,36533,0,822,35711
7/22/22,Bahamas,25.025885,-78.035889,36545,0,822,35723
7/23/22,Bahamas,25.025885,-78.035889,36568,0,822,35746
7/24/22,Bahamas,25.025885,-78.035889,36568,0,822,35746
7/25/22,Bahamas,25.025885,-78.035889,36604,0,822,35782
7/26/22,Bahamas,25.025885,-78.035889,36622,0,822,35800
7/27/22,Bahamas,25.025885,-78.035889,36633,0,822,35811
7/28/22,Bahamas,25.025885,-78.035889,36664,0,822,35842
7/29/22,Bahamas,25.025885,-78.035889,36670,0,822,35848
7/30/22,Bahamas,25.025885,-78.035889,36670,0,822,35848
7/31/22,Bahamas,25.025885,-78.035889,36724,0,822,35902
8/1/22,Bahamas,25.025885,-78.035889,36730,0,822,35908
8/2/22,Bahamas,25.025885,-78.035889,36730,0,822,35908
8/3/22,Bahamas,25.025885,-78.035889,36745,0,822,35923
8/4/22,Bahamas,25.025885,-78.035889,36776,0,822,35954
8/5/22,Bahamas,25.025885,-78.035889,36795,0,822,35973
8/6/22,Bahamas,25.025885,-78.035889,36812,0,822,35990
8/7/22,Bahamas,25.025885,-78.035889,36812,0,822,35990
8/8/22,Bahamas,25.025885,-78.035889,36850,0,822,36028
8/9/22,Bahamas,25.025885,-78.035889,36853,0,822,36031
8/10/22,Bahamas,25.025885,-78.035889,36853,0,822,36031
8/11/22,Bahamas,25.025885,-78.035889,36870,0,822,36048
8/12/22,Bahamas,25.025885,-78.035889,36881,0,822,36059
8/13/22,Bahamas,25.025885,-78.035889,36905,0,823,36082
8/14/22,Bahamas,25.025885,-78.035889,36905,0,823,36082
8/15/22,Bahamas,25.025885,-78.035889,36932,0,823,36109
8/16/22,Bahamas,25.025885,-78.035889,36936,0,823,36113
8/17/22,Bahamas,25.025885,-78.035889,36944,0,823,36121
8/18/22,Bahamas,25.025885,-78.035889,36958,0,823,36135
8/19/22,Bahamas,25.025885,-78.035889,36958,0,823,36135
8/20/22,Bahamas,25.025885,-78.035889,36983,0,823,36160
8/21/22,Bahamas,25.025885,-78.035889,36983,0,823,36160
8/22/22,Bahamas,25.025885,-78.035889,36983,0,823,36160
8/23/22,Bahamas,25.025885,-78.035889,36996,0,823,36173
8/24/22,Bahamas,25.025885,-78.035889,36996,0,823,36173
8/25/22,Bahamas,25.025885,-78.035889,37032,0,823,36209
8/26/22,Bahamas,25.025885,-78.035889,37044,0,823,36221
8/27/22,Bahamas,25.025885,-78.035889,37044,0,823,36221
8/28/22,Bahamas,25.025885,-78.035889,37044,0,823,36221
8/29/22,Bahamas,25.025885,-78.035889,37059,0,823,36236
8/30/22,Bahamas,25.025885,-78.035889,37059,0,823,36236
8/31/22,Bahamas,25.025885,-78.035889,37075,0,823,36252
9/1/22,Bahamas,25.025885,-78.035889,37081,0,823,36258
9/2/22,Bahamas,25.025885,-78.035889,37081,0,823,36258
9/3/22,Bahamas,25.025885,-78.035889,37081,0,823,36258
9/4/22,Bahamas,25.025885,-78.035889,37081,0,823,36258
9/5/22,Bahamas,25.025885,-78.035889,37101,0,823,36278
9/6/22,Bahamas,25.025885,-78.035889,37101,0,823,36278
9/7/22,Bahamas,25.025885,-78.035889,37101,0,823,36278
9/8/22,Bahamas,25.025885,-78.035889,37101,0,823,36278
9/9/22,Bahamas,25.025885,-78.035889,37125,0,823,36302
9/10/22,Bahamas,25.025885,-78.035889,37125,0,823,36302
9/11/22,Bahamas,25.025885,-78.035889,37146,0,823,36323
9/12/22,Bahamas,25.025885,-78.035889,37156,0,823,36333
9/13/22,Bahamas,25.025885,-78.035889,37156,0,823,36333
9/14/22,Bahamas,25.025885,-78.035889,37156,0,823,36333
9/15/22,Bahamas,25.025885,-78.035889,37187,0,833,36354
9/16/22,Bahamas,25.025885,-78.035889,37187,0,833,36354
9/17/22,Bahamas,25.025885,-78.035889,37187,0,833,36354
9/18/22,Bahamas,25.025885,-78.035889,37187,0,833,36354
9/19/22,Bahamas,25.025885,-78.035889,37203,0,833,36370
9/20/22,Bahamas,25.025885,-78.035889,37213,0,833,36380
9/21/22,Bahamas,25.025885,-78.035889,37213,0,833,36380
9/22/22,Bahamas,25.025885,-78.035889,37213,0,833,36380
9/23/22,Bahamas,25.025885,-78.035889,37258,0,833,36425
9/24/22,Bahamas,25.025885,-78.035889,37267,0,833,36434
9/25/22,Bahamas,25.025885,-78.035889,37267,0,833,36434
9/26/22,Bahamas,25.025885,-78.035889,37267,0,833,36434
9/27/22,Bahamas,25.025885,-78.035889,37267,0,833,36434
9/28/22,Bahamas,25.025885,-78.035889,37267,0,833,36434
9/29/22,Bahamas,25.025885,-78.035889,37276,0,833,36443
9/30/22,Bahamas,25.025885,-78.035889,37290,0,833,36457
10/1/22,Bahamas,25.025885,-78.035889,37290,0,833,36457
10/2/22,Bahamas,25.025885,-78.035889,37309,0,833,36476
10/3/22,Bahamas,25.025885,-78.035889,37309,0,833,36476
10/4/22,Bahamas,25.025885,-78.035889,37309,0,833,36476
10/5/22,Bahamas,25.025885,-78.035889,37309,0,833,36476
10/6/22,Bahamas,25.025885,-78.035889,37309,0,833,36476
10/7/22,Bahamas,25.025885,-78.035889,37309,0,833,36476
10/8/22,Bahamas,25.025885,-78.035889,37309,0,833,36476
10/9/22,Bahamas,25.025885,-78.035889,37318,0,833,36485
10/10/22,Bahamas,25.025885,-78.035889,37318,0,833,36485
10/11/22,Bahamas,25.025885,-78.035889,37318,0,833,36485
10/12/22,Bahamas,25.025885,-78.035889,37318,0,833,36485
10/13/22,Bahamas,25.025885,-78.035889,37318,0,833,36485
10/14/22,Bahamas,25.025885,-78.035889,37318,0,833,36485
10/15/22,Bahamas,25.025885,-78.035889,37334,0,833,36501
10/16/22,Bahamas,25.025885,-78.035889,37334,0,833,36501
10/17/22,Bahamas,25.025885,-78.035889,37334,0,833,36501
10/18/22,Bahamas,25.025885,-78.035889,37334,0,833,36501
10/19/22,Bahamas,25.025885,-78.035889,37334,0,833,36501
10/20/22,Bahamas,25.025885,-78.035889,37342,0,833,36509
10/21/22,Bahamas,25.025885,-78.035889,37342,0,833,36509
10/22/22,Bahamas,25.025885,-78.035889,37342,0,833,36509
10/23/22,Bahamas,25.025885,-78.035889,37342,0,833,36509
10/24/22,Bahamas,25.025885,-78.035889,37364,0,833,36531
10/25/22,Bahamas,25.025885,-78.035889,37364,0,833,36531
10/26/22,Bahamas,25.025885,-78.035889,37364,0,833,36531
10/27/22,Bahamas,25.025885,-78.035889,37369,0,833,36536
10/28/22,Bahamas,25.025885,-78.035889,37369,0,833,36536
10/29/22,Bahamas,25.025885,-78.035889,37369,0,833,36536
10/30/22,Bahamas,25.025885,-78.035889,37386,0,833,36553
10/31/22,Bahamas,25.025885,-78.035889,37386,0,833,36553
11/1/22,Bahamas,25.025885,-78.035889,37386,0,833,36553
11/2/22,Bahamas,25.025885,-78.035889,37386,0,833,36553
11/3/22,Bahamas,25.025885,-78.035889,37386,0,833,36553
11/4/22,Bahamas,25.025885,-78.035889,37386,0,833,36553
11/5/22,Bahamas,25.025885,-78.035889,37386,0,833,36553
11/6/22,Bahamas,25.025885,-78.035889,37386,0,833,36553
11/7/22,Bahamas,25.025885,-78.035889,37386,0,833,36553
11/8/22,Bahamas,25.025885,-78.035889,37416,0,833,36583
11/9/22,Bahamas,25.025885,-78.035889,37416,0,833,36583
11/10/22,Bahamas,25.025885,-78.035889,37429,0,833,36596
11/11/22,Bahamas,25.025885,-78.035889,37433,0,833,36600
11/12/22,Bahamas,25.025885,-78.035889,37433,0,833,36600
11/13/22,Bahamas,25.025885,-78.035889,37436,0,833,36603
11/14/22,Bahamas,25.025885,-78.035889,37436,0,833,36603
11/15/22,Bahamas,25.025885,-78.035889,37436,0,833,36603
11/16/22,Bahamas,25.025885,-78.035889,37439,0,833,36606
11/17/22,Bahamas,25.025885,-78.035889,37439,0,833,36606
11/18/22,Bahamas,25.025885,-78.035889,37453,0,833,36620
11/19/22,Bahamas,25.025885,-78.035889,37453,0,833,36620
11/20/22,Bahamas,25.025885,-78.035889,37453,0,833,36620
11/21/22,Bahamas,25.025885,-78.035889,37453,0,833,36620
11/22/22,Bahamas,25.025885,-78.035889,37461,0,833,36628
11/23/22,Bahamas,25.025885,-78.035889,37461,0,833,36628
11/24/22,Bahamas,25.025885,-78.035889,37471,0,833,36638
11/25/22,Bahamas,25.025885,-78.035889,37471,0,833,36638
11/26/22,Bahamas,25.025885,-78.035889,37476,0,833,36643
11/27/22,Bahamas,25.025885,-78.035889,37476,0,833,36643
11/28/22,Bahamas,25.025885,-78.035889,37476,0,833,36643
11/29/22,Bahamas,25.025885,-78.035889,37483,0,833,36650
11/30/22,Bahamas,25.025885,-78.035889,37483,0,833,36650
12/1/22,Bahamas,25.025885,-78.035889,37483,0,833,36650
12/2/22,Bahamas,25.025885,-78.035889,37491,0,833,36658
12/3/22,Bahamas,25.025885,-78.035889,37491,0,833,36658
12/4/22,Bahamas,25.025885,-78.035889,37491,0,833,36658
12/5/22,Bahamas,25.025885,-78.035889,37491,0,833,36658
12/6/22,Bahamas,25.025885,-78.035889,37491,0,833,36658
12/7/22,Bahamas,25.025885,-78.035889,37491,0,833,36658
12/8/22,Bahamas,25.025885,-78.035889,37491,0,833,36658
12/9/22,Bahamas,25.025885,-78.035889,37491,0,833,36658
12/10/22,Bahamas,25.025885,-78.035889,37491,0,833,36658
12/11/22,Bahamas,25.025885,-78.035889,37491,0,833,36658
12/12/22,Bahamas,25.025885,-78.035889,37491,0,833,36658
12/13/22,Bahamas,25.025885,-78.035889,37491,0,833,36658
12/14/22,Bahamas,25.025885,-78.035889,37491,0,833,36658
12/15/22,Bahamas,25.025885,-78.035889,37491,0,833,36658
12/16/22,Bahamas,25.025885,-78.035889,37491,0,833,36658
12/17/22,Bahamas,25.025885,-78.035889,37491,0,833,36658
1/1/22,Bahrain,26.0275,50.55,282677,0,1394,281283
1/2/22,Bahrain,26.0275,50.55,283344,0,1395,281949
1/3/22,Bahrain,26.0275,50.55,284224,0,1395,282829
1/4/22,Bahrain,26.0275,50.55,285448,0,1395,284053
1/5/22,Bahrain,26.0275,50.55,286529,0,1395,285134
1/6/22,Bahrain,26.0275,50.55,287939,0,1395,286544
1/7/22,Bahrain,26.0275,50.55,289454,0,1397,288057
1/8/22,Bahrain,26.0275,50.55,290878,0,1397,289481
1/9/22,Bahrain,26.0275,50.55,292572,0,1397,291175
1/10/22,Bahrain,26.0275,50.55,294466,0,1397,293069
1/11/22,Bahrain,26.0275,50.55,296253,0,1397,294856
1/12/22,Bahrain,26.0275,50.55,298542,0,1397,297145
1/13/22,Bahrain,26.0275,50.55,300631,0,1397,299234
1/14/22,Bahrain,26.0275,50.55,302872,0,1397,301475
1/15/22,Bahrain,26.0275,50.55,305414,0,1398,304016
1/16/22,Bahrain,26.0275,50.55,308008,0,1398,306610
1/17/22,Bahrain,26.0275,50.55,310906,0,1398,309508
1/18/22,Bahrain,26.0275,50.55,313925,0,1398,312527
1/19/22,Bahrain,26.0275,50.55,317380,0,1398,315982
1/20/22,Bahrain,26.0275,50.55,320688,0,1398,319290
1/21/22,Bahrain,26.0275,50.55,324304,0,1398,322906
1/22/22,Bahrain,26.0275,50.55,327466,0,1399,326067
1/23/22,Bahrain,26.0275,50.55,330621,0,1399,329222
1/24/22,Bahrain,26.0275,50.55,334164,0,1399,332765
1/25/22,Bahrain,26.0275,50.55,338524,0,1399,337125
1/26/22,Bahrain,26.0275,50.55,343400,0,1400,342000
1/27/22,Bahrain,26.0275,50.55,348655,0,1402,347253
1/28/22,Bahrain,26.0275,50.55,355314,0,1403,353911
1/29/22,Bahrain,26.0275,50.55,362022,0,1404,360618
1/30/22,Bahrain,26.0275,50.55,368767,0,1407,367360
1/31/22,Bahrain,26.0275,50.55,374575,0,1408,373167
2/1/22,Bahrain,26.0275,50.55,382748,0,1408,381340
2/2/22,Bahrain,26.0275,50.55,390602,0,1409,389193
2/3/22,Bahrain,26.0275,50.55,398665,0,1410,397255
2/4/22,Bahrain,26.0275,50.55,405938,0,1410,404528
2/5/22,Bahrain,26.0275,50.55,413372,0,1411,411961
2/6/22,Bahrain,26.0275,50.55,421081,0,1411,419670
2/7/22,Bahrain,26.0275,50.55,428123,0,1414,426709
2/8/22,Bahrain,26.0275,50.55,435244,0,1416,433828
2/9/22,Bahrain,26.0275,50.55,442062,0,1418,440644
2/10/22,Bahrain,26.0275,50.55,448166,0,1419,446747
2/11/22,Bahrain,26.0275,50.55,453916,0,1421,452495
2/12/22,Bahrain,26.0275,50.55,458539,0,1425,457114
2/13/22,Bahrain,26.0275,50.55,463805,0,1427,462378
2/14/22,Bahrain,26.0275,50.55,468623,0,1427,467196
2/15/22,Bahrain,26.0275,50.55,473462,0,1429,472033
2/16/22,Bahrain,26.0275,50.55,477750,0,1432,476318
2/17/22,Bahrain,26.0275,50.55,481512,0,1433,480079
2/18/22,Bahrain,26.0275,50.55,485163,0,1435,483728
2/19/22,Bahrain,26.0275,50.55,488423,0,1437,486986
2/20/22,Bahrain,26.0275,50.55,492327,0,1437,490890
2/21/22,Bahrain,26.0275,50.55,495212,0,1438,493774
2/22/22,Bahrain,26.0275,50.55,498637,0,1442,497195
2/23/22,Bahrain,26.0275,50.55,501643,0,1444,500199
2/24/22,Bahrain,26.0275,50.55,504375,0,1447,502928
2/25/22,Bahrain,26.0275,50.55,506974,0,1448,505526
2/26/22,Bahrain,26.0275,50.55,509390,0,1450,507940
2/27/22,Bahrain,26.0275,50.55,512306,0,1453,510853
2/28/22,Bahrain,26.0275,50.55,514883,0,1454,513429
3/1/22,Bahrain,26.0275,50.55,517635,0,1455,516180
3/2/22,Bahrain,26.0275,50.55,519584,0,1455,518129
3/3/22,Bahrain,26.0275,50.55,521613,0,1456,520157
3/4/22,Bahrain,26.0275,50.55,523654,0,1458,522196
3/5/22,Bahrain,26.0275,50.55,525171,0,1458,523713
3/6/22,Bahrain,26.0275,50.55,527135,0,1458,525677
3/7/22,Bahrain,26.0275,50.55,528834,0,1459,527375
3/8/22,Bahrain,26.0275,50.55,530730,0,1461,529269
3/9/22,Bahrain,26.0275,50.55,532265,0,1462,530803
3/10/22,Bahrain,26.0275,50.55,533748,0,1462,532286
3/11/22,Bahrain,26.0275,50.55,535065,0,1462,533603
3/12/22,Bahrain,26.0275,50.55,536241,0,1462,534779
3/13/22,Bahrain,26.0275,50.55,537395,0,1463,535932
3/14/22,Bahrain,26.0275,50.55,538794,0,1463,537331
3/15/22,Bahrain,26.0275,50.55,539988,0,1464,538524
3/16/22,Bahrain,26.0275,50.55,541184,0,1464,539720
3/17/22,Bahrain,26.0275,50.55,542305,0,1464,540841
3/18/22,Bahrain,26.0275,50.55,543089,0,1465,541624
3/19/22,Bahrain,26.0275,50.55,543835,0,1465,542370
3/20/22,Bahrain,26.0275,50.55,544851,0,1465,543386
3/21/22,Bahrain,26.0275,50.55,545761,0,1465,544296
3/22/22,Bahrain,26.0275,50.55,546896,0,1466,545430
3/23/22,Bahrain,26.0275,50.55,547951,0,1466,546485
3/24/22,Bahrain,26.0275,50.55,548866,0,1466,547400
3/25/22,Bahrain,26.0275,50.55,549718,0,1468,548250
3/26/22,Bahrain,26.0275,50.55,550362,0,1468,548894
3/27/22,Bahrain,26.0275,50.55,551342,0,1468,549874
3/28/22,Bahrain,26.0275,50.55,552155,0,1469,550686
3/29/22,Bahrain,26.0275,50.55,552890,0,1470,551420
3/30/22,Bahrain,26.0275,50.55,553750,0,1470,552280
3/31/22,Bahrain,26.0275,50.55,554469,0,1471,552998
4/1/22,Bahrain,26.0275,50.55,555003,0,1471,553532
4/2/22,Bahrain,26.0275,50.55,555560,0,1471,554089
4/3/22,Bahrain,26.0275,50.55,556241,0,1471,554770
4/4/22,Bahrain,26.0275,50.55,556763,0,1471,555292
4/5/22,Bahrain,26.0275,50.55,557387,0,1472,555915
4/6/22,Bahrain,26.0275,50.55,558007,0,1472,556535
4/7/22,Bahrain,26.0275,50.55,558609,0,1472,557137
4/8/22,Bahrain,26.0275,50.55,559034,0,1472,557562
4/9/22,Bahrain,26.0275,50.55,559431,0,1472,557959
4/10/22,Bahrain,26.0275,50.55,560023,0,1473,558550
4/11/22,Bahrain,26.0275,50.55,560552,0,1473,559079
4/12/22,Bahrain,26.0275,50.55,561065,0,1473,559592
4/13/22,Bahrain,26.0275,50.55,561525,0,1473,560052
4/14/22,Bahrain,26.0275,50.55,561940,0,1473,560467
4/15/22,Bahrain,26.0275,50.55,562399,0,1473,560926
4/16/22,Bahrain,26.0275,50.55,562759,0,1473,561286
4/17/22,Bahrain,26.0275,50.55,563183,0,1474,561709
4/18/22,Bahrain,26.0275,50.55,563584,0,1474,562110
4/19/22,Bahrain,26.0275,50.55,564176,0,1474,562702
4/20/22,Bahrain,26.0275,50.55,564617,0,1474,563143
4/21/22,Bahrain,26.0275,50.55,565076,0,1475,563601
4/22/22,Bahrain,26.0275,50.55,565464,0,1475,563989
4/23/22,Bahrain,26.0275,50.55,565830,0,1475,564355
4/24/22,Bahrain,26.0275,50.55,566272,0,1475,564797
4/25/22,Bahrain,26.0275,50.55,566679,0,1475,565204
4/26/22,Bahrain,26.0275,50.55,567173,0,1475,565698
4/27/22,Bahrain,26.0275,50.55,567614,0,1475,566139
4/28/22,Bahrain,26.0275,50.55,567988,0,1475,566513
4/29/22,Bahrain,26.0275,50.55,568367,0,1475,566892
4/30/22,Bahrain,26.0275,50.55,568706,0,1475,567231
5/1/22,Bahrain,26.0275,50.55,569091,0,1476,567615
5/2/22,Bahrain,26.0275,50.55,569370,0,1476,567894
5/3/22,Bahrain,26.0275,50.55,569727,0,1476,568251
5/4/22,Bahrain,26.0275,50.55,570103,0,1476,568627
5/5/22,Bahrain,26.0275,50.55,570761,0,1477,569284
5/6/22,Bahrain,26.0275,50.55,571441,0,1477,569964
5/7/22,Bahrain,26.0275,50.55,572082,0,1477,570605
5/8/22,Bahrain,26.0275,50.55,572810,0,1477,571333
5/9/22,Bahrain,26.0275,50.55,573757,0,1477,572280
5/10/22,Bahrain,26.0275,50.55,574401,0,1477,572924
5/11/22,Bahrain,26.0275,50.55,575129,0,1479,573650
5/12/22,Bahrain,26.0275,50.55,575762,0,1479,574283
5/13/22,Bahrain,26.0275,50.55,576395,0,1479,574916
5/14/22,Bahrain,26.0275,50.55,576997,0,1479,575518
5/15/22,Bahrain,26.0275,50.55,577652,0,1479,576173
5/16/22,Bahrain,26.0275,50.55,578255,0,1479,576776
5/17/22,Bahrain,26.0275,50.55,578848,0,1479,577369
5/18/22,Bahrain,26.0275,50.55,579410,0,1480,577930
5/19/22,Bahrain,26.0275,50.55,579932,0,1480,578452
5/20/22,Bahrain,26.0275,50.55,580346,0,1480,578866
5/21/22,Bahrain,26.0275,50.55,580797,0,1480,579317
5/22/22,Bahrain,26.0275,50.55,581371,0,1482,579889
5/23/22,Bahrain,26.0275,50.55,581866,0,1483,580383
5/24/22,Bahrain,26.0275,50.55,582287,0,1484,580803
5/25/22,Bahrain,26.0275,50.55,582694,0,1485,581209
5/26/22,Bahrain,26.0275,50.55,583130,0,1485,581645
5/27/22,Bahrain,26.0275,50.55,583530,0,1486,582044
5/28/22,Bahrain,26.0275,50.55,583984,0,1487,582497
5/29/22,Bahrain,26.0275,50.55,584566,0,1487,583079
5/30/22,Bahrain,26.0275,50.55,585082,0,1488,583594
5/31/22,Bahrain,26.0275,50.55,585665,0,1488,584177
6/1/22,Bahrain,26.0275,50.55,586267,0,1488,584779
6/2/22,Bahrain,26.0275,50.55,586861,0,1488,585373
6/3/22,Bahrain,26.0275,50.55,587456,0,1488,585968
6/4/22,Bahrain,26.0275,50.55,588070,0,1488,586582
6/5/22,Bahrain,26.0275,50.55,588801,0,1488,587313
6/6/22,Bahrain,26.0275,50.55,589809,0,1488,588321
6/7/22,Bahrain,26.0275,50.55,590806,0,1489,589317
6/8/22,Bahrain,26.0275,50.55,591690,0,1489,590201
6/9/22,Bahrain,26.0275,50.55,591690,0,1489,590201
6/10/22,Bahrain,26.0275,50.55,593654,0,1489,592165
6/11/22,Bahrain,26.0275,50.55,594621,0,1489,593132
6/12/22,Bahrain,26.0275,50.55,595787,0,1489,594298
6/13/22,Bahrain,26.0275,50.55,597184,0,1489,595695
6/14/22,Bahrain,26.0275,50.55,598552,0,1490,597062
6/15/22,Bahrain,26.0275,50.55,599924,0,1490,598434
6/16/22,Bahrain,26.0275,50.55,601322,0,1491,599831
6/17/22,Bahrain,26.0275,50.55,602465,0,1491,600974
6/18/22,Bahrain,26.0275,50.55,603848,0,1491,602357
6/19/22,Bahrain,26.0275,50.55,605756,0,1491,604265
6/20/22,Bahrain,26.0275,50.55,607475,0,1491,605984
6/21/22,Bahrain,26.0275,50.55,609553,0,1491,608062
6/22/22,Bahrain,26.0275,50.55,611632,0,1492,610140
6/23/22,Bahrain,26.0275,50.55,613386,0,1492,611894
6/24/22,Bahrain,26.0275,50.55,615125,0,1492,613633
6/25/22,Bahrain,26.0275,50.55,616588,0,1492,615096
6/26/22,Bahrain,26.0275,50.55,618498,0,1492,617006
6/27/22,Bahrain,26.0275,50.55,620427,0,1492,618935
6/28/22,Bahrain,26.0275,50.55,622261,0,1492,620769
6/29/22,Bahrain,26.0275,50.55,624269,0,1492,622777
6/30/22,Bahrain,26.0275,50.55,625856,0,1492,624364
7/1/22,Bahrain,26.0275,50.55,627327,0,1493,625834
7/2/22,Bahrain,26.0275,50.55,628743,0,1494,627249
7/3/22,Bahrain,26.0275,50.55,630059,0,1494,628565
7/4/22,Bahrain,26.0275,50.55,631562,0,1495,630067
7/5/22,Bahrain,26.0275,50.55,633348,0,1498,631850
7/6/22,Bahrain,26.0275,50.55,634927,0,1498,633429
7/7/22,Bahrain,26.0275,50.55,636294,0,1498,634796
7/8/22,Bahrain,26.0275,50.55,637542,0,1498,636044
7/9/22,Bahrain,26.0275,50.55,638522,0,1498,637024
7/10/22,Bahrain,26.0275,50.55,639455,0,1498,637957
7/11/22,Bahrain,26.0275,50.55,640656,0,1500,639156
7/12/22,Bahrain,26.0275,50.55,641978,0,1503,640475
7/13/22,Bahrain,26.0275,50.55,643672,0,1503,642169
7/14/22,Bahrain,26.0275,50.55,645399,0,1503,643896
7/15/22,Bahrain,26.0275,50.55,646695,0,1505,645190
7/16/22,Bahrain,26.0275,50.55,647935,0,1505,646430
7/17/22,Bahrain,26.0275,50.55,649401,0,1506,647895
7/18/22,Bahrain,26.0275,50.55,650625,0,1506,649119
7/19/22,Bahrain,26.0275,50.55,651514,0,1506,650008
7/20/22,Bahrain,26.0275,50.55,652527,0,1506,651021
7/21/22,Bahrain,26.0275,50.55,653447,0,1506,651941
7/22/22,Bahrain,26.0275,50.55,654221,0,1506,652715
7/23/22,Bahrain,26.0275,50.55,654873,0,1506,653367
7/24/22,Bahrain,26.0275,50.55,655649,0,1506,654143
7/25/22,Bahrain,26.0275,50.55,656410,0,1506,654904
7/26/22,Bahrain,26.0275,50.55,657047,0,1507,655540
7/27/22,Bahrain,26.0275,50.55,657669,0,1509,656160
7/28/22,Bahrain,26.0275,50.55,658238,0,1509,656729
7/29/22,Bahrain,26.0275,50.55,658727,0,1509,657218
7/30/22,Bahrain,26.0275,50.55,659224,0,1509,657715
7/31/22,Bahrain,26.0275,50.55,659647,0,1509,658138
8/1/22,Bahrain,26.0275,50.55,660152,0,1509,658643
8/2/22,Bahrain,26.0275,50.55,660640,0,1510,659130
8/3/22,Bahrain,26.0275,50.55,661116,0,1511,659605
8/4/22,Bahrain,26.0275,50.55,661570,0,1511,660059
8/5/22,Bahrain,26.0275,50.55,661974,0,1511,660463
8/6/22,Bahrain,26.0275,50.55,662406,0,1511,660895
8/7/22,Bahrain,26.0275,50.55,662814,0,1511,661303
8/8/22,Bahrain,26.0275,50.55,663257,0,1512,661745
8/9/22,Bahrain,26.0275,50.55,663763,0,1512,662251
8/10/22,Bahrain,26.0275,50.55,664388,0,1512,662876
8/11/22,Bahrain,26.0275,50.55,665092,0,1512,663580
8/12/22,Bahrain,26.0275,50.55,665792,0,1512,664280
8/13/22,Bahrain,26.0275,50.55,666373,0,1512,664861
8/14/22,Bahrain,26.0275,50.55,666939,0,1513,665426
8/15/22,Bahrain,26.0275,50.55,667573,0,1513,666060
8/16/22,Bahrain,26.0275,50.55,668047,0,1513,666534
8/17/22,Bahrain,26.0275,50.55,668499,0,1513,666986
8/18/22,Bahrain,26.0275,50.55,668846,0,1513,667333
8/19/22,Bahrain,26.0275,50.55,669147,0,1513,667634
8/20/22,Bahrain,26.0275,50.55,669392,0,1513,667879
8/21/22,Bahrain,26.0275,50.55,669650,0,1513,668137
8/22/22,Bahrain,26.0275,50.55,669937,0,1513,668424
8/23/22,Bahrain,26.0275,50.55,670176,0,1513,668663
8/24/22,Bahrain,26.0275,50.55,670420,0,1513,668907
8/25/22,Bahrain,26.0275,50.55,670577,0,1513,669064
8/26/22,Bahrain,26.0275,50.55,670717,0,1513,669204
8/27/22,Bahrain,26.0275,50.55,670854,0,1513,669341
8/28/22,Bahrain,26.0275,50.55,671055,0,1514,669541
8/29/22,Bahrain,26.0275,50.55,671252,0,1514,669738
8/30/22,Bahrain,26.0275,50.55,671484,0,1515,669969
8/31/22,Bahrain,26.0275,50.55,671697,0,1515,670182
9/1/22,Bahrain,26.0275,50.55,671920,0,1515,670405
9/2/22,Bahrain,26.0275,50.55,672074,0,1515,670559
9/3/22,Bahrain,26.0275,50.55,672245,0,1515,670730
9/4/22,Bahrain,26.0275,50.55,672447,0,1515,670932
9/5/22,Bahrain,26.0275,50.55,672636,0,1515,671121
9/6/22,Bahrain,26.0275,50.55,672859,0,1515,671344
9/7/22,Bahrain,26.0275,50.55,673066,0,1516,671550
9/8/22,Bahrain,26.0275,50.55,673314,0,1518,671796
9/9/22,Bahrain,26.0275,50.55,673498,0,1518,671980
9/10/22,Bahrain,26.0275,50.55,673693,0,1518,672175
9/11/22,Bahrain,26.0275,50.55,673996,0,1518,672478
9/12/22,Bahrain,26.0275,50.55,674303,0,1518,672785
9/13/22,Bahrain,26.0275,50.55,674621,0,1518,673103
9/14/22,Bahrain,26.0275,50.55,674909,0,1518,673391
9/15/22,Bahrain,26.0275,50.55,675205,0,1518,673687
9/16/22,Bahrain,26.0275,50.55,675460,0,1519,673941
9/17/22,Bahrain,26.0275,50.55,675741,0,1520,674221
9/18/22,Bahrain,26.0275,50.55,676094,0,1520,674574
9/19/22,Bahrain,26.0275,50.55,676451,0,1520,674931
9/20/22,Bahrain,26.0275,50.55,676846,0,1520,675326
9/21/22,Bahrain,26.0275,50.55,677242,0,1520,675722
9/22/22,Bahrain,26.0275,50.55,677667,0,1520,676147
9/23/22,Bahrain,26.0275,50.55,677961,0,1520,676441
9/24/22,Bahrain,26.0275,50.55,678280,0,1520,676760
9/25/22,Bahrain,26.0275,50.55,678703,0,1520,677183
9/26/22,Bahrain,26.0275,50.55,679151,0,1520,677631
9/27/22,Bahrain,26.0275,50.55,679560,0,1520,678040
9/28/22,Bahrain,26.0275,50.55,679912,0,1520,678392
9/29/22,Bahrain,26.0275,50.55,680271,0,1520,678751
9/30/22,Bahrain,26.0275,50.55,680559,0,1520,679039
10/1/22,Bahrain,26.0275,50.55,680805,0,1520,679285
10/2/22,Bahrain,26.0275,50.55,681210,0,1520,679690
10/3/22,Bahrain,26.0275,50.55,681675,0,1520,680155
10/4/22,Bahrain,26.0275,50.55,682114,0,1520,680594
10/5/22,Bahrain,26.0275,50.55,682470,0,1520,680950
10/6/22,Bahrain,26.0275,50.55,682816,0,1520,681296
10/7/22,Bahrain,26.0275,50.55,683047,0,1520,681527
10/8/22,Bahrain,26.0275,50.55,683242,0,1520,681722
10/9/22,Bahrain,26.0275,50.55,683482,0,1520,681962
10/10/22,Bahrain,26.0275,50.55,683773,0,1521,682252
10/11/22,Bahrain,26.0275,50.55,684229,0,1521,682708
10/12/22,Bahrain,26.0275,50.55,684545,0,1521,683024
10/13/22,Bahrain,26.0275,50.55,684832,0,1521,683311
10/14/22,Bahrain,26.0275,50.55,685067,0,1521,683546
10/15/22,Bahrain,26.0275,50.55,685269,0,1523,683746
10/16/22,Bahrain,26.0275,50.55,685602,0,1523,684079
10/17/22,Bahrain,26.0275,50.55,685969,0,1523,684446
10/18/22,Bahrain,26.0275,50.55,686317,0,1523,684794
10/19/22,Bahrain,26.0275,50.55,686629,0,1523,685106
10/20/22,Bahrain,26.0275,50.55,686932,0,1523,685409
10/21/22,Bahrain,26.0275,50.55,687146,0,1524,685622
10/22/22,Bahrain,26.0275,50.55,687353,0,1524,685829
10/23/22,Bahrain,26.0275,50.55,687591,0,1524,686067
10/24/22,Bahrain,26.0275,50.55,688044,0,1524,686520
10/25/22,Bahrain,26.0275,50.55,688359,0,1524,686835
10/26/22,Bahrain,26.0275,50.55,688646,0,1524,687122
10/27/22,Bahrain,26.0275,50.55,689013,0,1524,687489
10/28/22,Bahrain,26.0275,50.55,689256,0,1527,687729
10/29/22,Bahrain,26.0275,50.55,689480,0,1527,687953
10/30/22,Bahrain,26.0275,50.55,689820,0,1527,688293
10/31/22,Bahrain,26.0275,50.55,690187,0,1528,688659
11/1/22,Bahrain,26.0275,50.55,690401,0,1529,688872
11/2/22,Bahrain,26.0275,50.55,690760,0,1529,689231
11/3/22,Bahrain,26.0275,50.55,691074,0,1529,689545
11/4/22,Bahrain,26.0275,50.55,691300,0,1529,689771
11/5/22,Bahrain,26.0275,50.55,691509,0,1529,689980
11/6/22,Bahrain,26.0275,50.55,691760,0,1529,690231
11/7/22,Bahrain,26.0275,50.55,692129,0,1529,690600
11/8/22,Bahrain,26.0275,50.55,692378,0,1529,690849
11/9/22,Bahrain,26.0275,50.55,692639,0,1530,691109
11/10/22,Bahrain,26.0275,50.55,692885,0,1531,691354
11/11/22,Bahrain,26.0275,50.55,693082,0,1531,691551
11/12/22,Bahrain,26.0275,50.55,693261,0,1531,691730
11/13/22,Bahrain,26.0275,50.55,693492,0,1532,691960
11/14/22,Bahrain,26.0275,50.55,693725,0,1532,692193
11/15/22,Bahrain,26.0275,50.55,694021,0,1532,692489
11/16/22,Bahrain,26.0275,50.55,694223,0,1532,692691
11/17/22,Bahrain,26.0275,50.55,694464,0,1532,692932
11/18/22,Bahrain,26.0275,50.55,694602,0,1532,693070
11/19/22,Bahrain,26.0275,50.55,694740,0,1533,693207
11/20/22,Bahrain,26.0275,50.55,694955,0,1534,693421
11/21/22,Bahrain,26.0275,50.55,695133,0,1534,693599
11/22/22,Bahrain,26.0275,50.55,695279,0,1535,693744
11/23/22,Bahrain,26.0275,50.55,695448,0,1535,693913
11/24/22,Bahrain,26.0275,50.55,695584,0,1535,694049
11/25/22,Bahrain,26.0275,50.55,695676,0,1535,694141
11/26/22,Bahrain,26.0275,50.55,695766,0,1536,694230
11/27/22,Bahrain,26.0275,50.55,695914,0,1536,694378
11/28/22,Bahrain,26.0275,50.55,696061,0,1536,694525
11/29/22,Bahrain,26.0275,50.55,696198,0,1536,694662
11/30/22,Bahrain,26.0275,50.55,696332,0,1536,694796
12/1/22,Bahrain,26.0275,50.55,696451,0,1536,694915
12/2/22,Bahrain,26.0275,50.55,696524,0,1536,694988
12/3/22,Bahrain,26.0275,50.55,696622,0,1536,695086
12/4/22,Bahrain,26.0275,50.55,696723,0,1536,695187
12/5/22,Bahrain,26.0275,50.55,696851,0,1536,695315
12/6/22,Bahrain,26.0275,50.55,696851,0,1536,695315
12/7/22,Bahrain,26.0275,50.55,696851,0,1536,695315
12/8/22,Bahrain,26.0275,50.55,696958,0,1536,695422
12/9/22,Bahrain,26.0275,50.55,697223,0,1536,695687
12/10/22,Bahrain,26.0275,50.55,697267,0,1536,695731
12/11/22,Bahrain,26.0275,50.55,697387,0,1536,695851
12/12/22,Bahrain,26.0275,50.55,697461,0,1536,695925
12/13/22,Bahrain,26.0275,50.55,697520,0,1537,695983
12/14/22,Bahrain,26.0275,50.55,697618,0,1538,696080
12/15/22,Bahrain,26.0275,50.55,697697,0,1538,696159
12/16/22,Bahrain,26.0275,50.55,697713,0,1539,696174
12/17/22,Bahrain,26.0275,50.55,697758,0,1539,696219
1/1/22,Bangladesh,23.685,90.3563,1585909,0,28076,1557833
1/2/22,Bangladesh,23.685,90.3563,1586466,0,28077,1558389
1/3/22,Bangladesh,23.685,90.3563,1587140,0,28081,1559059
1/4/22,Bangladesh,23.685,90.3563,1587915,0,28087,1559828
1/5/22,Bangladesh,23.685,90.3563,1588807,0,28090,1560717
1/6/22,Bangladesh,23.685,90.3563,1589947,0,28097,1561850
1/7/22,Bangladesh,23.685,90.3563,1591093,0,28098,1562995
1/8/22,Bangladesh,23.685,90.3563,1592209,0,28099,1564110
1/9/22,Bangladesh,23.685,90.3563,1593700,0,28102,1565598
1/10/22,Bangladesh,23.685,90.3563,1595931,0,28105,1567826
1/11/22,Bangladesh,23.685,90.3563,1598389,0,28107,1570282
1/12/22,Bangladesh,23.685,90.3563,1601305,0,28111,1573194
1/13/22,Bangladesh,23.685,90.3563,1604664,0,28123,1576541
1/14/22,Bangladesh,23.685,90.3563,1609042,0,28129,1580913
1/15/22,Bangladesh,23.685,90.3563,1612489,0,28136,1584353
1/16/22,Bangladesh,23.685,90.3563,1617711,0,28144,1589567
1/17/22,Bangladesh,23.685,90.3563,1624387,0,28154,1596233
1/18/22,Bangladesh,23.685,90.3563,1632794,0,28164,1604630
1/19/22,Bangladesh,23.685,90.3563,1642294,0,28176,1614118
1/20/22,Bangladesh,23.685,90.3563,1653182,0,28180,1625002
1/21/22,Bangladesh,23.685,90.3563,1664616,0,28192,1636424
1/22/22,Bangladesh,23.685,90.3563,1674230,0,28209,1646021
1/23/22,Bangladesh,23.685,90.3563,1685136,0,28223,1656913
1/24/22,Bangladesh,23.685,90.3563,1699964,0,28238,1671726
1/25/22,Bangladesh,23.685,90.3563,1715997,0,28256,1687741
1/26/22,Bangladesh,23.685,90.3563,1731524,0,28273,1703251
1/27/22,Bangladesh,23.685,90.3563,1747331,0,28288,1719043
1/28/22,Bangladesh,23.685,90.3563,1762771,0,28308,1734463
1/29/22,Bangladesh,23.685,90.3563,1773149,0,28329,1744820
1/30/22,Bangladesh,23.685,90.3563,1785332,0,28363,1756969
1/31/22,Bangladesh,23.685,90.3563,1798833,0,28394,1770439
2/1/22,Bangladesh,23.685,90.3563,1811987,0,28425,1783562
2/2/22,Bangladesh,23.685,90.3563,1824180,0,28461,1795719
2/3/22,Bangladesh,23.685,90.3563,1835776,0,28494,1807282
2/4/22,Bangladesh,23.685,90.3563,1844828,0,28524,1816304
2/5/22,Bangladesh,23.685,90.3563,1853187,0,28560,1824627
2/6/22,Bangladesh,23.685,90.3563,1861532,0,28589,1832943
2/7/22,Bangladesh,23.685,90.3563,1870901,0,28627,1842274
2/8/22,Bangladesh,23.685,90.3563,1879255,0,28670,1850585
2/9/22,Bangladesh,23.685,90.3563,1887271,0,28703,1858568
2/10/22,Bangladesh,23.685,90.3563,1894535,0,28744,1865791
2/11/22,Bangladesh,23.685,90.3563,1899803,0,28771,1871032
2/12/22,Bangladesh,23.685,90.3563,1904826,0,28791,1876035
2/13/22,Bangladesh,23.685,90.3563,1909664,0,28819,1880845
2/14/22,Bangladesh,23.685,90.3563,1914356,0,28838,1885518
2/15/22,Bangladesh,23.685,90.3563,1919102,0,28872,1890230
2/16/22,Bangladesh,23.685,90.3563,1923031,0,28887,1894144
2/17/22,Bangladesh,23.685,90.3563,1926570,0,28907,1897663
2/18/22,Bangladesh,23.685,90.3563,1929154,0,28931,1900223
2/19/22,Bangladesh,23.685,90.3563,1931304,0,28944,1902360
2/20/22,Bangladesh,23.685,90.3563,1933291,0,28965,1904326
2/21/22,Bangladesh,23.685,90.3563,1935242,0,28974,1906268
2/22/22,Bangladesh,23.685,90.3563,1936837,0,28990,1907847
2/23/22,Bangladesh,23.685,90.3563,1938135,0,28995,1909140
2/24/22,Bangladesh,23.685,90.3563,1939651,0,29005,1910646
2/25/22,Bangladesh,23.685,90.3563,1941057,0,29016,1912041
2/26/22,Bangladesh,23.685,90.3563,1941816,0,29024,1912792
2/27/22,Bangladesh,23.685,90.3563,1942680,0,29033,1913647
2/28/22,Bangladesh,23.685,90.3563,1943577,0,29037,1914540
3/1/22,Bangladesh,23.685,90.3563,1944376,0,29045,1915331
3/2/22,Bangladesh,23.685,90.3563,1945108,0,29053,1916055
3/3/22,Bangladesh,23.685,90.3563,1945765,0,29058,1916707
3/4/22,Bangladesh,23.685,90.3563,1946369,0,29064,1917305
3/5/22,Bangladesh,23.685,90.3563,1946737,0,29077,1917660
3/6/22,Bangladesh,23.685,90.3563,1947266,0,29085,1918181
3/7/22,Bangladesh,23.685,90.3563,1947702,0,29089,1918613
3/8/22,Bangladesh,23.685,90.3563,1948148,0,29096,1919052
3/9/22,Bangladesh,23.685,90.3563,1948471,0,29097,1919374
3/10/22,Bangladesh,23.685,90.3563,1948798,0,29100,1919698
3/11/22,Bangladesh,23.685,90.3563,1949055,0,29105,1919950
3/12/22,Bangladesh,23.685,90.3563,1949253,0,29108,1920145
3/13/22,Bangladesh,23.685,90.3563,1949486,0,29111,1920375
3/14/22,Bangladesh,23.685,90.3563,1949725,0,29112,1920613
3/15/22,Bangladesh,23.685,90.3563,1949942,0,29112,1920830
3/16/22,Bangladesh,23.685,90.3563,1950124,0,29112,1921012
3/17/22,Bangladesh,23.685,90.3563,1950357,0,29112,1921245
3/18/22,Bangladesh,23.685,90.3563,1950465,0,29114,1921351
3/19/22,Bangladesh,23.685,90.3563,1950527,0,29114,1921413
3/20/22,Bangladesh,23.685,90.3563,1950609,0,29117,1921492
3/21/22,Bangladesh,23.685,90.3563,1950725,0,29117,1921608
3/22/22,Bangladesh,23.685,90.3563,1950846,0,29117,1921729
3/23/22,Bangladesh,23.685,90.3563,1950980,0,29118,1921862
3/24/22,Bangladesh,23.685,90.3563,1951072,0,29118,1921954
3/25/22,Bangladesh,23.685,90.3563,1951174,0,29118,1922056
3/26/22,Bangladesh,23.685,90.3563,1951239,0,29118,1922121
3/27/22,Bangladesh,23.685,90.3563,1951282,0,29118,1922164
3/28/22,Bangladesh,23.685,90.3563,1951363,0,29119,1922244
3/29/22,Bangladesh,23.685,90.3563,1951432,0,29120,1922312
3/30/22,Bangladesh,23.685,90.3563,1951504,0,29122,1922382
3/31/22,Bangladesh,23.685,90.3563,1951577,0,29122,1922455
4/1/22,Bangladesh,23.685,90.3563,1951658,0,29122,1922536
4/2/22,Bangladesh,23.685,90.3563,1951714,0,29122,1922592
4/3/22,Bangladesh,23.685,90.3563,1951770,0,29122,1922648
4/4/22,Bangladesh,23.685,90.3563,1951831,0,29123,1922708
4/5/22,Bangladesh,23.685,90.3563,1951867,0,29123,1922744
4/6/22,Bangladesh,23.685,90.3563,1951903,0,29123,1922780
4/7/22,Bangladesh,23.685,90.3563,1951947,0,29123,1922824
4/8/22,Bangladesh,23.685,90.3563,1951995,0,29123,1922872
4/9/22,Bangladesh,23.685,90.3563,1952023,0,29123,1922900
4/10/22,Bangladesh,23.685,90.3563,1952065,0,29123,1922942
4/11/22,Bangladesh,23.685,90.3563,1952109,0,29124,1922985
4/12/22,Bangladesh,23.685,90.3563,1952131,0,29124,1923007
4/13/22,Bangladesh,23.685,90.3563,1952162,0,29124,1923038
4/14/22,Bangladesh,23.685,90.3563,1952197,0,29124,1923073
4/15/22,Bangladesh,23.685,90.3563,1952224,0,29124,1923100
4/16/22,Bangladesh,23.685,90.3563,1952275,0,29124,1923151
4/17/22,Bangladesh,23.685,90.3563,1952326,0,29124,1923202
4/18/22,Bangladesh,23.685,90.3563,1952362,0,29126,1923236
4/19/22,Bangladesh,23.685,90.3563,1952412,0,29126,1923286
4/20/22,Bangladesh,23.685,90.3563,1952440,0,29127,1923313
4/21/22,Bangladesh,23.685,90.3563,1952485,0,29127,1923358
4/22/22,Bangladesh,23.685,90.3563,1952506,0,29127,1923379
4/23/22,Bangladesh,23.685,90.3563,1952532,0,29127,1923405
4/24/22,Bangladesh,23.685,90.3563,1952556,0,29127,1923429
4/25/22,Bangladesh,23.685,90.3563,1952583,0,29127,1923456
4/26/22,Bangladesh,23.685,90.3563,1952602,0,29127,1923475
4/27/22,Bangladesh,23.685,90.3563,1952625,0,29127,1923498
4/28/22,Bangladesh,23.685,90.3563,1952644,0,29127,1923517
4/29/22,Bangladesh,23.685,90.3563,1952674,0,29127,1923547
4/30/22,Bangladesh,23.685,90.3563,1952691,0,29127,1923564
5/1/22,Bangladesh,23.685,90.3563,1952716,0,29127,1923589
5/2/22,Bangladesh,23.685,90.3563,1952726,0,29127,1923599
5/3/22,Bangladesh,23.685,90.3563,1952733,0,29127,1923606
5/4/22,Bangladesh,23.685,90.3563,1952743,0,29127,1923616
5/5/22,Bangladesh,23.685,90.3563,1952747,0,29127,1923620
5/6/22,Bangladesh,23.685,90.3563,1952766,0,29127,1923639
5/7/22,Bangladesh,23.685,90.3563,1952776,0,29127,1923649
5/8/22,Bangladesh,23.685,90.3563,1952799,0,29127,1923672
5/9/22,Bangladesh,23.685,90.3563,1952829,0,29127,1923702
5/10/22,Bangladesh,23.685,90.3563,1952855,0,29127,1923728
5/11/22,Bangladesh,23.685,90.3563,1952888,0,29127,1923761
5/12/22,Bangladesh,23.685,90.3563,1952939,0,29127,1923812
5/13/22,Bangladesh,23.685,90.3563,1952957,0,29127,1923830
5/14/22,Bangladesh,23.685,90.3563,1952979,0,29127,1923852
5/15/22,Bangladesh,23.685,90.3563,1953012,0,29127,1923885
5/16/22,Bangladesh,23.685,90.3563,1953049,0,29127,1923922
5/17/22,Bangladesh,23.685,90.3563,1953081,0,29127,1923954
5/18/22,Bangladesh,23.685,90.3563,1953103,0,29127,1923976
5/19/22,Bangladesh,23.685,90.3563,1953138,0,29127,1924011
5/20/22,Bangladesh,23.685,90.3563,1953188,0,29127,1924061
5/21/22,Bangladesh,23.685,90.3563,1953204,0,29128,1924076
5/22/22,Bangladesh,23.685,90.3563,1953233,0,29128,1924105
5/23/22,Bangladesh,23.685,90.3563,1953264,0,29130,1924134
5/24/22,Bangladesh,23.685,90.3563,1953298,0,29130,1924168
5/25/22,Bangladesh,23.685,90.3563,1953328,0,29130,1924198
5/26/22,Bangladesh,23.685,90.3563,1953356,0,29130,1924226
5/27/22,Bangladesh,23.685,90.3563,1953379,0,29130,1924249
5/28/22,Bangladesh,23.685,90.3563,1953407,0,29130,1924277
5/29/22,Bangladesh,23.685,90.3563,1953447,0,29130,1924317
5/30/22,Bangladesh,23.685,90.3563,1953481,0,29131,1924350
5/31/22,Bangladesh,23.685,90.3563,1953507,0,29131,1924376
6/1/22,Bangladesh,23.685,90.3563,1953541,0,29131,1924410
6/2/22,Bangladesh,23.685,90.3563,1953563,0,29131,1924432
6/3/22,Bangladesh,23.685,90.3563,1953592,0,29131,1924461
6/4/22,Bangladesh,23.685,90.3563,1953623,0,29131,1924492
6/5/22,Bangladesh,23.685,90.3563,1953657,0,29131,1924526
6/6/22,Bangladesh,23.685,90.3563,1953700,0,29131,1924569
6/7/22,Bangladesh,23.685,90.3563,1953754,0,29131,1924623
6/8/22,Bangladesh,23.685,90.3563,1953812,0,29131,1924681
6/9/22,Bangladesh,23.685,90.3563,1953871,0,29131,1924740
6/10/22,Bangladesh,23.685,90.3563,1953935,0,29131,1924804
6/11/22,Bangladesh,23.685,90.3563,1954006,0,29131,1924875
6/12/22,Bangladesh,23.685,90.3563,1954115,0,29131,1924984
6/13/22,Bangladesh,23.685,90.3563,1954243,0,29131,1925112
6/14/22,Bangladesh,23.685,90.3563,1954405,0,29131,1925274
6/15/22,Bangladesh,23.685,90.3563,1954637,0,29131,1925506
6/16/22,Bangladesh,23.685,90.3563,1954994,0,29131,1925863
6/17/22,Bangladesh,23.685,90.3563,1955427,0,29131,1926296
6/18/22,Bangladesh,23.685,90.3563,1955731,0,29131,1926600
6/19/22,Bangladesh,23.685,90.3563,1956327,0,29131,1927196
6/20/22,Bangladesh,23.685,90.3563,1957200,0,29131,1928069
6/21/22,Bangladesh,23.685,90.3563,1958074,0,29133,1928941
6/22/22,Bangladesh,23.685,90.3563,1959209,0,29134,1930075
6/23/22,Bangladesh,23.685,90.3563,1960528,0,29135,1931393
6/24/22,Bangladesh,23.685,90.3563,1962213,0,29135,1933078
6/25/22,Bangladesh,23.685,90.3563,1963493,0,29138,1934355
6/26/22,Bangladesh,23.685,90.3563,1965173,0,29140,1936033
6/27/22,Bangladesh,23.685,90.3563,1967274,0,29142,1938132
6/28/22,Bangladesh,23.685,90.3563,1969361,0,29145,1940216
6/29/22,Bangladesh,23.685,90.3563,1971602,0,29145,1942457
6/30/22,Bangladesh,23.685,90.3563,1973789,0,29149,1944640
7/1/22,Bangladesh,23.685,90.3563,1975682,0,29154,1946528
7/2/22,Bangladesh,23.685,90.3563,1976787,0,29160,1947627
7/3/22,Bangladesh,23.685,90.3563,1978689,0,29162,1949527
7/4/22,Bangladesh,23.685,90.3563,1980974,0,29174,1951800
7/5/22,Bangladesh,23.685,90.3563,1982972,0,29181,1953791
7/6/22,Bangladesh,23.685,90.3563,1984700,0,29185,1955515
7/7/22,Bangladesh,23.685,90.3563,1986490,0,29188,1957302
7/8/22,Bangladesh,23.685,90.3563,1988101,0,29195,1958906
7/9/22,Bangladesh,23.685,90.3563,1989040,0,29198,1959842
7/10/22,Bangladesh,23.685,90.3563,1989854,0,29200,1960654
7/11/22,Bangladesh,23.685,90.3563,1990375,0,29203,1961172
7/12/22,Bangladesh,23.685,90.3563,1991031,0,29212,1961819
7/13/22,Bangladesh,23.685,90.3563,1992058,0,29217,1962841
7/14/22,Bangladesh,23.685,90.3563,1993382,0,29223,1964159
7/15/22,Bangladesh,23.685,90.3563,1994433,0,29225,1965208
7/16/22,Bangladesh,23.685,90.3563,1995440,0,29230,1966210
7/17/22,Bangladesh,23.685,90.3563,1996340,0,29234,1967106
7/18/22,Bangladesh,23.685,90.3563,1997412,0,29241,1968171
7/19/22,Bangladesh,23.685,90.3563,1998291,0,29249,1969042
7/20/22,Bangladesh,23.685,90.3563,1999395,0,29250,1970145
7/21/22,Bangladesh,23.685,90.3563,2000279,0,29256,1971023
7/22/22,Bangladesh,23.685,90.3563,2000899,0,29258,1971641
7/23/22,Bangladesh,23.685,90.3563,2001345,0,29262,1972083
7/24/22,Bangladesh,23.685,90.3563,2001775,0,29266,1972509
7/25/22,Bangladesh,23.685,90.3563,2002323,0,29271,1973052
7/26/22,Bangladesh,23.685,90.3563,2002944,0,29275,1973669
7/27/22,Bangladesh,23.685,90.3563,2003570,0,29280,1974290
7/28/22,Bangladesh,23.685,90.3563,2004188,0,29284,1974904
7/29/22,Bangladesh,23.685,90.3563,2004543,0,29285,1975258
7/30/22,Bangladesh,23.685,90.3563,2004892,0,29288,1975604
7/31/22,Bangladesh,23.685,90.3563,2005257,0,29291,1975966
8/1/22,Bangladesh,23.685,90.3563,2005606,0,29292,1976314
8/2/22,Bangladesh,23.685,90.3563,2005993,0,29295,1976698
8/3/22,Bangladesh,23.685,90.3563,2006368,0,29298,1977070
8/4/22,Bangladesh,23.685,90.3563,2006646,0,29300,1977346
8/5/22,Bangladesh,23.685,90.3563,2006899,0,29302,1977597
8/6/22,Bangladesh,23.685,90.3563,2007119,0,29304,1977815
8/7/22,Bangladesh,23.685,90.3563,2007335,0,29304,1978031
8/8/22,Bangladesh,23.685,90.3563,2007631,0,29307,1978324
8/9/22,Bangladesh,23.685,90.3563,2007870,0,29308,1978562
8/10/22,Bangladesh,23.685,90.3563,2008068,0,29309,1978759
8/11/22,Bangladesh,23.685,90.3563,2008282,0,29310,1978972
8/12/22,Bangladesh,23.685,90.3563,2008500,0,29312,1979188
8/13/22,Bangladesh,23.685,90.3563,2008644,0,29312,1979332
8/14/22,Bangladesh,23.685,90.3563,2008870,0,29313,1979557
8/15/22,Bangladesh,23.685,90.3563,2009129,0,29314,1979815
8/16/22,Bangladesh,23.685,90.3563,2009222,0,29314,1979908
8/17/22,Bangladesh,23.685,90.3563,2009434,0,29314,1980120
8/18/22,Bangladesh,23.685,90.3563,2009604,0,29315,1980289
8/19/22,Bangladesh,23.685,90.3563,2009697,0,29315,1980382
8/20/22,Bangladesh,23.685,90.3563,2009797,0,29315,1980482
8/21/22,Bangladesh,23.685,90.3563,2009970,0,29315,1980655
8/22/22,Bangladesh,23.685,90.3563,2010148,0,29316,1980832
8/23/22,Bangladesh,23.685,90.3563,2010323,0,29316,1981007
8/24/22,Bangladesh,23.685,90.3563,2010490,0,29319,1981171
8/25/22,Bangladesh,23.685,90.3563,2010748,0,29320,1981428
8/26/22,Bangladesh,23.685,90.3563,2010944,0,29321,1981623
8/27/22,Bangladesh,23.685,90.3563,2011100,0,29323,1981777
8/28/22,Bangladesh,23.685,90.3563,2011317,0,29323,1981994
8/29/22,Bangladesh,23.685,90.3563,2011560,0,29323,1982237
8/30/22,Bangladesh,23.685,90.3563,2011732,0,29323,1982409
8/31/22,Bangladesh,23.685,90.3563,2011946,0,29323,1982623
9/1/22,Bangladesh,23.685,90.3563,2012162,0,29325,1982837
9/2/22,Bangladesh,23.685,90.3563,2012376,0,29326,1983050
9/3/22,Bangladesh,23.685,90.3563,2012531,0,29327,1983204
9/4/22,Bangladesh,23.685,90.3563,2012761,0,29328,1983433
9/5/22,Bangladesh,23.685,90.3563,2013094,0,29328,1983766
9/6/22,Bangladesh,23.685,90.3563,2013407,0,29329,1984078
9/7/22,Bangladesh,23.685,90.3563,2013689,0,29329,1984360
9/8/22,Bangladesh,23.685,90.3563,2014077,0,29330,1984747
9/9/22,Bangladesh,23.685,90.3563,2014355,0,29331,1985024
9/10/22,Bangladesh,23.685,90.3563,2014577,0,29332,1985245
9/11/22,Bangladesh,23.685,90.3563,2014887,0,29334,1985553
9/12/22,Bangladesh,23.685,90.3563,2015308,0,29334,1985974
9/13/22,Bangladesh,23.685,90.3563,2015743,0,29335,1986408
9/14/22,Bangladesh,23.685,90.3563,2016145,0,29336,1986809
9/15/22,Bangladesh,23.685,90.3563,2016583,0,29337,1987246
9/16/22,Bangladesh,23.685,90.3563,2016946,0,29339,1987607
9/17/22,Bangladesh,23.685,90.3563,2017087,0,29339,1987748
9/18/22,Bangladesh,23.685,90.3563,2017614,0,29339,1988275
9/19/22,Bangladesh,23.685,90.3563,2018215,0,29340,1988875
9/20/22,Bangladesh,23.685,90.3563,2018829,0,29345,1989484
9/21/22,Bangladesh,23.685,90.3563,2019470,0,29345,1990125
9/22/22,Bangladesh,23.685,90.3563,2020148,0,29346,1990802
9/23/22,Bangladesh,23.685,90.3563,2020768,0,29347,1991421
9/24/22,Bangladesh,23.685,90.3563,2021118,0,29351,1991767
9/25/22,Bangladesh,23.685,90.3563,2021690,0,29353,1992337
9/26/22,Bangladesh,23.685,90.3563,2022408,0,29359,1993049
9/27/22,Bangladesh,23.685,90.3563,2023145,0,29360,1993785
9/28/22,Bangladesh,23.685,90.3563,2023810,0,29360,1994450
9/29/22,Bangladesh,23.685,90.3563,2024489,0,29362,1995127
9/30/22,Bangladesh,23.685,90.3563,2025197,0,29363,1995834
10/1/22,Bangladesh,23.685,90.3563,2025677,0,29368,1996309
10/2/22,Bangladesh,23.685,90.3563,2026212,0,29369,1996843
10/3/22,Bangladesh,23.685,90.3563,2026908,0,29371,1997537
10/4/22,Bangladesh,23.685,90.3563,2027565,0,29372,1998193
10/5/22,Bangladesh,23.685,90.3563,2028114,0,29374,1998740
10/6/22,Bangladesh,23.685,90.3563,2028524,0,29375,1999149
10/7/22,Bangladesh,23.685,90.3563,2029015,0,29380,1999635
10/8/22,Bangladesh,23.685,90.3563,2029314,0,29380,1999934
10/9/22,Bangladesh,23.685,90.3563,2029723,0,29381,2000342
10/10/22,Bangladesh,23.685,90.3563,2030090,0,29384,2000706
10/11/22,Bangladesh,23.685,90.3563,2030550,0,29386,2001164
10/12/22,Bangladesh,23.685,90.3563,2031006,0,29388,2001618
10/13/22,Bangladesh,23.685,90.3563,2031451,0,29389,2002062
10/14/22,Bangladesh,23.685,90.3563,2031797,0,29393,2002404
10/15/22,Bangladesh,23.685,90.3563,2032092,0,29395,2002697
10/16/22,Bangladesh,23.685,90.3563,2032443,0,29401,2003042
10/17/22,Bangladesh,23.685,90.3563,2032832,0,29402,2003430
10/18/22,Bangladesh,23.685,90.3563,2033119,0,29408,2003711
10/19/22,Bangladesh,23.685,90.3563,2033419,0,29410,2004009
10/20/22,Bangladesh,23.685,90.3563,2033662,0,29411,2004251
10/21/22,Bangladesh,23.685,90.3563,2033878,0,29411,2004467
10/22/22,Bangladesh,23.685,90.3563,2034002,0,29412,2004590
10/23/22,Bangladesh,23.685,90.3563,2034141,0,29413,2004728
10/24/22,Bangladesh,23.685,90.3563,2034348,0,29415,2004933
10/25/22,Bangladesh,23.685,90.3563,2034533,0,29416,2005117
10/26/22,Bangladesh,23.685,90.3563,2034729,0,29416,2005313
10/27/22,Bangladesh,23.685,90.3563,2034866,0,29417,2005449
10/28/22,Bangladesh,23.685,90.3563,2034968,0,29418,2005550
10/29/22,Bangladesh,23.685,90.3563,2035037,0,29419,2005618
10/30/22,Bangladesh,23.685,90.3563,2035152,0,29423,2005729
10/31/22,Bangladesh,23.685,90.3563,2035240,0,29423,2005817
11/1/22,Bangladesh,23.685,90.3563,2035334,0,29424,2005910
11/2/22,Bangladesh,23.685,90.3563,2035517,0,29424,2006093
11/3/22,Bangladesh,23.685,90.3563,2035657,0,29425,2006232
11/4/22,Bangladesh,23.685,90.3563,2035745,0,29425,2006320
11/5/22,Bangladesh,23.685,90.3563,2035782,0,29425,2006357
11/6/22,Bangladesh,23.685,90.3563,2035828,0,29426,2006402
11/7/22,Bangladesh,23.685,90.3563,2035882,0,29426,2006456
11/8/22,Bangladesh,23.685,90.3563,2035930,0,29426,2006504
11/9/22,Bangladesh,23.685,90.3563,2035992,0,29426,2006566
11/10/22,Bangladesh,23.685,90.3563,2036061,0,29426,2006635
11/11/22,Bangladesh,23.685,90.3563,2036109,0,29426,2006683
11/12/22,Bangladesh,23.685,90.3563,2036131,0,29426,2006705
11/13/22,Bangladesh,23.685,90.3563,2036166,0,29427,2006739
11/14/22,Bangladesh,23.685,90.3563,2036204,0,29429,2006775
11/15/22,Bangladesh,23.685,90.3563,2036233,0,29429,2006804
11/16/22,Bangladesh,23.685,90.3563,2036268,0,29430,2006838
11/17/22,Bangladesh,23.685,90.3563,2036306,0,29430,2006876
11/18/22,Bangladesh,23.685,90.3563,2036325,0,29430,2006895
11/19/22,Bangladesh,23.685,90.3563,2036343,0,29430,2006913
11/20/22,Bangladesh,23.685,90.3563,2036367,0,29430,2006937
11/21/22,Bangladesh,23.685,90.3563,2036393,0,29431,2006962
11/22/22,Bangladesh,23.685,90.3563,2036416,0,29431,2006985
11/23/22,Bangladesh,23.685,90.3563,2036449,0,29431,2007018
11/24/22,Bangladesh,23.685,90.3563,2036469,0,29431,2007038
11/25/22,Bangladesh,23.685,90.3563,2036488,0,29431,2007057
11/26/22,Bangladesh,23.685,90.3563,2036511,0,29431,2007080
11/27/22,Bangladesh,23.685,90.3563,2036527,0,29431,2007096
11/28/22,Bangladesh,23.685,90.3563,2036556,0,29432,2007124
11/29/22,Bangladesh,23.685,90.3563,2036567,0,29433,2007134
11/30/22,Bangladesh,23.685,90.3563,2036585,0,29433,2007152
12/1/22,Bangladesh,23.685,90.3563,2036597,0,29433,2007164
12/2/22,Bangladesh,23.685,90.3563,2036597,0,29433,2007164
12/3/22,Bangladesh,23.685,90.3563,2036622,0,29434,2007188
12/4/22,Bangladesh,23.685,90.3563,2036637,0,29434,2007203
12/5/22,Bangladesh,23.685,90.3563,2036663,0,29435,2007228
12/6/22,Bangladesh,23.685,90.3563,2036685,0,29435,2007250
12/7/22,Bangladesh,23.685,90.3563,2036717,0,29436,2007281
12/8/22,Bangladesh,23.685,90.3563,2036730,0,29436,2007294
12/9/22,Bangladesh,23.685,90.3563,2036760,0,29436,2007324
12/10/22,Bangladesh,23.685,90.3563,2036777,0,29436,2007341
12/11/22,Bangladesh,23.685,90.3563,2036806,0,29436,2007370
12/12/22,Bangladesh,23.685,90.3563,2036825,0,29437,2007388
12/13/22,Bangladesh,23.685,90.3563,2036845,0,29437,2007408
12/14/22,Bangladesh,23.685,90.3563,2036866,0,29437,2007429
12/15/22,Bangladesh,23.685,90.3563,2036881,0,29437,2007444
12/16/22,Bangladesh,23.685,90.3563,2036897,0,29437,2007460
12/17/22,Bangladesh,23.685,90.3563,2036911,0,29438,2007473
1/1/22,Barbados,13.1939,-59.5432,28810,0,262,28548
1/2/22,Barbados,13.1939,-59.5432,28960,0,262,28698
1/3/22,Barbados,13.1939,-59.5432,29160,0,262,28898
1/4/22,Barbados,13.1939,-59.5432,29698,0,263,29435
1/5/22,Barbados,13.1939,-59.5432,30177,0,263,29914
1/6/22,Barbados,13.1939,-59.5432,30597,0,264,30333
1/7/22,Barbados,13.1939,-59.5432,31004,0,265,30739
1/8/22,Barbados,13.1939,-59.5432,31499,0,266,31233
1/9/22,Barbados,13.1939,-59.5432,31841,0,266,31575
1/10/22,Barbados,13.1939,-59.5432,32228,0,266,31962
1/11/22,Barbados,13.1939,-59.5432,32795,0,266,32529
1/12/22,Barbados,13.1939,-59.5432,33311,0,267,33044
1/13/22,Barbados,13.1939,-59.5432,33888,0,269,33619
1/14/22,Barbados,13.1939,-59.5432,34425,0,269,34156
1/15/22,Barbados,13.1939,-59.5432,34961,0,269,34692
1/16/22,Barbados,13.1939,-59.5432,35373,0,269,35104
1/17/22,Barbados,13.1939,-59.5432,35734,0,269,35465
1/18/22,Barbados,13.1939,-59.5432,35734,0,271,35463
1/19/22,Barbados,13.1939,-59.5432,37063,0,271,36792
1/20/22,Barbados,13.1939,-59.5432,37622,0,273,37349
1/21/22,Barbados,13.1939,-59.5432,38171,0,274,37897
1/22/22,Barbados,13.1939,-59.5432,38586,0,274,38312
1/23/22,Barbados,13.1939,-59.5432,39212,0,275,38937
1/24/22,Barbados,13.1939,-59.5432,39709,0,276,39433
1/25/22,Barbados,13.1939,-59.5432,40632,0,277,40355
1/26/22,Barbados,13.1939,-59.5432,41355,0,277,41078
1/27/22,Barbados,13.1939,-59.5432,42122,0,277,41845
1/28/22,Barbados,13.1939,-59.5432,42851,0,277,42574
1/29/22,Barbados,13.1939,-59.5432,43481,0,278,43203
1/30/22,Barbados,13.1939,-59.5432,43993,0,279,43714
1/31/22,Barbados,13.1939,-59.5432,44430,0,280,44150
2/1/22,Barbados,13.1939,-59.5432,45216,0,281,44935
2/2/22,Barbados,13.1939,-59.5432,45897,0,282,45615
2/3/22,Barbados,13.1939,-59.5432,46506,0,283,46223
2/4/22,Barbados,13.1939,-59.5432,47124,0,286,46838
2/5/22,Barbados,13.1939,-59.5432,47777,0,286,47491
2/6/22,Barbados,13.1939,-59.5432,48239,0,286,47953
2/7/22,Barbados,13.1939,-59.5432,48658,0,286,48372
2/8/22,Barbados,13.1939,-59.5432,49372,0,288,49084
2/9/22,Barbados,13.1939,-59.5432,49958,0,289,49669
2/10/22,Barbados,13.1939,-59.5432,50477,0,291,50186
2/11/22,Barbados,13.1939,-59.5432,50880,0,291,50589
2/12/22,Barbados,13.1939,-59.5432,51311,0,295,51016
2/13/22,Barbados,13.1939,-59.5432,51624,0,299,51325
2/14/22,Barbados,13.1939,-59.5432,51895,0,299,51596
2/15/22,Barbados,13.1939,-59.5432,52310,0,302,52008
2/16/22,Barbados,13.1939,-59.5432,52637,0,305,52332
2/17/22,Barbados,13.1939,-59.5432,52909,0,307,52602
2/18/22,Barbados,13.1939,-59.5432,53253,0,307,52946
2/19/22,Barbados,13.1939,-59.5432,53508,0,308,53200
2/20/22,Barbados,13.1939,-59.5432,53698,0,310,53388
2/21/22,Barbados,13.1939,-59.5432,53884,0,311,53573
2/22/22,Barbados,13.1939,-59.5432,54106,0,311,53795
2/23/22,Barbados,13.1939,-59.5432,54344,0,311,54033
2/24/22,Barbados,13.1939,-59.5432,54536,0,312,54224
2/25/22,Barbados,13.1939,-59.5432,54731,0,312,54419
2/26/22,Barbados,13.1939,-59.5432,54902,0,313,54589
2/27/22,Barbados,13.1939,-59.5432,55031,0,315,54716
2/28/22,Barbados,13.1939,-59.5432,55165,0,316,54849
3/1/22,Barbados,13.1939,-59.5432,55385,0,316,55069
3/2/22,Barbados,13.1939,-59.5432,55543,0,316,55227
3/3/22,Barbados,13.1939,-59.5432,55705,0,316,55389
3/4/22,Barbados,13.1939,-59.5432,55863,0,316,55547
3/5/22,Barbados,13.1939,-59.5432,56013,0,319,55694
3/6/22,Barbados,13.1939,-59.5432,56124,0,319,55805
3/7/22,Barbados,13.1939,-59.5432,56220,0,322,55898
3/8/22,Barbados,13.1939,-59.5432,56376,0,323,56053
3/9/22,Barbados,13.1939,-59.5432,56551,0,323,56228
3/10/22,Barbados,13.1939,-59.5432,56679,0,323,56356
3/11/22,Barbados,13.1939,-59.5432,56805,0,323,56482
3/12/22,Barbados,13.1939,-59.5432,56922,0,324,56598
3/13/22,Barbados,13.1939,-59.5432,57023,0,325,56698
3/14/22,Barbados,13.1939,-59.5432,57102,0,326,56776
3/15/22,Barbados,13.1939,-59.5432,57230,0,326,56904
3/16/22,Barbados,13.1939,-59.5432,57348,0,326,57022
3/17/22,Barbados,13.1939,-59.5432,57451,0,326,57125
3/18/22,Barbados,13.1939,-59.5432,57548,0,326,57222
3/19/22,Barbados,13.1939,-59.5432,57660,0,327,57333
3/20/22,Barbados,13.1939,-59.5432,57733,0,329,57404
3/21/22,Barbados,13.1939,-59.5432,57800,0,329,57471
3/22/22,Barbados,13.1939,-59.5432,57903,0,329,57574
3/23/22,Barbados,13.1939,-59.5432,58018,0,329,57689
3/24/22,Barbados,13.1939,-59.5432,58128,0,329,57799
3/25/22,Barbados,13.1939,-59.5432,58270,0,330,57940
3/26/22,Barbados,13.1939,-59.5432,58270,0,330,57940
3/27/22,Barbados,13.1939,-59.5432,58532,0,330,58202
3/28/22,Barbados,13.1939,-59.5432,58634,0,331,58303
3/29/22,Barbados,13.1939,-59.5432,58862,0,331,58531
3/30/22,Barbados,13.1939,-59.5432,59080,0,331,58749
3/31/22,Barbados,13.1939,-59.5432,59272,0,374,58898
4/1/22,Barbados,13.1939,-59.5432,59495,0,375,59120
4/2/22,Barbados,13.1939,-59.5432,59734,0,375,59359
4/3/22,Barbados,13.1939,-59.5432,59938,0,375,59563
4/4/22,Barbados,13.1939,-59.5432,60160,0,375,59785
4/5/22,Barbados,13.1939,-59.5432,60592,0,375,60217
4/6/22,Barbados,13.1939,-59.5432,60890,0,376,60514
4/7/22,Barbados,13.1939,-59.5432,61267,0,377,60890
4/8/22,Barbados,13.1939,-59.5432,61267,0,377,60890
4/9/22,Barbados,13.1939,-59.5432,61953,0,379,61574
4/10/22,Barbados,13.1939,-59.5432,62214,0,379,61835
4/11/22,Barbados,13.1939,-59.5432,62425,0,379,62046
4/12/22,Barbados,13.1939,-59.5432,62968,0,379,62589
4/13/22,Barbados,13.1939,-59.5432,62968,0,379,62589
4/14/22,Barbados,13.1939,-59.5432,63785,0,381,63404
4/15/22,Barbados,13.1939,-59.5432,64177,0,381,63796
4/16/22,Barbados,13.1939,-59.5432,64348,0,383,63965
4/17/22,Barbados,13.1939,-59.5432,64348,0,383,63965
4/18/22,Barbados,13.1939,-59.5432,64794,0,386,64408
4/19/22,Barbados,13.1939,-59.5432,65096,0,386,64710
4/20/22,Barbados,13.1939,-59.5432,65770,0,386,65384
4/21/22,Barbados,13.1939,-59.5432,66317,0,386,65931
4/22/22,Barbados,13.1939,-59.5432,66810,0,388,66422
4/23/22,Barbados,13.1939,-59.5432,67256,0,389,66867
4/24/22,Barbados,13.1939,-59.5432,67611,0,389,67222
4/25/22,Barbados,13.1939,-59.5432,67934,0,390,67544
4/26/22,Barbados,13.1939,-59.5432,68440,0,390,68050
4/27/22,Barbados,13.1939,-59.5432,68913,0,390,68523
4/28/22,Barbados,13.1939,-59.5432,69345,0,390,68955
4/29/22,Barbados,13.1939,-59.5432,69562,0,392,69170
4/30/22,Barbados,13.1939,-59.5432,70080,0,394,69686
5/1/22,Barbados,13.1939,-59.5432,70449,0,395,70054
5/2/22,Barbados,13.1939,-59.5432,70793,0,398,70395
5/3/22,Barbados,13.1939,-59.5432,71127,0,399,70728
5/4/22,Barbados,13.1939,-59.5432,71127,0,399,70728
5/5/22,Barbados,13.1939,-59.5432,72282,0,402,71880
5/6/22,Barbados,13.1939,-59.5432,72743,0,403,72340
5/7/22,Barbados,13.1939,-59.5432,73198,0,405,72793
5/8/22,Barbados,13.1939,-59.5432,73592,0,406,73186
5/9/22,Barbados,13.1939,-59.5432,73856,0,430,73426
5/10/22,Barbados,13.1939,-59.5432,74454,0,430,74024
5/11/22,Barbados,13.1939,-59.5432,74967,0,430,74537
5/12/22,Barbados,13.1939,-59.5432,75438,0,432,75006
5/13/22,Barbados,13.1939,-59.5432,75845,0,432,75413
5/14/22,Barbados,13.1939,-59.5432,76261,0,433,75828
5/15/22,Barbados,13.1939,-59.5432,76571,0,433,76138
5/16/22,Barbados,13.1939,-59.5432,76895,0,434,76461
5/17/22,Barbados,13.1939,-59.5432,77364,0,434,76930
5/18/22,Barbados,13.1939,-59.5432,77767,0,435,77332
5/19/22,Barbados,13.1939,-59.5432,78138,0,435,77703
5/20/22,Barbados,13.1939,-59.5432,78448,0,436,78012
5/21/22,Barbados,13.1939,-59.5432,78448,0,436,78012
5/22/22,Barbados,13.1939,-59.5432,78919,0,440,78479
5/23/22,Barbados,13.1939,-59.5432,79049,0,440,78609
5/24/22,Barbados,13.1939,-59.5432,79383,0,443,78940
5/25/22,Barbados,13.1939,-59.5432,79628,0,444,79184
5/26/22,Barbados,13.1939,-59.5432,79860,0,444,79416
5/27/22,Barbados,13.1939,-59.5432,80038,0,444,79594
5/28/22,Barbados,13.1939,-59.5432,80038,0,444,79594
5/29/22,Barbados,13.1939,-59.5432,80324,0,446,79878
5/30/22,Barbados,13.1939,-59.5432,80324,0,446,79878
5/31/22,Barbados,13.1939,-59.5432,80654,0,450,80204
6/1/22,Barbados,13.1939,-59.5432,80846,0,461,80385
6/2/22,Barbados,13.1939,-59.5432,81028,0,462,80566
6/3/22,Barbados,13.1939,-59.5432,81174,0,462,80712
6/4/22,Barbados,13.1939,-59.5432,81319,0,462,80857
6/5/22,Barbados,13.1939,-59.5432,81427,0,462,80965
6/6/22,Barbados,13.1939,-59.5432,81518,0,463,81055
6/7/22,Barbados,13.1939,-59.5432,81622,0,463,81159
6/8/22,Barbados,13.1939,-59.5432,81800,0,466,81334
6/9/22,Barbados,13.1939,-59.5432,81929,0,467,81462
6/10/22,Barbados,13.1939,-59.5432,82071,0,467,81604
6/11/22,Barbados,13.1939,-59.5432,82183,0,467,81716
6/12/22,Barbados,13.1939,-59.5432,82255,0,467,81788
6/13/22,Barbados,13.1939,-59.5432,82318,0,468,81850
6/14/22,Barbados,13.1939,-59.5432,82449,0,468,81981
6/15/22,Barbados,13.1939,-59.5432,82545,0,471,82074
6/16/22,Barbados,13.1939,-59.5432,82643,0,471,82172
6/17/22,Barbados,13.1939,-59.5432,82730,0,471,82259
6/18/22,Barbados,13.1939,-59.5432,82826,0,471,82355
6/19/22,Barbados,13.1939,-59.5432,82899,0,472,82427
6/20/22,Barbados,13.1939,-59.5432,82950,0,472,82478
6/21/22,Barbados,13.1939,-59.5432,83095,0,472,82623
6/22/22,Barbados,13.1939,-59.5432,83242,0,472,82770
6/23/22,Barbados,13.1939,-59.5432,83390,0,472,82918
6/24/22,Barbados,13.1939,-59.5432,83524,0,473,83051
6/25/22,Barbados,13.1939,-59.5432,83663,0,473,83190
6/26/22,Barbados,13.1939,-59.5432,83776,0,473,83303
6/27/22,Barbados,13.1939,-59.5432,83820,0,473,83347
6/28/22,Barbados,13.1939,-59.5432,83975,0,473,83502
6/29/22,Barbados,13.1939,-59.5432,84095,0,476,83619
6/30/22,Barbados,13.1939,-59.5432,84421,0,477,83944
7/1/22,Barbados,13.1939,-59.5432,84562,0,477,84085
7/2/22,Barbados,13.1939,-59.5432,84709,0,477,84232
7/3/22,Barbados,13.1939,-59.5432,84830,0,477,84353
7/4/22,Barbados,13.1939,-59.5432,84919,0,477,84442
7/5/22,Barbados,13.1939,-59.5432,85121,0,477,84644
7/6/22,Barbados,13.1939,-59.5432,85331,0,477,84854
7/7/22,Barbados,13.1939,-59.5432,85488,0,478,85010
7/8/22,Barbados,13.1939,-59.5432,85679,0,478,85201
7/9/22,Barbados,13.1939,-59.5432,85881,0,478,85403
7/10/22,Barbados,13.1939,-59.5432,86010,0,478,85532
7/11/22,Barbados,13.1939,-59.5432,86154,0,478,85676
7/12/22,Barbados,13.1939,-59.5432,86451,0,478,85973
7/13/22,Barbados,13.1939,-59.5432,86691,0,479,86212
7/14/22,Barbados,13.1939,-59.5432,87002,0,479,86523
7/15/22,Barbados,13.1939,-59.5432,87219,0,479,86740
7/16/22,Barbados,13.1939,-59.5432,87463,0,479,86984
7/17/22,Barbados,13.1939,-59.5432,87584,0,479,87105
7/18/22,Barbados,13.1939,-59.5432,87754,0,479,87275
7/19/22,Barbados,13.1939,-59.5432,88154,0,480,87674
7/20/22,Barbados,13.1939,-59.5432,88565,0,480,88085
7/21/22,Barbados,13.1939,-59.5432,88965,0,480,88485
7/22/22,Barbados,13.1939,-59.5432,89339,0,482,88857
7/23/22,Barbados,13.1939,-59.5432,89654,0,482,89172
7/24/22,Barbados,13.1939,-59.5432,89887,0,484,89403
7/25/22,Barbados,13.1939,-59.5432,90080,0,484,89596
7/26/22,Barbados,13.1939,-59.5432,90550,0,484,90066
7/27/22,Barbados,13.1939,-59.5432,90934,0,489,90445
7/28/22,Barbados,13.1939,-59.5432,91264,0,491,90773
7/29/22,Barbados,13.1939,-59.5432,91593,0,492,91101
7/30/22,Barbados,13.1939,-59.5432,91895,0,493,91402
7/31/22,Barbados,13.1939,-59.5432,92086,0,493,91593
8/1/22,Barbados,13.1939,-59.5432,92301,0,495,91806
8/2/22,Barbados,13.1939,-59.5432,92516,0,495,92021
8/3/22,Barbados,13.1939,-59.5432,92841,0,495,92346
8/4/22,Barbados,13.1939,-59.5432,93559,0,496,93063
8/5/22,Barbados,13.1939,-59.5432,94093,0,498,93595
8/6/22,Barbados,13.1939,-59.5432,94601,0,499,94102
8/7/22,Barbados,13.1939,-59.5432,94963,0,501,94462
8/8/22,Barbados,13.1939,-59.5432,94963,0,501,94462
8/9/22,Barbados,13.1939,-59.5432,95876,0,505,95371
8/10/22,Barbados,13.1939,-59.5432,96350,0,514,95836
8/11/22,Barbados,13.1939,-59.5432,96781,0,514,96267
8/12/22,Barbados,13.1939,-59.5432,97104,0,515,96589
8/13/22,Barbados,13.1939,-59.5432,97411,0,516,96895
8/14/22,Barbados,13.1939,-59.5432,97638,0,516,97122
8/15/22,Barbados,13.1939,-59.5432,97846,0,519,97327
8/16/22,Barbados,13.1939,-59.5432,98277,0,525,97752
8/17/22,Barbados,13.1939,-59.5432,98622,0,525,98097
8/18/22,Barbados,13.1939,-59.5432,98958,0,529,98429
8/19/22,Barbados,13.1939,-59.5432,99204,0,529,98675
8/20/22,Barbados,13.1939,-59.5432,99426,0,530,98896
8/21/22,Barbados,13.1939,-59.5432,99572,0,530,99042
8/22/22,Barbados,13.1939,-59.5432,99690,0,532,99158
8/23/22,Barbados,13.1939,-59.5432,99970,0,532,99438
8/24/22,Barbados,13.1939,-59.5432,100191,0,537,99654
8/25/22,Barbados,13.1939,-59.5432,100373,0,537,99836
8/26/22,Barbados,13.1939,-59.5432,100526,0,537,99989
8/27/22,Barbados,13.1939,-59.5432,100676,0,539,100137
8/28/22,Barbados,13.1939,-59.5432,100762,0,539,100223
8/29/22,Barbados,13.1939,-59.5432,100825,0,539,100286
8/30/22,Barbados,13.1939,-59.5432,100973,0,541,100432
8/31/22,Barbados,13.1939,-59.5432,101120,0,542,100578
9/1/22,Barbados,13.1939,-59.5432,101215,0,544,100671
9/2/22,Barbados,13.1939,-59.5432,101215,0,544,100671
9/3/22,Barbados,13.1939,-59.5432,101397,0,544,100853
9/4/22,Barbados,13.1939,-59.5432,101451,0,544,100907
9/5/22,Barbados,13.1939,-59.5432,101510,0,544,100966
9/6/22,Barbados,13.1939,-59.5432,101624,0,546,101078
9/7/22,Barbados,13.1939,-59.5432,101696,0,553,101143
9/8/22,Barbados,13.1939,-59.5432,101747,0,556,101191
9/9/22,Barbados,13.1939,-59.5432,101809,0,556,101253
9/10/22,Barbados,13.1939,-59.5432,101850,0,556,101294
9/11/22,Barbados,13.1939,-59.5432,101850,0,556,101294
9/12/22,Barbados,13.1939,-59.5432,101899,0,556,101343
9/13/22,Barbados,13.1939,-59.5432,101979,0,558,101421
9/14/22,Barbados,13.1939,-59.5432,102025,0,559,101466
9/15/22,Barbados,13.1939,-59.5432,102068,0,559,101509
9/16/22,Barbados,13.1939,-59.5432,102119,0,559,101560
9/17/22,Barbados,13.1939,-59.5432,102119,0,559,101560
9/18/22,Barbados,13.1939,-59.5432,102193,0,559,101634
9/19/22,Barbados,13.1939,-59.5432,102230,0,559,101671
9/20/22,Barbados,13.1939,-59.5432,102279,0,559,101720
9/21/22,Barbados,13.1939,-59.5432,102321,0,559,101762
9/22/22,Barbados,13.1939,-59.5432,102366,0,559,101807
9/23/22,Barbados,13.1939,-59.5432,102383,0,559,101824
9/24/22,Barbados,13.1939,-59.5432,102383,0,559,101824
9/25/22,Barbados,13.1939,-59.5432,102436,0,559,101877
9/26/22,Barbados,13.1939,-59.5432,102456,0,559,101897
9/27/22,Barbados,13.1939,-59.5432,102488,0,559,101929
9/28/22,Barbados,13.1939,-59.5432,102516,0,559,101957
9/29/22,Barbados,13.1939,-59.5432,102546,0,559,101987
9/30/22,Barbados,13.1939,-59.5432,102580,0,560,102020
10/1/22,Barbados,13.1939,-59.5432,102580,0,560,102020
10/2/22,Barbados,13.1939,-59.5432,102580,0,560,102020
10/3/22,Barbados,13.1939,-59.5432,102580,0,560,102020
10/4/22,Barbados,13.1939,-59.5432,102580,0,560,102020
10/5/22,Barbados,13.1939,-59.5432,102580,0,560,102020
10/6/22,Barbados,13.1939,-59.5432,102580,0,560,102020
10/7/22,Barbados,13.1939,-59.5432,102580,0,560,102020
10/8/22,Barbados,13.1939,-59.5432,102580,0,560,102020
10/9/22,Barbados,13.1939,-59.5432,102580,0,560,102020
10/10/22,Barbados,13.1939,-59.5432,102580,0,560,102020
10/11/22,Barbados,13.1939,-59.5432,102580,0,560,102020
10/12/22,Barbados,13.1939,-59.5432,102609,0,560,102049
10/13/22,Barbados,13.1939,-59.5432,102609,0,560,102049
10/14/22,Barbados,13.1939,-59.5432,102609,0,560,102049
10/15/22,Barbados,13.1939,-59.5432,102609,0,560,102049
10/16/22,Barbados,13.1939,-59.5432,103014,0,560,102454
10/17/22,Barbados,13.1939,-59.5432,103014,0,560,102454
10/18/22,Barbados,13.1939,-59.5432,103014,0,560,102454
10/19/22,Barbados,13.1939,-59.5432,103014,0,560,102454
10/20/22,Barbados,13.1939,-59.5432,103014,0,560,102454
10/21/22,Barbados,13.1939,-59.5432,103014,0,560,102454
10/22/22,Barbados,13.1939,-59.5432,103014,0,560,102454
10/23/22,Barbados,13.1939,-59.5432,103014,0,560,102454
10/24/22,Barbados,13.1939,-59.5432,103014,0,560,102454
10/25/22,Barbados,13.1939,-59.5432,103014,0,560,102454
10/26/22,Barbados,13.1939,-59.5432,103014,0,560,102454
10/27/22,Barbados,13.1939,-59.5432,103014,0,560,102454
10/28/22,Barbados,13.1939,-59.5432,103014,0,560,102454
10/29/22,Barbados,13.1939,-59.5432,103014,0,560,102454
10/30/22,Barbados,13.1939,-59.5432,103014,0,560,102454
10/31/22,Barbados,13.1939,-59.5432,103014,0,560,102454
11/1/22,Barbados,13.1939,-59.5432,103424,0,560,102864
11/2/22,Barbados,13.1939,-59.5432,103424,0,560,102864
11/3/22,Barbados,13.1939,-59.5432,103424,0,560,102864
11/4/22,Barbados,13.1939,-59.5432,103424,0,560,102864
11/5/22,Barbados,13.1939,-59.5432,103424,0,560,102864
11/6/22,Barbados,13.1939,-59.5432,103424,0,560,102864
11/7/22,Barbados,13.1939,-59.5432,103424,0,560,102864
11/8/22,Barbados,13.1939,-59.5432,103424,0,560,102864
11/9/22,Barbados,13.1939,-59.5432,103424,0,560,102864
11/10/22,Barbados,13.1939,-59.5432,103424,0,560,102864
11/11/22,Barbados,13.1939,-59.5432,103424,0,560,102864
11/12/22,Barbados,13.1939,-59.5432,103424,0,560,102864
11/13/22,Barbados,13.1939,-59.5432,103424,0,560,102864
11/14/22,Barbados,13.1939,-59.5432,103424,0,560,102864
11/15/22,Barbados,13.1939,-59.5432,103545,0,564,102981
11/16/22,Barbados,13.1939,-59.5432,103545,0,564,102981
11/17/22,Barbados,13.1939,-59.5432,103545,0,564,102981
11/18/22,Barbados,13.1939,-59.5432,103545,0,564,102981
11/19/22,Barbados,13.1939,-59.5432,103545,0,564,102981
11/20/22,Barbados,13.1939,-59.5432,103545,0,564,102981
11/21/22,Barbados,13.1939,-59.5432,103545,0,564,102981
11/22/22,Barbados,13.1939,-59.5432,103545,0,564,102981
11/23/22,Barbados,13.1939,-59.5432,103955,0,564,103391
11/24/22,Barbados,13.1939,-59.5432,103955,0,564,103391
11/25/22,Barbados,13.1939,-59.5432,103955,0,564,103391
11/26/22,Barbados,13.1939,-59.5432,103955,0,564,103391
11/27/22,Barbados,13.1939,-59.5432,103955,0,564,103391
11/28/22,Barbados,13.1939,-59.5432,103955,0,564,103391
11/29/22,Barbados,13.1939,-59.5432,103955,0,564,103391
11/30/22,Barbados,13.1939,-59.5432,104416,0,567,103849
12/1/22,Barbados,13.1939,-59.5432,104416,0,567,103849
12/2/22,Barbados,13.1939,-59.5432,104416,0,567,103849
12/3/22,Barbados,13.1939,-59.5432,104416,0,567,103849
12/4/22,Barbados,13.1939,-59.5432,104416,0,567,103849
12/5/22,Barbados,13.1939,-59.5432,104416,0,567,103849
12/6/22,Barbados,13.1939,-59.5432,104416,0,567,103849
12/7/22,Barbados,13.1939,-59.5432,104416,0,567,103849
12/8/22,Barbados,13.1939,-59.5432,104416,0,567,103849
12/9/22,Barbados,13.1939,-59.5432,104416,0,567,103849
12/10/22,Barbados,13.1939,-59.5432,104416,0,567,103849
12/11/22,Barbados,13.1939,-59.5432,104416,0,567,103849
12/12/22,Barbados,13.1939,-59.5432,104416,0,567,103849
12/13/22,Barbados,13.1939,-59.5432,104944,0,568,104376
12/14/22,Barbados,13.1939,-59.5432,104944,0,568,104376
12/15/22,Barbados,13.1939,-59.5432,104944,0,568,104376
12/16/22,Barbados,13.1939,-59.5432,104944,0,568,104376
12/17/22,Barbados,13.1939,-59.5432,104944,0,568,104376
1/1/22,Belarus,53.7098,27.9534,700421,0,5594,694827
1/2/22,Belarus,53.7098,27.9534,701192,0,5609,695583
1/3/22,Belarus,53.7098,27.9534,701699,0,5624,696075
1/4/22,Belarus,53.7098,27.9534,702374,0,5638,696736
1/5/22,Belarus,53.7098,27.9534,703507,0,5653,697854
1/6/22,Belarus,53.7098,27.9534,704907,0,5669,699238
1/7/22,Belarus,53.7098,27.9534,706530,0,5685,700845
1/8/22,Belarus,53.7098,27.9534,707714,0,5699,702015
1/9/22,Belarus,53.7098,27.9534,708291,0,5712,702579
1/10/22,Belarus,53.7098,27.9534,708931,0,5724,703207
1/11/22,Belarus,53.7098,27.9534,709622,0,5739,703883
1/12/22,Belarus,53.7098,27.9534,710632,0,5757,704875
1/13/22,Belarus,53.7098,27.9534,711723,0,5774,705949
1/14/22,Belarus,53.7098,27.9534,713002,0,5792,707210
1/15/22,Belarus,53.7098,27.9534,714295,0,5808,708487
1/16/22,Belarus,53.7098,27.9534,715643,0,5824,709819
1/17/22,Belarus,53.7098,27.9534,717034,0,5836,711198
1/18/22,Belarus,53.7098,27.9534,718098,0,5850,712248
1/19/22,Belarus,53.7098,27.9534,719485,0,5866,713619
1/20/22,Belarus,53.7098,27.9534,721103,0,5882,715221
1/21/22,Belarus,53.7098,27.9534,722939,0,5899,717040
1/22/22,Belarus,53.7098,27.9534,724903,0,5916,718987
1/23/22,Belarus,53.7098,27.9534,726860,0,5933,720927
1/24/22,Belarus,53.7098,27.9534,728804,0,5949,722855
1/25/22,Belarus,53.7098,27.9534,730207,0,5959,724248
1/26/22,Belarus,53.7098,27.9534,732104,0,5976,726128
1/27/22,Belarus,53.7098,27.9534,734078,0,5992,728086
1/28/22,Belarus,53.7098,27.9534,736299,0,6009,730290
1/29/22,Belarus,53.7098,27.9534,738601,0,6024,732577
1/30/22,Belarus,53.7098,27.9534,740988,0,6039,734949
1/31/22,Belarus,53.7098,27.9534,742953,0,6052,736901
2/1/22,Belarus,53.7098,27.9534,744871,0,6067,738804
2/2/22,Belarus,53.7098,27.9534,748505,0,6084,742421
2/3/22,Belarus,53.7098,27.9534,753495,0,6099,747396
2/4/22,Belarus,53.7098,27.9534,760845,0,6116,754729
2/5/22,Belarus,53.7098,27.9534,769076,0,6132,762944
2/6/22,Belarus,53.7098,27.9534,777391,0,6147,771244
2/7/22,Belarus,53.7098,27.9534,783260,0,6159,777101
2/8/22,Belarus,53.7098,27.9534,788934,0,6175,782759
2/9/22,Belarus,53.7098,27.9534,797188,0,6190,790998
2/10/22,Belarus,53.7098,27.9534,805651,0,6204,799447
2/11/22,Belarus,53.7098,27.9534,814262,0,6221,808041
2/12/22,Belarus,53.7098,27.9534,823045,0,6237,816808
2/13/22,Belarus,53.7098,27.9534,831966,0,6253,825713
2/14/22,Belarus,53.7098,27.9534,838571,0,6265,832306
2/15/22,Belarus,53.7098,27.9534,843717,0,6278,837439
2/16/22,Belarus,53.7098,27.9534,851636,0,6295,845341
2/17/22,Belarus,53.7098,27.9534,859884,0,6313,853571
2/18/22,Belarus,53.7098,27.9534,868078,0,6329,861749
2/19/22,Belarus,53.7098,27.9534,875934,0,6348,869586
2/20/22,Belarus,53.7098,27.9534,883217,0,6361,876856
2/21/22,Belarus,53.7098,27.9534,887582,0,6375,881207
2/22/22,Belarus,53.7098,27.9534,890089,0,6392,883697
2/23/22,Belarus,53.7098,27.9534,896319,0,6407,889912
2/24/22,Belarus,53.7098,27.9534,902315,0,6421,895894
2/25/22,Belarus,53.7098,27.9534,907978,0,6438,901540
2/26/22,Belarus,53.7098,27.9534,913333,0,6454,906879
2/27/22,Belarus,53.7098,27.9534,917468,0,6470,910998
2/28/22,Belarus,53.7098,27.9534,919736,0,6480,913256
3/1/22,Belarus,53.7098,27.9534,921263,0,6493,914770
3/2/22,Belarus,53.7098,27.9534,923432,0,6506,916926
3/3/22,Belarus,53.7098,27.9534,925515,0,6521,918994
3/4/22,Belarus,53.7098,27.9534,927464,0,6535,920929
3/5/22,Belarus,53.7098,27.9534,929340,0,6550,922790
3/6/22,Belarus,53.7098,27.9534,931002,0,6566,924436
3/7/22,Belarus,53.7098,27.9534,932207,0,6579,925628
3/8/22,Belarus,53.7098,27.9534,932949,0,6594,926355
3/9/22,Belarus,53.7098,27.9534,934187,0,6608,927579
3/10/22,Belarus,53.7098,27.9534,935684,0,6618,929066
3/11/22,Belarus,53.7098,27.9534,937583,0,6633,930950
3/12/22,Belarus,53.7098,27.9534,939514,0,6647,932867
3/13/22,Belarus,53.7098,27.9534,941168,0,6661,934507
3/14/22,Belarus,53.7098,27.9534,942334,0,6670,935664
3/15/22,Belarus,53.7098,27.9534,943027,0,6681,936346
3/16/22,Belarus,53.7098,27.9534,944885,0,6688,938197
3/17/22,Belarus,53.7098,27.9534,946674,0,6698,939976
3/18/22,Belarus,53.7098,27.9534,948416,0,6705,941711
3/19/22,Belarus,53.7098,27.9534,949994,0,6716,943278
3/20/22,Belarus,53.7098,27.9534,951081,0,6722,944359
3/21/22,Belarus,53.7098,27.9534,951758,0,6727,945031
3/22/22,Belarus,53.7098,27.9534,952254,0,6737,945517
3/23/22,Belarus,53.7098,27.9534,953901,0,6747,947154
3/24/22,Belarus,53.7098,27.9534,955600,0,6759,948841
3/25/22,Belarus,53.7098,27.9534,957088,0,6767,950321
3/26/22,Belarus,53.7098,27.9534,958492,0,6778,951714
3/27/22,Belarus,53.7098,27.9534,959276,0,6785,952491
3/28/22,Belarus,53.7098,27.9534,959802,0,6791,953011
3/29/22,Belarus,53.7098,27.9534,960245,0,6799,953446
3/30/22,Belarus,53.7098,27.9534,961389,0,6810,954579
3/31/22,Belarus,53.7098,27.9534,962707,0,6819,955888
4/1/22,Belarus,53.7098,27.9534,963756,0,6829,956927
4/2/22,Belarus,53.7098,27.9534,964677,0,6836,957841
4/3/22,Belarus,53.7098,27.9534,965322,0,6844,958478
4/4/22,Belarus,53.7098,27.9534,965654,0,6849,958805
4/5/22,Belarus,53.7098,27.9534,965948,0,6853,959095
4/6/22,Belarus,53.7098,27.9534,966818,0,6862,959956
4/7/22,Belarus,53.7098,27.9534,967731,0,6866,960865
4/8/22,Belarus,53.7098,27.9534,968676,0,6870,961806
4/9/22,Belarus,53.7098,27.9534,969616,0,6872,962744
4/10/22,Belarus,53.7098,27.9534,970141,0,6872,963269
4/11/22,Belarus,53.7098,27.9534,970443,0,6877,963566
4/12/22,Belarus,53.7098,27.9534,970750,0,6882,963868
4/13/22,Belarus,53.7098,27.9534,971649,0,6885,964764
4/14/22,Belarus,53.7098,27.9534,972448,0,6889,965559
4/15/22,Belarus,53.7098,27.9534,973206,0,6894,966312
4/16/22,Belarus,53.7098,27.9534,974046,0,6899,967147
4/17/22,Belarus,53.7098,27.9534,974478,0,6901,967577
4/18/22,Belarus,53.7098,27.9534,974714,0,6903,967811
4/19/22,Belarus,53.7098,27.9534,974961,0,6908,968053
4/20/22,Belarus,53.7098,27.9534,975566,0,6914,968652
4/21/22,Belarus,53.7098,27.9534,976261,0,6917,969344
4/22/22,Belarus,53.7098,27.9534,976906,0,6920,969986
4/23/22,Belarus,53.7098,27.9534,977434,0,6922,970512
4/24/22,Belarus,53.7098,27.9534,977813,0,6926,970887
4/25/22,Belarus,53.7098,27.9534,977962,0,6928,971034
4/26/22,Belarus,53.7098,27.9534,978117,0,6931,971186
4/27/22,Belarus,53.7098,27.9534,978773,0,6936,971837
4/28/22,Belarus,53.7098,27.9534,979346,0,6940,972406
4/29/22,Belarus,53.7098,27.9534,979909,0,6943,972966
4/30/22,Belarus,53.7098,27.9534,980345,0,6947,973398
5/1/22,Belarus,53.7098,27.9534,980680,0,6947,973733
5/2/22,Belarus,53.7098,27.9534,980828,0,6947,973881
5/3/22,Belarus,53.7098,27.9534,980868,0,6954,973914
5/4/22,Belarus,53.7098,27.9534,981070,0,6958,974112
5/5/22,Belarus,53.7098,27.9534,981259,0,6963,974296
5/6/22,Belarus,53.7098,27.9534,981838,0,6966,974872
5/7/22,Belarus,53.7098,27.9534,982331,0,6966,975365
5/8/22,Belarus,53.7098,27.9534,982654,0,6969,975685
5/9/22,Belarus,53.7098,27.9534,982809,0,6969,975840
5/10/22,Belarus,53.7098,27.9534,982867,0,6978,975889
5/11/22,Belarus,53.7098,27.9534,982867,0,6978,975889
5/12/22,Belarus,53.7098,27.9534,982867,0,6978,975889
5/13/22,Belarus,53.7098,27.9534,982867,0,6978,975889
5/14/22,Belarus,53.7098,27.9534,982867,0,6978,975889
5/15/22,Belarus,53.7098,27.9534,982867,0,6978,975889
5/16/22,Belarus,53.7098,27.9534,982867,0,6978,975889
5/17/22,Belarus,53.7098,27.9534,982867,0,6978,975889
5/18/22,Belarus,53.7098,27.9534,982867,0,6978,975889
5/19/22,Belarus,53.7098,27.9534,982867,0,6978,975889
5/20/22,Belarus,53.7098,27.9534,982867,0,6978,975889
5/21/22,Belarus,53.7098,27.9534,982867,0,6978,975889
5/22/22,Belarus,53.7098,27.9534,982867,0,6978,975889
5/23/22,Belarus,53.7098,27.9534,982867,0,6978,975889
5/24/22,Belarus,53.7098,27.9534,982867,0,6978,975889
5/25/22,Belarus,53.7098,27.9534,982867,0,6978,975889
5/26/22,Belarus,53.7098,27.9534,982867,0,6978,975889
5/27/22,Belarus,53.7098,27.9534,982867,0,6978,975889
5/28/22,Belarus,53.7098,27.9534,982867,0,6978,975889
5/29/22,Belarus,53.7098,27.9534,982867,0,6978,975889
5/30/22,Belarus,53.7098,27.9534,982867,0,6978,975889
5/31/22,Belarus,53.7098,27.9534,982867,0,6978,975889
6/1/22,Belarus,53.7098,27.9534,982867,0,6978,975889
6/2/22,Belarus,53.7098,27.9534,982867,0,6978,975889
6/3/22,Belarus,53.7098,27.9534,982867,0,6978,975889
6/4/22,Belarus,53.7098,27.9534,982867,0,6978,975889
6/5/22,Belarus,53.7098,27.9534,982867,0,6978,975889
6/6/22,Belarus,53.7098,27.9534,982867,0,6978,975889
6/7/22,Belarus,53.7098,27.9534,982867,0,6978,975889
6/8/22,Belarus,53.7098,27.9534,982867,0,6978,975889
6/9/22,Belarus,53.7098,27.9534,982867,0,6978,975889
6/10/22,Belarus,53.7098,27.9534,982867,0,6978,975889
6/11/22,Belarus,53.7098,27.9534,982867,0,6978,975889
6/12/22,Belarus,53.7098,27.9534,982867,0,6978,975889
6/13/22,Belarus,53.7098,27.9534,982867,0,6978,975889
6/14/22,Belarus,53.7098,27.9534,982867,0,6978,975889
6/15/22,Belarus,53.7098,27.9534,982867,0,6978,975889
6/16/22,Belarus,53.7098,27.9534,982867,0,6978,975889
6/17/22,Belarus,53.7098,27.9534,982867,0,6978,975889
6/18/22,Belarus,53.7098,27.9534,982867,0,6978,975889
6/19/22,Belarus,53.7098,27.9534,982867,0,6978,975889
6/20/22,Belarus,53.7098,27.9534,982867,0,6978,975889
6/21/22,Belarus,53.7098,27.9534,982867,0,6978,975889
6/22/22,Belarus,53.7098,27.9534,982867,0,6978,975889
6/23/22,Belarus,53.7098,27.9534,982867,0,6978,975889
6/24/22,Belarus,53.7098,27.9534,982867,0,6978,975889
6/25/22,Belarus,53.7098,27.9534,982867,0,6978,975889
6/26/22,Belarus,53.7098,27.9534,982867,0,6978,975889
6/27/22,Belarus,53.7098,27.9534,982867,0,6978,975889
6/28/22,Belarus,53.7098,27.9534,982867,0,6978,975889
6/29/22,Belarus,53.7098,27.9534,982867,0,6978,975889
6/30/22,Belarus,53.7098,27.9534,982867,0,6978,975889
7/1/22,Belarus,53.7098,27.9534,982867,0,6978,975889
7/2/22,Belarus,53.7098,27.9534,982867,0,6978,975889
7/3/22,Belarus,53.7098,27.9534,982867,0,6978,975889
7/4/22,Belarus,53.7098,27.9534,982867,0,6978,975889
7/5/22,Belarus,53.7098,27.9534,994037,0,7118,986919
7/6/22,Belarus,53.7098,27.9534,994037,0,7118,986919
7/7/22,Belarus,53.7098,27.9534,994037,0,7118,986919
7/8/22,Belarus,53.7098,27.9534,994037,0,7118,986919
7/9/22,Belarus,53.7098,27.9534,994037,0,7118,986919
7/10/22,Belarus,53.7098,27.9534,994037,0,7118,986919
7/11/22,Belarus,53.7098,27.9534,994037,0,7118,986919
7/12/22,Belarus,53.7098,27.9534,994037,0,7118,986919
7/13/22,Belarus,53.7098,27.9534,994037,0,7118,986919
7/14/22,Belarus,53.7098,27.9534,994037,0,7118,986919
7/15/22,Belarus,53.7098,27.9534,994037,0,7118,986919
7/16/22,Belarus,53.7098,27.9534,994037,0,7118,986919
7/17/22,Belarus,53.7098,27.9534,994037,0,7118,986919
7/18/22,Belarus,53.7098,27.9534,994037,0,7118,986919
7/19/22,Belarus,53.7098,27.9534,994037,0,7118,986919
7/20/22,Belarus,53.7098,27.9534,994037,0,7118,986919
7/21/22,Belarus,53.7098,27.9534,994037,0,7118,986919
7/22/22,Belarus,53.7098,27.9534,994037,0,7118,986919
7/23/22,Belarus,53.7098,27.9534,994037,0,7118,986919
7/24/22,Belarus,53.7098,27.9534,994037,0,7118,986919
7/25/22,Belarus,53.7098,27.9534,994037,0,7118,986919
7/26/22,Belarus,53.7098,27.9534,994037,0,7118,986919
7/27/22,Belarus,53.7098,27.9534,994037,0,7118,986919
7/28/22,Belarus,53.7098,27.9534,994037,0,7118,986919
7/29/22,Belarus,53.7098,27.9534,994037,0,7118,986919
7/30/22,Belarus,53.7098,27.9534,994037,0,7118,986919
7/31/22,Belarus,53.7098,27.9534,994037,0,7118,986919
8/1/22,Belarus,53.7098,27.9534,994037,0,7118,986919
8/2/22,Belarus,53.7098,27.9534,994037,0,7118,986919
8/3/22,Belarus,53.7098,27.9534,994037,0,7118,986919
8/4/22,Belarus,53.7098,27.9534,994037,0,7118,986919
8/5/22,Belarus,53.7098,27.9534,994037,0,7118,986919
8/6/22,Belarus,53.7098,27.9534,994037,0,7118,986919
8/7/22,Belarus,53.7098,27.9534,994037,0,7118,986919
8/8/22,Belarus,53.7098,27.9534,994037,0,7118,986919
8/9/22,Belarus,53.7098,27.9534,994037,0,7118,986919
8/10/22,Belarus,53.7098,27.9534,994037,0,7118,986919
8/11/22,Belarus,53.7098,27.9534,994037,0,7118,986919
8/12/22,Belarus,53.7098,27.9534,994037,0,7118,986919
8/13/22,Belarus,53.7098,27.9534,994037,0,7118,986919
8/14/22,Belarus,53.7098,27.9534,994037,0,7118,986919
8/15/22,Belarus,53.7098,27.9534,994037,0,7118,986919
8/16/22,Belarus,53.7098,27.9534,994037,0,7118,986919
8/17/22,Belarus,53.7098,27.9534,994037,0,7118,986919
8/18/22,Belarus,53.7098,27.9534,994037,0,7118,986919
8/19/22,Belarus,53.7098,27.9534,994037,0,7118,986919
8/20/22,Belarus,53.7098,27.9534,994037,0,7118,986919
8/21/22,Belarus,53.7098,27.9534,994037,0,7118,986919
8/22/22,Belarus,53.7098,27.9534,994037,0,7118,986919
8/23/22,Belarus,53.7098,27.9534,994037,0,7118,986919
8/24/22,Belarus,53.7098,27.9534,994037,0,7118,986919
8/25/22,Belarus,53.7098,27.9534,994037,0,7118,986919
8/26/22,Belarus,53.7098,27.9534,994037,0,7118,986919
8/27/22,Belarus,53.7098,27.9534,994037,0,7118,986919
8/28/22,Belarus,53.7098,27.9534,994037,0,7118,986919
8/29/22,Belarus,53.7098,27.9534,994037,0,7118,986919
8/30/22,Belarus,53.7098,27.9534,994037,0,7118,986919
8/31/22,Belarus,53.7098,27.9534,994037,0,7118,986919
9/1/22,Belarus,53.7098,27.9534,994037,0,7118,986919
9/2/22,Belarus,53.7098,27.9534,994037,0,7118,986919
9/3/22,Belarus,53.7098,27.9534,994037,0,7118,986919
9/4/22,Belarus,53.7098,27.9534,994037,0,7118,986919
9/5/22,Belarus,53.7098,27.9534,994037,0,7118,986919
9/6/22,Belarus,53.7098,27.9534,994037,0,7118,986919
9/7/22,Belarus,53.7098,27.9534,994037,0,7118,986919
9/8/22,Belarus,53.7098,27.9534,994037,0,7118,986919
9/9/22,Belarus,53.7098,27.9534,994037,0,7118,986919
9/10/22,Belarus,53.7098,27.9534,994037,0,7118,986919
9/11/22,Belarus,53.7098,27.9534,994037,0,7118,986919
9/12/22,Belarus,53.7098,27.9534,994037,0,7118,986919
9/13/22,Belarus,53.7098,27.9534,994037,0,7118,986919
9/14/22,Belarus,53.7098,27.9534,994037,0,7118,986919
9/15/22,Belarus,53.7098,27.9534,994037,0,7118,986919
9/16/22,Belarus,53.7098,27.9534,994037,0,7118,986919
9/17/22,Belarus,53.7098,27.9534,994037,0,7118,986919
9/18/22,Belarus,53.7098,27.9534,994037,0,7118,986919
9/19/22,Belarus,53.7098,27.9534,994037,0,7118,986919
9/20/22,Belarus,53.7098,27.9534,994037,0,7118,986919
9/21/22,Belarus,53.7098,27.9534,994037,0,7118,986919
9/22/22,Belarus,53.7098,27.9534,994037,0,7118,986919
9/23/22,Belarus,53.7098,27.9534,994037,0,7118,986919
9/24/22,Belarus,53.7098,27.9534,994037,0,7118,986919
9/25/22,Belarus,53.7098,27.9534,994037,0,7118,986919
9/26/22,Belarus,53.7098,27.9534,994037,0,7118,986919
9/27/22,Belarus,53.7098,27.9534,994037,0,7118,986919
9/28/22,Belarus,53.7098,27.9534,994037,0,7118,986919
9/29/22,Belarus,53.7098,27.9534,994037,0,7118,986919
9/30/22,Belarus,53.7098,27.9534,994037,0,7118,986919
10/1/22,Belarus,53.7098,27.9534,994037,0,7118,986919
10/2/22,Belarus,53.7098,27.9534,994037,0,7118,986919
10/3/22,Belarus,53.7098,27.9534,994037,0,7118,986919
10/4/22,Belarus,53.7098,27.9534,994037,0,7118,986919
10/5/22,Belarus,53.7098,27.9534,994037,0,7118,986919
10/6/22,Belarus,53.7098,27.9534,994037,0,7118,986919
10/7/22,Belarus,53.7098,27.9534,994037,0,7118,986919
10/8/22,Belarus,53.7098,27.9534,994037,0,7118,986919
10/9/22,Belarus,53.7098,27.9534,994037,0,7118,986919
10/10/22,Belarus,53.7098,27.9534,994037,0,7118,986919
10/11/22,Belarus,53.7098,27.9534,994037,0,7118,986919
10/12/22,Belarus,53.7098,27.9534,994037,0,7118,986919
10/13/22,Belarus,53.7098,27.9534,994037,0,7118,986919
10/14/22,Belarus,53.7098,27.9534,994037,0,7118,986919
10/15/22,Belarus,53.7098,27.9534,994037,0,7118,986919
10/16/22,Belarus,53.7098,27.9534,994037,0,7118,986919
10/17/22,Belarus,53.7098,27.9534,994037,0,7118,986919
10/18/22,Belarus,53.7098,27.9534,994037,0,7118,986919
10/19/22,Belarus,53.7098,27.9534,994037,0,7118,986919
10/20/22,Belarus,53.7098,27.9534,994037,0,7118,986919
10/21/22,Belarus,53.7098,27.9534,994037,0,7118,986919
10/22/22,Belarus,53.7098,27.9534,994037,0,7118,986919
10/23/22,Belarus,53.7098,27.9534,994037,0,7118,986919
10/24/22,Belarus,53.7098,27.9534,994037,0,7118,986919
10/25/22,Belarus,53.7098,27.9534,994037,0,7118,986919
10/26/22,Belarus,53.7098,27.9534,994037,0,7118,986919
10/27/22,Belarus,53.7098,27.9534,994037,0,7118,986919
10/28/22,Belarus,53.7098,27.9534,994037,0,7118,986919
10/29/22,Belarus,53.7098,27.9534,994037,0,7118,986919
10/30/22,Belarus,53.7098,27.9534,994037,0,7118,986919
10/31/22,Belarus,53.7098,27.9534,994037,0,7118,986919
11/1/22,Belarus,53.7098,27.9534,994037,0,7118,986919
11/2/22,Belarus,53.7098,27.9534,994037,0,7118,986919
11/3/22,Belarus,53.7098,27.9534,994037,0,7118,986919
11/4/22,Belarus,53.7098,27.9534,994037,0,7118,986919
11/5/22,Belarus,53.7098,27.9534,994037,0,7118,986919
11/6/22,Belarus,53.7098,27.9534,994037,0,7118,986919
11/7/22,Belarus,53.7098,27.9534,994037,0,7118,986919
11/8/22,Belarus,53.7098,27.9534,994037,0,7118,986919
11/9/22,Belarus,53.7098,27.9534,994037,0,7118,986919
11/10/22,Belarus,53.7098,27.9534,994037,0,7118,986919
11/11/22,Belarus,53.7098,27.9534,994037,0,7118,986919
11/12/22,Belarus,53.7098,27.9534,994037,0,7118,986919
11/13/22,Belarus,53.7098,27.9534,994037,0,7118,986919
11/14/22,Belarus,53.7098,27.9534,994037,0,7118,986919
11/15/22,Belarus,53.7098,27.9534,994037,0,7118,986919
11/16/22,Belarus,53.7098,27.9534,994037,0,7118,986919
11/17/22,Belarus,53.7098,27.9534,994037,0,7118,986919
11/18/22,Belarus,53.7098,27.9534,994037,0,7118,986919
11/19/22,Belarus,53.7098,27.9534,994037,0,7118,986919
11/20/22,Belarus,53.7098,27.9534,994037,0,7118,986919
11/21/22,Belarus,53.7098,27.9534,994037,0,7118,986919
11/22/22,Belarus,53.7098,27.9534,994037,0,7118,986919
11/23/22,Belarus,53.7098,27.9534,994037,0,7118,986919
11/24/22,Belarus,53.7098,27.9534,994037,0,7118,986919
11/25/22,Belarus,53.7098,27.9534,994037,0,7118,986919
11/26/22,Belarus,53.7098,27.9534,994037,0,7118,986919
11/27/22,Belarus,53.7098,27.9534,994037,0,7118,986919
11/28/22,Belarus,53.7098,27.9534,994037,0,7118,986919
11/29/22,Belarus,53.7098,27.9534,994037,0,7118,986919
11/30/22,Belarus,53.7098,27.9534,994037,0,7118,986919
12/1/22,Belarus,53.7098,27.9534,994037,0,7118,986919
12/2/22,Belarus,53.7098,27.9534,994037,0,7118,986919
12/3/22,Belarus,53.7098,27.9534,994037,0,7118,986919
12/4/22,Belarus,53.7098,27.9534,994037,0,7118,986919
12/5/22,Belarus,53.7098,27.9534,994037,0,7118,986919
12/6/22,Belarus,53.7098,27.9534,994037,0,7118,986919
12/7/22,Belarus,53.7098,27.9534,994037,0,7118,986919
12/8/22,Belarus,53.7098,27.9534,994037,0,7118,986919
12/9/22,Belarus,53.7098,27.9534,994037,0,7118,986919
12/10/22,Belarus,53.7098,27.9534,994037,0,7118,986919
12/11/22,Belarus,53.7098,27.9534,994037,0,7118,986919
12/12/22,Belarus,53.7098,27.9534,994037,0,7118,986919
12/13/22,Belarus,53.7098,27.9534,994037,0,7118,986919
12/14/22,Belarus,53.7098,27.9534,994037,0,7118,986919
12/15/22,Belarus,53.7098,27.9534,994037,0,7118,986919
12/16/22,Belarus,53.7098,27.9534,994037,0,7118,986919
12/17/22,Belarus,53.7098,27.9534,994037,0,7118,986919
1/1/22,Belgium,50.8333,4.469936,2105343,0,28331,2077012
1/2/22,Belgium,50.8333,4.469936,2105343,0,28331,2077012
1/3/22,Belgium,50.8333,4.469936,2133284,0,28385,2104899
1/4/22,Belgium,50.8333,4.469936,2151914,0,28407,2123507
1/5/22,Belgium,50.8333,4.469936,2179710,0,28429,2151281
1/6/22,Belgium,50.8333,4.469936,2206992,0,28446,2178546
1/7/22,Belgium,50.8333,4.469936,2231686,0,28459,2203227
1/8/22,Belgium,50.8333,4.469936,2231686,0,28459,2203227
1/9/22,Belgium,50.8333,4.469936,2231686,0,28459,2203227
1/10/22,Belgium,50.8333,4.469936,2286532,0,28518,2258014
1/11/22,Belgium,50.8333,4.469936,2307843,0,28539,2279304
1/12/22,Belgium,50.8333,4.469936,2347164,0,28566,2318598
1/13/22,Belgium,50.8333,4.469936,2347164,0,28566,2318598
1/14/22,Belgium,50.8333,4.469936,2410731,0,28612,2382119
1/15/22,Belgium,50.8333,4.469936,2410731,0,28612,2382119
1/16/22,Belgium,50.8333,4.469936,2410731,0,28612,2382119
1/17/22,Belgium,50.8333,4.469936,2484027,0,28661,2455366
1/18/22,Belgium,50.8333,4.469936,2521462,0,28695,2492767
1/19/22,Belgium,50.8333,4.469936,2575313,0,28726,2546587
1/20/22,Belgium,50.8333,4.469936,2642761,0,28759,2614002
1/21/22,Belgium,50.8333,4.469936,2697239,0,28780,2668459
1/22/22,Belgium,50.8333,4.469936,2697239,0,28780,2668459
1/23/22,Belgium,50.8333,4.469936,2697239,0,28780,2668459
1/24/22,Belgium,50.8333,4.469936,2830719,0,28835,2801884
1/25/22,Belgium,50.8333,4.469936,2878212,0,28863,2849349
1/26/22,Belgium,50.8333,4.469936,2939439,0,28902,2910537
1/27/22,Belgium,50.8333,4.469936,3007724,0,28938,2978786
1/28/22,Belgium,50.8333,4.469936,3055925,0,28957,3026968
1/29/22,Belgium,50.8333,4.469936,3055925,0,28957,3026968
1/30/22,Belgium,50.8333,4.469936,3055925,0,28957,3026968
1/31/22,Belgium,50.8333,4.469936,3155239,0,29052,3126187
2/1/22,Belgium,50.8333,4.469936,3184201,0,29083,3155118
2/2/22,Belgium,50.8333,4.469936,3229629,0,29132,3200497
2/3/22,Belgium,50.8333,4.469936,3267656,0,29185,3238471
2/4/22,Belgium,50.8333,4.469936,3296038,0,29227,3266811
2/5/22,Belgium,50.8333,4.469936,3296038,0,29227,3266811
2/6/22,Belgium,50.8333,4.469936,3296038,0,29227,3266811
2/7/22,Belgium,50.8333,4.469936,3344833,0,29337,3315496
2/8/22,Belgium,50.8333,4.469936,3363890,0,29429,3334461
2/9/22,Belgium,50.8333,4.469936,3386223,0,29497,3356726
2/10/22,Belgium,50.8333,4.469936,3405839,0,29563,3376276
2/11/22,Belgium,50.8333,4.469936,3421081,0,29624,3391457
2/12/22,Belgium,50.8333,4.469936,3421081,0,29624,3391457
2/13/22,Belgium,50.8333,4.469936,3421081,0,29624,3391457
2/14/22,Belgium,50.8333,4.469936,3447539,0,29724,3417815
2/15/22,Belgium,50.8333,4.469936,3460301,0,29778,3430523
2/16/22,Belgium,50.8333,4.469936,3473015,0,29832,3443183
2/17/22,Belgium,50.8333,4.469936,3484518,0,29886,3454632
2/18/22,Belgium,50.8333,4.469936,3494223,0,29920,3464303
2/19/22,Belgium,50.8333,4.469936,3494223,0,29920,3464303
2/20/22,Belgium,50.8333,4.469936,3494223,0,29920,3464303
2/21/22,Belgium,50.8333,4.469936,3512212,0,30015,3482197
2/22/22,Belgium,50.8333,4.469936,3520568,0,30040,3490528
2/23/22,Belgium,50.8333,4.469936,3529041,0,30076,3498965
2/24/22,Belgium,50.8333,4.469936,3537675,0,30101,3507574
2/25/22,Belgium,50.8333,4.469936,3544034,0,30121,3513913
2/26/22,Belgium,50.8333,4.469936,3544034,0,30121,3513913
2/27/22,Belgium,50.8333,4.469936,3544034,0,30121,3513913
2/28/22,Belgium,50.8333,4.469936,3557314,0,30179,3527135
3/1/22,Belgium,50.8333,4.469936,3563841,0,30199,3533642
3/2/22,Belgium,50.8333,4.469936,3563841,0,30199,3533642
3/3/22,Belgium,50.8333,4.469936,3571579,0,30217,3541362
3/4/22,Belgium,50.8333,4.469936,3586292,0,30259,3556033
3/5/22,Belgium,50.8333,4.469936,3586292,0,30259,3556033
3/6/22,Belgium,50.8333,4.469936,3586292,0,30259,3556033
3/7/22,Belgium,50.8333,4.469936,3601627,0,30296,3571331
3/8/22,Belgium,50.8333,4.469936,3609122,0,30313,3578809
3/9/22,Belgium,50.8333,4.469936,3609122,0,30313,3578809
3/10/22,Belgium,50.8333,4.469936,3629671,0,30380,3599291
3/11/22,Belgium,50.8333,4.469936,3640052,0,30408,3609644
3/12/22,Belgium,50.8333,4.469936,3640052,0,30408,3609644
3/13/22,Belgium,50.8333,4.469936,3640052,0,30408,3609644
3/14/22,Belgium,50.8333,4.469936,3658084,0,30445,3627639
3/15/22,Belgium,50.8333,4.469936,3658084,0,30445,3627639
3/16/22,Belgium,50.8333,4.469936,3683784,0,30492,3653292
3/17/22,Belgium,50.8333,4.469936,3696059,0,30510,3665549
3/18/22,Belgium,50.8333,4.469936,3696059,0,30510,3665549
3/19/22,Belgium,50.8333,4.469936,3707561,0,30529,3677032
3/20/22,Belgium,50.8333,4.469936,3707561,0,30529,3677032
3/21/22,Belgium,50.8333,4.469936,3728945,0,30575,3698370
3/22/22,Belgium,50.8333,4.469936,3741614,0,30605,3711009
3/23/22,Belgium,50.8333,4.469936,3757776,0,30635,3727141
3/24/22,Belgium,50.8333,4.469936,3771233,0,30662,3740571
3/25/22,Belgium,50.8333,4.469936,3782085,0,30686,3751399
3/26/22,Belgium,50.8333,4.469936,3782085,0,30686,3751399
3/27/22,Belgium,50.8333,4.469936,3782085,0,30686,3751399
3/28/22,Belgium,50.8333,4.469936,3807447,0,30747,3776700
3/29/22,Belgium,50.8333,4.469936,3807447,0,30747,3776700
3/30/22,Belgium,50.8333,4.469936,3807447,0,30747,3776700
3/31/22,Belgium,50.8333,4.469936,3851048,0,30826,3820222
4/1/22,Belgium,50.8333,4.469936,3851048,0,30826,3820222
4/2/22,Belgium,50.8333,4.469936,3851048,0,30826,3820222
4/3/22,Belgium,50.8333,4.469936,3851048,0,30826,3820222
4/4/22,Belgium,50.8333,4.469936,3881523,0,30908,3850615
4/5/22,Belgium,50.8333,4.469936,3881523,0,30908,3850615
4/6/22,Belgium,50.8333,4.469936,3881523,0,30908,3850615
4/7/22,Belgium,50.8333,4.469936,3915732,0,30997,3884735
4/8/22,Belgium,50.8333,4.469936,3915732,0,30997,3884735
4/9/22,Belgium,50.8333,4.469936,3915732,0,30997,3884735
4/10/22,Belgium,50.8333,4.469936,3915732,0,30997,3884735
4/11/22,Belgium,50.8333,4.469936,3943831,0,31079,3912752
4/12/22,Belgium,50.8333,4.469936,3943831,0,31079,3912752
4/13/22,Belgium,50.8333,4.469936,3943831,0,31079,3912752
4/14/22,Belgium,50.8333,4.469936,3972963,0,31165,3941798
4/15/22,Belgium,50.8333,4.469936,3972963,0,31165,3941798
4/16/22,Belgium,50.8333,4.469936,3972963,0,31165,3941798
4/17/22,Belgium,50.8333,4.469936,3972963,0,31165,3941798
4/18/22,Belgium,50.8333,4.469936,3972963,0,31165,3941798
4/19/22,Belgium,50.8333,4.469936,3998722,0,31262,3967460
4/20/22,Belgium,50.8333,4.469936,3998722,0,31262,3967460
4/21/22,Belgium,50.8333,4.469936,4015791,0,31319,3984472
4/22/22,Belgium,50.8333,4.469936,4015791,0,31319,3984472
4/23/22,Belgium,50.8333,4.469936,4015791,0,31319,3984472
4/24/22,Belgium,50.8333,4.469936,4015791,0,31319,3984472
4/25/22,Belgium,50.8333,4.469936,4015791,0,31319,3984472
4/26/22,Belgium,50.8333,4.469936,4036113,0,31382,4004731
4/27/22,Belgium,50.8333,4.469936,4036113,0,31382,4004731
4/28/22,Belgium,50.8333,4.469936,4056448,0,31439,4025009
4/29/22,Belgium,50.8333,4.469936,4056448,0,31439,4025009
4/30/22,Belgium,50.8333,4.469936,4056448,0,31439,4025009
5/1/22,Belgium,50.8333,4.469936,4056448,0,31439,4025009
5/2/22,Belgium,50.8333,4.469936,4071279,0,31494,4039785
5/3/22,Belgium,50.8333,4.469936,4071279,0,31494,4039785
5/4/22,Belgium,50.8333,4.469936,4071279,0,31494,4039785
5/5/22,Belgium,50.8333,4.469936,4088336,0,31552,4056784
5/6/22,Belgium,50.8333,4.469936,4088336,0,31552,4056784
5/7/22,Belgium,50.8333,4.469936,4088336,0,31552,4056784
5/8/22,Belgium,50.8333,4.469936,4088336,0,31552,4056784
5/9/22,Belgium,50.8333,4.469936,4102082,0,31580,4070502
5/10/22,Belgium,50.8333,4.469936,4102082,0,31580,4070502
5/11/22,Belgium,50.8333,4.469936,4102082,0,31580,4070502
5/12/22,Belgium,50.8333,4.469936,4116397,0,31613,4084784
5/13/22,Belgium,50.8333,4.469936,4116397,0,31613,4084784
5/14/22,Belgium,50.8333,4.469936,4116397,0,31613,4084784
5/15/22,Belgium,50.8333,4.469936,4116397,0,31613,4084784
5/16/22,Belgium,50.8333,4.469936,4127123,0,31656,4095467
5/17/22,Belgium,50.8333,4.469936,4127123,0,31656,4095467
5/18/22,Belgium,50.8333,4.469936,4134293,0,31675,4102618
5/19/22,Belgium,50.8333,4.469936,4134293,0,31675,4102618
5/20/22,Belgium,50.8333,4.469936,4134293,0,31675,4102618
5/21/22,Belgium,50.8333,4.469936,4134293,0,31675,4102618
5/22/22,Belgium,50.8333,4.469936,4134293,0,31675,4102618
5/23/22,Belgium,50.8333,4.469936,4143408,0,31710,4111698
5/24/22,Belgium,50.8333,4.469936,4143408,0,31710,4111698
5/25/22,Belgium,50.8333,4.469936,4147568,0,31727,4115841
5/26/22,Belgium,50.8333,4.469936,4147568,0,31727,4115841
5/27/22,Belgium,50.8333,4.469936,4147568,0,31727,4115841
5/28/22,Belgium,50.8333,4.469936,4147568,0,31727,4115841
5/29/22,Belgium,50.8333,4.469936,4147568,0,31727,4115841
5/30/22,Belgium,50.8333,4.469936,4152558,0,31754,4120804
5/31/22,Belgium,50.8333,4.469936,4152558,0,31754,4120804
6/1/22,Belgium,50.8333,4.469936,4152558,0,31754,4120804
6/2/22,Belgium,50.8333,4.469936,4158754,0,31768,4126986
6/3/22,Belgium,50.8333,4.469936,4158754,0,31768,4126986
6/4/22,Belgium,50.8333,4.469936,4158754,0,31768,4126986
6/5/22,Belgium,50.8333,4.469936,4158754,0,31768,4126986
6/6/22,Belgium,50.8333,4.469936,4158754,0,31768,4126986
6/7/22,Belgium,50.8333,4.469936,4164698,0,31799,4132899
6/8/22,Belgium,50.8333,4.469936,4164698,0,31799,4132899
6/9/22,Belgium,50.8333,4.469936,4170252,0,31816,4138436
6/10/22,Belgium,50.8333,4.469936,4170252,0,31816,4138436
6/11/22,Belgium,50.8333,4.469936,4170252,0,31816,4138436
6/12/22,Belgium,50.8333,4.469936,4170252,0,31816,4138436
6/13/22,Belgium,50.8333,4.469936,4177440,0,31835,4145605
6/14/22,Belgium,50.8333,4.469936,4177440,0,31835,4145605
6/15/22,Belgium,50.8333,4.469936,4177440,0,31835,4145605
6/16/22,Belgium,50.8333,4.469936,4187940,0,31856,4156084
6/17/22,Belgium,50.8333,4.469936,4187940,0,31856,4156084
6/18/22,Belgium,50.8333,4.469936,4187940,0,31856,4156084
6/19/22,Belgium,50.8333,4.469936,4187940,0,31856,4156084
6/20/22,Belgium,50.8333,4.469936,4197345,0,31868,4165477
6/21/22,Belgium,50.8333,4.469936,4197345,0,31868,4165477
6/22/22,Belgium,50.8333,4.469936,4197345,0,31868,4165477
6/23/22,Belgium,50.8333,4.469936,4211511,0,31883,4179628
6/24/22,Belgium,50.8333,4.469936,4211511,0,31883,4179628
6/25/22,Belgium,50.8333,4.469936,4211511,0,31883,4179628
6/26/22,Belgium,50.8333,4.469936,4211511,0,31883,4179628
6/27/22,Belgium,50.8333,4.469936,4225222,0,31903,4193319
6/28/22,Belgium,50.8333,4.469936,4225222,0,31903,4193319
6/29/22,Belgium,50.8333,4.469936,4225222,0,31903,4193319
6/30/22,Belgium,50.8333,4.469936,4246078,0,31918,4214160
7/1/22,Belgium,50.8333,4.469936,4246078,0,31918,4214160
7/2/22,Belgium,50.8333,4.469936,4246078,0,31918,4214160
7/3/22,Belgium,50.8333,4.469936,4246078,0,31918,4214160
7/4/22,Belgium,50.8333,4.469936,4265296,0,31952,4233344
7/5/22,Belgium,50.8333,4.469936,4265296,0,31952,4233344
7/6/22,Belgium,50.8333,4.469936,4265296,0,31952,4233344
7/7/22,Belgium,50.8333,4.469936,4294880,0,31977,4262903
7/8/22,Belgium,50.8333,4.469936,4294880,0,31977,4262903
7/9/22,Belgium,50.8333,4.469936,4294880,0,31977,4262903
7/10/22,Belgium,50.8333,4.469936,4294880,0,31977,4262903
7/11/22,Belgium,50.8333,4.469936,4320107,0,32015,4288092
7/12/22,Belgium,50.8333,4.469936,4320107,0,32015,4288092
7/13/22,Belgium,50.8333,4.469936,4320107,0,32015,4288092
7/14/22,Belgium,50.8333,4.469936,4349050,0,32051,4316999
7/15/22,Belgium,50.8333,4.469936,4349050,0,32051,4316999
7/16/22,Belgium,50.8333,4.469936,4349050,0,32051,4316999
7/17/22,Belgium,50.8333,4.469936,4349050,0,32051,4316999
7/18/22,Belgium,50.8333,4.469936,4368611,0,32089,4336522
7/19/22,Belgium,50.8333,4.469936,4368611,0,32089,4336522
7/20/22,Belgium,50.8333,4.469936,4381331,0,32118,4349213
7/21/22,Belgium,50.8333,4.469936,4381331,0,32118,4349213
7/22/22,Belgium,50.8333,4.469936,4381331,0,32118,4349213
7/23/22,Belgium,50.8333,4.469936,4381331,0,32118,4349213
7/24/22,Belgium,50.8333,4.469936,4381331,0,32118,4349213
7/25/22,Belgium,50.8333,4.469936,4398161,0,32179,4365982
7/26/22,Belgium,50.8333,4.469936,4398161,0,32179,4365982
7/27/22,Belgium,50.8333,4.469936,4398161,0,32179,4365982
7/28/22,Belgium,50.8333,4.469936,4414255,0,32228,4382027
7/29/22,Belgium,50.8333,4.469936,4414255,0,32228,4382027
7/30/22,Belgium,50.8333,4.469936,4414255,0,32228,4382027
7/31/22,Belgium,50.8333,4.469936,4414255,0,32228,4382027
8/1/22,Belgium,50.8333,4.469936,4425201,0,32263,4392938
8/2/22,Belgium,50.8333,4.469936,4425201,0,32263,4392938
8/3/22,Belgium,50.8333,4.469936,4425201,0,32263,4392938
8/4/22,Belgium,50.8333,4.469936,4425201,0,32263,4392938
8/5/22,Belgium,50.8333,4.469936,4437299,0,32296,4405003
8/6/22,Belgium,50.8333,4.469936,4437299,0,32296,4405003
8/7/22,Belgium,50.8333,4.469936,4437299,0,32296,4405003
8/8/22,Belgium,50.8333,4.469936,4444819,0,32329,4412490
8/9/22,Belgium,50.8333,4.469936,4444819,0,32329,4412490
8/10/22,Belgium,50.8333,4.469936,4444819,0,32329,4412490
8/11/22,Belgium,50.8333,4.469936,4453483,0,32364,4421119
8/12/22,Belgium,50.8333,4.469936,4453483,0,32364,4421119
8/13/22,Belgium,50.8333,4.469936,4453483,0,32364,4421119
8/14/22,Belgium,50.8333,4.469936,4453483,0,32364,4421119
8/15/22,Belgium,50.8333,4.469936,4453483,0,32364,4421119
8/16/22,Belgium,50.8333,4.469936,4460582,0,32410,4428172
8/17/22,Belgium,50.8333,4.469936,4460582,0,32410,4428172
8/18/22,Belgium,50.8333,4.469936,4466095,0,32436,4433659
8/19/22,Belgium,50.8333,4.469936,4466095,0,32436,4433659
8/20/22,Belgium,50.8333,4.469936,4466095,0,32436,4433659
8/21/22,Belgium,50.8333,4.469936,4466095,0,32436,4433659
8/22/22,Belgium,50.8333,4.469936,4471620,0,32463,4439157
8/23/22,Belgium,50.8333,4.469936,4471620,0,32463,4439157
8/24/22,Belgium,50.8333,4.469936,4471620,0,32463,4439157
8/25/22,Belgium,50.8333,4.469936,4477770,0,32496,4445274
8/26/22,Belgium,50.8333,4.469936,4477770,0,32496,4445274
8/27/22,Belgium,50.8333,4.469936,4477770,0,32496,4445274
8/28/22,Belgium,50.8333,4.469936,4477770,0,32496,4445274
8/29/22,Belgium,50.8333,4.469936,4482315,0,32516,4449799
8/30/22,Belgium,50.8333,4.469936,4482315,0,32516,4449799
8/31/22,Belgium,50.8333,4.469936,4482315,0,32516,4449799
9/1/22,Belgium,50.8333,4.469936,4488054,0,32534,4455520
9/2/22,Belgium,50.8333,4.469936,4488054,0,32534,4455520
9/3/22,Belgium,50.8333,4.469936,4488054,0,32534,4455520
9/4/22,Belgium,50.8333,4.469936,4488054,0,32534,4455520
9/5/22,Belgium,50.8333,4.469936,4492773,0,32561,4460212
9/6/22,Belgium,50.8333,4.469936,4492773,0,32561,4460212
9/7/22,Belgium,50.8333,4.469936,4497199,0,32575,4464624
9/8/22,Belgium,50.8333,4.469936,4497199,0,32575,4464624
9/9/22,Belgium,50.8333,4.469936,4497199,0,32575,4464624
9/10/22,Belgium,50.8333,4.469936,4497199,0,32575,4464624
9/11/22,Belgium,50.8333,4.469936,4497199,0,32575,4464624
9/12/22,Belgium,50.8333,4.469936,4497199,0,32575,4464624
9/13/22,Belgium,50.8333,4.469936,4504106,0,32605,4471501
9/14/22,Belgium,50.8333,4.469936,4504106,0,32605,4471501
9/15/22,Belgium,50.8333,4.469936,4511590,0,32625,4478965
9/16/22,Belgium,50.8333,4.469936,4511590,0,32625,4478965
9/17/22,Belgium,50.8333,4.469936,4511590,0,32625,4478965
9/18/22,Belgium,50.8333,4.469936,4511590,0,32625,4478965
9/19/22,Belgium,50.8333,4.469936,4511590,0,32625,4478965
9/20/22,Belgium,50.8333,4.469936,4517212,0,32636,4484576
9/21/22,Belgium,50.8333,4.469936,4517212,0,32636,4484576
9/22/22,Belgium,50.8333,4.469936,4525931,0,32647,4493284
9/23/22,Belgium,50.8333,4.469936,4525931,0,32647,4493284
9/24/22,Belgium,50.8333,4.469936,4525931,0,32647,4493284
9/25/22,Belgium,50.8333,4.469936,4525931,0,32647,4493284
9/26/22,Belgium,50.8333,4.469936,4533249,0,32659,4500590
9/27/22,Belgium,50.8333,4.469936,4533249,0,32659,4500590
9/28/22,Belgium,50.8333,4.469936,4533249,0,32659,4500590
9/29/22,Belgium,50.8333,4.469936,4544505,0,32673,4511832
9/30/22,Belgium,50.8333,4.469936,4544505,0,32673,4511832
10/1/22,Belgium,50.8333,4.469936,4544505,0,32673,4511832
10/2/22,Belgium,50.8333,4.469936,4544505,0,32673,4511832
10/3/22,Belgium,50.8333,4.469936,4553333,0,32690,4520643
10/4/22,Belgium,50.8333,4.469936,4553333,0,32690,4520643
10/5/22,Belgium,50.8333,4.469936,4553333,0,32690,4520643
10/6/22,Belgium,50.8333,4.469936,4566207,0,32716,4533491
10/7/22,Belgium,50.8333,4.469936,4566207,0,32716,4533491
10/8/22,Belgium,50.8333,4.469936,4566207,0,32716,4533491
10/9/22,Belgium,50.8333,4.469936,4566207,0,32716,4533491
10/10/22,Belgium,50.8333,4.469936,4575519,0,32746,4542773
10/11/22,Belgium,50.8333,4.469936,4575519,0,32746,4542773
10/12/22,Belgium,50.8333,4.469936,4575519,0,32746,4542773
10/13/22,Belgium,50.8333,4.469936,4586564,0,32776,4553788
10/14/22,Belgium,50.8333,4.469936,4586564,0,32776,4553788
10/15/22,Belgium,50.8333,4.469936,4586564,0,32776,4553788
10/16/22,Belgium,50.8333,4.469936,4586564,0,32776,4553788
10/17/22,Belgium,50.8333,4.469936,4594338,0,32810,4561528
10/18/22,Belgium,50.8333,4.469936,4594338,0,32810,4561528
10/19/22,Belgium,50.8333,4.469936,4594338,0,32810,4561528
10/20/22,Belgium,50.8333,4.469936,4602438,0,32846,4569592
10/21/22,Belgium,50.8333,4.469936,4602438,0,32846,4569592
10/22/22,Belgium,50.8333,4.469936,4602438,0,32846,4569592
10/23/22,Belgium,50.8333,4.469936,4602438,0,32846,4569592
10/24/22,Belgium,50.8333,4.469936,4607296,0,32883,4574413
10/25/22,Belgium,50.8333,4.469936,4607296,0,32883,4574413
10/26/22,Belgium,50.8333,4.469936,4607296,0,32883,4574413
10/27/22,Belgium,50.8333,4.469936,4612239,0,32902,4579337
10/28/22,Belgium,50.8333,4.469936,4612239,0,32902,4579337
10/29/22,Belgium,50.8333,4.469936,4612239,0,32902,4579337
10/30/22,Belgium,50.8333,4.469936,4612239,0,32902,4579337
10/31/22,Belgium,50.8333,4.469936,4612239,0,32902,4579337
11/1/22,Belgium,50.8333,4.469936,4612239,0,32902,4579337
11/2/22,Belgium,50.8333,4.469936,4612239,0,32902,4579337
11/3/22,Belgium,50.8333,4.469936,4617315,0,32941,4584374
11/4/22,Belgium,50.8333,4.469936,4617315,0,32941,4584374
11/5/22,Belgium,50.8333,4.469936,4617315,0,32941,4584374
11/6/22,Belgium,50.8333,4.469936,4617315,0,32941,4584374
11/7/22,Belgium,50.8333,4.469936,4619721,0,32959,4586762
11/8/22,Belgium,50.8333,4.469936,4619721,0,32959,4586762
11/9/22,Belgium,50.8333,4.469936,4619721,0,32959,4586762
11/10/22,Belgium,50.8333,4.469936,4622723,0,32976,4589747
11/11/22,Belgium,50.8333,4.469936,4622723,0,32976,4589747
11/12/22,Belgium,50.8333,4.469936,4622723,0,32976,4589747
11/13/22,Belgium,50.8333,4.469936,4622723,0,32976,4589747
11/14/22,Belgium,50.8333,4.469936,4624251,0,33000,4591251
11/15/22,Belgium,50.8333,4.469936,4624251,0,33000,4591251
11/16/22,Belgium,50.8333,4.469936,4624251,0,33000,4591251
11/17/22,Belgium,50.8333,4.469936,4627186,0,33021,4594165
11/18/22,Belgium,50.8333,4.469936,4627186,0,33021,4594165
11/19/22,Belgium,50.8333,4.469936,4627186,0,33021,4594165
11/20/22,Belgium,50.8333,4.469936,4627186,0,33021,4594165
11/21/22,Belgium,50.8333,4.469936,4627186,0,33021,4594165
11/22/22,Belgium,50.8333,4.469936,4629552,0,33027,4596525
11/23/22,Belgium,50.8333,4.469936,4629552,0,33027,4596525
11/24/22,Belgium,50.8333,4.469936,4633112,0,33042,4600070
11/25/22,Belgium,50.8333,4.469936,4633112,0,33042,4600070
11/26/22,Belgium,50.8333,4.469936,4633112,0,33042,4600070
11/27/22,Belgium,50.8333,4.469936,4633112,0,33042,4600070
11/28/22,Belgium,50.8333,4.469936,4636264,0,33057,4603207
11/29/22,Belgium,50.8333,4.469936,4636264,0,33057,4603207
11/30/22,Belgium,50.8333,4.469936,4639411,0,33061,4606350
12/1/22,Belgium,50.8333,4.469936,4639411,0,33061,4606350
12/2/22,Belgium,50.8333,4.469936,4639411,0,33061,4606350
12/3/22,Belgium,50.8333,4.469936,4639411,0,33061,4606350
12/4/22,Belgium,50.8333,4.469936,4639411,0,33061,4606350
12/5/22,Belgium,50.8333,4.469936,4644478,0,33086,4611392
12/6/22,Belgium,50.8333,4.469936,4644478,0,33086,4611392
12/7/22,Belgium,50.8333,4.469936,4644478,0,33086,4611392
12/8/22,Belgium,50.8333,4.469936,4648042,0,33100,4614942
12/9/22,Belgium,50.8333,4.469936,4648042,0,33100,4614942
12/10/22,Belgium,50.8333,4.469936,4648042,0,33100,4614942
12/11/22,Belgium,50.8333,4.469936,4648042,0,33100,4614942
12/12/22,Belgium,50.8333,4.469936,4654473,0,33133,4621340
12/13/22,Belgium,50.8333,4.469936,4654473,0,33133,4621340
12/14/22,Belgium,50.8333,4.469936,4654473,0,33133,4621340
12/15/22,Belgium,50.8333,4.469936,4658298,0,33155,4625143
12/16/22,Belgium,50.8333,4.469936,4658298,0,33155,4625143
12/17/22,Belgium,50.8333,4.469936,4658298,0,33155,4625143
1/1/22,Belize,17.1899,-88.4976,32840,0,602,32238
1/2/22,Belize,17.1899,-88.4976,32840,0,602,32238
1/3/22,Belize,17.1899,-88.4976,33457,0,605,32852
1/4/22,Belize,17.1899,-88.4976,34087,0,605,33482
1/5/22,Belize,17.1899,-88.4976,34628,0,605,34023
1/6/22,Belize,17.1899,-88.4976,35206,0,605,34601
1/7/22,Belize,17.1899,-88.4976,35802,0,605,35197
1/8/22,Belize,17.1899,-88.4976,35802,0,605,35197
1/9/22,Belize,17.1899,-88.4976,35802,0,605,35197
1/10/22,Belize,17.1899,-88.4976,36983,0,607,36376
1/11/22,Belize,17.1899,-88.4976,38072,0,607,37465
1/12/22,Belize,17.1899,-88.4976,38950,0,607,38343
1/13/22,Belize,17.1899,-88.4976,39890,0,607,39283
1/14/22,Belize,17.1899,-88.4976,40612,0,608,40004
1/15/22,Belize,17.1899,-88.4976,40612,0,608,40004
1/16/22,Belize,17.1899,-88.4976,40612,0,608,40004
1/17/22,Belize,17.1899,-88.4976,41867,0,611,41256
1/18/22,Belize,17.1899,-88.4976,43115,0,611,42504
1/19/22,Belize,17.1899,-88.4976,44145,0,611,43534
1/20/22,Belize,17.1899,-88.4976,44959,0,612,44347
1/21/22,Belize,17.1899,-88.4976,45753,0,616,45137
1/22/22,Belize,17.1899,-88.4976,45753,0,616,45137
1/23/22,Belize,17.1899,-88.4976,45753,0,616,45137
1/24/22,Belize,17.1899,-88.4976,47147,0,622,46525
1/25/22,Belize,17.1899,-88.4976,48263,0,622,47641
1/26/22,Belize,17.1899,-88.4976,49059,0,624,48435
1/27/22,Belize,17.1899,-88.4976,49794,0,624,49170
1/28/22,Belize,17.1899,-88.4976,50487,0,625,49862
1/29/22,Belize,17.1899,-88.4976,50487,0,625,49862
1/30/22,Belize,17.1899,-88.4976,50487,0,625,49862
1/31/22,Belize,17.1899,-88.4976,50487,0,625,49862
2/1/22,Belize,17.1899,-88.4976,52004,0,629,51375
2/2/22,Belize,17.1899,-88.4976,52775,0,629,52146
2/3/22,Belize,17.1899,-88.4976,53198,0,629,52569
2/4/22,Belize,17.1899,-88.4976,53544,0,629,52915
2/5/22,Belize,17.1899,-88.4976,53544,0,629,52915
2/6/22,Belize,17.1899,-88.4976,53544,0,629,52915
2/7/22,Belize,17.1899,-88.4976,54179,0,630,53549
2/8/22,Belize,17.1899,-88.4976,54516,0,631,53885
2/9/22,Belize,17.1899,-88.4976,54758,0,631,54127
2/10/22,Belize,17.1899,-88.4976,54973,0,631,54342
2/11/22,Belize,17.1899,-88.4976,55183,0,631,54552
2/12/22,Belize,17.1899,-88.4976,55183,0,631,54552
2/13/22,Belize,17.1899,-88.4976,55183,0,631,54552
2/14/22,Belize,17.1899,-88.4976,55518,0,632,54886
2/15/22,Belize,17.1899,-88.4976,55653,0,632,55021
2/16/22,Belize,17.1899,-88.4976,55803,0,633,55170
2/17/22,Belize,17.1899,-88.4976,55975,0,633,55342
2/18/22,Belize,17.1899,-88.4976,56079,0,641,55438
2/19/22,Belize,17.1899,-88.4976,56079,0,641,55438
2/20/22,Belize,17.1899,-88.4976,56079,0,641,55438
2/21/22,Belize,17.1899,-88.4976,56256,0,645,55611
2/22/22,Belize,17.1899,-88.4976,56374,0,647,55727
2/23/22,Belize,17.1899,-88.4976,56450,0,648,55802
2/24/22,Belize,17.1899,-88.4976,56525,0,648,55877
2/25/22,Belize,17.1899,-88.4976,56597,0,650,55947
2/26/22,Belize,17.1899,-88.4976,56597,0,650,55947
2/27/22,Belize,17.1899,-88.4976,56597,0,650,55947
2/28/22,Belize,17.1899,-88.4976,56694,0,650,56044
3/1/22,Belize,17.1899,-88.4976,56773,0,650,56123
3/2/22,Belize,17.1899,-88.4976,56816,0,650,56166
3/3/22,Belize,17.1899,-88.4976,56842,0,651,56191
3/4/22,Belize,17.1899,-88.4976,56876,0,651,56225
3/5/22,Belize,17.1899,-88.4976,56876,0,651,56225
3/6/22,Belize,17.1899,-88.4976,56876,0,651,56225
3/7/22,Belize,17.1899,-88.4976,56876,0,651,56225
3/8/22,Belize,17.1899,-88.4976,56952,0,652,56300
3/9/22,Belize,17.1899,-88.4976,56976,0,652,56324
3/10/22,Belize,17.1899,-88.4976,57003,0,652,56351
3/11/22,Belize,17.1899,-88.4976,57034,0,652,56382
3/12/22,Belize,17.1899,-88.4976,57034,0,652,56382
3/13/22,Belize,17.1899,-88.4976,57034,0,652,56382
3/14/22,Belize,17.1899,-88.4976,57071,0,652,56419
3/15/22,Belize,17.1899,-88.4976,57096,0,652,56444
3/16/22,Belize,17.1899,-88.4976,57113,0,652,56461
3/17/22,Belize,17.1899,-88.4976,57131,0,652,56479
3/18/22,Belize,17.1899,-88.4976,57143,0,654,56489
3/19/22,Belize,17.1899,-88.4976,57143,0,654,56489
3/20/22,Belize,17.1899,-88.4976,57143,0,654,56489
3/21/22,Belize,17.1899,-88.4976,57168,0,654,56514
3/22/22,Belize,17.1899,-88.4976,57191,0,654,56537
3/23/22,Belize,17.1899,-88.4976,57203,0,654,56549
3/24/22,Belize,17.1899,-88.4976,57212,0,654,56558
3/25/22,Belize,17.1899,-88.4976,57231,0,654,56577
3/26/22,Belize,17.1899,-88.4976,57231,0,654,56577
3/27/22,Belize,17.1899,-88.4976,57231,0,654,56577
3/28/22,Belize,17.1899,-88.4976,57253,0,654,56599
3/29/22,Belize,17.1899,-88.4976,57253,0,654,56599
3/30/22,Belize,17.1899,-88.4976,57277,0,654,56623
3/31/22,Belize,17.1899,-88.4976,57280,0,654,56626
4/1/22,Belize,17.1899,-88.4976,57289,0,656,56633
4/2/22,Belize,17.1899,-88.4976,57289,0,656,56633
4/3/22,Belize,17.1899,-88.4976,57289,0,656,56633
4/4/22,Belize,17.1899,-88.4976,57303,0,656,56647
4/5/22,Belize,17.1899,-88.4976,57318,0,656,56662
4/6/22,Belize,17.1899,-88.4976,57318,0,656,56662
4/7/22,Belize,17.1899,-88.4976,57318,0,656,56662
4/8/22,Belize,17.1899,-88.4976,57318,0,660,56658
4/9/22,Belize,17.1899,-88.4976,57318,0,660,56658
4/10/22,Belize,17.1899,-88.4976,57318,0,660,56658
4/11/22,Belize,17.1899,-88.4976,57318,0,664,56654
4/12/22,Belize,17.1899,-88.4976,57318,0,672,56646
4/13/22,Belize,17.1899,-88.4976,57331,0,672,56659
4/14/22,Belize,17.1899,-88.4976,57331,0,672,56659
4/15/22,Belize,17.1899,-88.4976,57331,0,672,56659
4/16/22,Belize,17.1899,-88.4976,57331,0,672,56659
4/17/22,Belize,17.1899,-88.4976,57331,0,672,56659
4/18/22,Belize,17.1899,-88.4976,57331,0,672,56659
4/19/22,Belize,17.1899,-88.4976,57385,0,676,56709
4/20/22,Belize,17.1899,-88.4976,57394,0,676,56718
4/21/22,Belize,17.1899,-88.4976,57406,0,676,56730
4/22/22,Belize,17.1899,-88.4976,57419,0,676,56743
4/23/22,Belize,17.1899,-88.4976,57419,0,676,56743
4/24/22,Belize,17.1899,-88.4976,57419,0,676,56743
4/25/22,Belize,17.1899,-88.4976,57454,0,676,56778
4/26/22,Belize,17.1899,-88.4976,57467,0,676,56791
4/27/22,Belize,17.1899,-88.4976,57477,0,676,56801
4/28/22,Belize,17.1899,-88.4976,57491,0,676,56815
4/29/22,Belize,17.1899,-88.4976,57497,0,676,56821
4/30/22,Belize,17.1899,-88.4976,57497,0,676,56821
5/1/22,Belize,17.1899,-88.4976,57497,0,676,56821
5/2/22,Belize,17.1899,-88.4976,57497,0,676,56821
5/3/22,Belize,17.1899,-88.4976,57535,0,676,56859
5/4/22,Belize,17.1899,-88.4976,57561,0,676,56885
5/5/22,Belize,17.1899,-88.4976,57578,0,676,56902
5/6/22,Belize,17.1899,-88.4976,57612,0,676,56936
5/7/22,Belize,17.1899,-88.4976,57612,0,676,56936
5/8/22,Belize,17.1899,-88.4976,57612,0,676,56936
5/9/22,Belize,17.1899,-88.4976,57675,0,676,56999
5/10/22,Belize,17.1899,-88.4976,57729,0,676,57053
5/11/22,Belize,17.1899,-88.4976,57787,0,676,57111
5/12/22,Belize,17.1899,-88.4976,57836,0,676,57160
5/13/22,Belize,17.1899,-88.4976,57896,0,676,57220
5/14/22,Belize,17.1899,-88.4976,57896,0,676,57220
5/15/22,Belize,17.1899,-88.4976,57896,0,676,57220
5/16/22,Belize,17.1899,-88.4976,58028,0,676,57352
5/17/22,Belize,17.1899,-88.4976,58135,0,676,57459
5/18/22,Belize,17.1899,-88.4976,58215,0,677,57538
5/19/22,Belize,17.1899,-88.4976,58332,0,677,57655
5/20/22,Belize,17.1899,-88.4976,58419,0,677,57742
5/21/22,Belize,17.1899,-88.4976,58419,0,677,57742
5/22/22,Belize,17.1899,-88.4976,58419,0,677,57742
5/23/22,Belize,17.1899,-88.4976,58617,0,677,57940
5/24/22,Belize,17.1899,-88.4976,58749,0,677,58072
5/25/22,Belize,17.1899,-88.4976,58873,0,677,58196
5/26/22,Belize,17.1899,-88.4976,58949,0,677,58272
5/27/22,Belize,17.1899,-88.4976,59049,0,677,58372
5/28/22,Belize,17.1899,-88.4976,59049,0,677,58372
5/29/22,Belize,17.1899,-88.4976,59049,0,677,58372
5/30/22,Belize,17.1899,-88.4976,59243,0,677,58566
5/31/22,Belize,17.1899,-88.4976,59365,0,677,58688
6/1/22,Belize,17.1899,-88.4976,59537,0,678,58859
6/2/22,Belize,17.1899,-88.4976,59666,0,678,58988
6/3/22,Belize,17.1899,-88.4976,59788,0,678,59110
6/4/22,Belize,17.1899,-88.4976,59788,0,678,59110
6/5/22,Belize,17.1899,-88.4976,59788,0,678,59110
6/6/22,Belize,17.1899,-88.4976,60063,0,678,59385
6/7/22,Belize,17.1899,-88.4976,60287,0,678,59609
6/8/22,Belize,17.1899,-88.4976,60493,0,678,59815
6/9/22,Belize,17.1899,-88.4976,60694,0,678,60016
6/10/22,Belize,17.1899,-88.4976,60863,0,678,60185
6/11/22,Belize,17.1899,-88.4976,60863,0,678,60185
6/12/22,Belize,17.1899,-88.4976,60863,0,678,60185
6/13/22,Belize,17.1899,-88.4976,61150,0,678,60472
6/14/22,Belize,17.1899,-88.4976,61150,0,678,60472
6/15/22,Belize,17.1899,-88.4976,61150,0,678,60472
6/16/22,Belize,17.1899,-88.4976,61150,0,678,60472
6/17/22,Belize,17.1899,-88.4976,61918,0,678,61240
6/18/22,Belize,17.1899,-88.4976,61918,0,678,61240
6/19/22,Belize,17.1899,-88.4976,61918,0,678,61240
6/20/22,Belize,17.1899,-88.4976,62188,0,678,61510
6/21/22,Belize,17.1899,-88.4976,62465,0,679,61786
6/22/22,Belize,17.1899,-88.4976,62667,0,679,61988
6/23/22,Belize,17.1899,-88.4976,62875,0,679,62196
6/24/22,Belize,17.1899,-88.4976,63037,0,679,62358
6/25/22,Belize,17.1899,-88.4976,63037,0,679,62358
6/26/22,Belize,17.1899,-88.4976,63037,0,679,62358
6/27/22,Belize,17.1899,-88.4976,63310,0,679,62631
6/28/22,Belize,17.1899,-88.4976,63572,0,679,62893
6/29/22,Belize,17.1899,-88.4976,63795,0,679,63116
6/30/22,Belize,17.1899,-88.4976,63966,0,680,63286
7/1/22,Belize,17.1899,-88.4976,64138,0,680,63458
7/2/22,Belize,17.1899,-88.4976,64138,0,680,63458
7/3/22,Belize,17.1899,-88.4976,64138,0,680,63458
7/4/22,Belize,17.1899,-88.4976,64371,0,680,63691
7/5/22,Belize,17.1899,-88.4976,64581,0,680,63901
7/6/22,Belize,17.1899,-88.4976,64787,0,680,64107
7/7/22,Belize,17.1899,-88.4976,64948,0,680,64268
7/8/22,Belize,17.1899,-88.4976,64948,0,680,64268
7/9/22,Belize,17.1899,-88.4976,64948,0,680,64268
7/10/22,Belize,17.1899,-88.4976,64948,0,680,64268
7/11/22,Belize,17.1899,-88.4976,64948,0,680,64268
7/12/22,Belize,17.1899,-88.4976,65508,0,680,64828
7/13/22,Belize,17.1899,-88.4976,65508,0,680,64828
7/14/22,Belize,17.1899,-88.4976,65840,0,680,65160
7/15/22,Belize,17.1899,-88.4976,65994,0,680,65314
7/16/22,Belize,17.1899,-88.4976,65994,0,680,65314
7/17/22,Belize,17.1899,-88.4976,65994,0,680,65314
7/18/22,Belize,17.1899,-88.4976,66179,0,680,65499
7/19/22,Belize,17.1899,-88.4976,66317,0,680,65637
7/20/22,Belize,17.1899,-88.4976,66438,0,680,65758
7/21/22,Belize,17.1899,-88.4976,66546,0,680,65866
7/22/22,Belize,17.1899,-88.4976,66621,0,680,65941
7/23/22,Belize,17.1899,-88.4976,66621,0,680,65941
7/24/22,Belize,17.1899,-88.4976,66621,0,680,65941
7/25/22,Belize,17.1899,-88.4976,66767,0,680,66087
7/26/22,Belize,17.1899,-88.4976,66857,0,680,66177
7/27/22,Belize,17.1899,-88.4976,66857,0,680,66177
7/28/22,Belize,17.1899,-88.4976,66857,0,680,66177
7/29/22,Belize,17.1899,-88.4976,67111,0,680,66431
7/30/22,Belize,17.1899,-88.4976,67111,0,680,66431
7/31/22,Belize,17.1899,-88.4976,67111,0,680,66431
8/1/22,Belize,17.1899,-88.4976,67111,0,680,66431
8/2/22,Belize,17.1899,-88.4976,67111,0,680,66431
8/3/22,Belize,17.1899,-88.4976,67309,0,680,66629
8/4/22,Belize,17.1899,-88.4976,67309,0,680,66629
8/5/22,Belize,17.1899,-88.4976,67424,0,680,66744
8/6/22,Belize,17.1899,-88.4976,67424,0,680,66744
8/7/22,Belize,17.1899,-88.4976,67424,0,680,66744
8/8/22,Belize,17.1899,-88.4976,67522,0,680,66842
8/9/22,Belize,17.1899,-88.4976,67522,0,680,66842
8/10/22,Belize,17.1899,-88.4976,67522,0,680,66842
8/11/22,Belize,17.1899,-88.4976,67630,0,680,66950
8/12/22,Belize,17.1899,-88.4976,67630,0,680,66950
8/13/22,Belize,17.1899,-88.4976,67630,0,680,66950
8/14/22,Belize,17.1899,-88.4976,67630,0,680,66950
8/15/22,Belize,17.1899,-88.4976,67777,0,680,67097
8/16/22,Belize,17.1899,-88.4976,67777,0,680,67097
8/17/22,Belize,17.1899,-88.4976,67891,0,680,67211
8/18/22,Belize,17.1899,-88.4976,67891,0,680,67211
8/19/22,Belize,17.1899,-88.4976,67961,0,680,67281
8/20/22,Belize,17.1899,-88.4976,67961,0,680,67281
8/21/22,Belize,17.1899,-88.4976,67961,0,680,67281
8/22/22,Belize,17.1899,-88.4976,68032,0,680,67352
8/23/22,Belize,17.1899,-88.4976,68032,0,680,67352
8/24/22,Belize,17.1899,-88.4976,68111,0,680,67431
8/25/22,Belize,17.1899,-88.4976,68111,0,680,67431
8/26/22,Belize,17.1899,-88.4976,68187,0,680,67507
8/27/22,Belize,17.1899,-88.4976,68187,0,680,67507
8/28/22,Belize,17.1899,-88.4976,68187,0,680,67507
8/29/22,Belize,17.1899,-88.4976,68238,0,680,67558
8/30/22,Belize,17.1899,-88.4976,68238,0,680,67558
8/31/22,Belize,17.1899,-88.4976,68302,0,680,67622
9/1/22,Belize,17.1899,-88.4976,68302,0,680,67622
9/2/22,Belize,17.1899,-88.4976,68350,0,680,67670
9/3/22,Belize,17.1899,-88.4976,68350,0,680,67670
9/4/22,Belize,17.1899,-88.4976,68350,0,680,67670
9/5/22,Belize,17.1899,-88.4976,68350,0,680,67670
9/6/22,Belize,17.1899,-88.4976,68452,0,680,67772
9/7/22,Belize,17.1899,-88.4976,68452,0,680,67772
9/8/22,Belize,17.1899,-88.4976,68452,0,680,67772
9/9/22,Belize,17.1899,-88.4976,68473,0,680,67793
9/10/22,Belize,17.1899,-88.4976,68473,0,680,67793
9/11/22,Belize,17.1899,-88.4976,68473,0,680,67793
9/12/22,Belize,17.1899,-88.4976,68473,0,680,67793
9/13/22,Belize,17.1899,-88.4976,68612,0,680,67932
9/14/22,Belize,17.1899,-88.4976,68612,0,680,67932
9/15/22,Belize,17.1899,-88.4976,68612,0,680,67932
9/16/22,Belize,17.1899,-88.4976,68704,0,680,68024
9/17/22,Belize,17.1899,-88.4976,68704,0,680,68024
9/18/22,Belize,17.1899,-88.4976,68704,0,680,68024
9/19/22,Belize,17.1899,-88.4976,68704,0,680,68024
9/20/22,Belize,17.1899,-88.4976,68743,0,683,68060
9/21/22,Belize,17.1899,-88.4976,68743,0,683,68060
9/22/22,Belize,17.1899,-88.4976,68743,0,683,68060
9/23/22,Belize,17.1899,-88.4976,68784,0,683,68101
9/24/22,Belize,17.1899,-88.4976,68784,0,683,68101
9/25/22,Belize,17.1899,-88.4976,68784,0,683,68101
9/26/22,Belize,17.1899,-88.4976,68784,0,683,68101
9/27/22,Belize,17.1899,-88.4976,68826,0,683,68143
9/28/22,Belize,17.1899,-88.4976,68826,0,683,68143
9/29/22,Belize,17.1899,-88.4976,68826,0,683,68143
9/30/22,Belize,17.1899,-88.4976,68854,0,686,68168
10/1/22,Belize,17.1899,-88.4976,68854,0,686,68168
10/2/22,Belize,17.1899,-88.4976,68854,0,686,68168
10/3/22,Belize,17.1899,-88.4976,68854,0,686,68168
10/4/22,Belize,17.1899,-88.4976,68884,0,686,68198
10/5/22,Belize,17.1899,-88.4976,68884,0,686,68198
10/6/22,Belize,17.1899,-88.4976,68884,0,686,68198
10/7/22,Belize,17.1899,-88.4976,68884,0,686,68198
10/8/22,Belize,17.1899,-88.4976,68884,0,686,68198
10/9/22,Belize,17.1899,-88.4976,68884,0,686,68198
10/10/22,Belize,17.1899,-88.4976,68884,0,686,68198
10/11/22,Belize,17.1899,-88.4976,68909,0,686,68223
10/12/22,Belize,17.1899,-88.4976,68909,0,686,68223
10/13/22,Belize,17.1899,-88.4976,68909,0,686,68223
10/14/22,Belize,17.1899,-88.4976,68909,0,686,68223
10/15/22,Belize,17.1899,-88.4976,68909,0,686,68223
10/16/22,Belize,17.1899,-88.4976,68909,0,686,68223
10/17/22,Belize,17.1899,-88.4976,68926,0,687,68239
10/18/22,Belize,17.1899,-88.4976,68926,0,687,68239
10/19/22,Belize,17.1899,-88.4976,68926,0,687,68239
10/20/22,Belize,17.1899,-88.4976,68926,0,687,68239
10/21/22,Belize,17.1899,-88.4976,68926,0,687,68239
10/22/22,Belize,17.1899,-88.4976,68926,0,687,68239
10/23/22,Belize,17.1899,-88.4976,68926,0,687,68239
10/24/22,Belize,17.1899,-88.4976,68943,0,687,68256
10/25/22,Belize,17.1899,-88.4976,68943,0,687,68256
10/26/22,Belize,17.1899,-88.4976,68943,0,687,68256
10/27/22,Belize,17.1899,-88.4976,68943,0,687,68256
10/28/22,Belize,17.1899,-88.4976,68943,0,687,68256
10/29/22,Belize,17.1899,-88.4976,68943,0,687,68256
10/30/22,Belize,17.1899,-88.4976,68943,0,687,68256
10/31/22,Belize,17.1899,-88.4976,68943,0,687,68256
11/1/22,Belize,17.1899,-88.4976,68957,0,687,68270
11/2/22,Belize,17.1899,-88.4976,68957,0,687,68270
11/3/22,Belize,17.1899,-88.4976,68957,0,687,68270
11/4/22,Belize,17.1899,-88.4976,68957,0,687,68270
11/5/22,Belize,17.1899,-88.4976,68957,0,687,68270
11/6/22,Belize,17.1899,-88.4976,68957,0,687,68270
11/7/22,Belize,17.1899,-88.4976,68972,0,687,68285
11/8/22,Belize,17.1899,-88.4976,68972,0,687,68285
11/9/22,Belize,17.1899,-88.4976,68972,0,687,68285
11/10/22,Belize,17.1899,-88.4976,68972,0,687,68285
11/11/22,Belize,17.1899,-88.4976,68972,0,687,68285
11/12/22,Belize,17.1899,-88.4976,68972,0,687,68285
11/13/22,Belize,17.1899,-88.4976,68972,0,687,68285
11/14/22,Belize,17.1899,-88.4976,68988,0,687,68301
11/15/22,Belize,17.1899,-88.4976,68988,0,687,68301
11/16/22,Belize,17.1899,-88.4976,68988,0,687,68301
11/17/22,Belize,17.1899,-88.4976,68988,0,687,68301
11/18/22,Belize,17.1899,-88.4976,68988,0,687,68301
11/19/22,Belize,17.1899,-88.4976,68988,0,687,68301
11/20/22,Belize,17.1899,-88.4976,68988,0,687,68301
11/21/22,Belize,17.1899,-88.4976,68988,0,687,68301
11/22/22,Belize,17.1899,-88.4976,69012,0,688,68324
11/23/22,Belize,17.1899,-88.4976,69012,0,688,68324
11/24/22,Belize,17.1899,-88.4976,69012,0,688,68324
11/25/22,Belize,17.1899,-88.4976,69012,0,688,68324
11/26/22,Belize,17.1899,-88.4976,69012,0,688,68324
11/27/22,Belize,17.1899,-88.4976,69012,0,688,68324
11/28/22,Belize,17.1899,-88.4976,69048,0,688,68360
11/29/22,Belize,17.1899,-88.4976,69048,0,688,68360
11/30/22,Belize,17.1899,-88.4976,69048,0,688,68360
12/1/22,Belize,17.1899,-88.4976,69048,0,688,68360
12/2/22,Belize,17.1899,-88.4976,69048,0,688,68360
12/3/22,Belize,17.1899,-88.4976,69048,0,688,68360
12/4/22,Belize,17.1899,-88.4976,69048,0,688,68360
12/5/22,Belize,17.1899,-88.4976,69117,0,688,68429
12/6/22,Belize,17.1899,-88.4976,69117,0,688,68429
12/7/22,Belize,17.1899,-88.4976,69117,0,688,68429
12/8/22,Belize,17.1899,-88.4976,69117,0,688,68429
12/9/22,Belize,17.1899,-88.4976,69117,0,688,68429
12/10/22,Belize,17.1899,-88.4976,69117,0,688,68429
12/11/22,Belize,17.1899,-88.4976,69117,0,688,68429
12/12/22,Belize,17.1899,-88.4976,69376,0,688,68688
12/13/22,Belize,17.1899,-88.4976,69376,0,688,68688
12/14/22,Belize,17.1899,-88.4976,69376,0,688,68688
12/15/22,Belize,17.1899,-88.4976,69376,0,688,68688
12/16/22,Belize,17.1899,-88.4976,69376,0,688,68688
12/17/22,Belize,17.1899,-88.4976,69376,0,688,68688
1/1/22,Benin,9.3077,2.3158,24935,0,161,24774
1/2/22,Benin,9.3077,2.3158,24935,0,161,24774
1/3/22,Benin,9.3077,2.3158,24935,0,161,24774
1/4/22,Benin,9.3077,2.3158,25522,0,161,25361
1/5/22,Benin,9.3077,2.3158,25522,0,161,25361
1/6/22,Benin,9.3077,2.3158,25522,0,161,25361
1/7/22,Benin,9.3077,2.3158,25522,0,161,25361
1/8/22,Benin,9.3077,2.3158,25522,0,161,25361
1/9/22,Benin,9.3077,2.3158,25522,0,161,25361
1/10/22,Benin,9.3077,2.3158,25522,0,161,25361
1/11/22,Benin,9.3077,2.3158,25522,0,161,25361
1/12/22,Benin,9.3077,2.3158,26036,0,162,25874
1/13/22,Benin,9.3077,2.3158,26036,0,162,25874
1/14/22,Benin,9.3077,2.3158,26036,0,162,25874
1/15/22,Benin,9.3077,2.3158,26036,0,162,25874
1/16/22,Benin,9.3077,2.3158,26036,0,162,25874
1/17/22,Benin,9.3077,2.3158,26036,0,162,25874
1/18/22,Benin,9.3077,2.3158,26036,0,162,25874
1/19/22,Benin,9.3077,2.3158,26309,0,163,26146
1/20/22,Benin,9.3077,2.3158,26309,0,163,26146
1/21/22,Benin,9.3077,2.3158,26309,0,163,26146
1/22/22,Benin,9.3077,2.3158,26309,0,163,26146
1/23/22,Benin,9.3077,2.3158,26309,0,163,26146
1/24/22,Benin,9.3077,2.3158,26309,0,163,26146
1/25/22,Benin,9.3077,2.3158,26309,0,163,26146
1/26/22,Benin,9.3077,2.3158,26450,0,163,26287
1/27/22,Benin,9.3077,2.3158,26450,0,163,26287
1/28/22,Benin,9.3077,2.3158,26450,0,163,26287
1/29/22,Benin,9.3077,2.3158,26450,0,163,26287
1/30/22,Benin,9.3077,2.3158,26450,0,163,26287
1/31/22,Benin,9.3077,2.3158,26450,0,163,26287
2/1/22,Benin,9.3077,2.3158,26450,0,163,26287
2/2/22,Benin,9.3077,2.3158,26498,0,163,26335
2/3/22,Benin,9.3077,2.3158,26498,0,163,26335
2/4/22,Benin,9.3077,2.3158,26498,0,163,26335
2/5/22,Benin,9.3077,2.3158,26498,0,163,26335
2/6/22,Benin,9.3077,2.3158,26498,0,163,26335
2/7/22,Benin,9.3077,2.3158,26498,0,163,26335
2/8/22,Benin,9.3077,2.3158,26498,0,163,26335
2/9/22,Benin,9.3077,2.3158,26498,0,163,26335
2/10/22,Benin,9.3077,2.3158,26498,0,163,26335
2/11/22,Benin,9.3077,2.3158,26552,0,163,26389
2/12/22,Benin,9.3077,2.3158,26552,0,163,26389
2/13/22,Benin,9.3077,2.3158,26552,0,163,26389
2/14/22,Benin,9.3077,2.3158,26552,0,163,26389
2/15/22,Benin,9.3077,2.3158,26552,0,163,26389
2/16/22,Benin,9.3077,2.3158,26567,0,163,26404
2/17/22,Benin,9.3077,2.3158,26567,0,163,26404
2/18/22,Benin,9.3077,2.3158,26567,0,163,26404
2/19/22,Benin,9.3077,2.3158,26567,0,163,26404
2/20/22,Benin,9.3077,2.3158,26567,0,163,26404
2/21/22,Benin,9.3077,2.3158,26567,0,163,26404
2/22/22,Benin,9.3077,2.3158,26567,0,163,26404
2/23/22,Benin,9.3077,2.3158,26567,0,163,26404
2/24/22,Benin,9.3077,2.3158,26567,0,163,26404
2/25/22,Benin,9.3077,2.3158,26567,0,163,26404
2/26/22,Benin,9.3077,2.3158,26567,0,163,26404
2/27/22,Benin,9.3077,2.3158,26567,0,163,26404
2/28/22,Benin,9.3077,2.3158,26567,0,163,26404
3/1/22,Benin,9.3077,2.3158,26567,0,163,26404
3/2/22,Benin,9.3077,2.3158,26567,0,163,26404
3/3/22,Benin,9.3077,2.3158,26575,0,163,26412
3/4/22,Benin,9.3077,2.3158,26575,0,163,26412
3/5/22,Benin,9.3077,2.3158,26575,0,163,26412
3/6/22,Benin,9.3077,2.3158,26575,0,163,26412
3/7/22,Benin,9.3077,2.3158,26575,0,163,26412
3/8/22,Benin,9.3077,2.3158,26575,0,163,26412
3/9/22,Benin,9.3077,2.3158,26575,0,163,26412
3/10/22,Benin,9.3077,2.3158,26575,0,163,26412
3/11/22,Benin,9.3077,2.3158,26575,0,163,26412
3/12/22,Benin,9.3077,2.3158,26575,0,163,26412
3/13/22,Benin,9.3077,2.3158,26575,0,163,26412
3/14/22,Benin,9.3077,2.3158,26575,0,163,26412
3/15/22,Benin,9.3077,2.3158,26575,0,163,26412
3/16/22,Benin,9.3077,2.3158,26952,0,163,26789
3/17/22,Benin,9.3077,2.3158,26952,0,163,26789
3/18/22,Benin,9.3077,2.3158,26952,0,163,26789
3/19/22,Benin,9.3077,2.3158,26952,0,163,26789
3/20/22,Benin,9.3077,2.3158,26952,0,163,26789
3/21/22,Benin,9.3077,2.3158,26952,0,163,26789
3/22/22,Benin,9.3077,2.3158,26952,0,163,26789
3/23/22,Benin,9.3077,2.3158,26952,0,163,26789
3/24/22,Benin,9.3077,2.3158,26952,0,163,26789
3/25/22,Benin,9.3077,2.3158,26952,0,163,26789
3/26/22,Benin,9.3077,2.3158,26952,0,163,26789
3/27/22,Benin,9.3077,2.3158,26952,0,163,26789
3/28/22,Benin,9.3077,2.3158,26952,0,163,26789
3/29/22,Benin,9.3077,2.3158,26952,0,163,26789
3/30/22,Benin,9.3077,2.3158,26952,0,163,26789
3/31/22,Benin,9.3077,2.3158,26952,0,163,26789
4/1/22,Benin,9.3077,2.3158,26952,0,163,26789
4/2/22,Benin,9.3077,2.3158,26952,0,163,26789
4/3/22,Benin,9.3077,2.3158,26952,0,163,26789
4/4/22,Benin,9.3077,2.3158,26952,0,163,26789
4/5/22,Benin,9.3077,2.3158,26952,0,163,26789
4/6/22,Benin,9.3077,2.3158,26952,0,163,26789
4/7/22,Benin,9.3077,2.3158,26952,0,163,26789
4/8/22,Benin,9.3077,2.3158,26952,0,163,26789
4/9/22,Benin,9.3077,2.3158,26952,0,163,26789
4/10/22,Benin,9.3077,2.3158,26952,0,163,26789
4/11/22,Benin,9.3077,2.3158,26952,0,163,26789
4/12/22,Benin,9.3077,2.3158,26952,0,163,26789
4/13/22,Benin,9.3077,2.3158,26952,0,163,26789
4/14/22,Benin,9.3077,2.3158,26952,0,163,26789
4/15/22,Benin,9.3077,2.3158,26952,0,163,26789
4/16/22,Benin,9.3077,2.3158,26952,0,163,26789
4/17/22,Benin,9.3077,2.3158,26952,0,163,26789
4/18/22,Benin,9.3077,2.3158,26952,0,163,26789
4/19/22,Benin,9.3077,2.3158,26952,0,163,26789
4/20/22,Benin,9.3077,2.3158,26952,0,163,26789
4/21/22,Benin,9.3077,2.3158,26952,0,163,26789
4/22/22,Benin,9.3077,2.3158,26952,0,163,26789
4/23/22,Benin,9.3077,2.3158,26952,0,163,26789
4/24/22,Benin,9.3077,2.3158,26952,0,163,26789
4/25/22,Benin,9.3077,2.3158,26952,0,163,26789
4/26/22,Benin,9.3077,2.3158,26952,0,163,26789
4/27/22,Benin,9.3077,2.3158,26952,0,163,26789
4/28/22,Benin,9.3077,2.3158,26952,0,163,26789
4/29/22,Benin,9.3077,2.3158,26952,0,163,26789
4/30/22,Benin,9.3077,2.3158,26952,0,163,26789
5/1/22,Benin,9.3077,2.3158,26952,0,163,26789
5/2/22,Benin,9.3077,2.3158,26952,0,163,26789
5/3/22,Benin,9.3077,2.3158,26952,0,163,26789
5/4/22,Benin,9.3077,2.3158,26952,0,163,26789
5/5/22,Benin,9.3077,2.3158,26952,0,163,26789
5/6/22,Benin,9.3077,2.3158,26952,0,163,26789
5/7/22,Benin,9.3077,2.3158,26952,0,163,26789
5/8/22,Benin,9.3077,2.3158,26952,0,163,26789
5/9/22,Benin,9.3077,2.3158,26952,0,163,26789
5/10/22,Benin,9.3077,2.3158,26952,0,163,26789
5/11/22,Benin,9.3077,2.3158,26952,0,163,26789
5/12/22,Benin,9.3077,2.3158,26952,0,163,26789
5/13/22,Benin,9.3077,2.3158,26952,0,163,26789
5/14/22,Benin,9.3077,2.3158,26952,0,163,26789
5/15/22,Benin,9.3077,2.3158,26952,0,163,26789
5/16/22,Benin,9.3077,2.3158,26952,0,163,26789
5/17/22,Benin,9.3077,2.3158,26952,0,163,26789
5/18/22,Benin,9.3077,2.3158,26952,0,163,26789
5/19/22,Benin,9.3077,2.3158,26952,0,163,26789
5/20/22,Benin,9.3077,2.3158,26952,0,163,26789
5/21/22,Benin,9.3077,2.3158,26952,0,163,26789
5/22/22,Benin,9.3077,2.3158,26952,0,163,26789
5/23/22,Benin,9.3077,2.3158,26952,0,163,26789
5/24/22,Benin,9.3077,2.3158,26952,0,163,26789
5/25/22,Benin,9.3077,2.3158,26952,0,163,26789
5/26/22,Benin,9.3077,2.3158,26952,0,163,26789
5/27/22,Benin,9.3077,2.3158,26952,0,163,26789
5/28/22,Benin,9.3077,2.3158,26952,0,163,26789
5/29/22,Benin,9.3077,2.3158,26952,0,163,26789
5/30/22,Benin,9.3077,2.3158,26952,0,163,26789
5/31/22,Benin,9.3077,2.3158,26952,0,163,26789
6/1/22,Benin,9.3077,2.3158,26952,0,163,26789
6/2/22,Benin,9.3077,2.3158,26952,0,163,26789
6/3/22,Benin,9.3077,2.3158,26952,0,163,26789
6/4/22,Benin,9.3077,2.3158,26952,0,163,26789
6/5/22,Benin,9.3077,2.3158,26952,0,163,26789
6/6/22,Benin,9.3077,2.3158,26952,0,163,26789
6/7/22,Benin,9.3077,2.3158,26952,0,163,26789
6/8/22,Benin,9.3077,2.3158,26952,0,163,26789
6/9/22,Benin,9.3077,2.3158,26952,0,163,26789
6/10/22,Benin,9.3077,2.3158,26952,0,163,26789
6/11/22,Benin,9.3077,2.3158,26952,0,163,26789
6/12/22,Benin,9.3077,2.3158,26952,0,163,26789
6/13/22,Benin,9.3077,2.3158,26952,0,163,26789
6/14/22,Benin,9.3077,2.3158,26952,0,163,26789
6/15/22,Benin,9.3077,2.3158,26952,0,163,26789
6/16/22,Benin,9.3077,2.3158,27122,0,163,26959
6/17/22,Benin,9.3077,2.3158,27122,0,163,26959
6/18/22,Benin,9.3077,2.3158,27122,0,163,26959
6/19/22,Benin,9.3077,2.3158,27122,0,163,26959
6/20/22,Benin,9.3077,2.3158,27122,0,163,26959
6/21/22,Benin,9.3077,2.3158,27122,0,163,26959
6/22/22,Benin,9.3077,2.3158,27122,0,163,26959
6/23/22,Benin,9.3077,2.3158,27122,0,163,26959
6/24/22,Benin,9.3077,2.3158,27122,0,163,26959
6/25/22,Benin,9.3077,2.3158,27122,0,163,26959
6/26/22,Benin,9.3077,2.3158,27122,0,163,26959
6/27/22,Benin,9.3077,2.3158,27122,0,163,26959
6/28/22,Benin,9.3077,2.3158,27122,0,163,26959
6/29/22,Benin,9.3077,2.3158,27122,0,163,26959
6/30/22,Benin,9.3077,2.3158,27216,0,163,27053
7/1/22,Benin,9.3077,2.3158,27216,0,163,27053
7/2/22,Benin,9.3077,2.3158,27216,0,163,27053
7/3/22,Benin,9.3077,2.3158,27216,0,163,27053
7/4/22,Benin,9.3077,2.3158,27216,0,163,27053
7/5/22,Benin,9.3077,2.3158,27216,0,163,27053
7/6/22,Benin,9.3077,2.3158,27216,0,163,27053
7/7/22,Benin,9.3077,2.3158,27216,0,163,27053
7/8/22,Benin,9.3077,2.3158,27216,0,163,27053
7/9/22,Benin,9.3077,2.3158,27216,0,163,27053
7/10/22,Benin,9.3077,2.3158,27216,0,163,27053
7/11/22,Benin,9.3077,2.3158,27216,0,163,27053
7/12/22,Benin,9.3077,2.3158,27216,0,163,27053
7/13/22,Benin,9.3077,2.3158,27216,0,163,27053
7/14/22,Benin,9.3077,2.3158,27216,0,163,27053
7/15/22,Benin,9.3077,2.3158,27216,0,163,27053
7/16/22,Benin,9.3077,2.3158,27216,0,163,27053
7/17/22,Benin,9.3077,2.3158,27216,0,163,27053
7/18/22,Benin,9.3077,2.3158,27216,0,163,27053
7/19/22,Benin,9.3077,2.3158,27271,0,163,27108
7/20/22,Benin,9.3077,2.3158,27271,0,163,27108
7/21/22,Benin,9.3077,2.3158,27271,0,163,27108
7/22/22,Benin,9.3077,2.3158,27271,0,163,27108
7/23/22,Benin,9.3077,2.3158,27271,0,163,27108
7/24/22,Benin,9.3077,2.3158,27271,0,163,27108
7/25/22,Benin,9.3077,2.3158,27271,0,163,27108
7/26/22,Benin,9.3077,2.3158,27271,0,163,27108
7/27/22,Benin,9.3077,2.3158,27271,0,163,27108
7/28/22,Benin,9.3077,2.3158,27271,0,163,27108
7/29/22,Benin,9.3077,2.3158,27316,0,163,27153
7/30/22,Benin,9.3077,2.3158,27316,0,163,27153
7/31/22,Benin,9.3077,2.3158,27316,0,163,27153
8/1/22,Benin,9.3077,2.3158,27316,0,163,27153
8/2/22,Benin,9.3077,2.3158,27316,0,163,27153
8/3/22,Benin,9.3077,2.3158,27316,0,163,27153
8/4/22,Benin,9.3077,2.3158,27316,0,163,27153
8/5/22,Benin,9.3077,2.3158,27316,0,163,27153
8/6/22,Benin,9.3077,2.3158,27316,0,163,27153
8/7/22,Benin,9.3077,2.3158,27316,0,163,27153
8/8/22,Benin,9.3077,2.3158,27316,0,163,27153
8/9/22,Benin,9.3077,2.3158,27316,0,163,27153
8/10/22,Benin,9.3077,2.3158,27316,0,163,27153
8/11/22,Benin,9.3077,2.3158,27316,0,163,27153
8/12/22,Benin,9.3077,2.3158,27316,0,163,27153
8/13/22,Benin,9.3077,2.3158,27316,0,163,27153
8/14/22,Benin,9.3077,2.3158,27316,0,163,27153
8/15/22,Benin,9.3077,2.3158,27316,0,163,27153
8/16/22,Benin,9.3077,2.3158,27316,0,163,27153
8/17/22,Benin,9.3077,2.3158,27316,0,163,27153
8/18/22,Benin,9.3077,2.3158,27316,0,163,27153
8/19/22,Benin,9.3077,2.3158,27316,0,163,27153
8/20/22,Benin,9.3077,2.3158,27316,0,163,27153
8/21/22,Benin,9.3077,2.3158,27316,0,163,27153
8/22/22,Benin,9.3077,2.3158,27316,0,163,27153
8/23/22,Benin,9.3077,2.3158,27316,0,163,27153
8/24/22,Benin,9.3077,2.3158,27316,0,163,27153
8/25/22,Benin,9.3077,2.3158,27316,0,163,27153
8/26/22,Benin,9.3077,2.3158,27316,0,163,27153
8/27/22,Benin,9.3077,2.3158,27316,0,163,27153
8/28/22,Benin,9.3077,2.3158,27316,0,163,27153
8/29/22,Benin,9.3077,2.3158,27490,0,163,27327
8/30/22,Benin,9.3077,2.3158,27490,0,163,27327
8/31/22,Benin,9.3077,2.3158,27490,0,163,27327
9/1/22,Benin,9.3077,2.3158,27490,0,163,27327
9/2/22,Benin,9.3077,2.3158,27490,0,163,27327
9/3/22,Benin,9.3077,2.3158,27490,0,163,27327
9/4/22,Benin,9.3077,2.3158,27490,0,163,27327
9/5/22,Benin,9.3077,2.3158,27490,0,163,27327
9/6/22,Benin,9.3077,2.3158,27490,0,163,27327
9/7/22,Benin,9.3077,2.3158,27490,0,163,27327
9/8/22,Benin,9.3077,2.3158,27490,0,163,27327
9/9/22,Benin,9.3077,2.3158,27490,0,163,27327
9/10/22,Benin,9.3077,2.3158,27490,0,163,27327
9/11/22,Benin,9.3077,2.3158,27490,0,163,27327
9/12/22,Benin,9.3077,2.3158,27490,0,163,27327
9/13/22,Benin,9.3077,2.3158,27490,0,163,27327
9/14/22,Benin,9.3077,2.3158,27638,0,163,27475
9/15/22,Benin,9.3077,2.3158,27638,0,163,27475
9/16/22,Benin,9.3077,2.3158,27638,0,163,27475
9/17/22,Benin,9.3077,2.3158,27638,0,163,27475
9/18/22,Benin,9.3077,2.3158,27638,0,163,27475
9/19/22,Benin,9.3077,2.3158,27638,0,163,27475
9/20/22,Benin,9.3077,2.3158,27638,0,163,27475
9/21/22,Benin,9.3077,2.3158,27638,0,163,27475
9/22/22,Benin,9.3077,2.3158,27638,0,163,27475
9/23/22,Benin,9.3077,2.3158,27638,0,163,27475
9/24/22,Benin,9.3077,2.3158,27638,0,163,27475
9/25/22,Benin,9.3077,2.3158,27638,0,163,27475
9/26/22,Benin,9.3077,2.3158,27638,0,163,27475
9/27/22,Benin,9.3077,2.3158,27638,0,163,27475
9/28/22,Benin,9.3077,2.3158,27638,0,163,27475
9/29/22,Benin,9.3077,2.3158,27638,0,163,27475
9/30/22,Benin,9.3077,2.3158,27638,0,163,27475
10/1/22,Benin,9.3077,2.3158,27638,0,163,27475
10/2/22,Benin,9.3077,2.3158,27638,0,163,27475
10/3/22,Benin,9.3077,2.3158,27638,0,163,27475
10/4/22,Benin,9.3077,2.3158,27638,0,163,27475
10/5/22,Benin,9.3077,2.3158,27782,0,163,27619
10/6/22,Benin,9.3077,2.3158,27782,0,163,27619
10/7/22,Benin,9.3077,2.3158,27782,0,163,27619
10/8/22,Benin,9.3077,2.3158,27782,0,163,27619
10/9/22,Benin,9.3077,2.3158,27782,0,163,27619
10/10/22,Benin,9.3077,2.3158,27782,0,163,27619
10/11/22,Benin,9.3077,2.3158,27782,0,163,27619
10/12/22,Benin,9.3077,2.3158,27782,0,163,27619
10/13/22,Benin,9.3077,2.3158,27782,0,163,27619
10/14/22,Benin,9.3077,2.3158,27782,0,163,27619
10/15/22,Benin,9.3077,2.3158,27782,0,163,27619
10/16/22,Benin,9.3077,2.3158,27782,0,163,27619
10/17/22,Benin,9.3077,2.3158,27782,0,163,27619
10/18/22,Benin,9.3077,2.3158,27782,0,163,27619
10/19/22,Benin,9.3077,2.3158,27782,0,163,27619
10/20/22,Benin,9.3077,2.3158,27782,0,163,27619
10/21/22,Benin,9.3077,2.3158,27782,0,163,27619
10/22/22,Benin,9.3077,2.3158,27782,0,163,27619
10/23/22,Benin,9.3077,2.3158,27782,0,163,27619
10/24/22,Benin,9.3077,2.3158,27782,0,163,27619
10/25/22,Benin,9.3077,2.3158,27782,0,163,27619
10/26/22,Benin,9.3077,2.3158,27782,0,163,27619
10/27/22,Benin,9.3077,2.3158,27782,0,163,27619
10/28/22,Benin,9.3077,2.3158,27782,0,163,27619
10/29/22,Benin,9.3077,2.3158,27782,0,163,27619
10/30/22,Benin,9.3077,2.3158,27782,0,163,27619
10/31/22,Benin,9.3077,2.3158,27782,0,163,27619
11/1/22,Benin,9.3077,2.3158,27782,0,163,27619
11/2/22,Benin,9.3077,2.3158,27782,0,163,27619
11/3/22,Benin,9.3077,2.3158,27782,0,163,27619
11/4/22,Benin,9.3077,2.3158,27782,0,163,27619
11/5/22,Benin,9.3077,2.3158,27782,0,163,27619
11/6/22,Benin,9.3077,2.3158,27782,0,163,27619
11/7/22,Benin,9.3077,2.3158,27912,0,163,27749
11/8/22,Benin,9.3077,2.3158,27912,0,163,27749
11/9/22,Benin,9.3077,2.3158,27912,0,163,27749
11/10/22,Benin,9.3077,2.3158,27912,0,163,27749
11/11/22,Benin,9.3077,2.3158,27912,0,163,27749
11/12/22,Benin,9.3077,2.3158,27912,0,163,27749
11/13/22,Benin,9.3077,2.3158,27912,0,163,27749
11/14/22,Benin,9.3077,2.3158,27922,0,163,27759
11/15/22,Benin,9.3077,2.3158,27922,0,163,27759
11/16/22,Benin,9.3077,2.3158,27922,0,163,27759
11/17/22,Benin,9.3077,2.3158,27922,0,163,27759
11/18/22,Benin,9.3077,2.3158,27922,0,163,27759
11/19/22,Benin,9.3077,2.3158,27922,0,163,27759
11/20/22,Benin,9.3077,2.3158,27922,0,163,27759
11/21/22,Benin,9.3077,2.3158,27922,0,163,27759
11/22/22,Benin,9.3077,2.3158,27922,0,163,27759
11/23/22,Benin,9.3077,2.3158,27922,0,163,27759
11/24/22,Benin,9.3077,2.3158,27922,0,163,27759
11/25/22,Benin,9.3077,2.3158,27922,0,163,27759
11/26/22,Benin,9.3077,2.3158,27922,0,163,27759
11/27/22,Benin,9.3077,2.3158,27922,0,163,27759
11/28/22,Benin,9.3077,2.3158,27922,0,163,27759
11/29/22,Benin,9.3077,2.3158,27980,0,163,27817
11/30/22,Benin,9.3077,2.3158,27980,0,163,27817
12/1/22,Benin,9.3077,2.3158,27980,0,163,27817
12/2/22,Benin,9.3077,2.3158,27980,0,163,27817
12/3/22,Benin,9.3077,2.3158,27980,0,163,27817
12/4/22,Benin,9.3077,2.3158,27980,0,163,27817
12/5/22,Benin,9.3077,2.3158,27980,0,163,27817
12/6/22,Benin,9.3077,2.3158,27980,0,163,27817
12/7/22,Benin,9.3077,2.3158,27980,0,163,27817
12/8/22,Benin,9.3077,2.3158,27980,0,163,27817
12/9/22,Benin,9.3077,2.3158,27980,0,163,27817
12/10/22,Benin,9.3077,2.3158,27980,0,163,27817
12/11/22,Benin,9.3077,2.3158,27980,0,163,27817
12/12/22,Benin,9.3077,2.3158,27980,0,163,27817
12/13/22,Benin,9.3077,2.3158,27980,0,163,27817
12/14/22,Benin,9.3077,2.3158,27980,0,163,27817
12/15/22,Benin,9.3077,2.3158,27980,0,163,27817
12/16/22,Benin,9.3077,2.3158,27982,0,163,27819
12/17/22,Benin,9.3077,2.3158,27982,0,163,27819
1/1/22,Bhutan,27.5142,90.4336,2660,0,3,2657
1/2/22,Bhutan,27.5142,90.4336,2660,0,3,2657
1/3/22,Bhutan,27.5142,90.4336,2664,0,3,2661
1/4/22,Bhutan,27.5142,90.4336,2666,0,3,2663
1/5/22,Bhutan,27.5142,90.4336,2669,0,3,2666
1/6/22,Bhutan,27.5142,90.4336,2671,0,3,2668
1/7/22,Bhutan,27.5142,90.4336,2753,0,3,2750
1/8/22,Bhutan,27.5142,90.4336,2760,0,3,2757
1/9/22,Bhutan,27.5142,90.4336,2781,0,3,2778
1/10/22,Bhutan,27.5142,90.4336,2802,0,3,2799
1/11/22,Bhutan,27.5142,90.4336,2830,0,3,2827
1/12/22,Bhutan,27.5142,90.4336,2837,0,3,2834
1/13/22,Bhutan,27.5142,90.4336,2873,0,3,2870
1/14/22,Bhutan,27.5142,90.4336,2886,0,3,2883
1/15/22,Bhutan,27.5142,90.4336,2904,0,3,2901
1/16/22,Bhutan,27.5142,90.4336,2928,0,3,2925
1/17/22,Bhutan,27.5142,90.4336,3069,0,3,3066
1/18/22,Bhutan,27.5142,90.4336,3170,0,3,3167
1/19/22,Bhutan,27.5142,90.4336,3229,0,3,3226
1/20/22,Bhutan,27.5142,90.4336,3317,0,3,3314
1/21/22,Bhutan,27.5142,90.4336,3458,0,3,3455
1/22/22,Bhutan,27.5142,90.4336,3557,0,3,3554
1/23/22,Bhutan,27.5142,90.4336,3649,0,3,3646
1/24/22,Bhutan,27.5142,90.4336,3811,0,3,3808
1/25/22,Bhutan,27.5142,90.4336,3951,0,3,3948
1/26/22,Bhutan,27.5142,90.4336,4089,0,3,4086
1/27/22,Bhutan,27.5142,90.4336,4225,0,3,4222
1/28/22,Bhutan,27.5142,90.4336,4430,0,4,4426
1/29/22,Bhutan,27.5142,90.4336,4566,0,4,4562
1/30/22,Bhutan,27.5142,90.4336,4685,0,4,4681
1/31/22,Bhutan,27.5142,90.4336,4891,0,4,4887
2/1/22,Bhutan,27.5142,90.4336,5203,0,4,5199
2/2/22,Bhutan,27.5142,90.4336,5393,0,4,5389
2/3/22,Bhutan,27.5142,90.4336,5532,0,4,5528
2/4/22,Bhutan,27.5142,90.4336,5720,0,4,5716
2/5/22,Bhutan,27.5142,90.4336,5934,0,4,5930
2/6/22,Bhutan,27.5142,90.4336,6092,0,4,6088
2/7/22,Bhutan,27.5142,90.4336,6300,0,4,6296
2/8/22,Bhutan,27.5142,90.4336,6459,0,4,6455
2/9/22,Bhutan,27.5142,90.4336,6648,0,4,6644
2/10/22,Bhutan,27.5142,90.4336,6779,0,5,6774
2/11/22,Bhutan,27.5142,90.4336,6964,0,5,6959
2/12/22,Bhutan,27.5142,90.4336,7199,0,5,7194
2/13/22,Bhutan,27.5142,90.4336,7429,0,5,7424
2/14/22,Bhutan,27.5142,90.4336,7666,0,5,7661
2/15/22,Bhutan,27.5142,90.4336,7916,0,5,7911
2/16/22,Bhutan,27.5142,90.4336,8297,0,5,8292
2/17/22,Bhutan,27.5142,90.4336,8683,0,5,8678
2/18/22,Bhutan,27.5142,90.4336,9210,0,5,9205
2/19/22,Bhutan,27.5142,90.4336,9557,0,5,9552
2/20/22,Bhutan,27.5142,90.4336,10078,0,6,10072
2/21/22,Bhutan,27.5142,90.4336,10112,0,6,10106
2/22/22,Bhutan,27.5142,90.4336,10196,0,6,10190
2/23/22,Bhutan,27.5142,90.4336,10514,0,6,10508
2/24/22,Bhutan,27.5142,90.4336,11010,0,6,11004
2/25/22,Bhutan,27.5142,90.4336,11369,0,6,11363
2/26/22,Bhutan,27.5142,90.4336,11820,0,6,11814
2/27/22,Bhutan,27.5142,90.4336,12194,0,6,12188
2/28/22,Bhutan,27.5142,90.4336,12702,0,6,12696
3/1/22,Bhutan,27.5142,90.4336,13137,0,6,13131
3/2/22,Bhutan,27.5142,90.4336,13535,0,6,13529
3/3/22,Bhutan,27.5142,90.4336,13846,0,6,13840
3/4/22,Bhutan,27.5142,90.4336,14120,0,6,14114
3/5/22,Bhutan,27.5142,90.4336,14451,0,7,14444
3/6/22,Bhutan,27.5142,90.4336,14798,0,7,14791
3/7/22,Bhutan,27.5142,90.4336,15119,0,7,15112
3/8/22,Bhutan,27.5142,90.4336,15560,0,7,15553
3/9/22,Bhutan,27.5142,90.4336,15946,0,7,15939
3/10/22,Bhutan,27.5142,90.4336,16277,0,7,16270
3/11/22,Bhutan,27.5142,90.4336,16666,0,7,16659
3/12/22,Bhutan,27.5142,90.4336,17150,0,7,17143
3/13/22,Bhutan,27.5142,90.4336,17620,0,7,17613
3/14/22,Bhutan,27.5142,90.4336,18652,0,7,18645
3/15/22,Bhutan,27.5142,90.4336,19435,0,7,19428
3/16/22,Bhutan,27.5142,90.4336,20116,0,7,20109
3/17/22,Bhutan,27.5142,90.4336,20722,0,9,20713
3/18/22,Bhutan,27.5142,90.4336,21310,0,9,21301
3/19/22,Bhutan,27.5142,90.4336,21660,0,9,21651
3/20/22,Bhutan,27.5142,90.4336,22004,0,9,21995
3/21/22,Bhutan,27.5142,90.4336,22385,0,9,22376
3/22/22,Bhutan,27.5142,90.4336,22625,0,9,22616
3/23/22,Bhutan,27.5142,90.4336,23155,0,9,23146
3/24/22,Bhutan,27.5142,90.4336,23814,0,9,23805
3/25/22,Bhutan,27.5142,90.4336,24316,0,9,24307
3/26/22,Bhutan,27.5142,90.4336,24761,0,9,24752
3/27/22,Bhutan,27.5142,90.4336,25080,0,9,25071
3/28/22,Bhutan,27.5142,90.4336,25080,0,9,25071
3/29/22,Bhutan,27.5142,90.4336,25876,0,10,25866
3/30/22,Bhutan,27.5142,90.4336,26963,0,10,26953
3/31/22,Bhutan,27.5142,90.4336,28101,0,10,28091
4/1/22,Bhutan,27.5142,90.4336,29139,0,11,29128
4/2/22,Bhutan,27.5142,90.4336,30053,0,12,30041
4/3/22,Bhutan,27.5142,90.4336,31437,0,12,31425
4/4/22,Bhutan,27.5142,90.4336,31927,0,12,31915
4/5/22,Bhutan,27.5142,90.4336,33146,0,12,33134
4/6/22,Bhutan,27.5142,90.4336,35437,0,12,35425
4/7/22,Bhutan,27.5142,90.4336,37049,0,12,37037
4/8/22,Bhutan,27.5142,90.4336,38921,0,13,38908
4/9/22,Bhutan,27.5142,90.4336,40629,0,14,40615
4/10/22,Bhutan,27.5142,90.4336,42222,0,14,42208
4/11/22,Bhutan,27.5142,90.4336,42856,0,14,42842
4/12/22,Bhutan,27.5142,90.4336,45056,0,14,45042
4/13/22,Bhutan,27.5142,90.4336,47187,0,14,47173
4/14/22,Bhutan,27.5142,90.4336,49066,0,15,49051
4/15/22,Bhutan,27.5142,90.4336,50433,0,16,50417
4/16/22,Bhutan,27.5142,90.4336,51800,0,16,51784
4/17/22,Bhutan,27.5142,90.4336,52796,0,18,52778
4/18/22,Bhutan,27.5142,90.4336,53104,0,18,53086
4/19/22,Bhutan,27.5142,90.4336,54592,0,19,54573
4/20/22,Bhutan,27.5142,90.4336,55606,0,19,55587
4/21/22,Bhutan,27.5142,90.4336,56301,0,19,56282
4/22/22,Bhutan,27.5142,90.4336,56603,0,20,56583
4/23/22,Bhutan,27.5142,90.4336,57340,0,20,57320
4/24/22,Bhutan,27.5142,90.4336,57771,0,20,57751
4/25/22,Bhutan,27.5142,90.4336,57909,0,20,57889
4/26/22,Bhutan,27.5142,90.4336,58373,0,20,58353
4/27/22,Bhutan,27.5142,90.4336,58643,0,20,58623
4/28/22,Bhutan,27.5142,90.4336,58876,0,20,58856
4/29/22,Bhutan,27.5142,90.4336,59054,0,21,59033
4/30/22,Bhutan,27.5142,90.4336,59163,0,21,59142
5/1/22,Bhutan,27.5142,90.4336,59219,0,21,59198
5/2/22,Bhutan,27.5142,90.4336,59247,0,21,59226
5/3/22,Bhutan,27.5142,90.4336,59274,0,21,59253
5/4/22,Bhutan,27.5142,90.4336,59358,0,21,59337
5/5/22,Bhutan,27.5142,90.4336,59422,0,21,59401
5/6/22,Bhutan,27.5142,90.4336,59450,0,21,59429
5/7/22,Bhutan,27.5142,90.4336,59483,0,21,59462
5/8/22,Bhutan,27.5142,90.4336,59497,0,21,59476
5/9/22,Bhutan,27.5142,90.4336,59512,0,21,59491
5/10/22,Bhutan,27.5142,90.4336,59530,0,21,59509
5/11/22,Bhutan,27.5142,90.4336,59540,0,21,59519
5/12/22,Bhutan,27.5142,90.4336,59552,0,21,59531
5/13/22,Bhutan,27.5142,90.4336,59564,0,21,59543
5/14/22,Bhutan,27.5142,90.4336,59566,0,21,59545
5/15/22,Bhutan,27.5142,90.4336,59570,0,21,59549
5/16/22,Bhutan,27.5142,90.4336,59574,0,21,59553
5/17/22,Bhutan,27.5142,90.4336,59574,0,21,59553
5/18/22,Bhutan,27.5142,90.4336,59574,0,21,59553
5/19/22,Bhutan,27.5142,90.4336,59574,0,21,59553
5/20/22,Bhutan,27.5142,90.4336,59574,0,21,59553
5/21/22,Bhutan,27.5142,90.4336,59574,0,21,59553
5/22/22,Bhutan,27.5142,90.4336,59574,0,21,59553
5/23/22,Bhutan,27.5142,90.4336,59614,0,21,59593
5/24/22,Bhutan,27.5142,90.4336,59614,0,21,59593
5/25/22,Bhutan,27.5142,90.4336,59614,0,21,59593
5/26/22,Bhutan,27.5142,90.4336,59614,0,21,59593
5/27/22,Bhutan,27.5142,90.4336,59614,0,21,59593
5/28/22,Bhutan,27.5142,90.4336,59614,0,21,59593
5/29/22,Bhutan,27.5142,90.4336,59614,0,21,59593
5/30/22,Bhutan,27.5142,90.4336,59628,0,21,59607
5/31/22,Bhutan,27.5142,90.4336,59628,0,21,59607
6/1/22,Bhutan,27.5142,90.4336,59628,0,21,59607
6/2/22,Bhutan,27.5142,90.4336,59628,0,21,59607
6/3/22,Bhutan,27.5142,90.4336,59628,0,21,59607
6/4/22,Bhutan,27.5142,90.4336,59628,0,21,59607
6/5/22,Bhutan,27.5142,90.4336,59628,0,21,59607
6/6/22,Bhutan,27.5142,90.4336,59636,0,21,59615
6/7/22,Bhutan,27.5142,90.4336,59636,0,21,59615
6/8/22,Bhutan,27.5142,90.4336,59636,0,21,59615
6/9/22,Bhutan,27.5142,90.4336,59636,0,21,59615
6/10/22,Bhutan,27.5142,90.4336,59636,0,21,59615
6/11/22,Bhutan,27.5142,90.4336,59636,0,21,59615
6/12/22,Bhutan,27.5142,90.4336,59636,0,21,59615
6/13/22,Bhutan,27.5142,90.4336,59644,0,21,59623
6/14/22,Bhutan,27.5142,90.4336,59644,0,21,59623
6/15/22,Bhutan,27.5142,90.4336,59644,0,21,59623
6/16/22,Bhutan,27.5142,90.4336,59644,0,21,59623
6/17/22,Bhutan,27.5142,90.4336,59644,0,21,59623
6/18/22,Bhutan,27.5142,90.4336,59644,0,21,59623
6/19/22,Bhutan,27.5142,90.4336,59644,0,21,59623
6/20/22,Bhutan,27.5142,90.4336,59674,0,21,59653
6/21/22,Bhutan,27.5142,90.4336,59674,0,21,59653
6/22/22,Bhutan,27.5142,90.4336,59674,0,21,59653
6/23/22,Bhutan,27.5142,90.4336,59674,0,21,59653
6/24/22,Bhutan,27.5142,90.4336,59674,0,21,59653
6/25/22,Bhutan,27.5142,90.4336,59674,0,21,59653
6/26/22,Bhutan,27.5142,90.4336,59674,0,21,59653
6/27/22,Bhutan,27.5142,90.4336,59729,0,21,59708
6/28/22,Bhutan,27.5142,90.4336,59729,0,21,59708
6/29/22,Bhutan,27.5142,90.4336,59729,0,21,59708
6/30/22,Bhutan,27.5142,90.4336,59729,0,21,59708
7/1/22,Bhutan,27.5142,90.4336,59729,0,21,59708
7/2/22,Bhutan,27.5142,90.4336,59729,0,21,59708
7/3/22,Bhutan,27.5142,90.4336,59729,0,21,59708
7/4/22,Bhutan,27.5142,90.4336,59824,0,21,59803
7/5/22,Bhutan,27.5142,90.4336,59824,0,21,59803
7/6/22,Bhutan,27.5142,90.4336,59824,0,21,59803
7/7/22,Bhutan,27.5142,90.4336,59824,0,21,59803
7/8/22,Bhutan,27.5142,90.4336,59824,0,21,59803
7/9/22,Bhutan,27.5142,90.4336,59824,0,21,59803
7/10/22,Bhutan,27.5142,90.4336,59824,0,21,59803
7/11/22,Bhutan,27.5142,90.4336,59940,0,21,59919
7/12/22,Bhutan,27.5142,90.4336,59940,0,21,59919
7/13/22,Bhutan,27.5142,90.4336,59940,0,21,59919
7/14/22,Bhutan,27.5142,90.4336,59940,0,21,59919
7/15/22,Bhutan,27.5142,90.4336,59940,0,21,59919
7/16/22,Bhutan,27.5142,90.4336,59940,0,21,59919
7/17/22,Bhutan,27.5142,90.4336,59940,0,21,59919
7/18/22,Bhutan,27.5142,90.4336,60109,0,21,60088
7/19/22,Bhutan,27.5142,90.4336,60109,0,21,60088
7/20/22,Bhutan,27.5142,90.4336,60109,0,21,60088
7/21/22,Bhutan,27.5142,90.4336,60109,0,21,60088
7/22/22,Bhutan,27.5142,90.4336,60109,0,21,60088
7/23/22,Bhutan,27.5142,90.4336,60109,0,21,60088
7/24/22,Bhutan,27.5142,90.4336,60109,0,21,60088
7/25/22,Bhutan,27.5142,90.4336,60368,0,21,60347
7/26/22,Bhutan,27.5142,90.4336,60368,0,21,60347
7/27/22,Bhutan,27.5142,90.4336,60368,0,21,60347
7/28/22,Bhutan,27.5142,90.4336,60368,0,21,60347
7/29/22,Bhutan,27.5142,90.4336,60368,0,21,60347
7/30/22,Bhutan,27.5142,90.4336,60368,0,21,60347
7/31/22,Bhutan,27.5142,90.4336,60368,0,21,60347
8/1/22,Bhutan,27.5142,90.4336,60530,0,21,60509
8/2/22,Bhutan,27.5142,90.4336,60530,0,21,60509
8/3/22,Bhutan,27.5142,90.4336,60530,0,21,60509
8/4/22,Bhutan,27.5142,90.4336,60530,0,21,60509
8/5/22,Bhutan,27.5142,90.4336,60530,0,21,60509
8/6/22,Bhutan,27.5142,90.4336,60530,0,21,60509
8/7/22,Bhutan,27.5142,90.4336,60530,0,21,60509
8/8/22,Bhutan,27.5142,90.4336,60663,0,21,60642
8/9/22,Bhutan,27.5142,90.4336,60663,0,21,60642
8/10/22,Bhutan,27.5142,90.4336,60663,0,21,60642
8/11/22,Bhutan,27.5142,90.4336,60663,0,21,60642
8/12/22,Bhutan,27.5142,90.4336,60663,0,21,60642
8/13/22,Bhutan,27.5142,90.4336,60663,0,21,60642
8/14/22,Bhutan,27.5142,90.4336,60663,0,21,60642
8/15/22,Bhutan,27.5142,90.4336,60779,0,21,60758
8/16/22,Bhutan,27.5142,90.4336,60779,0,21,60758
8/17/22,Bhutan,27.5142,90.4336,60779,0,21,60758
8/18/22,Bhutan,27.5142,90.4336,60779,0,21,60758
8/19/22,Bhutan,27.5142,90.4336,60779,0,21,60758
8/20/22,Bhutan,27.5142,90.4336,60779,0,21,60758
8/21/22,Bhutan,27.5142,90.4336,60779,0,21,60758
8/22/22,Bhutan,27.5142,90.4336,60898,0,21,60877
8/23/22,Bhutan,27.5142,90.4336,60898,0,21,60877
8/24/22,Bhutan,27.5142,90.4336,60898,0,21,60877
8/25/22,Bhutan,27.5142,90.4336,60898,0,21,60877
8/26/22,Bhutan,27.5142,90.4336,60898,0,21,60877
8/27/22,Bhutan,27.5142,90.4336,60898,0,21,60877
8/28/22,Bhutan,27.5142,90.4336,60898,0,21,60877
8/29/22,Bhutan,27.5142,90.4336,61076,0,21,61055
8/30/22,Bhutan,27.5142,90.4336,61076,0,21,61055
8/31/22,Bhutan,27.5142,90.4336,61076,0,21,61055
9/1/22,Bhutan,27.5142,90.4336,61076,0,21,61055
9/2/22,Bhutan,27.5142,90.4336,61076,0,21,61055
9/3/22,Bhutan,27.5142,90.4336,61076,0,21,61055
9/4/22,Bhutan,27.5142,90.4336,61076,0,21,61055
9/5/22,Bhutan,27.5142,90.4336,61233,0,21,61212
9/6/22,Bhutan,27.5142,90.4336,61233,0,21,61212
9/7/22,Bhutan,27.5142,90.4336,61233,0,21,61212
9/8/22,Bhutan,27.5142,90.4336,61233,0,21,61212
9/9/22,Bhutan,27.5142,90.4336,61233,0,21,61212
9/10/22,Bhutan,27.5142,90.4336,61233,0,21,61212
9/11/22,Bhutan,27.5142,90.4336,61233,0,21,61212
9/12/22,Bhutan,27.5142,90.4336,61419,0,21,61398
9/13/22,Bhutan,27.5142,90.4336,61419,0,21,61398
9/14/22,Bhutan,27.5142,90.4336,61419,0,21,61398
9/15/22,Bhutan,27.5142,90.4336,61419,0,21,61398
9/16/22,Bhutan,27.5142,90.4336,61419,0,21,61398
9/17/22,Bhutan,27.5142,90.4336,61419,0,21,61398
9/18/22,Bhutan,27.5142,90.4336,61419,0,21,61398
9/19/22,Bhutan,27.5142,90.4336,61730,0,21,61709
9/20/22,Bhutan,27.5142,90.4336,61730,0,21,61709
9/21/22,Bhutan,27.5142,90.4336,61730,0,21,61709
9/22/22,Bhutan,27.5142,90.4336,61730,0,21,61709
9/23/22,Bhutan,27.5142,90.4336,61730,0,21,61709
9/24/22,Bhutan,27.5142,90.4336,61730,0,21,61709
9/25/22,Bhutan,27.5142,90.4336,61730,0,21,61709
9/26/22,Bhutan,27.5142,90.4336,61730,0,21,61709
9/27/22,Bhutan,27.5142,90.4336,61969,0,21,61948
9/28/22,Bhutan,27.5142,90.4336,61969,0,21,61948
9/29/22,Bhutan,27.5142,90.4336,61969,0,21,61948
9/30/22,Bhutan,27.5142,90.4336,61969,0,21,61948
10/1/22,Bhutan,27.5142,90.4336,61969,0,21,61948
10/2/22,Bhutan,27.5142,90.4336,61969,0,21,61948
10/3/22,Bhutan,27.5142,90.4336,62095,0,21,62074
10/4/22,Bhutan,27.5142,90.4336,62095,0,21,62074
10/5/22,Bhutan,27.5142,90.4336,62095,0,21,62074
10/6/22,Bhutan,27.5142,90.4336,62095,0,21,62074
10/7/22,Bhutan,27.5142,90.4336,62095,0,21,62074
10/8/22,Bhutan,27.5142,90.4336,62095,0,21,62074
10/9/22,Bhutan,27.5142,90.4336,62095,0,21,62074
10/10/22,Bhutan,27.5142,90.4336,62200,0,21,62179
10/11/22,Bhutan,27.5142,90.4336,62200,0,21,62179
10/12/22,Bhutan,27.5142,90.4336,62200,0,21,62179
10/13/22,Bhutan,27.5142,90.4336,62200,0,21,62179
10/14/22,Bhutan,27.5142,90.4336,62200,0,21,62179
10/15/22,Bhutan,27.5142,90.4336,62200,0,21,62179
10/16/22,Bhutan,27.5142,90.4336,62200,0,21,62179
10/17/22,Bhutan,27.5142,90.4336,62247,0,21,62226
10/18/22,Bhutan,27.5142,90.4336,62248,0,21,62227
10/19/22,Bhutan,27.5142,90.4336,62248,0,21,62227
10/20/22,Bhutan,27.5142,90.4336,62248,0,21,62227
10/21/22,Bhutan,27.5142,90.4336,62248,0,21,62227
10/22/22,Bhutan,27.5142,90.4336,62248,0,21,62227
10/23/22,Bhutan,27.5142,90.4336,62248,0,21,62227
10/24/22,Bhutan,27.5142,90.4336,62331,0,21,62310
10/25/22,Bhutan,27.5142,90.4336,62331,0,21,62310
10/26/22,Bhutan,27.5142,90.4336,62331,0,21,62310
10/27/22,Bhutan,27.5142,90.4336,62331,0,21,62310
10/28/22,Bhutan,27.5142,90.4336,62331,0,21,62310
10/29/22,Bhutan,27.5142,90.4336,62331,0,21,62310
10/30/22,Bhutan,27.5142,90.4336,62331,0,21,62310
10/31/22,Bhutan,27.5142,90.4336,62380,0,21,62359
11/1/22,Bhutan,27.5142,90.4336,62380,0,21,62359
11/2/22,Bhutan,27.5142,90.4336,62380,0,21,62359
11/3/22,Bhutan,27.5142,90.4336,62380,0,21,62359
11/4/22,Bhutan,27.5142,90.4336,62380,0,21,62359
11/5/22,Bhutan,27.5142,90.4336,62380,0,21,62359
11/6/22,Bhutan,27.5142,90.4336,62380,0,21,62359
11/7/22,Bhutan,27.5142,90.4336,62430,0,21,62409
11/8/22,Bhutan,27.5142,90.4336,62430,0,21,62409
11/9/22,Bhutan,27.5142,90.4336,62430,0,21,62409
11/10/22,Bhutan,27.5142,90.4336,62430,0,21,62409
11/11/22,Bhutan,27.5142,90.4336,62430,0,21,62409
11/12/22,Bhutan,27.5142,90.4336,62430,0,21,62409
11/13/22,Bhutan,27.5142,90.4336,62430,0,21,62409
11/14/22,Bhutan,27.5142,90.4336,62460,0,21,62439
11/15/22,Bhutan,27.5142,90.4336,62460,0,21,62439
11/16/22,Bhutan,27.5142,90.4336,62460,0,21,62439
11/17/22,Bhutan,27.5142,90.4336,62460,0,21,62439
11/18/22,Bhutan,27.5142,90.4336,62460,0,21,62439
11/19/22,Bhutan,27.5142,90.4336,62460,0,21,62439
11/20/22,Bhutan,27.5142,90.4336,62460,0,21,62439
11/21/22,Bhutan,27.5142,90.4336,62488,0,21,62467
11/22/22,Bhutan,27.5142,90.4336,62488,0,21,62467
11/23/22,Bhutan,27.5142,90.4336,62488,0,21,62467
11/24/22,Bhutan,27.5142,90.4336,62488,0,21,62467
11/25/22,Bhutan,27.5142,90.4336,62488,0,21,62467
11/26/22,Bhutan,27.5142,90.4336,62488,0,21,62467
11/27/22,Bhutan,27.5142,90.4336,62488,0,21,62467
11/28/22,Bhutan,27.5142,90.4336,62488,0,21,62467
11/29/22,Bhutan,27.5142,90.4336,62503,0,21,62482
11/30/22,Bhutan,27.5142,90.4336,62503,0,21,62482
12/1/22,Bhutan,27.5142,90.4336,62503,0,21,62482
12/2/22,Bhutan,27.5142,90.4336,62503,0,21,62482
12/3/22,Bhutan,27.5142,90.4336,62503,0,21,62482
12/4/22,Bhutan,27.5142,90.4336,62503,0,21,62482
12/5/22,Bhutan,27.5142,90.4336,62512,0,21,62491
12/6/22,Bhutan,27.5142,90.4336,62512,0,21,62491
12/7/22,Bhutan,27.5142,90.4336,62512,0,21,62491
12/8/22,Bhutan,27.5142,90.4336,62512,0,21,62491
12/9/22,Bhutan,27.5142,90.4336,62512,0,21,62491
12/10/22,Bhutan,27.5142,90.4336,62512,0,21,62491
12/11/22,Bhutan,27.5142,90.4336,62512,0,21,62491
12/12/22,Bhutan,27.5142,90.4336,62521,0,21,62500
12/13/22,Bhutan,27.5142,90.4336,62521,0,21,62500
12/14/22,Bhutan,27.5142,90.4336,62521,0,21,62500
12/15/22,Bhutan,27.5142,90.4336,62521,0,21,62500
12/16/22,Bhutan,27.5142,90.4336,62521,0,21,62500
12/17/22,Bhutan,27.5142,90.4336,62521,0,21,62500
1/1/22,Bolivia,-16.2902,-63.5887,599753,0,19680,580073
1/2/22,Bolivia,-16.2902,-63.5887,611031,0,19722,591309
1/3/22,Bolivia,-16.2902,-63.5887,622312,0,19763,602549
1/4/22,Bolivia,-16.2902,-63.5887,622312,0,19763,602549
1/5/22,Bolivia,-16.2902,-63.5887,631554,0,19810,611744
1/6/22,Bolivia,-16.2902,-63.5887,641817,0,19848,621969
1/7/22,Bolivia,-16.2902,-63.5887,652819,0,19888,632931
1/8/22,Bolivia,-16.2902,-63.5887,671832,0,19957,651875
1/9/22,Bolivia,-16.2902,-63.5887,677166,0,19983,657183
1/10/22,Bolivia,-16.2902,-63.5887,686023,0,19999,666024
1/11/22,Bolivia,-16.2902,-63.5887,697236,0,20056,677180
1/12/22,Bolivia,-16.2902,-63.5887,711299,0,20103,691196
1/13/22,Bolivia,-16.2902,-63.5887,711299,0,20103,691196
1/14/22,Bolivia,-16.2902,-63.5887,725459,0,20149,705310
1/15/22,Bolivia,-16.2902,-63.5887,725459,0,20149,705310
1/16/22,Bolivia,-16.2902,-63.5887,749070,0,20238,728832
1/17/22,Bolivia,-16.2902,-63.5887,754335,0,20254,734081
1/18/22,Bolivia,-16.2902,-63.5887,763392,0,20291,743101
1/19/22,Bolivia,-16.2902,-63.5887,774227,0,20377,753850
1/20/22,Bolivia,-16.2902,-63.5887,795087,0,20504,774583
1/21/22,Bolivia,-16.2902,-63.5887,804677,0,20570,784107
1/22/22,Bolivia,-16.2902,-63.5887,804677,0,20570,784107
1/23/22,Bolivia,-16.2902,-63.5887,804677,0,20570,784107
1/24/22,Bolivia,-16.2902,-63.5887,820583,0,20671,799912
1/25/22,Bolivia,-16.2902,-63.5887,828232,0,20720,807512
1/26/22,Bolivia,-16.2902,-63.5887,835170,0,20774,814396
1/27/22,Bolivia,-16.2902,-63.5887,841757,0,20824,820933
1/28/22,Bolivia,-16.2902,-63.5887,841757,0,20824,820933
1/29/22,Bolivia,-16.2902,-63.5887,847180,0,20865,826315
1/30/22,Bolivia,-16.2902,-63.5887,852280,0,20919,831361
1/31/22,Bolivia,-16.2902,-63.5887,855705,0,20951,834754
2/1/22,Bolivia,-16.2902,-63.5887,859530,0,21011,838519
2/2/22,Bolivia,-16.2902,-63.5887,863675,0,21045,842630
2/3/22,Bolivia,-16.2902,-63.5887,867071,0,21073,845998
2/4/22,Bolivia,-16.2902,-63.5887,867071,0,21073,845998
2/5/22,Bolivia,-16.2902,-63.5887,871749,0,21129,850620
2/6/22,Bolivia,-16.2902,-63.5887,871749,0,21129,850620
2/7/22,Bolivia,-16.2902,-63.5887,874906,0,21171,853735
2/8/22,Bolivia,-16.2902,-63.5887,874906,0,21171,853735
2/9/22,Bolivia,-16.2902,-63.5887,878922,0,21219,857703
2/10/22,Bolivia,-16.2902,-63.5887,878922,0,21219,857703
2/11/22,Bolivia,-16.2902,-63.5887,880891,0,21240,859651
2/12/22,Bolivia,-16.2902,-63.5887,882649,0,21261,861388
2/13/22,Bolivia,-16.2902,-63.5887,883382,0,21284,862098
2/14/22,Bolivia,-16.2902,-63.5887,885004,0,21314,863690
2/15/22,Bolivia,-16.2902,-63.5887,886108,0,21331,864777
2/16/22,Bolivia,-16.2902,-63.5887,887089,0,21342,865747
2/17/22,Bolivia,-16.2902,-63.5887,887089,0,21342,865747
2/18/22,Bolivia,-16.2902,-63.5887,888175,0,21358,866817
2/19/22,Bolivia,-16.2902,-63.5887,889044,0,21367,867677
2/20/22,Bolivia,-16.2902,-63.5887,889511,0,21372,868139
2/21/22,Bolivia,-16.2902,-63.5887,890420,0,21386,869034
2/22/22,Bolivia,-16.2902,-63.5887,891112,0,21400,869712
2/23/22,Bolivia,-16.2902,-63.5887,891851,0,21406,870445
2/24/22,Bolivia,-16.2902,-63.5887,891851,0,21406,870445
2/25/22,Bolivia,-16.2902,-63.5887,892537,0,21414,871123
2/26/22,Bolivia,-16.2902,-63.5887,893048,0,21419,871629
2/27/22,Bolivia,-16.2902,-63.5887,893223,0,21426,871797
2/28/22,Bolivia,-16.2902,-63.5887,893395,0,21438,871957
3/1/22,Bolivia,-16.2902,-63.5887,893512,0,21441,872071
3/2/22,Bolivia,-16.2902,-63.5887,893775,0,21443,872332
3/3/22,Bolivia,-16.2902,-63.5887,894200,0,21453,872747
3/4/22,Bolivia,-16.2902,-63.5887,894200,0,21453,872747
3/5/22,Bolivia,-16.2902,-63.5887,894551,0,21455,873096
3/6/22,Bolivia,-16.2902,-63.5887,895098,0,21463,873635
3/7/22,Bolivia,-16.2902,-63.5887,895098,0,21463,873635
3/8/22,Bolivia,-16.2902,-63.5887,895424,0,21469,873955
3/9/22,Bolivia,-16.2902,-63.5887,896315,0,21470,874845
3/10/22,Bolivia,-16.2902,-63.5887,896744,0,21472,875272
3/11/22,Bolivia,-16.2902,-63.5887,897098,0,21473,875625
3/12/22,Bolivia,-16.2902,-63.5887,897351,0,21473,875878
3/13/22,Bolivia,-16.2902,-63.5887,897489,0,21473,876016
3/14/22,Bolivia,-16.2902,-63.5887,897489,0,21473,876016
3/15/22,Bolivia,-16.2902,-63.5887,897970,0,21475,876495
3/16/22,Bolivia,-16.2902,-63.5887,898464,0,21476,876988
3/17/22,Bolivia,-16.2902,-63.5887,898941,0,21477,877464
3/18/22,Bolivia,-16.2902,-63.5887,899524,0,21482,878042
3/19/22,Bolivia,-16.2902,-63.5887,899524,0,21482,878042
3/20/22,Bolivia,-16.2902,-63.5887,899697,0,21482,878215
3/21/22,Bolivia,-16.2902,-63.5887,899999,0,21483,878516
3/22/22,Bolivia,-16.2902,-63.5887,899999,0,21483,878516
3/23/22,Bolivia,-16.2902,-63.5887,900260,0,21483,878777
3/24/22,Bolivia,-16.2902,-63.5887,900557,0,21484,879073
3/25/22,Bolivia,-16.2902,-63.5887,900845,0,21487,879358
3/26/22,Bolivia,-16.2902,-63.5887,901108,0,21487,879621
3/27/22,Bolivia,-16.2902,-63.5887,901367,0,21487,879880
3/28/22,Bolivia,-16.2902,-63.5887,901587,0,21489,880098
3/29/22,Bolivia,-16.2902,-63.5887,901752,0,21894,879858
3/30/22,Bolivia,-16.2902,-63.5887,901943,0,21894,880049
3/31/22,Bolivia,-16.2902,-63.5887,901943,0,21894,880049
4/1/22,Bolivia,-16.2902,-63.5887,902316,0,21895,880421
4/2/22,Bolivia,-16.2902,-63.5887,902448,0,21896,880552
4/3/22,Bolivia,-16.2902,-63.5887,902497,0,21896,880601
4/4/22,Bolivia,-16.2902,-63.5887,902497,0,21896,880601
4/5/22,Bolivia,-16.2902,-63.5887,902749,0,21897,880852
4/6/22,Bolivia,-16.2902,-63.5887,902749,0,21897,880852
4/7/22,Bolivia,-16.2902,-63.5887,903062,0,21899,881163
4/8/22,Bolivia,-16.2902,-63.5887,903062,0,21899,881163
4/9/22,Bolivia,-16.2902,-63.5887,903306,0,21899,881407
4/10/22,Bolivia,-16.2902,-63.5887,903306,0,21899,881407
4/11/22,Bolivia,-16.2902,-63.5887,903477,0,21899,881578
4/12/22,Bolivia,-16.2902,-63.5887,903584,0,21899,881685
4/13/22,Bolivia,-16.2902,-63.5887,903677,0,21901,881776
4/14/22,Bolivia,-16.2902,-63.5887,903776,0,21901,881875
4/15/22,Bolivia,-16.2902,-63.5887,903776,0,21901,881875
4/16/22,Bolivia,-16.2902,-63.5887,903888,0,21903,881985
4/17/22,Bolivia,-16.2902,-63.5887,903908,0,21903,882005
4/18/22,Bolivia,-16.2902,-63.5887,903908,0,21903,882005
4/19/22,Bolivia,-16.2902,-63.5887,904029,0,21904,882125
4/20/22,Bolivia,-16.2902,-63.5887,904126,0,21905,882221
4/21/22,Bolivia,-16.2902,-63.5887,904212,0,21906,882306
4/22/22,Bolivia,-16.2902,-63.5887,904294,0,21907,882387
4/23/22,Bolivia,-16.2902,-63.5887,904294,0,21907,882387
4/24/22,Bolivia,-16.2902,-63.5887,904446,0,21908,882538
4/25/22,Bolivia,-16.2902,-63.5887,904479,0,21908,882571
4/26/22,Bolivia,-16.2902,-63.5887,904657,0,21909,882748
4/27/22,Bolivia,-16.2902,-63.5887,904758,0,21910,882848
4/28/22,Bolivia,-16.2902,-63.5887,904758,0,21910,882848
4/29/22,Bolivia,-16.2902,-63.5887,904883,0,21910,882973
4/30/22,Bolivia,-16.2902,-63.5887,904974,0,21910,883064
5/1/22,Bolivia,-16.2902,-63.5887,905074,0,21923,883151
5/2/22,Bolivia,-16.2902,-63.5887,905074,0,21923,883151
5/3/22,Bolivia,-16.2902,-63.5887,905097,0,21923,883174
5/4/22,Bolivia,-16.2902,-63.5887,905150,0,21923,883227
5/5/22,Bolivia,-16.2902,-63.5887,905212,0,21924,883288
5/6/22,Bolivia,-16.2902,-63.5887,905355,0,21925,883430
5/7/22,Bolivia,-16.2902,-63.5887,905428,0,21925,883503
5/8/22,Bolivia,-16.2902,-63.5887,905453,0,21925,883528
5/9/22,Bolivia,-16.2902,-63.5887,905453,0,21925,883528
5/10/22,Bolivia,-16.2902,-63.5887,905530,0,21925,883605
5/11/22,Bolivia,-16.2902,-63.5887,905820,0,21926,883894
5/12/22,Bolivia,-16.2902,-63.5887,905820,0,21926,883894
5/13/22,Bolivia,-16.2902,-63.5887,905994,0,21926,884068
5/14/22,Bolivia,-16.2902,-63.5887,906146,0,21943,884203
5/15/22,Bolivia,-16.2902,-63.5887,906146,0,21943,884203
5/16/22,Bolivia,-16.2902,-63.5887,906333,0,21943,884390
5/17/22,Bolivia,-16.2902,-63.5887,906462,0,21943,884519
5/18/22,Bolivia,-16.2902,-63.5887,906462,0,21943,884519
5/19/22,Bolivia,-16.2902,-63.5887,906743,0,21943,884800
5/20/22,Bolivia,-16.2902,-63.5887,907013,0,21943,885070
5/21/22,Bolivia,-16.2902,-63.5887,907224,0,21944,885280
5/22/22,Bolivia,-16.2902,-63.5887,907224,0,21944,885280
5/23/22,Bolivia,-16.2902,-63.5887,907307,0,21945,885362
5/24/22,Bolivia,-16.2902,-63.5887,907767,0,21945,885822
5/25/22,Bolivia,-16.2902,-63.5887,907767,0,21945,885822
5/26/22,Bolivia,-16.2902,-63.5887,907958,0,21946,886012
5/27/22,Bolivia,-16.2902,-63.5887,908383,0,21947,886436
5/28/22,Bolivia,-16.2902,-63.5887,908525,0,21947,886578
5/29/22,Bolivia,-16.2902,-63.5887,908659,0,21947,886712
5/30/22,Bolivia,-16.2902,-63.5887,908862,0,21948,886914
5/31/22,Bolivia,-16.2902,-63.5887,908862,0,21948,886914
6/1/22,Bolivia,-16.2902,-63.5887,909372,0,21948,887424
6/2/22,Bolivia,-16.2902,-63.5887,909372,0,21948,887424
6/3/22,Bolivia,-16.2902,-63.5887,909919,0,21948,887971
6/4/22,Bolivia,-16.2902,-63.5887,909919,0,21948,887971
6/5/22,Bolivia,-16.2902,-63.5887,910134,0,21949,888185
6/6/22,Bolivia,-16.2902,-63.5887,910516,0,21949,888567
6/7/22,Bolivia,-16.2902,-63.5887,910832,0,21949,888883
6/8/22,Bolivia,-16.2902,-63.5887,911188,0,21950,889238
6/9/22,Bolivia,-16.2902,-63.5887,911635,0,21950,889685
6/10/22,Bolivia,-16.2902,-63.5887,911635,0,21950,889685
6/11/22,Bolivia,-16.2902,-63.5887,912272,0,21951,890321
6/12/22,Bolivia,-16.2902,-63.5887,912473,0,21951,890522
6/13/22,Bolivia,-16.2902,-63.5887,912869,0,21951,890918
6/14/22,Bolivia,-16.2902,-63.5887,913362,0,21951,891411
6/15/22,Bolivia,-16.2902,-63.5887,913874,0,21951,891923
6/16/22,Bolivia,-16.2902,-63.5887,914252,0,21951,892301
6/17/22,Bolivia,-16.2902,-63.5887,914827,0,21951,892876
6/18/22,Bolivia,-16.2902,-63.5887,914827,0,21951,892876
6/19/22,Bolivia,-16.2902,-63.5887,915500,0,21951,893549
6/20/22,Bolivia,-16.2902,-63.5887,916092,0,21952,894140
6/21/22,Bolivia,-16.2902,-63.5887,916092,0,21952,894140
6/22/22,Bolivia,-16.2902,-63.5887,917537,0,21952,895585
6/23/22,Bolivia,-16.2902,-63.5887,918551,0,21952,896599
6/24/22,Bolivia,-16.2902,-63.5887,919737,0,21952,897785
6/25/22,Bolivia,-16.2902,-63.5887,920595,0,21953,898642
6/26/22,Bolivia,-16.2902,-63.5887,921104,0,21953,899151
6/27/22,Bolivia,-16.2902,-63.5887,921104,0,21953,899151
6/28/22,Bolivia,-16.2902,-63.5887,922121,0,21953,900168
6/29/22,Bolivia,-16.2902,-63.5887,925096,0,21953,903143
6/30/22,Bolivia,-16.2902,-63.5887,926718,0,21953,904765
7/1/22,Bolivia,-16.2902,-63.5887,928450,0,21955,906495
7/2/22,Bolivia,-16.2902,-63.5887,928450,0,21955,906495
7/3/22,Bolivia,-16.2902,-63.5887,929544,0,21957,907587
7/4/22,Bolivia,-16.2902,-63.5887,931955,0,21958,909997
7/5/22,Bolivia,-16.2902,-63.5887,931955,0,21958,909997
7/6/22,Bolivia,-16.2902,-63.5887,936702,0,21963,914739
7/7/22,Bolivia,-16.2902,-63.5887,939612,0,21963,917649
7/8/22,Bolivia,-16.2902,-63.5887,939612,0,21963,917649
7/9/22,Bolivia,-16.2902,-63.5887,942307,0,21964,920343
7/10/22,Bolivia,-16.2902,-63.5887,944286,0,21969,922317
7/11/22,Bolivia,-16.2902,-63.5887,948655,0,21970,926685
7/12/22,Bolivia,-16.2902,-63.5887,948655,0,21970,926685
7/13/22,Bolivia,-16.2902,-63.5887,956629,0,21977,934652
7/14/22,Bolivia,-16.2902,-63.5887,960779,0,21979,938800
7/15/22,Bolivia,-16.2902,-63.5887,960779,0,21979,938800
7/16/22,Bolivia,-16.2902,-63.5887,968212,0,21979,946233
7/17/22,Bolivia,-16.2902,-63.5887,969652,0,21982,947670
7/18/22,Bolivia,-16.2902,-63.5887,969652,0,21982,947670
7/19/22,Bolivia,-16.2902,-63.5887,974005,0,21989,952016
7/20/22,Bolivia,-16.2902,-63.5887,985630,0,21999,963631
7/21/22,Bolivia,-16.2902,-63.5887,991680,0,22007,969673
7/22/22,Bolivia,-16.2902,-63.5887,997615,0,22013,975602
7/23/22,Bolivia,-16.2902,-63.5887,1001213,0,22017,979196
7/24/22,Bolivia,-16.2902,-63.5887,1003400,0,22021,981379
7/25/22,Bolivia,-16.2902,-63.5887,1007919,0,22025,985894
7/26/22,Bolivia,-16.2902,-63.5887,1014252,0,22032,992220
7/27/22,Bolivia,-16.2902,-63.5887,1020678,0,22036,998642
7/28/22,Bolivia,-16.2902,-63.5887,1026692,0,22045,1004647
7/29/22,Bolivia,-16.2902,-63.5887,1032023,0,22053,1009970
7/30/22,Bolivia,-16.2902,-63.5887,1035593,0,22056,1013537
7/31/22,Bolivia,-16.2902,-63.5887,1037500,0,22061,1015439
8/1/22,Bolivia,-16.2902,-63.5887,1037500,0,22061,1015439
8/2/22,Bolivia,-16.2902,-63.5887,1047198,0,22072,1025126
8/3/22,Bolivia,-16.2902,-63.5887,1047198,0,22072,1025126
8/4/22,Bolivia,-16.2902,-63.5887,1056378,0,22083,1034295
8/5/22,Bolivia,-16.2902,-63.5887,1060484,0,22089,1038395
8/6/22,Bolivia,-16.2902,-63.5887,1062772,0,22091,1040681
8/7/22,Bolivia,-16.2902,-63.5887,1064405,0,22095,1042310
8/8/22,Bolivia,-16.2902,-63.5887,1067338,0,22102,1045236
8/9/22,Bolivia,-16.2902,-63.5887,1070521,0,22110,1048411
8/10/22,Bolivia,-16.2902,-63.5887,1073593,0,22113,1051480
8/11/22,Bolivia,-16.2902,-63.5887,1076815,0,22120,1054695
8/12/22,Bolivia,-16.2902,-63.5887,1076815,0,22120,1054695
8/13/22,Bolivia,-16.2902,-63.5887,1079371,0,22126,1057245
8/14/22,Bolivia,-16.2902,-63.5887,1081206,0,22129,1059077
8/15/22,Bolivia,-16.2902,-63.5887,1084013,0,22144,1061869
8/16/22,Bolivia,-16.2902,-63.5887,1086347,0,22150,1064197
8/17/22,Bolivia,-16.2902,-63.5887,1088291,0,22155,1066136
8/18/22,Bolivia,-16.2902,-63.5887,1088291,0,22155,1066136
8/19/22,Bolivia,-16.2902,-63.5887,1089997,0,22164,1067833
8/20/22,Bolivia,-16.2902,-63.5887,1092520,0,22168,1070352
8/21/22,Bolivia,-16.2902,-63.5887,1093218,0,22171,1071047
8/22/22,Bolivia,-16.2902,-63.5887,1094285,0,22175,1072110
8/23/22,Bolivia,-16.2902,-63.5887,1095623,0,22177,1073446
8/24/22,Bolivia,-16.2902,-63.5887,1095623,0,22177,1073446
8/25/22,Bolivia,-16.2902,-63.5887,1096844,0,22183,1074661
8/26/22,Bolivia,-16.2902,-63.5887,1098027,0,22186,1075841
8/27/22,Bolivia,-16.2902,-63.5887,1099718,0,22194,1077524
8/28/22,Bolivia,-16.2902,-63.5887,1100112,0,22195,1077917
8/29/22,Bolivia,-16.2902,-63.5887,1100112,0,22195,1077917
8/30/22,Bolivia,-16.2902,-63.5887,1101652,0,22198,1079454
8/31/22,Bolivia,-16.2902,-63.5887,1101652,0,22198,1079454
9/1/22,Bolivia,-16.2902,-63.5887,1103008,0,22201,1080807
9/2/22,Bolivia,-16.2902,-63.5887,1103556,0,22205,1081351
9/3/22,Bolivia,-16.2902,-63.5887,1103889,0,22208,1081681
9/4/22,Bolivia,-16.2902,-63.5887,1104102,0,22209,1081893
9/5/22,Bolivia,-16.2902,-63.5887,1104102,0,22209,1081893
9/6/22,Bolivia,-16.2902,-63.5887,1104421,0,22209,1082212
9/7/22,Bolivia,-16.2902,-63.5887,1105236,0,22212,1083024
9/8/22,Bolivia,-16.2902,-63.5887,1105236,0,22212,1083024
9/9/22,Bolivia,-16.2902,-63.5887,1105543,0,22214,1083329
9/10/22,Bolivia,-16.2902,-63.5887,1105812,0,22216,1083596
9/11/22,Bolivia,-16.2902,-63.5887,1106142,0,22217,1083925
9/12/22,Bolivia,-16.2902,-63.5887,1106142,0,22217,1083925
9/13/22,Bolivia,-16.2902,-63.5887,1106319,0,22218,1084101
9/14/22,Bolivia,-16.2902,-63.5887,1106538,0,22218,1084320
9/15/22,Bolivia,-16.2902,-63.5887,1106900,0,22226,1084674
9/16/22,Bolivia,-16.2902,-63.5887,1106900,0,22226,1084674
9/17/22,Bolivia,-16.2902,-63.5887,1107049,0,22227,1084822
9/18/22,Bolivia,-16.2902,-63.5887,1107139,0,22228,1084911
9/19/22,Bolivia,-16.2902,-63.5887,1107201,0,22228,1084973
9/20/22,Bolivia,-16.2902,-63.5887,1107456,0,22229,1085227
9/21/22,Bolivia,-16.2902,-63.5887,1107456,0,22229,1085227
9/22/22,Bolivia,-16.2902,-63.5887,1107689,0,22229,1085460
9/23/22,Bolivia,-16.2902,-63.5887,1107689,0,22229,1085460
9/24/22,Bolivia,-16.2902,-63.5887,1107782,0,22232,1085550
9/25/22,Bolivia,-16.2902,-63.5887,1107908,0,22232,1085676
9/26/22,Bolivia,-16.2902,-63.5887,1107963,0,22233,1085730
9/27/22,Bolivia,-16.2902,-63.5887,1107963,0,22233,1085730
9/28/22,Bolivia,-16.2902,-63.5887,1108055,0,22233,1085822
9/29/22,Bolivia,-16.2902,-63.5887,1108195,0,22234,1085961
9/30/22,Bolivia,-16.2902,-63.5887,1108262,0,22237,1086025
10/1/22,Bolivia,-16.2902,-63.5887,1108316,0,22237,1086079
10/2/22,Bolivia,-16.2902,-63.5887,1108347,0,22237,1086110
10/3/22,Bolivia,-16.2902,-63.5887,1108415,0,22237,1086178
10/4/22,Bolivia,-16.2902,-63.5887,1108472,0,22237,1086235
10/5/22,Bolivia,-16.2902,-63.5887,1108472,0,22237,1086235
10/6/22,Bolivia,-16.2902,-63.5887,1108595,0,22237,1086358
10/7/22,Bolivia,-16.2902,-63.5887,1108595,0,22237,1086358
10/8/22,Bolivia,-16.2902,-63.5887,1108648,0,22237,1086411
10/9/22,Bolivia,-16.2902,-63.5887,1108702,0,22237,1086465
10/10/22,Bolivia,-16.2902,-63.5887,1108702,0,22237,1086465
10/11/22,Bolivia,-16.2902,-63.5887,1108768,0,22237,1086531
10/12/22,Bolivia,-16.2902,-63.5887,1108818,0,22237,1086581
10/13/22,Bolivia,-16.2902,-63.5887,1108865,0,22237,1086628
10/14/22,Bolivia,-16.2902,-63.5887,1108903,0,22237,1086666
10/15/22,Bolivia,-16.2902,-63.5887,1108948,0,22237,1086711
10/16/22,Bolivia,-16.2902,-63.5887,1108948,0,22237,1086711
10/17/22,Bolivia,-16.2902,-63.5887,1109037,0,22237,1086800
10/18/22,Bolivia,-16.2902,-63.5887,1109037,0,22237,1086800
10/19/22,Bolivia,-16.2902,-63.5887,1109123,0,22237,1086886
10/20/22,Bolivia,-16.2902,-63.5887,1109171,0,22237,1086934
10/21/22,Bolivia,-16.2902,-63.5887,1109171,0,22237,1086934
10/22/22,Bolivia,-16.2902,-63.5887,1109171,0,22237,1086934
10/23/22,Bolivia,-16.2902,-63.5887,1109238,0,22239,1086999
10/24/22,Bolivia,-16.2902,-63.5887,1109238,0,22239,1086999
10/25/22,Bolivia,-16.2902,-63.5887,1109277,0,22239,1087038
10/26/22,Bolivia,-16.2902,-63.5887,1109309,0,22239,1087070
10/27/22,Bolivia,-16.2902,-63.5887,1109309,0,22239,1087070
10/28/22,Bolivia,-16.2902,-63.5887,1109385,0,22239,1087146
10/29/22,Bolivia,-16.2902,-63.5887,1109385,0,22239,1087146
10/30/22,Bolivia,-16.2902,-63.5887,1109447,0,22239,1087208
10/31/22,Bolivia,-16.2902,-63.5887,1109447,0,22239,1087208
11/1/22,Bolivia,-16.2902,-63.5887,1109491,0,22239,1087252
11/2/22,Bolivia,-16.2902,-63.5887,1109491,0,22239,1087252
11/3/22,Bolivia,-16.2902,-63.5887,1109512,0,22239,1087273
11/4/22,Bolivia,-16.2902,-63.5887,1109529,0,22239,1087290
11/5/22,Bolivia,-16.2902,-63.5887,1109581,0,22240,1087341
11/6/22,Bolivia,-16.2902,-63.5887,1109601,0,22240,1087361
11/7/22,Bolivia,-16.2902,-63.5887,1109652,0,22240,1087412
11/8/22,Bolivia,-16.2902,-63.5887,1109652,0,22240,1087412
11/9/22,Bolivia,-16.2902,-63.5887,1109730,0,22241,1087489
11/10/22,Bolivia,-16.2902,-63.5887,1109730,0,22241,1087489
11/11/22,Bolivia,-16.2902,-63.5887,1109763,0,22243,1087520
11/12/22,Bolivia,-16.2902,-63.5887,1109822,0,22243,1087579
11/13/22,Bolivia,-16.2902,-63.5887,1109822,0,22243,1087579
11/14/22,Bolivia,-16.2902,-63.5887,1109838,0,22243,1087595
11/15/22,Bolivia,-16.2902,-63.5887,1109889,0,22244,1087645
11/16/22,Bolivia,-16.2902,-63.5887,1110014,0,22244,1087770
11/17/22,Bolivia,-16.2902,-63.5887,1110014,0,22244,1087770
11/18/22,Bolivia,-16.2902,-63.5887,1110064,0,22244,1087820
11/19/22,Bolivia,-16.2902,-63.5887,1110064,0,22244,1087820
11/20/22,Bolivia,-16.2902,-63.5887,1110190,0,22244,1087946
11/21/22,Bolivia,-16.2902,-63.5887,1110190,0,22244,1087946
11/22/22,Bolivia,-16.2902,-63.5887,1110256,0,22244,1088012
11/23/22,Bolivia,-16.2902,-63.5887,1110413,0,22244,1088169
11/24/22,Bolivia,-16.2902,-63.5887,1110413,0,22244,1088169
11/25/22,Bolivia,-16.2902,-63.5887,1110505,0,22244,1088261
11/26/22,Bolivia,-16.2902,-63.5887,1110608,0,22245,1088363
11/27/22,Bolivia,-16.2902,-63.5887,1110701,0,22246,1088455
11/28/22,Bolivia,-16.2902,-63.5887,1110766,0,22246,1088520
11/29/22,Bolivia,-16.2902,-63.5887,1111086,0,22247,1088839
11/30/22,Bolivia,-16.2902,-63.5887,1111086,0,22247,1088839
12/1/22,Bolivia,-16.2902,-63.5887,1111357,0,22248,1089109
12/2/22,Bolivia,-16.2902,-63.5887,1111646,0,22248,1089398
12/3/22,Bolivia,-16.2902,-63.5887,1112309,0,22249,1090060
12/4/22,Bolivia,-16.2902,-63.5887,1112501,0,22250,1090251
12/5/22,Bolivia,-16.2902,-63.5887,1112501,0,22250,1090251
12/6/22,Bolivia,-16.2902,-63.5887,1112997,0,22251,1090746
12/7/22,Bolivia,-16.2902,-63.5887,1114914,0,22252,1092662
12/8/22,Bolivia,-16.2902,-63.5887,1114914,0,22252,1092662
12/9/22,Bolivia,-16.2902,-63.5887,1116117,0,22253,1093864
12/10/22,Bolivia,-16.2902,-63.5887,1116117,0,22253,1093864
12/11/22,Bolivia,-16.2902,-63.5887,1118388,0,22253,1096135
12/12/22,Bolivia,-16.2902,-63.5887,1120512,0,22253,1098259
12/13/22,Bolivia,-16.2902,-63.5887,1122783,0,22253,1100530
12/14/22,Bolivia,-16.2902,-63.5887,1122783,0,22253,1100530
12/15/22,Bolivia,-16.2902,-63.5887,1127584,0,22262,1105322
12/16/22,Bolivia,-16.2902,-63.5887,1127584,0,22262,1105322
12/17/22,Bolivia,-16.2902,-63.5887,1130165,0,22266,1107899
1/1/22,Bosnia and Herzegovina,43.9159,17.6791,291313,0,13442,277871
1/2/22,Bosnia and Herzegovina,43.9159,17.6791,291313,0,13442,277871
1/3/22,Bosnia and Herzegovina,43.9159,17.6791,291313,0,13442,277871
1/4/22,Bosnia and Herzegovina,43.9159,17.6791,293684,0,13517,280167
1/5/22,Bosnia and Herzegovina,43.9159,17.6791,295240,0,13547,281693
1/6/22,Bosnia and Herzegovina,43.9159,17.6791,297333,0,13568,283765
1/7/22,Bosnia and Herzegovina,43.9159,17.6791,297333,0,13568,283765
1/8/22,Bosnia and Herzegovina,43.9159,17.6791,297333,0,13568,283765
1/9/22,Bosnia and Herzegovina,43.9159,17.6791,297333,0,13568,283765
1/10/22,Bosnia and Herzegovina,43.9159,17.6791,302587,0,13645,288942
1/11/22,Bosnia and Herzegovina,43.9159,17.6791,304856,0,13673,291183
1/12/22,Bosnia and Herzegovina,43.9159,17.6791,307433,0,13696,293737
1/13/22,Bosnia and Herzegovina,43.9159,17.6791,310023,0,13722,296301
1/14/22,Bosnia and Herzegovina,43.9159,17.6791,313185,0,13741,299444
1/15/22,Bosnia and Herzegovina,43.9159,17.6791,313185,0,13741,299444
1/16/22,Bosnia and Herzegovina,43.9159,17.6791,313185,0,13741,299444
1/17/22,Bosnia and Herzegovina,43.9159,17.6791,317692,0,13841,303851
1/18/22,Bosnia and Herzegovina,43.9159,17.6791,321034,0,13888,307146
1/19/22,Bosnia and Herzegovina,43.9159,17.6791,324026,0,13912,310114
1/20/22,Bosnia and Herzegovina,43.9159,17.6791,326995,0,13951,313044
1/21/22,Bosnia and Herzegovina,43.9159,17.6791,329569,0,13984,315585
1/22/22,Bosnia and Herzegovina,43.9159,17.6791,329569,0,13984,315585
1/23/22,Bosnia and Herzegovina,43.9159,17.6791,329569,0,13984,315585
1/24/22,Bosnia and Herzegovina,43.9159,17.6791,334141,0,14085,320056
1/25/22,Bosnia and Herzegovina,43.9159,17.6791,336680,0,14136,322544
1/26/22,Bosnia and Herzegovina,43.9159,17.6791,339281,0,14185,325096
1/27/22,Bosnia and Herzegovina,43.9159,17.6791,341913,0,14243,327670
1/28/22,Bosnia and Herzegovina,43.9159,17.6791,343986,0,14310,329676
1/29/22,Bosnia and Herzegovina,43.9159,17.6791,343986,0,14310,329676
1/30/22,Bosnia and Herzegovina,43.9159,17.6791,343986,0,14310,329676
1/31/22,Bosnia and Herzegovina,43.9159,17.6791,347467,0,14447,333020
2/1/22,Bosnia and Herzegovina,43.9159,17.6791,349095,0,14498,334597
2/2/22,Bosnia and Herzegovina,43.9159,17.6791,351219,0,14555,336664
2/3/22,Bosnia and Herzegovina,43.9159,17.6791,353137,0,14603,338534
2/4/22,Bosnia and Herzegovina,43.9159,17.6791,354325,0,14672,339653
2/5/22,Bosnia and Herzegovina,43.9159,17.6791,354325,0,14672,339653
2/6/22,Bosnia and Herzegovina,43.9159,17.6791,354325,0,14672,339653
2/7/22,Bosnia and Herzegovina,43.9159,17.6791,356930,0,14800,342130
2/8/22,Bosnia and Herzegovina,43.9159,17.6791,358398,0,14856,343542
2/9/22,Bosnia and Herzegovina,43.9159,17.6791,359876,0,14897,344979
2/10/22,Bosnia and Herzegovina,43.9159,17.6791,361189,0,14938,346251
2/11/22,Bosnia and Herzegovina,43.9159,17.6791,362527,0,14984,347543
2/12/22,Bosnia and Herzegovina,43.9159,17.6791,362527,0,14984,347543
2/13/22,Bosnia and Herzegovina,43.9159,17.6791,362527,0,14984,347543
2/14/22,Bosnia and Herzegovina,43.9159,17.6791,364610,0,15096,349514
2/15/22,Bosnia and Herzegovina,43.9159,17.6791,365589,0,15127,350462
2/16/22,Bosnia and Herzegovina,43.9159,17.6791,366450,0,15162,351288
2/17/22,Bosnia and Herzegovina,43.9159,17.6791,367025,0,15232,351793
2/18/22,Bosnia and Herzegovina,43.9159,17.6791,367641,0,15263,352378
2/19/22,Bosnia and Herzegovina,43.9159,17.6791,367641,0,15263,352378
2/20/22,Bosnia and Herzegovina,43.9159,17.6791,367641,0,15263,352378
2/21/22,Bosnia and Herzegovina,43.9159,17.6791,368735,0,15327,353408
2/22/22,Bosnia and Herzegovina,43.9159,17.6791,369230,0,15362,353868
2/23/22,Bosnia and Herzegovina,43.9159,17.6791,369870,0,15380,354490
2/24/22,Bosnia and Herzegovina,43.9159,17.6791,370295,0,15392,354903
2/25/22,Bosnia and Herzegovina,43.9159,17.6791,370652,0,15411,355241
2/26/22,Bosnia and Herzegovina,43.9159,17.6791,370652,0,15411,355241
2/27/22,Bosnia and Herzegovina,43.9159,17.6791,370652,0,15411,355241
2/28/22,Bosnia and Herzegovina,43.9159,17.6791,371202,0,15459,355743
3/1/22,Bosnia and Herzegovina,43.9159,17.6791,371381,0,15470,355911
3/2/22,Bosnia and Herzegovina,43.9159,17.6791,371553,0,15484,356069
3/3/22,Bosnia and Herzegovina,43.9159,17.6791,371846,0,15505,356341
3/4/22,Bosnia and Herzegovina,43.9159,17.6791,372139,0,15519,356620
3/5/22,Bosnia and Herzegovina,43.9159,17.6791,372139,0,15519,356620
3/6/22,Bosnia and Herzegovina,43.9159,17.6791,372139,0,15519,356620
3/7/22,Bosnia and Herzegovina,43.9159,17.6791,372478,0,15575,356903
3/8/22,Bosnia and Herzegovina,43.9159,17.6791,372645,0,15590,357055
3/9/22,Bosnia and Herzegovina,43.9159,17.6791,372817,0,15599,357218
3/10/22,Bosnia and Herzegovina,43.9159,17.6791,372962,0,15610,357352
3/11/22,Bosnia and Herzegovina,43.9159,17.6791,373105,0,15614,357491
3/12/22,Bosnia and Herzegovina,43.9159,17.6791,373105,0,15614,357491
3/13/22,Bosnia and Herzegovina,43.9159,17.6791,373105,0,15614,357491
3/14/22,Bosnia and Herzegovina,43.9159,17.6791,373359,0,15635,357724
3/15/22,Bosnia and Herzegovina,43.9159,17.6791,373506,0,15641,357865
3/16/22,Bosnia and Herzegovina,43.9159,17.6791,373670,0,15651,358019
3/17/22,Bosnia and Herzegovina,43.9159,17.6791,373799,0,15661,358138
3/18/22,Bosnia and Herzegovina,43.9159,17.6791,373985,0,15664,358321
3/19/22,Bosnia and Herzegovina,43.9159,17.6791,373985,0,15664,358321
3/20/22,Bosnia and Herzegovina,43.9159,17.6791,373985,0,15664,358321
3/21/22,Bosnia and Herzegovina,43.9159,17.6791,374276,0,15677,358599
3/22/22,Bosnia and Herzegovina,43.9159,17.6791,374426,0,15685,358741
3/23/22,Bosnia and Herzegovina,43.9159,17.6791,374573,0,15691,358882
3/24/22,Bosnia and Herzegovina,43.9159,17.6791,374696,0,15695,359001
3/25/22,Bosnia and Herzegovina,43.9159,17.6791,374810,0,15702,359108
3/26/22,Bosnia and Herzegovina,43.9159,17.6791,374810,0,15702,359108
3/27/22,Bosnia and Herzegovina,43.9159,17.6791,374810,0,15702,359108
3/28/22,Bosnia and Herzegovina,43.9159,17.6791,375054,0,15706,359348
3/29/22,Bosnia and Herzegovina,43.9159,17.6791,375222,0,15708,359514
3/30/22,Bosnia and Herzegovina,43.9159,17.6791,375332,0,15710,359622
3/31/22,Bosnia and Herzegovina,43.9159,17.6791,375440,0,15713,359727
4/1/22,Bosnia and Herzegovina,43.9159,17.6791,375554,0,15718,359836
4/2/22,Bosnia and Herzegovina,43.9159,17.6791,375554,0,15718,359836
4/3/22,Bosnia and Herzegovina,43.9159,17.6791,375554,0,15718,359836
4/4/22,Bosnia and Herzegovina,43.9159,17.6791,375735,0,15724,360011
4/5/22,Bosnia and Herzegovina,43.9159,17.6791,375849,0,15727,360122
4/6/22,Bosnia and Herzegovina,43.9159,17.6791,375948,0,15728,360220
4/7/22,Bosnia and Herzegovina,43.9159,17.6791,376028,0,15728,360300
4/8/22,Bosnia and Herzegovina,43.9159,17.6791,376081,0,15732,360349
4/9/22,Bosnia and Herzegovina,43.9159,17.6791,376081,0,15732,360349
4/10/22,Bosnia and Herzegovina,43.9159,17.6791,376081,0,15732,360349
4/11/22,Bosnia and Herzegovina,43.9159,17.6791,376198,0,15740,360458
4/12/22,Bosnia and Herzegovina,43.9159,17.6791,376264,0,15742,360522
4/13/22,Bosnia and Herzegovina,43.9159,17.6791,376339,0,15744,360595
4/14/22,Bosnia and Herzegovina,43.9159,17.6791,376384,0,15748,360636
4/15/22,Bosnia and Herzegovina,43.9159,17.6791,376437,0,15749,360688
4/16/22,Bosnia and Herzegovina,43.9159,17.6791,376437,0,15749,360688
4/17/22,Bosnia and Herzegovina,43.9159,17.6791,376437,0,15749,360688
4/18/22,Bosnia and Herzegovina,43.9159,17.6791,376437,0,15749,360688
4/19/22,Bosnia and Herzegovina,43.9159,17.6791,376526,0,15752,360774
4/20/22,Bosnia and Herzegovina,43.9159,17.6791,376567,0,15753,360814
4/21/22,Bosnia and Herzegovina,43.9159,17.6791,376642,0,15753,360889
4/22/22,Bosnia and Herzegovina,43.9159,17.6791,376699,0,15756,360943
4/23/22,Bosnia and Herzegovina,43.9159,17.6791,376699,0,15756,360943
4/24/22,Bosnia and Herzegovina,43.9159,17.6791,376699,0,15756,360943
4/25/22,Bosnia and Herzegovina,43.9159,17.6791,376841,0,15762,361079
4/26/22,Bosnia and Herzegovina,43.9159,17.6791,376897,0,15764,361133
4/27/22,Bosnia and Herzegovina,43.9159,17.6791,376948,0,15764,361184
4/28/22,Bosnia and Herzegovina,43.9159,17.6791,377043,0,15764,361279
4/29/22,Bosnia and Herzegovina,43.9159,17.6791,377087,0,15765,361322
4/30/22,Bosnia and Herzegovina,43.9159,17.6791,377087,0,15765,361322
5/1/22,Bosnia and Herzegovina,43.9159,17.6791,377087,0,15765,361322
5/2/22,Bosnia and Herzegovina,43.9159,17.6791,377087,0,15765,361322
5/3/22,Bosnia and Herzegovina,43.9159,17.6791,377145,0,15766,361379
5/4/22,Bosnia and Herzegovina,43.9159,17.6791,377175,0,15768,361407
5/5/22,Bosnia and Herzegovina,43.9159,17.6791,377229,0,15768,361461
5/6/22,Bosnia and Herzegovina,43.9159,17.6791,377229,0,15768,361461
5/7/22,Bosnia and Herzegovina,43.9159,17.6791,377276,0,15768,361508
5/8/22,Bosnia and Herzegovina,43.9159,17.6791,377276,0,15768,361508
5/9/22,Bosnia and Herzegovina,43.9159,17.6791,377345,0,15768,361577
5/10/22,Bosnia and Herzegovina,43.9159,17.6791,377385,0,15773,361612
5/11/22,Bosnia and Herzegovina,43.9159,17.6791,377432,0,15775,361657
5/12/22,Bosnia and Herzegovina,43.9159,17.6791,377475,0,15775,361700
5/13/22,Bosnia and Herzegovina,43.9159,17.6791,377511,0,15778,361733
5/14/22,Bosnia and Herzegovina,43.9159,17.6791,377511,0,15778,361733
5/15/22,Bosnia and Herzegovina,43.9159,17.6791,377511,0,15778,361733
5/16/22,Bosnia and Herzegovina,43.9159,17.6791,377579,0,15781,361798
5/17/22,Bosnia and Herzegovina,43.9159,17.6791,377606,0,15783,361823
5/18/22,Bosnia and Herzegovina,43.9159,17.6791,377648,0,15783,361865
5/19/22,Bosnia and Herzegovina,43.9159,17.6791,377677,0,15783,361894
5/20/22,Bosnia and Herzegovina,43.9159,17.6791,377709,0,15783,361926
5/21/22,Bosnia and Herzegovina,43.9159,17.6791,377709,0,15783,361926
5/22/22,Bosnia and Herzegovina,43.9159,17.6791,377709,0,15783,361926
5/23/22,Bosnia and Herzegovina,43.9159,17.6791,377745,0,15785,361960
5/24/22,Bosnia and Herzegovina,43.9159,17.6791,377769,0,15786,361983
5/25/22,Bosnia and Herzegovina,43.9159,17.6791,377769,0,15786,361983
5/26/22,Bosnia and Herzegovina,43.9159,17.6791,377829,0,15787,362042
5/27/22,Bosnia and Herzegovina,43.9159,17.6791,377829,0,15787,362042
5/28/22,Bosnia and Herzegovina,43.9159,17.6791,377829,0,15787,362042
5/29/22,Bosnia and Herzegovina,43.9159,17.6791,377829,0,15787,362042
5/30/22,Bosnia and Herzegovina,43.9159,17.6791,377878,0,15787,362091
5/31/22,Bosnia and Herzegovina,43.9159,17.6791,377904,0,15788,362116
6/1/22,Bosnia and Herzegovina,43.9159,17.6791,377928,0,15788,362140
6/2/22,Bosnia and Herzegovina,43.9159,17.6791,377949,0,15788,362161
6/3/22,Bosnia and Herzegovina,43.9159,17.6791,377962,0,15788,362174
6/4/22,Bosnia and Herzegovina,43.9159,17.6791,377962,0,15788,362174
6/5/22,Bosnia and Herzegovina,43.9159,17.6791,377962,0,15788,362174
6/6/22,Bosnia and Herzegovina,43.9159,17.6791,377998,0,15791,362207
6/7/22,Bosnia and Herzegovina,43.9159,17.6791,378022,0,15791,362231
6/8/22,Bosnia and Herzegovina,43.9159,17.6791,378054,0,15791,362263
6/9/22,Bosnia and Herzegovina,43.9159,17.6791,378069,0,15792,362277
6/10/22,Bosnia and Herzegovina,43.9159,17.6791,378083,0,15793,362290
6/11/22,Bosnia and Herzegovina,43.9159,17.6791,378083,0,15793,362290
6/12/22,Bosnia and Herzegovina,43.9159,17.6791,378083,0,15793,362290
6/13/22,Bosnia and Herzegovina,43.9159,17.6791,378112,0,15793,362319
6/14/22,Bosnia and Herzegovina,43.9159,17.6791,378112,0,15795,362317
6/15/22,Bosnia and Herzegovina,43.9159,17.6791,378168,0,15796,362372
6/16/22,Bosnia and Herzegovina,43.9159,17.6791,378193,0,15796,362397
6/17/22,Bosnia and Herzegovina,43.9159,17.6791,378209,0,15796,362413
6/18/22,Bosnia and Herzegovina,43.9159,17.6791,378209,0,15796,362413
6/19/22,Bosnia and Herzegovina,43.9159,17.6791,378209,0,15796,362413
6/20/22,Bosnia and Herzegovina,43.9159,17.6791,378295,0,15797,362498
6/21/22,Bosnia and Herzegovina,43.9159,17.6791,378301,0,15797,362504
6/22/22,Bosnia and Herzegovina,43.9159,17.6791,378328,0,15798,362530
6/23/22,Bosnia and Herzegovina,43.9159,17.6791,378370,0,15799,362571
6/24/22,Bosnia and Herzegovina,43.9159,17.6791,378413,0,15799,362614
6/25/22,Bosnia and Herzegovina,43.9159,17.6791,378413,0,15799,362614
6/26/22,Bosnia and Herzegovina,43.9159,17.6791,378413,0,15799,362614
6/27/22,Bosnia and Herzegovina,43.9159,17.6791,378505,0,15803,362702
6/28/22,Bosnia and Herzegovina,43.9159,17.6791,378577,0,15805,362772
6/29/22,Bosnia and Herzegovina,43.9159,17.6791,378630,0,15805,362825
6/30/22,Bosnia and Herzegovina,43.9159,17.6791,378716,0,15806,362910
7/1/22,Bosnia and Herzegovina,43.9159,17.6791,378797,0,15806,362991
7/2/22,Bosnia and Herzegovina,43.9159,17.6791,378797,0,15806,362991
7/3/22,Bosnia and Herzegovina,43.9159,17.6791,378797,0,15806,362991
7/4/22,Bosnia and Herzegovina,43.9159,17.6791,379041,0,15807,363234
7/5/22,Bosnia and Herzegovina,43.9159,17.6791,379132,0,15808,363324
7/6/22,Bosnia and Herzegovina,43.9159,17.6791,379244,0,15808,363436
7/7/22,Bosnia and Herzegovina,43.9159,17.6791,379408,0,15809,363599
7/8/22,Bosnia and Herzegovina,43.9159,17.6791,379563,0,15809,363754
7/9/22,Bosnia and Herzegovina,43.9159,17.6791,379563,0,15809,363754
7/10/22,Bosnia and Herzegovina,43.9159,17.6791,379563,0,15809,363754
7/11/22,Bosnia and Herzegovina,43.9159,17.6791,379817,0,15810,364007
7/12/22,Bosnia and Herzegovina,43.9159,17.6791,379982,0,15810,364172
7/13/22,Bosnia and Herzegovina,43.9159,17.6791,380211,0,15812,364399
7/14/22,Bosnia and Herzegovina,43.9159,17.6791,380498,0,15814,364684
7/15/22,Bosnia and Herzegovina,43.9159,17.6791,380749,0,15817,364932
7/16/22,Bosnia and Herzegovina,43.9159,17.6791,380749,0,15817,364932
7/17/22,Bosnia and Herzegovina,43.9159,17.6791,380749,0,15817,364932
7/18/22,Bosnia and Herzegovina,43.9159,17.6791,381150,0,15819,365331
7/19/22,Bosnia and Herzegovina,43.9159,17.6791,381543,0,15824,365719
7/20/22,Bosnia and Herzegovina,43.9159,17.6791,381982,0,15825,366157
7/21/22,Bosnia and Herzegovina,43.9159,17.6791,382382,0,15825,366557
7/22/22,Bosnia and Herzegovina,43.9159,17.6791,382861,0,15828,367033
7/23/22,Bosnia and Herzegovina,43.9159,17.6791,382861,0,15828,367033
7/24/22,Bosnia and Herzegovina,43.9159,17.6791,382861,0,15828,367033
7/25/22,Bosnia and Herzegovina,43.9159,17.6791,383415,0,15839,367576
7/26/22,Bosnia and Herzegovina,43.9159,17.6791,383826,0,15841,367985
7/27/22,Bosnia and Herzegovina,43.9159,17.6791,384390,0,15851,368539
7/28/22,Bosnia and Herzegovina,43.9159,17.6791,384390,0,15851,368539
7/29/22,Bosnia and Herzegovina,43.9159,17.6791,384976,0,15853,369123
7/30/22,Bosnia and Herzegovina,43.9159,17.6791,384976,0,15853,369123
7/31/22,Bosnia and Herzegovina,43.9159,17.6791,384976,0,15853,369123
8/1/22,Bosnia and Herzegovina,43.9159,17.6791,385367,0,15862,369505
8/2/22,Bosnia and Herzegovina,43.9159,17.6791,386012,0,15868,370144
8/3/22,Bosnia and Herzegovina,43.9159,17.6791,386474,0,15883,370591
8/4/22,Bosnia and Herzegovina,43.9159,17.6791,387076,0,15888,371188
8/5/22,Bosnia and Herzegovina,43.9159,17.6791,387803,0,15902,371901
8/6/22,Bosnia and Herzegovina,43.9159,17.6791,387803,0,15902,371901
8/7/22,Bosnia and Herzegovina,43.9159,17.6791,387803,0,15902,371901
8/8/22,Bosnia and Herzegovina,43.9159,17.6791,388630,0,15923,372707
8/9/22,Bosnia and Herzegovina,43.9159,17.6791,389308,0,15930,373378
8/10/22,Bosnia and Herzegovina,43.9159,17.6791,389729,0,15933,373796
8/11/22,Bosnia and Herzegovina,43.9159,17.6791,390284,0,15939,374345
8/12/22,Bosnia and Herzegovina,43.9159,17.6791,390650,0,15942,374708
8/13/22,Bosnia and Herzegovina,43.9159,17.6791,390650,0,15942,374708
8/14/22,Bosnia and Herzegovina,43.9159,17.6791,390650,0,15942,374708
8/15/22,Bosnia and Herzegovina,43.9159,17.6791,391429,0,15956,375473
8/16/22,Bosnia and Herzegovina,43.9159,17.6791,391922,0,15965,375957
8/17/22,Bosnia and Herzegovina,43.9159,17.6791,392253,0,15971,376282
8/18/22,Bosnia and Herzegovina,43.9159,17.6791,392713,0,15973,376740
8/19/22,Bosnia and Herzegovina,43.9159,17.6791,393235,0,15980,377255
8/20/22,Bosnia and Herzegovina,43.9159,17.6791,393235,0,15980,377255
8/21/22,Bosnia and Herzegovina,43.9159,17.6791,393235,0,15980,377255
8/22/22,Bosnia and Herzegovina,43.9159,17.6791,393804,0,15996,377808
8/23/22,Bosnia and Herzegovina,43.9159,17.6791,394161,0,16004,378157
8/24/22,Bosnia and Herzegovina,43.9159,17.6791,394563,0,16012,378551
8/25/22,Bosnia and Herzegovina,43.9159,17.6791,394866,0,16021,378845
8/26/22,Bosnia and Herzegovina,43.9159,17.6791,395086,0,16026,379060
8/27/22,Bosnia and Herzegovina,43.9159,17.6791,395086,0,16026,379060
8/28/22,Bosnia and Herzegovina,43.9159,17.6791,395086,0,16026,379060
8/29/22,Bosnia and Herzegovina,43.9159,17.6791,395429,0,16041,379388
8/30/22,Bosnia and Herzegovina,43.9159,17.6791,395630,0,16049,379581
8/31/22,Bosnia and Herzegovina,43.9159,17.6791,395850,0,16050,379800
9/1/22,Bosnia and Herzegovina,43.9159,17.6791,395994,0,16057,379937
9/2/22,Bosnia and Herzegovina,43.9159,17.6791,396273,0,16062,380211
9/3/22,Bosnia and Herzegovina,43.9159,17.6791,396273,0,16062,380211
9/4/22,Bosnia and Herzegovina,43.9159,17.6791,396273,0,16062,380211
9/5/22,Bosnia and Herzegovina,43.9159,17.6791,396524,0,16074,380450
9/6/22,Bosnia and Herzegovina,43.9159,17.6791,396524,0,16074,380450
9/7/22,Bosnia and Herzegovina,43.9159,17.6791,396873,0,16086,380787
9/8/22,Bosnia and Herzegovina,43.9159,17.6791,396873,0,16086,380787
9/9/22,Bosnia and Herzegovina,43.9159,17.6791,397098,0,16090,381008
9/10/22,Bosnia and Herzegovina,43.9159,17.6791,397098,0,16090,381008
9/11/22,Bosnia and Herzegovina,43.9159,17.6791,397098,0,16090,381008
9/12/22,Bosnia and Herzegovina,43.9159,17.6791,397296,0,16100,381196
9/13/22,Bosnia and Herzegovina,43.9159,17.6791,397467,0,16102,381365
9/14/22,Bosnia and Herzegovina,43.9159,17.6791,397602,0,16104,381498
9/15/22,Bosnia and Herzegovina,43.9159,17.6791,397678,0,16106,381572
9/16/22,Bosnia and Herzegovina,43.9159,17.6791,397822,0,16108,381714
9/17/22,Bosnia and Herzegovina,43.9159,17.6791,397822,0,16108,381714
9/18/22,Bosnia and Herzegovina,43.9159,17.6791,397822,0,16108,381714
9/19/22,Bosnia and Herzegovina,43.9159,17.6791,397822,0,16108,381714
9/20/22,Bosnia and Herzegovina,43.9159,17.6791,397949,0,16114,381835
9/21/22,Bosnia and Herzegovina,43.9159,17.6791,398035,0,16116,381919
9/22/22,Bosnia and Herzegovina,43.9159,17.6791,398035,0,16116,381919
9/23/22,Bosnia and Herzegovina,43.9159,17.6791,398221,0,16119,382102
9/24/22,Bosnia and Herzegovina,43.9159,17.6791,398221,0,16119,382102
9/25/22,Bosnia and Herzegovina,43.9159,17.6791,398221,0,16119,382102
9/26/22,Bosnia and Herzegovina,43.9159,17.6791,398415,0,16131,382284
9/27/22,Bosnia and Herzegovina,43.9159,17.6791,398506,0,16131,382375
9/28/22,Bosnia and Herzegovina,43.9159,17.6791,398574,0,16135,382439
9/29/22,Bosnia and Herzegovina,43.9159,17.6791,398668,0,16136,382532
9/30/22,Bosnia and Herzegovina,43.9159,17.6791,398750,0,16137,382613
10/1/22,Bosnia and Herzegovina,43.9159,17.6791,398750,0,16137,382613
10/2/22,Bosnia and Herzegovina,43.9159,17.6791,398750,0,16137,382613
10/3/22,Bosnia and Herzegovina,43.9159,17.6791,398796,0,16138,382658
10/4/22,Bosnia and Herzegovina,43.9159,17.6791,398796,0,16138,382658
10/5/22,Bosnia and Herzegovina,43.9159,17.6791,398796,0,16138,382658
10/6/22,Bosnia and Herzegovina,43.9159,17.6791,399036,0,16150,382886
10/7/22,Bosnia and Herzegovina,43.9159,17.6791,399071,0,16151,382920
10/8/22,Bosnia and Herzegovina,43.9159,17.6791,399071,0,16151,382920
10/9/22,Bosnia and Herzegovina,43.9159,17.6791,399071,0,16151,382920
10/10/22,Bosnia and Herzegovina,43.9159,17.6791,399184,0,16154,383030
10/11/22,Bosnia and Herzegovina,43.9159,17.6791,399227,0,16155,383072
10/12/22,Bosnia and Herzegovina,43.9159,17.6791,399298,0,16156,383142
10/13/22,Bosnia and Herzegovina,43.9159,17.6791,399346,0,16156,383190
10/14/22,Bosnia and Herzegovina,43.9159,17.6791,399410,0,16156,383254
10/15/22,Bosnia and Herzegovina,43.9159,17.6791,399410,0,16156,383254
10/16/22,Bosnia and Herzegovina,43.9159,17.6791,399410,0,16156,383254
10/17/22,Bosnia and Herzegovina,43.9159,17.6791,399499,0,16160,383339
10/18/22,Bosnia and Herzegovina,43.9159,17.6791,399544,0,16160,383384
10/19/22,Bosnia and Herzegovina,43.9159,17.6791,399584,0,16161,383423
10/20/22,Bosnia and Herzegovina,43.9159,17.6791,399626,0,16164,383462
10/21/22,Bosnia and Herzegovina,43.9159,17.6791,399663,0,16165,383498
10/22/22,Bosnia and Herzegovina,43.9159,17.6791,399663,0,16165,383498
10/23/22,Bosnia and Herzegovina,43.9159,17.6791,399663,0,16165,383498
10/24/22,Bosnia and Herzegovina,43.9159,17.6791,399719,0,16166,383553
10/25/22,Bosnia and Herzegovina,43.9159,17.6791,399784,0,16167,383617
10/26/22,Bosnia and Herzegovina,43.9159,17.6791,399811,0,16169,383642
10/27/22,Bosnia and Herzegovina,43.9159,17.6791,399861,0,16169,383692
10/28/22,Bosnia and Herzegovina,43.9159,17.6791,399891,0,16169,383722
10/29/22,Bosnia and Herzegovina,43.9159,17.6791,399891,0,16169,383722
10/30/22,Bosnia and Herzegovina,43.9159,17.6791,399891,0,16169,383722
10/31/22,Bosnia and Herzegovina,43.9159,17.6791,399963,0,16174,383789
11/1/22,Bosnia and Herzegovina,43.9159,17.6791,399981,0,16175,383806
11/2/22,Bosnia and Herzegovina,43.9159,17.6791,399993,0,16177,383816
11/3/22,Bosnia and Herzegovina,43.9159,17.6791,400027,0,16180,383847
11/4/22,Bosnia and Herzegovina,43.9159,17.6791,400043,0,16180,383863
11/5/22,Bosnia and Herzegovina,43.9159,17.6791,400043,0,16180,383863
11/6/22,Bosnia and Herzegovina,43.9159,17.6791,400043,0,16180,383863
11/7/22,Bosnia and Herzegovina,43.9159,17.6791,400090,0,16182,383908
11/8/22,Bosnia and Herzegovina,43.9159,17.6791,400119,0,16182,383937
11/9/22,Bosnia and Herzegovina,43.9159,17.6791,400129,0,16183,383946
11/10/22,Bosnia and Herzegovina,43.9159,17.6791,400162,0,16184,383978
11/11/22,Bosnia and Herzegovina,43.9159,17.6791,400185,0,16184,384001
11/12/22,Bosnia and Herzegovina,43.9159,17.6791,400185,0,16184,384001
11/13/22,Bosnia and Herzegovina,43.9159,17.6791,400185,0,16184,384001
11/14/22,Bosnia and Herzegovina,43.9159,17.6791,400261,0,16187,384074
11/15/22,Bosnia and Herzegovina,43.9159,17.6791,400279,0,16188,384091
11/16/22,Bosnia and Herzegovina,43.9159,17.6791,400301,0,16189,384112
11/17/22,Bosnia and Herzegovina,43.9159,17.6791,400322,0,16190,384132
11/18/22,Bosnia and Herzegovina,43.9159,17.6791,400336,0,16190,384146
11/19/22,Bosnia and Herzegovina,43.9159,17.6791,400336,0,16190,384146
11/20/22,Bosnia and Herzegovina,43.9159,17.6791,400336,0,16190,384146
11/21/22,Bosnia and Herzegovina,43.9159,17.6791,400340,0,16193,384147
11/22/22,Bosnia and Herzegovina,43.9159,17.6791,400412,0,16197,384215
11/23/22,Bosnia and Herzegovina,43.9159,17.6791,400430,0,16198,384232
11/24/22,Bosnia and Herzegovina,43.9159,17.6791,400448,0,16199,384249
11/25/22,Bosnia and Herzegovina,43.9159,17.6791,400466,0,16200,384266
11/26/22,Bosnia and Herzegovina,43.9159,17.6791,400466,0,16200,384266
11/27/22,Bosnia and Herzegovina,43.9159,17.6791,400466,0,16200,384266
11/28/22,Bosnia and Herzegovina,43.9159,17.6791,400501,0,16201,384300
11/29/22,Bosnia and Herzegovina,43.9159,17.6791,400529,0,16202,384327
11/30/22,Bosnia and Herzegovina,43.9159,17.6791,400548,0,16202,384346
12/1/22,Bosnia and Herzegovina,43.9159,17.6791,400564,0,16202,384362
12/2/22,Bosnia and Herzegovina,43.9159,17.6791,400572,0,16203,384369
12/3/22,Bosnia and Herzegovina,43.9159,17.6791,400572,0,16203,384369
12/4/22,Bosnia and Herzegovina,43.9159,17.6791,400572,0,16203,384369
12/5/22,Bosnia and Herzegovina,43.9159,17.6791,400601,0,16205,384396
12/6/22,Bosnia and Herzegovina,43.9159,17.6791,400613,0,16207,384406
12/7/22,Bosnia and Herzegovina,43.9159,17.6791,400626,0,16208,384418
12/8/22,Bosnia and Herzegovina,43.9159,17.6791,400636,0,16212,384424
12/9/22,Bosnia and Herzegovina,43.9159,17.6791,400661,0,16212,384449
12/10/22,Bosnia and Herzegovina,43.9159,17.6791,400661,0,16212,384449
12/11/22,Bosnia and Herzegovina,43.9159,17.6791,400661,0,16212,384449
12/12/22,Bosnia and Herzegovina,43.9159,17.6791,400698,0,16215,384483
12/13/22,Bosnia and Herzegovina,43.9159,17.6791,400722,0,16217,384505
12/14/22,Bosnia and Herzegovina,43.9159,17.6791,400734,0,16217,384517
12/15/22,Bosnia and Herzegovina,43.9159,17.6791,400754,0,16217,384537
12/16/22,Bosnia and Herzegovina,43.9159,17.6791,400769,0,16218,384551
12/17/22,Bosnia and Herzegovina,43.9159,17.6791,400769,0,16218,384551
1/1/22,Botswana,-22.3285,24.6849,219509,0,2444,217065
1/2/22,Botswana,-22.3285,24.6849,219509,0,2444,217065
1/3/22,Botswana,-22.3285,24.6849,222053,0,2452,219601
1/4/22,Botswana,-22.3285,24.6849,222053,0,2452,219601
1/5/22,Botswana,-22.3285,24.6849,222053,0,2452,219601
1/6/22,Botswana,-22.3285,24.6849,229855,0,2475,227380
1/7/22,Botswana,-22.3285,24.6849,229855,0,2475,227380
1/8/22,Botswana,-22.3285,24.6849,229855,0,2475,227380
1/9/22,Botswana,-22.3285,24.6849,229855,0,2475,227380
1/10/22,Botswana,-22.3285,24.6849,232432,0,2497,229935
1/11/22,Botswana,-22.3285,24.6849,232432,0,2497,229935
1/12/22,Botswana,-22.3285,24.6849,232432,0,2497,229935
1/13/22,Botswana,-22.3285,24.6849,237678,0,2514,235164
1/14/22,Botswana,-22.3285,24.6849,237678,0,2514,235164
1/15/22,Botswana,-22.3285,24.6849,237678,0,2514,235164
1/16/22,Botswana,-22.3285,24.6849,237678,0,2514,235164
1/17/22,Botswana,-22.3285,24.6849,239887,0,2534,237353
1/18/22,Botswana,-22.3285,24.6849,239887,0,2534,237353
1/19/22,Botswana,-22.3285,24.6849,239887,0,2534,237353
1/20/22,Botswana,-22.3285,24.6849,243946,0,2544,241402
1/21/22,Botswana,-22.3285,24.6849,243946,0,2544,241402
1/22/22,Botswana,-22.3285,24.6849,243946,0,2544,241402
1/23/22,Botswana,-22.3285,24.6849,243946,0,2544,241402
1/24/22,Botswana,-22.3285,24.6849,245904,0,2565,243339
1/25/22,Botswana,-22.3285,24.6849,245904,0,2565,243339
1/26/22,Botswana,-22.3285,24.6849,245904,0,2565,243339
1/27/22,Botswana,-22.3285,24.6849,250746,0,2580,248166
1/28/22,Botswana,-22.3285,24.6849,250746,0,2580,248166
1/29/22,Botswana,-22.3285,24.6849,250746,0,2580,248166
1/30/22,Botswana,-22.3285,24.6849,250746,0,2580,248166
1/31/22,Botswana,-22.3285,24.6849,253036,0,2581,250455
2/1/22,Botswana,-22.3285,24.6849,253036,0,2581,250455
2/2/22,Botswana,-22.3285,24.6849,253036,0,2581,250455
2/3/22,Botswana,-22.3285,24.6849,256041,0,2585,253456
2/4/22,Botswana,-22.3285,24.6849,256041,0,2585,253456
2/5/22,Botswana,-22.3285,24.6849,256041,0,2585,253456
2/6/22,Botswana,-22.3285,24.6849,256041,0,2585,253456
2/7/22,Botswana,-22.3285,24.6849,257167,0,2593,254574
2/8/22,Botswana,-22.3285,24.6849,257167,0,2593,254574
2/9/22,Botswana,-22.3285,24.6849,257167,0,2593,254574
2/10/22,Botswana,-22.3285,24.6849,259655,0,2597,257058
2/11/22,Botswana,-22.3285,24.6849,259655,0,2597,257058
2/12/22,Botswana,-22.3285,24.6849,259655,0,2597,257058
2/13/22,Botswana,-22.3285,24.6849,259655,0,2597,257058
2/14/22,Botswana,-22.3285,24.6849,260491,0,2603,257888
2/15/22,Botswana,-22.3285,24.6849,260491,0,2603,257888
2/16/22,Botswana,-22.3285,24.6849,260491,0,2603,257888
2/17/22,Botswana,-22.3285,24.6849,261913,0,2608,259305
2/18/22,Botswana,-22.3285,24.6849,261913,0,2608,259305
2/19/22,Botswana,-22.3285,24.6849,261913,0,2608,259305
2/20/22,Botswana,-22.3285,24.6849,261913,0,2608,259305
2/21/22,Botswana,-22.3285,24.6849,262652,0,2614,260038
2/22/22,Botswana,-22.3285,24.6849,262652,0,2614,260038
2/23/22,Botswana,-22.3285,24.6849,262652,0,2614,260038
2/24/22,Botswana,-22.3285,24.6849,262652,0,2614,260038
2/25/22,Botswana,-22.3285,24.6849,263950,0,2619,261331
2/26/22,Botswana,-22.3285,24.6849,263950,0,2619,261331
2/27/22,Botswana,-22.3285,24.6849,263950,0,2619,261331
2/28/22,Botswana,-22.3285,24.6849,263950,0,2619,261331
3/1/22,Botswana,-22.3285,24.6849,263950,0,2619,261331
3/2/22,Botswana,-22.3285,24.6849,263950,0,2619,261331
3/3/22,Botswana,-22.3285,24.6849,263950,0,2619,261331
3/4/22,Botswana,-22.3285,24.6849,263950,0,2619,261331
3/5/22,Botswana,-22.3285,24.6849,263950,0,2619,261331
3/6/22,Botswana,-22.3285,24.6849,263950,0,2619,261331
3/7/22,Botswana,-22.3285,24.6849,263950,0,2619,261331
3/8/22,Botswana,-22.3285,24.6849,263950,0,2619,261331
3/9/22,Botswana,-22.3285,24.6849,263950,0,2619,261331
3/10/22,Botswana,-22.3285,24.6849,263950,0,2619,261331
3/11/22,Botswana,-22.3285,24.6849,263950,0,2619,261331
3/12/22,Botswana,-22.3285,24.6849,263950,0,2619,261331
3/13/22,Botswana,-22.3285,24.6849,263950,0,2619,261331
3/14/22,Botswana,-22.3285,24.6849,263950,0,2619,261331
3/15/22,Botswana,-22.3285,24.6849,263950,0,2619,261331
3/16/22,Botswana,-22.3285,24.6849,263950,0,2619,261331
3/17/22,Botswana,-22.3285,24.6849,263950,0,2619,261331
3/18/22,Botswana,-22.3285,24.6849,263950,0,2619,261331
3/19/22,Botswana,-22.3285,24.6849,263950,0,2619,261331
3/20/22,Botswana,-22.3285,24.6849,263950,0,2619,261331
3/21/22,Botswana,-22.3285,24.6849,263950,0,2619,261331
3/22/22,Botswana,-22.3285,24.6849,263950,0,2619,261331
3/23/22,Botswana,-22.3285,24.6849,263950,0,2619,261331
3/24/22,Botswana,-22.3285,24.6849,263950,0,2619,261331
3/25/22,Botswana,-22.3285,24.6849,263950,0,2619,261331
3/26/22,Botswana,-22.3285,24.6849,263950,0,2619,261331
3/27/22,Botswana,-22.3285,24.6849,263950,0,2619,261331
3/28/22,Botswana,-22.3285,24.6849,263950,0,2619,261331
3/29/22,Botswana,-22.3285,24.6849,263950,0,2619,261331
3/30/22,Botswana,-22.3285,24.6849,305526,0,2686,302840
3/31/22,Botswana,-22.3285,24.6849,305526,0,2686,302840
4/1/22,Botswana,-22.3285,24.6849,305526,0,2686,302840
4/2/22,Botswana,-22.3285,24.6849,305526,0,2686,302840
4/3/22,Botswana,-22.3285,24.6849,305526,0,2686,302840
4/4/22,Botswana,-22.3285,24.6849,305526,0,2686,302840
4/5/22,Botswana,-22.3285,24.6849,305526,0,2686,302840
4/6/22,Botswana,-22.3285,24.6849,305526,0,2686,302840
4/7/22,Botswana,-22.3285,24.6849,305526,0,2686,302840
4/8/22,Botswana,-22.3285,24.6849,305526,0,2686,302840
4/9/22,Botswana,-22.3285,24.6849,305526,0,2686,302840
4/10/22,Botswana,-22.3285,24.6849,305526,0,2686,302840
4/11/22,Botswana,-22.3285,24.6849,305526,0,2686,302840
4/12/22,Botswana,-22.3285,24.6849,305859,0,2688,303171
4/13/22,Botswana,-22.3285,24.6849,305859,0,2688,303171
4/14/22,Botswana,-22.3285,24.6849,305859,0,2688,303171
4/15/22,Botswana,-22.3285,24.6849,305859,0,2688,303171
4/16/22,Botswana,-22.3285,24.6849,305859,0,2688,303171
4/17/22,Botswana,-22.3285,24.6849,305859,0,2688,303171
4/18/22,Botswana,-22.3285,24.6849,305859,0,2688,303171
4/19/22,Botswana,-22.3285,24.6849,305859,0,2688,303171
4/20/22,Botswana,-22.3285,24.6849,305859,0,2688,303171
4/21/22,Botswana,-22.3285,24.6849,305859,0,2688,303171
4/22/22,Botswana,-22.3285,24.6849,305859,0,2688,303171
4/23/22,Botswana,-22.3285,24.6849,305859,0,2688,303171
4/24/22,Botswana,-22.3285,24.6849,305859,0,2688,303171
4/25/22,Botswana,-22.3285,24.6849,305859,0,2688,303171
4/26/22,Botswana,-22.3285,24.6849,305859,0,2688,303171
4/27/22,Botswana,-22.3285,24.6849,305859,0,2688,303171
4/28/22,Botswana,-22.3285,24.6849,305984,0,2688,303296
4/29/22,Botswana,-22.3285,24.6849,305984,0,2688,303296
4/30/22,Botswana,-22.3285,24.6849,305984,0,2688,303296
5/1/22,Botswana,-22.3285,24.6849,305984,0,2688,303296
5/2/22,Botswana,-22.3285,24.6849,305984,0,2688,303296
5/3/22,Botswana,-22.3285,24.6849,305984,0,2688,303296
5/4/22,Botswana,-22.3285,24.6849,306200,0,2690,303510
5/5/22,Botswana,-22.3285,24.6849,306200,0,2690,303510
5/6/22,Botswana,-22.3285,24.6849,306200,0,2690,303510
5/7/22,Botswana,-22.3285,24.6849,306200,0,2690,303510
5/8/22,Botswana,-22.3285,24.6849,306200,0,2690,303510
5/9/22,Botswana,-22.3285,24.6849,306200,0,2690,303510
5/10/22,Botswana,-22.3285,24.6849,306324,0,2690,303634
5/11/22,Botswana,-22.3285,24.6849,306324,0,2690,303634
5/12/22,Botswana,-22.3285,24.6849,306324,0,2690,303634
5/13/22,Botswana,-22.3285,24.6849,306324,0,2690,303634
5/14/22,Botswana,-22.3285,24.6849,306324,0,2690,303634
5/15/22,Botswana,-22.3285,24.6849,306324,0,2690,303634
5/16/22,Botswana,-22.3285,24.6849,306324,0,2690,303634
5/17/22,Botswana,-22.3285,24.6849,306614,0,2692,303922
5/18/22,Botswana,-22.3285,24.6849,306614,0,2692,303922
5/19/22,Botswana,-22.3285,24.6849,306614,0,2692,303922
5/20/22,Botswana,-22.3285,24.6849,306614,0,2692,303922
5/21/22,Botswana,-22.3285,24.6849,306614,0,2692,303922
5/22/22,Botswana,-22.3285,24.6849,306614,0,2692,303922
5/23/22,Botswana,-22.3285,24.6849,306614,0,2692,303922
5/24/22,Botswana,-22.3285,24.6849,307126,0,2695,304431
5/25/22,Botswana,-22.3285,24.6849,307126,0,2695,304431
5/26/22,Botswana,-22.3285,24.6849,307126,0,2695,304431
5/27/22,Botswana,-22.3285,24.6849,307126,0,2695,304431
5/28/22,Botswana,-22.3285,24.6849,307126,0,2695,304431
5/29/22,Botswana,-22.3285,24.6849,307126,0,2695,304431
5/30/22,Botswana,-22.3285,24.6849,307126,0,2695,304431
5/31/22,Botswana,-22.3285,24.6849,308126,0,2697,305429
6/1/22,Botswana,-22.3285,24.6849,308126,0,2697,305429
6/2/22,Botswana,-22.3285,24.6849,308126,0,2697,305429
6/3/22,Botswana,-22.3285,24.6849,308126,0,2697,305429
6/4/22,Botswana,-22.3285,24.6849,308126,0,2697,305429
6/5/22,Botswana,-22.3285,24.6849,308126,0,2697,305429
6/6/22,Botswana,-22.3285,24.6849,308126,0,2697,305429
6/7/22,Botswana,-22.3285,24.6849,310431,0,2701,307730
6/8/22,Botswana,-22.3285,24.6849,310431,0,2701,307730
6/9/22,Botswana,-22.3285,24.6849,310431,0,2701,307730
6/10/22,Botswana,-22.3285,24.6849,310431,0,2701,307730
6/11/22,Botswana,-22.3285,24.6849,310431,0,2701,307730
6/12/22,Botswana,-22.3285,24.6849,310431,0,2701,307730
6/13/22,Botswana,-22.3285,24.6849,310431,0,2701,307730
6/14/22,Botswana,-22.3285,24.6849,314242,0,2709,311533
6/15/22,Botswana,-22.3285,24.6849,314242,0,2709,311533
6/16/22,Botswana,-22.3285,24.6849,314242,0,2709,311533
6/17/22,Botswana,-22.3285,24.6849,314242,0,2709,311533
6/18/22,Botswana,-22.3285,24.6849,314242,0,2709,311533
6/19/22,Botswana,-22.3285,24.6849,314242,0,2709,311533
6/20/22,Botswana,-22.3285,24.6849,314242,0,2709,311533
6/21/22,Botswana,-22.3285,24.6849,318528,0,2719,315809
6/22/22,Botswana,-22.3285,24.6849,318528,0,2719,315809
6/23/22,Botswana,-22.3285,24.6849,318528,0,2719,315809
6/24/22,Botswana,-22.3285,24.6849,318528,0,2719,315809
6/25/22,Botswana,-22.3285,24.6849,318528,0,2719,315809
6/26/22,Botswana,-22.3285,24.6849,318528,0,2719,315809
6/27/22,Botswana,-22.3285,24.6849,320127,0,2726,317401
6/28/22,Botswana,-22.3285,24.6849,321968,0,2739,319229
6/29/22,Botswana,-22.3285,24.6849,321968,0,2739,319229
6/30/22,Botswana,-22.3285,24.6849,322769,0,2750,320019
7/1/22,Botswana,-22.3285,24.6849,322769,0,2750,320019
7/2/22,Botswana,-22.3285,24.6849,322769,0,2750,320019
7/3/22,Botswana,-22.3285,24.6849,322769,0,2750,320019
7/4/22,Botswana,-22.3285,24.6849,322769,0,2750,320019
7/5/22,Botswana,-22.3285,24.6849,322769,0,2750,320019
7/6/22,Botswana,-22.3285,24.6849,323327,0,2752,320575
7/7/22,Botswana,-22.3285,24.6849,324154,0,2753,321401
7/8/22,Botswana,-22.3285,24.6849,324154,0,2753,321401
7/9/22,Botswana,-22.3285,24.6849,324154,0,2753,321401
7/10/22,Botswana,-22.3285,24.6849,324154,0,2753,321401
7/11/22,Botswana,-22.3285,24.6849,324154,0,2753,321401
7/12/22,Botswana,-22.3285,24.6849,324154,0,2753,321401
7/13/22,Botswana,-22.3285,24.6849,324154,0,2753,321401
7/14/22,Botswana,-22.3285,24.6849,324841,0,2760,322081
7/15/22,Botswana,-22.3285,24.6849,324841,0,2760,322081
7/16/22,Botswana,-22.3285,24.6849,324841,0,2760,322081
7/17/22,Botswana,-22.3285,24.6849,324841,0,2760,322081
7/18/22,Botswana,-22.3285,24.6849,324841,0,2760,322081
7/19/22,Botswana,-22.3285,24.6849,324841,0,2760,322081
7/20/22,Botswana,-22.3285,24.6849,324841,0,2760,322081
7/21/22,Botswana,-22.3285,24.6849,325181,0,2763,322418
7/22/22,Botswana,-22.3285,24.6849,325181,0,2763,322418
7/23/22,Botswana,-22.3285,24.6849,325181,0,2763,322418
7/24/22,Botswana,-22.3285,24.6849,325181,0,2763,322418
7/25/22,Botswana,-22.3285,24.6849,325181,0,2763,322418
7/26/22,Botswana,-22.3285,24.6849,325181,0,2763,322418
7/27/22,Botswana,-22.3285,24.6849,325181,0,2763,322418
7/28/22,Botswana,-22.3285,24.6849,325470,0,2770,322700
7/29/22,Botswana,-22.3285,24.6849,325470,0,2770,322700
7/30/22,Botswana,-22.3285,24.6849,325470,0,2770,322700
7/31/22,Botswana,-22.3285,24.6849,325470,0,2770,322700
8/1/22,Botswana,-22.3285,24.6849,325470,0,2770,322700
8/2/22,Botswana,-22.3285,24.6849,325470,0,2770,322700
8/3/22,Botswana,-22.3285,24.6849,325470,0,2770,322700
8/4/22,Botswana,-22.3285,24.6849,325724,0,2772,322952
8/5/22,Botswana,-22.3285,24.6849,325724,0,2772,322952
8/6/22,Botswana,-22.3285,24.6849,325724,0,2772,322952
8/7/22,Botswana,-22.3285,24.6849,325724,0,2772,322952
8/8/22,Botswana,-22.3285,24.6849,325724,0,2772,322952
8/9/22,Botswana,-22.3285,24.6849,325724,0,2772,322952
8/10/22,Botswana,-22.3285,24.6849,325724,0,2772,322952
8/11/22,Botswana,-22.3285,24.6849,325824,0,2774,323050
8/12/22,Botswana,-22.3285,24.6849,325824,0,2774,323050
8/13/22,Botswana,-22.3285,24.6849,325824,0,2774,323050
8/14/22,Botswana,-22.3285,24.6849,325824,0,2774,323050
8/15/22,Botswana,-22.3285,24.6849,325824,0,2774,323050
8/16/22,Botswana,-22.3285,24.6849,325824,0,2774,323050
8/17/22,Botswana,-22.3285,24.6849,325824,0,2774,323050
8/18/22,Botswana,-22.3285,24.6849,325850,0,2777,323073
8/19/22,Botswana,-22.3285,24.6849,325850,0,2777,323073
8/20/22,Botswana,-22.3285,24.6849,325850,0,2777,323073
8/21/22,Botswana,-22.3285,24.6849,325850,0,2777,323073
8/22/22,Botswana,-22.3285,24.6849,325850,0,2777,323073
8/23/22,Botswana,-22.3285,24.6849,325850,0,2777,323073
8/24/22,Botswana,-22.3285,24.6849,325850,0,2777,323073
8/25/22,Botswana,-22.3285,24.6849,325864,0,2778,323086
8/26/22,Botswana,-22.3285,24.6849,325864,0,2778,323086
8/27/22,Botswana,-22.3285,24.6849,325864,0,2778,323086
8/28/22,Botswana,-22.3285,24.6849,325864,0,2778,323086
8/29/22,Botswana,-22.3285,24.6849,325864,0,2778,323086
8/30/22,Botswana,-22.3285,24.6849,325864,0,2778,323086
8/31/22,Botswana,-22.3285,24.6849,325864,0,2778,323086
9/1/22,Botswana,-22.3285,24.6849,325864,0,2778,323086
9/2/22,Botswana,-22.3285,24.6849,325864,0,2778,323086
9/3/22,Botswana,-22.3285,24.6849,325864,0,2778,323086
9/4/22,Botswana,-22.3285,24.6849,325864,0,2778,323086
9/5/22,Botswana,-22.3285,24.6849,325864,0,2778,323086
9/6/22,Botswana,-22.3285,24.6849,325911,0,2778,323133
9/7/22,Botswana,-22.3285,24.6849,325911,0,2778,323133
9/8/22,Botswana,-22.3285,24.6849,325911,0,2778,323133
9/9/22,Botswana,-22.3285,24.6849,325931,0,2786,323145
9/10/22,Botswana,-22.3285,24.6849,325931,0,2786,323145
9/11/22,Botswana,-22.3285,24.6849,325931,0,2786,323145
9/12/22,Botswana,-22.3285,24.6849,325931,0,2786,323145
9/13/22,Botswana,-22.3285,24.6849,326127,0,2787,323340
9/14/22,Botswana,-22.3285,24.6849,326127,0,2787,323340
9/15/22,Botswana,-22.3285,24.6849,326127,0,2787,323340
9/16/22,Botswana,-22.3285,24.6849,326127,0,2787,323340
9/17/22,Botswana,-22.3285,24.6849,326127,0,2787,323340
9/18/22,Botswana,-22.3285,24.6849,326127,0,2787,323340
9/19/22,Botswana,-22.3285,24.6849,326127,0,2787,323340
9/20/22,Botswana,-22.3285,24.6849,326127,0,2787,323340
9/21/22,Botswana,-22.3285,24.6849,326127,0,2787,323340
9/22/22,Botswana,-22.3285,24.6849,326127,0,2787,323340
9/23/22,Botswana,-22.3285,24.6849,326127,0,2787,323340
9/24/22,Botswana,-22.3285,24.6849,326127,0,2787,323340
9/25/22,Botswana,-22.3285,24.6849,326127,0,2787,323340
9/26/22,Botswana,-22.3285,24.6849,326308,0,2789,323519
9/27/22,Botswana,-22.3285,24.6849,326308,0,2789,323519
9/28/22,Botswana,-22.3285,24.6849,326308,0,2789,323519
9/29/22,Botswana,-22.3285,24.6849,326308,0,2789,323519
9/30/22,Botswana,-22.3285,24.6849,326308,0,2789,323519
10/1/22,Botswana,-22.3285,24.6849,326308,0,2789,323519
10/2/22,Botswana,-22.3285,24.6849,326308,0,2789,323519
10/3/22,Botswana,-22.3285,24.6849,326329,0,2789,323540
10/4/22,Botswana,-22.3285,24.6849,326329,0,2789,323540
10/5/22,Botswana,-22.3285,24.6849,326329,0,2789,323540
10/6/22,Botswana,-22.3285,24.6849,326329,0,2789,323540
10/7/22,Botswana,-22.3285,24.6849,326329,0,2789,323540
10/8/22,Botswana,-22.3285,24.6849,326329,0,2789,323540
10/9/22,Botswana,-22.3285,24.6849,326329,0,2789,323540
10/10/22,Botswana,-22.3285,24.6849,326344,0,2790,323554
10/11/22,Botswana,-22.3285,24.6849,326344,0,2790,323554
10/12/22,Botswana,-22.3285,24.6849,326344,0,2790,323554
10/13/22,Botswana,-22.3285,24.6849,326344,0,2790,323554
10/14/22,Botswana,-22.3285,24.6849,326344,0,2790,323554
10/15/22,Botswana,-22.3285,24.6849,326344,0,2790,323554
10/16/22,Botswana,-22.3285,24.6849,326344,0,2790,323554
10/17/22,Botswana,-22.3285,24.6849,326344,0,2790,323554
10/18/22,Botswana,-22.3285,24.6849,326344,0,2790,323554
10/19/22,Botswana,-22.3285,24.6849,326344,0,2790,323554
10/20/22,Botswana,-22.3285,24.6849,326344,0,2790,323554
10/21/22,Botswana,-22.3285,24.6849,326344,0,2790,323554
10/22/22,Botswana,-22.3285,24.6849,326344,0,2790,323554
10/23/22,Botswana,-22.3285,24.6849,326344,0,2790,323554
10/24/22,Botswana,-22.3285,24.6849,326344,0,2790,323554
10/25/22,Botswana,-22.3285,24.6849,326344,0,2790,323554
10/26/22,Botswana,-22.3285,24.6849,326344,0,2790,323554
10/27/22,Botswana,-22.3285,24.6849,326344,0,2790,323554
10/28/22,Botswana,-22.3285,24.6849,326344,0,2790,323554
10/29/22,Botswana,-22.3285,24.6849,326344,0,2790,323554
10/30/22,Botswana,-22.3285,24.6849,326344,0,2790,323554
10/31/22,Botswana,-22.3285,24.6849,326344,0,2790,323554
11/1/22,Botswana,-22.3285,24.6849,326344,0,2790,323554
11/2/22,Botswana,-22.3285,24.6849,326344,0,2790,323554
11/3/22,Botswana,-22.3285,24.6849,326344,0,2790,323554
11/4/22,Botswana,-22.3285,24.6849,326344,0,2790,323554
11/5/22,Botswana,-22.3285,24.6849,326344,0,2790,323554
11/6/22,Botswana,-22.3285,24.6849,326344,0,2790,323554
11/7/22,Botswana,-22.3285,24.6849,326344,0,2790,323554
11/8/22,Botswana,-22.3285,24.6849,326344,0,2790,323554
11/9/22,Botswana,-22.3285,24.6849,326344,0,2790,323554
11/10/22,Botswana,-22.3285,24.6849,326344,0,2790,323554
11/11/22,Botswana,-22.3285,24.6849,326344,0,2790,323554
11/12/22,Botswana,-22.3285,24.6849,326344,0,2790,323554
11/13/22,Botswana,-22.3285,24.6849,326344,0,2790,323554
11/14/22,Botswana,-22.3285,24.6849,326344,0,2790,323554
11/15/22,Botswana,-22.3285,24.6849,326344,0,2790,323554
11/16/22,Botswana,-22.3285,24.6849,326344,0,2790,323554
11/17/22,Botswana,-22.3285,24.6849,326344,0,2790,323554
11/18/22,Botswana,-22.3285,24.6849,326344,0,2790,323554
11/19/22,Botswana,-22.3285,24.6849,326344,0,2790,323554
11/20/22,Botswana,-22.3285,24.6849,326344,0,2790,323554
11/21/22,Botswana,-22.3285,24.6849,326344,0,2790,323554
11/22/22,Botswana,-22.3285,24.6849,326344,0,2790,323554
11/23/22,Botswana,-22.3285,24.6849,326344,0,2790,323554
11/24/22,Botswana,-22.3285,24.6849,326344,0,2790,323554
11/25/22,Botswana,-22.3285,24.6849,326344,0,2790,323554
11/26/22,Botswana,-22.3285,24.6849,326344,0,2790,323554
11/27/22,Botswana,-22.3285,24.6849,326344,0,2790,323554
11/28/22,Botswana,-22.3285,24.6849,326373,0,2790,323583
11/29/22,Botswana,-22.3285,24.6849,326373,0,2790,323583
11/30/22,Botswana,-22.3285,24.6849,326633,0,2790,323843
12/1/22,Botswana,-22.3285,24.6849,326633,0,2790,323843
12/2/22,Botswana,-22.3285,24.6849,326633,0,2790,323843
12/3/22,Botswana,-22.3285,24.6849,326633,0,2790,323843
12/4/22,Botswana,-22.3285,24.6849,326633,0,2790,323843
12/5/22,Botswana,-22.3285,24.6849,328760,0,2790,325970
12/6/22,Botswana,-22.3285,24.6849,328760,0,2793,325967
12/7/22,Botswana,-22.3285,24.6849,326800,0,2793,324007
12/8/22,Botswana,-22.3285,24.6849,326800,0,2793,324007
12/9/22,Botswana,-22.3285,24.6849,326800,0,2793,324007
12/10/22,Botswana,-22.3285,24.6849,326800,0,2793,324007
12/11/22,Botswana,-22.3285,24.6849,326800,0,2793,324007
12/12/22,Botswana,-22.3285,24.6849,327061,0,2793,324268
12/13/22,Botswana,-22.3285,24.6849,327061,0,2793,324268
12/14/22,Botswana,-22.3285,24.6849,327061,0,2793,324268
12/15/22,Botswana,-22.3285,24.6849,327061,0,2793,324268
12/16/22,Botswana,-22.3285,24.6849,327511,0,2794,324717
12/17/22,Botswana,-22.3285,24.6849,327511,0,2794,324717
1/1/22,Brazil,-14.235,-51.9253,22295621,0,619367,21676254
1/2/22,Brazil,-14.235,-51.9253,22297427,0,619401,21678026
1/3/22,Brazil,-14.235,-51.9253,22309081,0,619473,21689608
1/4/22,Brazil,-14.235,-51.9253,22328252,0,619654,21708598
1/5/22,Brazil,-14.235,-51.9253,22351104,0,619654,21731450
1/6/22,Brazil,-14.235,-51.9253,22386930,0,619654,21767276
1/7/22,Brazil,-14.235,-51.9253,22450222,0,619822,21830400
1/8/22,Brazil,-14.235,-51.9253,22499525,0,619937,21879588
1/9/22,Brazil,-14.235,-51.9253,22529183,0,620251,21908932
1/10/22,Brazil,-14.235,-51.9253,22563104,0,620366,21942738
1/11/22,Brazil,-14.235,-51.9253,22636359,0,620507,22015852
1/12/22,Brazil,-14.235,-51.9253,22724232,0,620641,22103591
1/13/22,Brazil,-14.235,-51.9253,22822177,0,620830,22201347
1/14/22,Brazil,-14.235,-51.9253,22933289,0,621063,22312226
1/15/22,Brazil,-14.235,-51.9253,22981851,0,621233,22360618
1/16/22,Brazil,-14.235,-51.9253,23015128,0,621327,22393801
1/17/22,Brazil,-14.235,-51.9253,23089509,0,621478,22468031
1/18/22,Brazil,-14.235,-51.9253,23229851,0,621803,22608048
1/19/22,Brazil,-14.235,-51.9253,23425392,0,622125,22803267
1/20/22,Brazil,-14.235,-51.9253,23595178,0,622476,22972702
1/21/22,Brazil,-14.235,-51.9253,23766499,0,622875,23143624
1/22/22,Brazil,-14.235,-51.9253,23931609,0,623191,23308418
1/23/22,Brazil,-14.235,-51.9253,24054405,0,623370,23431035
1/24/22,Brazil,-14.235,-51.9253,24142032,0,623636,23518396
1/25/22,Brazil,-14.235,-51.9253,24342322,0,624129,23718193
1/26/22,Brazil,-14.235,-51.9253,24560093,0,624717,23935376
1/27/22,Brazil,-14.235,-51.9253,24789795,0,625390,24164405
1/28/22,Brazil,-14.235,-51.9253,25050601,0,626170,24424431
1/29/22,Brazil,-14.235,-51.9253,25256198,0,626870,24629328
1/30/22,Brazil,-14.235,-51.9253,25360647,0,627150,24733497
1/31/22,Brazil,-14.235,-51.9253,25463530,0,627589,24835941
2/1/22,Brazil,-14.235,-51.9253,25634781,0,628356,25006425
2/2/22,Brazil,-14.235,-51.9253,25820745,0,629301,25191444
2/3/22,Brazil,-14.235,-51.9253,26107894,0,630301,25477593
2/4/22,Brazil,-14.235,-51.9253,26326454,0,631265,25695189
2/5/22,Brazil,-14.235,-51.9253,26484546,0,632095,25852451
2/6/22,Brazil,-14.235,-51.9253,26546399,0,632514,25913885
2/7/22,Brazil,-14.235,-51.9253,26616014,0,632946,25983068
2/8/22,Brazil,-14.235,-51.9253,26793497,0,634118,26159379
2/9/22,Brazil,-14.235,-51.9253,26972914,0,635421,26337493
2/10/22,Brazil,-14.235,-51.9253,27135550,0,636338,26499212
2/11/22,Brazil,-14.235,-51.9253,27299336,0,637467,26661869
2/12/22,Brazil,-14.235,-51.9253,27434286,0,638346,26795940
2/13/22,Brazil,-14.235,-51.9253,27492904,0,638673,26854231
2/14/22,Brazil,-14.235,-51.9253,27552267,0,639151,26913116
2/15/22,Brazil,-14.235,-51.9253,27677468,0,640076,27037392
2/16/22,Brazil,-14.235,-51.9253,27819996,0,641096,27178900
2/17/22,Brazil,-14.235,-51.9253,27940119,0,642156,27297963
2/18/22,Brazil,-14.235,-51.9253,28072238,0,643340,27428898
2/19/22,Brazil,-14.235,-51.9253,28177367,0,644195,27533172
2/20/22,Brazil,-14.235,-51.9253,28218180,0,644592,27573588
2/21/22,Brazil,-14.235,-51.9253,28258458,0,644918,27613540
2/22/22,Brazil,-14.235,-51.9253,28361951,0,645735,27716216
2/23/22,Brazil,-14.235,-51.9253,28493336,0,646714,27846622
2/24/22,Brazil,-14.235,-51.9253,28589235,0,647703,27941532
2/25/22,Brazil,-14.235,-51.9253,28679671,0,648496,28031175
2/26/22,Brazil,-14.235,-51.9253,28749552,0,649184,28100368
2/27/22,Brazil,-14.235,-51.9253,28776794,0,649437,28127357
2/28/22,Brazil,-14.235,-51.9253,28796571,0,649676,28146895
3/1/22,Brazil,-14.235,-51.9253,28818850,0,649922,28168928
3/2/22,Brazil,-14.235,-51.9253,28846495,0,650254,28196241
3/3/22,Brazil,-14.235,-51.9253,28906672,0,650824,28255848
3/4/22,Brazil,-14.235,-51.9253,28978052,0,651522,28326530
3/5/22,Brazil,-14.235,-51.9253,29040800,0,652216,28388584
3/6/22,Brazil,-14.235,-51.9253,29056525,0,652438,28404087
3/7/22,Brazil,-14.235,-51.9253,29077831,0,652648,28425183
3/8/22,Brazil,-14.235,-51.9253,29152318,0,653134,28499184
3/9/22,Brazil,-14.235,-51.9253,29198101,0,653767,28544334
3/10/22,Brazil,-14.235,-51.9253,29259206,0,654380,28604826
3/11/22,Brazil,-14.235,-51.9253,29313228,0,654843,28658385
3/12/22,Brazil,-14.235,-51.9253,29361024,0,655234,28705790
3/13/22,Brazil,-14.235,-51.9253,29374833,0,655359,28719474
3/14/22,Brazil,-14.235,-51.9253,29391345,0,655557,28735788
3/15/22,Brazil,-14.235,-51.9253,29441039,0,655878,28785161
3/16/22,Brazil,-14.235,-51.9253,29488777,0,656231,28832546
3/17/22,Brazil,-14.235,-51.9253,29532810,0,656693,28876117
3/18/22,Brazil,-14.235,-51.9253,29584800,0,657098,28927702
3/19/22,Brazil,-14.235,-51.9253,29624435,0,657389,28967046
3/20/22,Brazil,-14.235,-51.9253,29637814,0,657495,28980319
3/21/22,Brazil,-14.235,-51.9253,29650082,0,657595,28992487
3/22/22,Brazil,-14.235,-51.9253,29691641,0,658005,29033636
3/23/22,Brazil,-14.235,-51.9253,29738362,0,658286,29080076
3/24/22,Brazil,-14.235,-51.9253,29775568,0,658600,29116968
3/25/22,Brazil,-14.235,-51.9253,29809769,0,658855,29150914
3/26/22,Brazil,-14.235,-51.9253,29839103,0,659046,29180057
3/27/22,Brazil,-14.235,-51.9253,29849740,0,659159,29190581
3/28/22,Brazil,-14.235,-51.9253,29857641,0,659227,29198414
3/29/22,Brazil,-14.235,-51.9253,29887191,0,659508,29227683
3/30/22,Brazil,-14.235,-51.9253,29920604,0,659769,29260835
3/31/22,Brazil,-14.235,-51.9253,29951670,0,660022,29291648
4/1/22,Brazil,-14.235,-51.9253,29978513,0,660265,29318248
4/2/22,Brazil,-14.235,-51.9253,29995575,0,660371,29335204
4/3/22,Brazil,-14.235,-51.9253,30002785,0,660410,29342375
4/4/22,Brazil,-14.235,-51.9253,30015357,0,660570,29354787
4/5/22,Brazil,-14.235,-51.9253,30042272,0,660786,29381486
4/6/22,Brazil,-14.235,-51.9253,30069094,0,660980,29408114
4/7/22,Brazil,-14.235,-51.9253,30095328,0,661228,29434100
4/8/22,Brazil,-14.235,-51.9253,30125540,0,661377,29464163
4/9/22,Brazil,-14.235,-51.9253,30146769,0,661475,29485294
4/10/22,Brazil,-14.235,-51.9253,30153979,0,661513,29492466
4/11/22,Brazil,-14.235,-51.9253,30161909,0,661576,29500333
4/12/22,Brazil,-14.235,-51.9253,30184286,0,661741,29522545
4/13/22,Brazil,-14.235,-51.9253,30210934,0,661904,29549030
4/14/22,Brazil,-14.235,-51.9253,30234024,0,662043,29571981
4/15/22,Brazil,-14.235,-51.9253,30247302,0,662154,29585148
4/16/22,Brazil,-14.235,-51.9253,30250077,0,662185,29587892
4/17/22,Brazil,-14.235,-51.9253,30252618,0,662207,29590411
4/18/22,Brazil,-14.235,-51.9253,30261088,0,662271,29598817
4/19/22,Brazil,-14.235,-51.9253,30275219,0,662396,29612823
4/20/22,Brazil,-14.235,-51.9253,30311969,0,662659,29649310
4/21/22,Brazil,-14.235,-51.9253,30330629,0,662751,29667878
4/22/22,Brazil,-14.235,-51.9253,30338697,0,662802,29675895
4/23/22,Brazil,-14.235,-51.9253,30345808,0,662855,29682953
4/24/22,Brazil,-14.235,-51.9253,30349463,0,662891,29686572
4/25/22,Brazil,-14.235,-51.9253,30355919,0,662964,29692955
4/26/22,Brazil,-14.235,-51.9253,30378061,0,663108,29714953
4/27/22,Brazil,-14.235,-51.9253,30399004,0,663350,29735654
4/28/22,Brazil,-14.235,-51.9253,30418920,0,663464,29755456
4/29/22,Brazil,-14.235,-51.9253,30433042,0,663649,29769393
4/30/22,Brazil,-14.235,-51.9253,30448236,0,663736,29784500
5/1/22,Brazil,-14.235,-51.9253,30454499,0,663752,29790747
5/2/22,Brazil,-14.235,-51.9253,30460997,0,663838,29797159
5/3/22,Brazil,-14.235,-51.9253,30482429,0,663930,29818499
5/4/22,Brazil,-14.235,-51.9253,30502501,0,663994,29838507
5/5/22,Brazil,-14.235,-51.9253,30524183,0,664131,29860052
5/6/22,Brazil,-14.235,-51.9253,30543908,0,664326,29879582
5/7/22,Brazil,-14.235,-51.9253,30558530,0,664361,29894169
5/8/22,Brazil,-14.235,-51.9253,30564536,0,664374,29900162
5/9/22,Brazil,-14.235,-51.9253,30574245,0,664426,29909819
5/10/22,Brazil,-14.235,-51.9253,30594388,0,664624,29929764
5/11/22,Brazil,-14.235,-51.9253,30617786,0,664750,29953036
5/12/22,Brazil,-14.235,-51.9253,30639130,0,664874,29974256
5/13/22,Brazil,-14.235,-51.9253,30664739,0,665012,29999727
5/14/22,Brazil,-14.235,-51.9253,30682094,0,665104,30016990
5/15/22,Brazil,-14.235,-51.9253,30688390,0,665150,30023240
5/16/22,Brazil,-14.235,-51.9253,30701900,0,665216,30036684
5/17/22,Brazil,-14.235,-51.9253,30701900,0,665216,30036684
5/18/22,Brazil,-14.235,-51.9253,30701900,0,665216,30036684
5/19/22,Brazil,-14.235,-51.9253,30701900,0,665216,30036684
5/20/22,Brazil,-14.235,-51.9253,30762413,0,665722,30096691
5/21/22,Brazil,-14.235,-51.9253,30762413,0,665720,30096693
5/22/22,Brazil,-14.235,-51.9253,30791220,0,665854,30125366
5/23/22,Brazil,-14.235,-51.9253,30803995,0,665891,30138104
5/24/22,Brazil,-14.235,-51.9253,30836815,0,666129,30170686
5/25/22,Brazil,-14.235,-51.9253,30851191,0,666261,30184930
5/26/22,Brazil,-14.235,-51.9253,30880512,0,666180,30214332
5/27/22,Brazil,-14.235,-51.9253,30921145,0,666319,30254826
5/28/22,Brazil,-14.235,-51.9253,30945384,0,666391,30278993
5/29/22,Brazil,-14.235,-51.9253,30953579,0,666453,30287126
5/30/22,Brazil,-14.235,-51.9253,30977661,0,666516,30311145
5/31/22,Brazil,-14.235,-51.9253,31019038,0,666676,30352362
6/1/22,Brazil,-14.235,-51.9253,31060017,0,666801,30393216
6/2/22,Brazil,-14.235,-51.9253,31101290,0,666930,30434360
6/3/22,Brazil,-14.235,-51.9253,31137479,0,666971,30470508
6/4/22,Brazil,-14.235,-51.9253,31137479,0,666971,30470508
6/5/22,Brazil,-14.235,-51.9253,31137479,0,666971,30470508
6/6/22,Brazil,-14.235,-51.9253,31195118,0,667041,30528077
6/7/22,Brazil,-14.235,-51.9253,31266163,0,667348,30598815
6/8/22,Brazil,-14.235,-51.9253,31315777,0,667647,30648130
6/9/22,Brazil,-14.235,-51.9253,31360850,0,667790,30693060
6/10/22,Brazil,-14.235,-51.9253,31417341,0,667960,30749381
6/11/22,Brazil,-14.235,-51.9253,31445137,0,668074,30777063
6/12/22,Brazil,-14.235,-51.9253,31456865,0,668110,30788755
6/13/22,Brazil,-14.235,-51.9253,31497038,0,668180,30828858
6/14/22,Brazil,-14.235,-51.9253,31541479,0,668354,30873125
6/15/22,Brazil,-14.235,-51.9253,31611769,0,668693,30943076
6/16/22,Brazil,-14.235,-51.9253,31611769,0,668693,30943076
6/17/22,Brazil,-14.235,-51.9253,31611769,0,668693,30943076
6/18/22,Brazil,-14.235,-51.9253,31611769,0,668693,30943076
6/19/22,Brazil,-14.235,-51.9253,31611769,0,668693,30943076
6/20/22,Brazil,-14.235,-51.9253,31754465,0,669161,31085304
6/21/22,Brazil,-14.235,-51.9253,31818827,0,669390,31149437
6/22/22,Brazil,-14.235,-51.9253,31890733,0,669530,31221203
6/23/22,Brazil,-14.235,-51.9253,31962782,0,669895,31292887
6/24/22,Brazil,-14.235,-51.9253,32023166,0,670229,31352937
6/25/22,Brazil,-14.235,-51.9253,32023166,0,670229,31352937
6/26/22,Brazil,-14.235,-51.9253,32023166,0,670229,31352937
6/27/22,Brazil,-14.235,-51.9253,32130316,0,670532,31459784
6/28/22,Brazil,-14.235,-51.9253,32206954,0,670848,31536106
6/29/22,Brazil,-14.235,-51.9253,32206954,0,670848,31536106
6/30/22,Brazil,-14.235,-51.9253,32358018,0,671416,31686602
7/1/22,Brazil,-14.235,-51.9253,32434063,0,671700,31762363
7/2/22,Brazil,-14.235,-51.9253,32471847,0,671858,31799989
7/3/22,Brazil,-14.235,-51.9253,32490422,0,671911,31818511
7/4/22,Brazil,-14.235,-51.9253,32535923,0,672033,31863890
7/5/22,Brazil,-14.235,-51.9253,32610514,0,672429,31938085
7/6/22,Brazil,-14.235,-51.9253,32687680,0,672790,32014890
7/7/22,Brazil,-14.235,-51.9253,32759730,0,673073,32086657
7/8/22,Brazil,-14.235,-51.9253,32830844,0,673339,32157505
7/9/22,Brazil,-14.235,-51.9253,32874501,0,673554,32200947
7/10/22,Brazil,-14.235,-51.9253,32896464,0,673610,32222854
7/11/22,Brazil,-14.235,-51.9253,32940507,0,673758,32266749
7/12/22,Brazil,-14.235,-51.9253,33004555,0,674102,32330453
7/13/22,Brazil,-14.235,-51.9253,33076779,0,674482,32402297
7/14/22,Brazil,-14.235,-51.9253,33142158,0,674779,32467379
7/15/22,Brazil,-14.235,-51.9253,33250117,0,675090,32575027
7/16/22,Brazil,-14.235,-51.9253,33290266,0,675295,32614971
7/17/22,Brazil,-14.235,-51.9253,33301118,0,675350,32625768
7/18/22,Brazil,-14.235,-51.9253,33339815,0,675518,32664297
7/19/22,Brazil,-14.235,-51.9253,33397814,0,675871,32721943
7/20/22,Brazil,-14.235,-51.9253,33454294,0,676217,32778077
7/21/22,Brazil,-14.235,-51.9253,33505727,0,676486,32829241
7/22/22,Brazil,-14.235,-51.9253,33555526,0,676766,32878760
7/23/22,Brazil,-14.235,-51.9253,33555526,0,676766,32878760
7/24/22,Brazil,-14.235,-51.9253,33591356,0,676964,32914392
7/25/22,Brazil,-14.235,-51.9253,33621965,0,677143,32944822
7/26/22,Brazil,-14.235,-51.9253,33659879,0,677494,32982385
7/27/22,Brazil,-14.235,-51.9253,33704393,0,677804,33026589
7/28/22,Brazil,-14.235,-51.9253,33748985,0,678069,33070916
7/29/22,Brazil,-14.235,-51.9253,33790698,0,678313,33112385
7/30/22,Brazil,-14.235,-51.9253,33813587,0,678486,33135101
7/31/22,Brazil,-14.235,-51.9253,33833900,0,678514,33155386
8/1/22,Brazil,-14.235,-51.9253,33855964,0,678715,33177249
8/2/22,Brazil,-14.235,-51.9253,33890428,0,679010,33211418
8/3/22,Brazil,-14.235,-51.9253,33924061,0,679275,33244786
8/4/22,Brazil,-14.235,-51.9253,33964494,0,679536,33284958
8/5/22,Brazil,-14.235,-51.9253,33994470,0,679758,33314712
8/6/22,Brazil,-14.235,-51.9253,34011173,0,679939,33331234
8/7/22,Brazil,-14.235,-51.9253,34018371,0,679996,33338375
8/8/22,Brazil,-14.235,-51.9253,34035780,0,680166,33355614
8/9/22,Brazil,-14.235,-51.9253,34066000,0,680531,33385469
8/10/22,Brazil,-14.235,-51.9253,34066000,0,680531,33385469
8/11/22,Brazil,-14.235,-51.9253,34124579,0,681006,33443573
8/12/22,Brazil,-14.235,-51.9253,34148131,0,681253,33466878
8/13/22,Brazil,-14.235,-51.9253,34148131,0,681253,33466878
8/14/22,Brazil,-14.235,-51.9253,34148131,0,681253,33466878
8/15/22,Brazil,-14.235,-51.9253,34178240,0,681557,33496683
8/16/22,Brazil,-14.235,-51.9253,34201280,0,681763,33519517
8/17/22,Brazil,-14.235,-51.9253,34223207,0,682010,33541197
8/18/22,Brazil,-14.235,-51.9253,34245374,0,682216,33563158
8/19/22,Brazil,-14.235,-51.9253,34264237,0,682358,33581879
8/20/22,Brazil,-14.235,-51.9253,34264237,0,682358,33581879
8/21/22,Brazil,-14.235,-51.9253,34264237,0,682358,33581879
8/22/22,Brazil,-14.235,-51.9253,34284864,0,682549,33602315
8/23/22,Brazil,-14.235,-51.9253,34284864,0,682549,33602315
8/24/22,Brazil,-14.235,-51.9253,34329600,0,683076,33646524
8/25/22,Brazil,-14.235,-51.9253,34350639,0,683233,33667406
8/26/22,Brazil,-14.235,-51.9253,34368909,0,683397,33685512
8/27/22,Brazil,-14.235,-51.9253,34368909,0,683397,33685512
8/28/22,Brazil,-14.235,-51.9253,34368909,0,683397,33685512
8/29/22,Brazil,-14.235,-51.9253,34397205,0,683622,33713583
8/30/22,Brazil,-14.235,-51.9253,34414011,0,683851,33730160
8/31/22,Brazil,-14.235,-51.9253,34429853,0,683965,33745888
9/1/22,Brazil,-14.235,-51.9253,34429853,0,683965,33745888
9/2/22,Brazil,-14.235,-51.9253,34456145,0,684262,33771883
9/3/22,Brazil,-14.235,-51.9253,34456145,0,684262,33771883
9/4/22,Brazil,-14.235,-51.9253,34456145,0,684262,33771883
9/5/22,Brazil,-14.235,-51.9253,34477539,0,684425,33793114
9/6/22,Brazil,-14.235,-51.9253,34477539,0,684425,33793114
9/7/22,Brazil,-14.235,-51.9253,34477539,0,684425,33793114
9/8/22,Brazil,-14.235,-51.9253,34477539,0,684425,33793114
9/9/22,Brazil,-14.235,-51.9253,34516739,0,684813,33831926
9/10/22,Brazil,-14.235,-51.9253,34516739,0,684813,33831926
9/11/22,Brazil,-14.235,-51.9253,34516739,0,684813,33831926
9/12/22,Brazil,-14.235,-51.9253,34533957,0,684898,33849059
9/13/22,Brazil,-14.235,-51.9253,34544377,0,685002,33859375
9/14/22,Brazil,-14.235,-51.9253,34558902,0,685121,33873781
9/15/22,Brazil,-14.235,-51.9253,34568833,0,685203,33883630
9/16/22,Brazil,-14.235,-51.9253,34568833,0,685203,33883630
9/17/22,Brazil,-14.235,-51.9253,34568833,0,685203,33883630
9/18/22,Brazil,-14.235,-51.9253,34568833,0,685203,33883630
9/19/22,Brazil,-14.235,-51.9253,34592163,0,685424,33906739
9/20/22,Brazil,-14.235,-51.9253,34592027,0,685428,33906599
9/21/22,Brazil,-14.235,-51.9253,34592027,0,685428,33906599
9/22/22,Brazil,-14.235,-51.9253,34616655,0,685677,33930978
9/23/22,Brazil,-14.235,-51.9253,34624427,0,685750,33938677
9/24/22,Brazil,-14.235,-51.9253,34624427,0,685750,33938677
9/25/22,Brazil,-14.235,-51.9253,34624427,0,685750,33938677
9/26/22,Brazil,-14.235,-51.9253,34638288,0,685835,33952453
9/27/22,Brazil,-14.235,-51.9253,34638288,0,685835,33952453
9/28/22,Brazil,-14.235,-51.9253,34654190,0,685927,33968263
9/29/22,Brazil,-14.235,-51.9253,34654190,0,685927,33968263
9/30/22,Brazil,-14.235,-51.9253,34672524,0,686036,33986488
10/1/22,Brazil,-14.235,-51.9253,34672524,0,686036,33986488
10/2/22,Brazil,-14.235,-51.9253,34672524,0,686036,33986488
10/3/22,Brazil,-14.235,-51.9253,34684529,0,686371,33998158
10/4/22,Brazil,-14.235,-51.9253,34684529,0,686371,33998158
10/5/22,Brazil,-14.235,-51.9253,34699017,0,686573,34012444
10/6/22,Brazil,-14.235,-51.9253,34707233,0,686706,34020527
10/7/22,Brazil,-14.235,-51.9253,34707233,0,686706,34020527
10/8/22,Brazil,-14.235,-51.9253,34707233,0,686706,34020527
10/9/22,Brazil,-14.235,-51.9253,34707233,0,686706,34020527
10/10/22,Brazil,-14.235,-51.9253,34724189,0,686877,34037312
10/11/22,Brazil,-14.235,-51.9253,34731539,0,686963,34044576
10/12/22,Brazil,-14.235,-51.9253,34731539,0,686963,34044576
10/13/22,Brazil,-14.235,-51.9253,34739865,0,687069,34052796
10/14/22,Brazil,-14.235,-51.9253,34746462,0,687144,34059318
10/15/22,Brazil,-14.235,-51.9253,34746462,0,687144,34059318
10/16/22,Brazil,-14.235,-51.9253,34746462,0,687144,34059318
10/17/22,Brazil,-14.235,-51.9253,34746462,0,687144,34059318
10/18/22,Brazil,-14.235,-51.9253,34746462,0,687144,34059318
10/19/22,Brazil,-14.235,-51.9253,34771320,0,687423,34083897
10/20/22,Brazil,-14.235,-51.9253,34771320,0,687423,34083897
10/21/22,Brazil,-14.235,-51.9253,34780462,0,687527,34092935
10/22/22,Brazil,-14.235,-51.9253,34780462,0,687527,34092935
10/23/22,Brazil,-14.235,-51.9253,34780462,0,687527,34092935
10/24/22,Brazil,-14.235,-51.9253,34783786,0,687574,34096212
10/25/22,Brazil,-14.235,-51.9253,34799324,0,687710,34111614
10/26/22,Brazil,-14.235,-51.9253,34807075,0,687907,34119168
10/27/22,Brazil,-14.235,-51.9253,34815258,0,687962,34127296
10/28/22,Brazil,-14.235,-51.9253,34815258,0,687962,34127296
10/29/22,Brazil,-14.235,-51.9253,34815258,0,687962,34127296
10/30/22,Brazil,-14.235,-51.9253,34815258,0,687962,34127296
10/31/22,Brazil,-14.235,-51.9253,34828749,0,688157,34140592
11/1/22,Brazil,-14.235,-51.9253,34837035,0,688219,34148816
11/2/22,Brazil,-14.235,-51.9253,34837035,0,688219,34148816
11/3/22,Brazil,-14.235,-51.9253,34846308,0,688267,34158041
11/4/22,Brazil,-14.235,-51.9253,34849063,0,688332,34160731
11/5/22,Brazil,-14.235,-51.9253,34849063,0,688332,34160731
11/6/22,Brazil,-14.235,-51.9253,34849063,0,688332,34160731
11/7/22,Brazil,-14.235,-51.9253,34855492,0,688395,34167097
11/8/22,Brazil,-14.235,-51.9253,34855492,0,688395,34167097
11/9/22,Brazil,-14.235,-51.9253,34855492,0,688395,34167097
11/10/22,Brazil,-14.235,-51.9253,34889576,0,688607,34200969
11/11/22,Brazil,-14.235,-51.9253,34908198,0,688656,34219542
11/12/22,Brazil,-14.235,-51.9253,34908198,0,688656,34219542
11/13/22,Brazil,-14.235,-51.9253,34908198,0,688656,34219542
11/14/22,Brazil,-14.235,-51.9253,34908198,0,688656,34219542
11/15/22,Brazil,-14.235,-51.9253,34908198,0,688656,34219542
11/16/22,Brazil,-14.235,-51.9253,34938073,0,688764,34249309
11/17/22,Brazil,-14.235,-51.9253,34971043,0,688835,34282208
11/18/22,Brazil,-14.235,-51.9253,34999495,0,688907,34310588
11/19/22,Brazil,-14.235,-51.9253,34999495,0,688907,34310588
11/20/22,Brazil,-14.235,-51.9253,34999495,0,688907,34310588
11/21/22,Brazil,-14.235,-51.9253,34999495,0,688907,34310588
11/22/22,Brazil,-14.235,-51.9253,35052152,0,689155,34362997
11/23/22,Brazil,-14.235,-51.9253,35082036,0,689272,34392764
11/24/22,Brazil,-14.235,-51.9253,35105241,0,689342,34415899
11/25/22,Brazil,-14.235,-51.9253,35149503,0,689442,34460061
11/26/22,Brazil,-14.235,-51.9253,35149503,0,689442,34460061
11/27/22,Brazil,-14.235,-51.9253,35149503,0,689442,34460061
11/28/22,Brazil,-14.235,-51.9253,35149503,0,689442,34460061
11/29/22,Brazil,-14.235,-51.9253,35227599,0,689665,34537934
11/30/22,Brazil,-14.235,-51.9253,35227599,0,689665,34537934
12/1/22,Brazil,-14.235,-51.9253,35302137,0,689945,34612192
12/2/22,Brazil,-14.235,-51.9253,35337546,0,690074,34647472
12/3/22,Brazil,-14.235,-51.9253,35337546,0,690074,34647472
12/4/22,Brazil,-14.235,-51.9253,35337546,0,690074,34647472
12/5/22,Brazil,-14.235,-51.9253,35396191,0,690229,34705962
12/6/22,Brazil,-14.235,-51.9253,35396191,0,690229,34705962
12/7/22,Brazil,-14.235,-51.9253,35396191,0,690229,34705962
12/8/22,Brazil,-14.235,-51.9253,35531716,0,690677,34841039
12/9/22,Brazil,-14.235,-51.9253,35531716,0,690677,34841039
12/10/22,Brazil,-14.235,-51.9253,35531716,0,690677,34841039
12/11/22,Brazil,-14.235,-51.9253,35531716,0,690677,34841039
12/12/22,Brazil,-14.235,-51.9253,35643770,0,691015,34952755
12/13/22,Brazil,-14.235,-51.9253,35696918,0,691178,35005740
12/14/22,Brazil,-14.235,-51.9253,35751411,0,691449,35059962
12/15/22,Brazil,-14.235,-51.9253,35809832,0,691652,35118180
12/16/22,Brazil,-14.235,-51.9253,35869526,0,691810,35177716
12/17/22,Brazil,-14.235,-51.9253,35869526,0,691810,35177716
1/1/22,Brunei,4.5353,114.7277,15470,0,98,15372
1/2/22,Brunei,4.5353,114.7277,15470,0,98,15372
1/3/22,Brunei,4.5353,114.7277,15506,0,98,15408
1/4/22,Brunei,4.5353,114.7277,15506,0,98,15408
1/5/22,Brunei,4.5353,114.7277,15532,0,98,15434
1/6/22,Brunei,4.5353,114.7277,15532,0,98,15434
1/7/22,Brunei,4.5353,114.7277,15577,0,98,15479
1/8/22,Brunei,4.5353,114.7277,15597,0,98,15499
1/9/22,Brunei,4.5353,114.7277,15634,0,98,15536
1/10/22,Brunei,4.5353,114.7277,15678,0,98,15580
1/11/22,Brunei,4.5353,114.7277,15678,0,98,15580
1/12/22,Brunei,4.5353,114.7277,15750,0,98,15652
1/13/22,Brunei,4.5353,114.7277,15750,0,98,15652
1/14/22,Brunei,4.5353,114.7277,15797,0,98,15699
1/15/22,Brunei,4.5353,114.7277,15797,0,98,15699
1/16/22,Brunei,4.5353,114.7277,15797,0,98,15699
1/17/22,Brunei,4.5353,114.7277,15901,0,98,15803
1/18/22,Brunei,4.5353,114.7277,15901,0,98,15803
1/19/22,Brunei,4.5353,114.7277,15986,0,98,15888
1/20/22,Brunei,4.5353,114.7277,15986,0,98,15888
1/21/22,Brunei,4.5353,114.7277,16066,0,98,15968
1/22/22,Brunei,4.5353,114.7277,16084,0,98,15986
1/23/22,Brunei,4.5353,114.7277,16084,0,98,15986
1/24/22,Brunei,4.5353,114.7277,16148,0,98,16050
1/25/22,Brunei,4.5353,114.7277,16148,0,98,16050
1/26/22,Brunei,4.5353,114.7277,16179,0,98,16081
1/27/22,Brunei,4.5353,114.7277,16206,0,98,16108
1/28/22,Brunei,4.5353,114.7277,16293,0,98,16195
1/29/22,Brunei,4.5353,114.7277,16345,0,98,16247
1/30/22,Brunei,4.5353,114.7277,16345,0,98,16247
1/31/22,Brunei,4.5353,114.7277,16476,0,98,16378
2/1/22,Brunei,4.5353,114.7277,16476,0,98,16378
2/2/22,Brunei,4.5353,114.7277,16691,0,98,16593
2/3/22,Brunei,4.5353,114.7277,16691,0,98,16593
2/4/22,Brunei,4.5353,114.7277,16891,0,98,16793
2/5/22,Brunei,4.5353,114.7277,17404,0,98,17306
2/6/22,Brunei,4.5353,114.7277,17404,0,98,17306
2/7/22,Brunei,4.5353,114.7277,18152,0,98,18054
2/8/22,Brunei,4.5353,114.7277,18404,0,98,18306
2/9/22,Brunei,4.5353,114.7277,18845,0,98,18747
2/10/22,Brunei,4.5353,114.7277,19473,0,98,19375
2/11/22,Brunei,4.5353,114.7277,20454,0,98,20356
2/12/22,Brunei,4.5353,114.7277,21579,0,98,21481
2/13/22,Brunei,4.5353,114.7277,22515,0,98,22417
2/14/22,Brunei,4.5353,114.7277,23992,0,98,23894
2/15/22,Brunei,4.5353,114.7277,24659,0,98,24561
2/16/22,Brunei,4.5353,114.7277,25584,0,98,25486
2/17/22,Brunei,4.5353,114.7277,27599,0,98,27501
2/18/22,Brunei,4.5353,114.7277,27599,0,98,27501
2/19/22,Brunei,4.5353,114.7277,27599,0,98,27501
2/20/22,Brunei,4.5353,114.7277,34979,0,109,34870
2/21/22,Brunei,4.5353,114.7277,37798,0,111,37687
2/22/22,Brunei,4.5353,114.7277,41049,0,112,40937
2/23/22,Brunei,4.5353,114.7277,44334,0,112,44222
2/24/22,Brunei,4.5353,114.7277,48055,0,113,47942
2/25/22,Brunei,4.5353,114.7277,51516,0,115,51401
2/26/22,Brunei,4.5353,114.7277,55485,0,115,55370
2/27/22,Brunei,4.5353,114.7277,59447,0,121,59326
2/28/22,Brunei,4.5353,114.7277,63542,0,125,63417
3/1/22,Brunei,4.5353,114.7277,67762,0,127,67635
3/2/22,Brunei,4.5353,114.7277,71649,0,129,71520
3/3/22,Brunei,4.5353,114.7277,76534,0,135,76399
3/4/22,Brunei,4.5353,114.7277,80749,0,135,80614
3/5/22,Brunei,4.5353,114.7277,84844,0,140,84704
3/6/22,Brunei,4.5353,114.7277,88849,0,143,88706
3/7/22,Brunei,4.5353,114.7277,93034,0,147,92887
3/8/22,Brunei,4.5353,114.7277,97018,0,151,96867
3/9/22,Brunei,4.5353,114.7277,100173,0,155,100018
3/10/22,Brunei,4.5353,114.7277,104022,0,156,103866
3/11/22,Brunei,4.5353,114.7277,106936,0,158,106778
3/12/22,Brunei,4.5353,114.7277,109538,0,163,109375
3/13/22,Brunei,4.5353,114.7277,112093,0,166,111927
3/14/22,Brunei,4.5353,114.7277,114371,0,170,114201
3/15/22,Brunei,4.5353,114.7277,116924,0,171,116753
3/16/22,Brunei,4.5353,114.7277,118892,0,176,118716
3/17/22,Brunei,4.5353,114.7277,120600,0,177,120423
3/18/22,Brunei,4.5353,114.7277,121957,0,178,121779
3/19/22,Brunei,4.5353,114.7277,123422,0,180,123242
3/20/22,Brunei,4.5353,114.7277,124716,0,189,124527
3/21/22,Brunei,4.5353,114.7277,126109,0,193,125916
3/22/22,Brunei,4.5353,114.7277,127300,0,196,127104
3/23/22,Brunei,4.5353,114.7277,128306,0,199,128107
3/24/22,Brunei,4.5353,114.7277,129081,0,200,128881
3/25/22,Brunei,4.5353,114.7277,129837,0,200,129637
3/26/22,Brunei,4.5353,114.7277,130611,0,202,130409
3/27/22,Brunei,4.5353,114.7277,131403,0,202,131201
3/28/22,Brunei,4.5353,114.7277,132194,0,203,131991
3/29/22,Brunei,4.5353,114.7277,132981,0,206,132775
3/30/22,Brunei,4.5353,114.7277,133726,0,208,133518
3/31/22,Brunei,4.5353,114.7277,134412,0,208,134204
4/1/22,Brunei,4.5353,114.7277,134915,0,210,134705
4/2/22,Brunei,4.5353,114.7277,135430,0,213,135217
4/3/22,Brunei,4.5353,114.7277,135974,0,213,135761
4/4/22,Brunei,4.5353,114.7277,136374,0,213,136161
4/5/22,Brunei,4.5353,114.7277,136821,0,214,136607
4/6/22,Brunei,4.5353,114.7277,137239,0,214,137025
4/7/22,Brunei,4.5353,114.7277,137585,0,214,137371
4/8/22,Brunei,4.5353,114.7277,137947,0,214,137733
4/9/22,Brunei,4.5353,114.7277,138261,0,215,138046
4/10/22,Brunei,4.5353,114.7277,138530,0,215,138315
4/11/22,Brunei,4.5353,114.7277,138811,0,215,138596
4/12/22,Brunei,4.5353,114.7277,139061,0,216,138845
4/13/22,Brunei,4.5353,114.7277,139278,0,216,139062
4/14/22,Brunei,4.5353,114.7277,139465,0,217,139248
4/15/22,Brunei,4.5353,114.7277,139637,0,217,139420
4/16/22,Brunei,4.5353,114.7277,139847,0,217,139630
4/17/22,Brunei,4.5353,114.7277,140023,0,218,139805
4/18/22,Brunei,4.5353,114.7277,140182,0,218,139964
4/19/22,Brunei,4.5353,114.7277,140364,0,218,140146
4/20/22,Brunei,4.5353,114.7277,140542,0,218,140324
4/21/22,Brunei,4.5353,114.7277,140723,0,218,140505
4/22/22,Brunei,4.5353,114.7277,140873,0,218,140655
4/23/22,Brunei,4.5353,114.7277,141014,0,218,140796
4/24/22,Brunei,4.5353,114.7277,141119,0,218,140901
4/25/22,Brunei,4.5353,114.7277,141269,0,218,141051
4/26/22,Brunei,4.5353,114.7277,141405,0,218,141187
4/27/22,Brunei,4.5353,114.7277,141531,0,218,141313
4/28/22,Brunei,4.5353,114.7277,141629,0,218,141411
4/29/22,Brunei,4.5353,114.7277,141748,0,218,141530
4/30/22,Brunei,4.5353,114.7277,141850,0,218,141632
5/1/22,Brunei,4.5353,114.7277,141911,0,218,141693
5/2/22,Brunei,4.5353,114.7277,141911,0,218,141693
5/3/22,Brunei,4.5353,114.7277,141976,0,218,141758
5/4/22,Brunei,4.5353,114.7277,142166,0,218,141948
5/5/22,Brunei,4.5353,114.7277,142312,0,218,142094
5/6/22,Brunei,4.5353,114.7277,142465,0,218,142247
5/7/22,Brunei,4.5353,114.7277,142627,0,218,142409
5/8/22,Brunei,4.5353,114.7277,142858,0,218,142640
5/9/22,Brunei,4.5353,114.7277,143107,0,219,142888
5/10/22,Brunei,4.5353,114.7277,143372,0,219,143153
5/11/22,Brunei,4.5353,114.7277,143616,0,219,143397
5/12/22,Brunei,4.5353,114.7277,143866,0,219,143647
5/13/22,Brunei,4.5353,114.7277,144136,0,220,143916
5/14/22,Brunei,4.5353,114.7277,144411,0,220,144191
5/15/22,Brunei,4.5353,114.7277,144659,0,220,144439
5/16/22,Brunei,4.5353,114.7277,144956,0,221,144735
5/17/22,Brunei,4.5353,114.7277,145221,0,221,145000
5/18/22,Brunei,4.5353,114.7277,145521,0,221,145300
5/19/22,Brunei,4.5353,114.7277,145783,0,221,145562
5/20/22,Brunei,4.5353,114.7277,146044,0,221,145823
5/21/22,Brunei,4.5353,114.7277,146315,0,221,146094
5/22/22,Brunei,4.5353,114.7277,146506,0,221,146285
5/23/22,Brunei,4.5353,114.7277,146775,0,222,146553
5/24/22,Brunei,4.5353,114.7277,147021,0,222,146799
5/25/22,Brunei,4.5353,114.7277,147271,0,222,147049
5/26/22,Brunei,4.5353,114.7277,147493,0,223,147270
5/27/22,Brunei,4.5353,114.7277,147667,0,223,147444
5/28/22,Brunei,4.5353,114.7277,147872,0,223,147649
5/29/22,Brunei,4.5353,114.7277,148089,0,223,147866
5/30/22,Brunei,4.5353,114.7277,148395,0,223,148172
5/31/22,Brunei,4.5353,114.7277,148674,0,223,148451
6/1/22,Brunei,4.5353,114.7277,148970,0,223,148747
6/2/22,Brunei,4.5353,114.7277,149337,0,223,149114
6/3/22,Brunei,4.5353,114.7277,149679,0,223,149456
6/4/22,Brunei,4.5353,114.7277,150058,0,223,149835
6/5/22,Brunei,4.5353,114.7277,150402,0,223,150179
6/6/22,Brunei,4.5353,114.7277,150781,0,223,150558
6/7/22,Brunei,4.5353,114.7277,151161,0,223,150938
6/8/22,Brunei,4.5353,114.7277,151560,0,224,151336
6/9/22,Brunei,4.5353,114.7277,151950,0,224,151726
6/10/22,Brunei,4.5353,114.7277,152320,0,225,152095
6/11/22,Brunei,4.5353,114.7277,152712,0,225,152487
6/12/22,Brunei,4.5353,114.7277,153093,0,225,152868
6/13/22,Brunei,4.5353,114.7277,153611,0,225,153386
6/14/22,Brunei,4.5353,114.7277,154133,0,225,153908
6/15/22,Brunei,4.5353,114.7277,154133,0,225,153908
6/16/22,Brunei,4.5353,114.7277,155274,0,225,155049
6/17/22,Brunei,4.5353,114.7277,155793,0,225,155568
6/18/22,Brunei,4.5353,114.7277,156452,0,225,156227
6/19/22,Brunei,4.5353,114.7277,156452,0,225,156227
6/20/22,Brunei,4.5353,114.7277,157772,0,225,157547
6/21/22,Brunei,4.5353,114.7277,158524,0,225,158299
6/22/22,Brunei,4.5353,114.7277,158527,0,225,158302
6/23/22,Brunei,4.5353,114.7277,158527,0,225,158302
6/24/22,Brunei,4.5353,114.7277,159591,0,225,159366
6/25/22,Brunei,4.5353,114.7277,159591,0,225,159366
6/26/22,Brunei,4.5353,114.7277,159591,0,225,159366
6/27/22,Brunei,4.5353,114.7277,161538,0,225,161313
6/28/22,Brunei,4.5353,114.7277,162311,0,225,162086
6/29/22,Brunei,4.5353,114.7277,163055,0,225,162830
6/30/22,Brunei,4.5353,114.7277,163900,0,225,163675
7/1/22,Brunei,4.5353,114.7277,164727,0,225,164502
7/2/22,Brunei,4.5353,114.7277,164727,0,225,164502
7/3/22,Brunei,4.5353,114.7277,164727,0,225,164502
7/4/22,Brunei,4.5353,114.7277,167669,0,225,167444
7/5/22,Brunei,4.5353,114.7277,168760,0,225,168535
7/6/22,Brunei,4.5353,114.7277,169848,0,225,169623
7/7/22,Brunei,4.5353,114.7277,171027,0,225,170802
7/8/22,Brunei,4.5353,114.7277,172280,0,225,172055
7/9/22,Brunei,4.5353,114.7277,172280,0,225,172055
7/10/22,Brunei,4.5353,114.7277,172280,0,225,172055
7/11/22,Brunei,4.5353,114.7277,176682,0,225,176457
7/12/22,Brunei,4.5353,114.7277,178267,0,225,178042
7/13/22,Brunei,4.5353,114.7277,179759,0,225,179534
7/14/22,Brunei,4.5353,114.7277,181256,0,225,181031
7/15/22,Brunei,4.5353,114.7277,182950,0,225,182725
7/16/22,Brunei,4.5353,114.7277,182950,0,225,182725
7/17/22,Brunei,4.5353,114.7277,182950,0,225,182725
7/18/22,Brunei,4.5353,114.7277,188219,0,225,187994
7/19/22,Brunei,4.5353,114.7277,189903,0,225,189678
7/20/22,Brunei,4.5353,114.7277,191774,0,225,191549
7/21/22,Brunei,4.5353,114.7277,193434,0,225,193209
7/22/22,Brunei,4.5353,114.7277,195113,0,225,194888
7/23/22,Brunei,4.5353,114.7277,195113,0,225,194888
7/24/22,Brunei,4.5353,114.7277,195113,0,225,194888
7/25/22,Brunei,4.5353,114.7277,200279,0,225,200054
7/26/22,Brunei,4.5353,114.7277,201857,0,225,201632
7/27/22,Brunei,4.5353,114.7277,203185,0,225,202960
7/28/22,Brunei,4.5353,114.7277,204384,0,225,204159
7/29/22,Brunei,4.5353,114.7277,205890,0,225,205665
7/30/22,Brunei,4.5353,114.7277,205890,0,225,205665
7/31/22,Brunei,4.5353,114.7277,205890,0,225,205665
8/1/22,Brunei,4.5353,114.7277,205890,0,225,205665
8/2/22,Brunei,4.5353,114.7277,210417,0,225,210192
8/3/22,Brunei,4.5353,114.7277,211132,0,225,210907
8/4/22,Brunei,4.5353,114.7277,211157,0,225,210932
8/5/22,Brunei,4.5353,114.7277,211157,0,225,210932
8/6/22,Brunei,4.5353,114.7277,211157,0,225,210932
8/7/22,Brunei,4.5353,114.7277,211157,0,225,210932
8/8/22,Brunei,4.5353,114.7277,211157,0,225,210932
8/9/22,Brunei,4.5353,114.7277,215283,0,225,215058
8/10/22,Brunei,4.5353,114.7277,215283,0,225,215058
8/11/22,Brunei,4.5353,114.7277,215283,0,225,215058
8/12/22,Brunei,4.5353,114.7277,215283,0,225,215058
8/13/22,Brunei,4.5353,114.7277,215283,0,225,215058
8/14/22,Brunei,4.5353,114.7277,215283,0,225,215058
8/15/22,Brunei,4.5353,114.7277,215283,0,225,215058
8/16/22,Brunei,4.5353,114.7277,215283,0,225,215058
8/17/22,Brunei,4.5353,114.7277,215283,0,225,215058
8/18/22,Brunei,4.5353,114.7277,215283,0,225,215058
8/19/22,Brunei,4.5353,114.7277,215283,0,225,215058
8/20/22,Brunei,4.5353,114.7277,215283,0,225,215058
8/21/22,Brunei,4.5353,114.7277,215283,0,225,215058
8/22/22,Brunei,4.5353,114.7277,215283,0,225,215058
8/23/22,Brunei,4.5353,114.7277,215283,0,225,215058
8/24/22,Brunei,4.5353,114.7277,220245,0,225,220020
8/25/22,Brunei,4.5353,114.7277,220245,0,225,220020
8/26/22,Brunei,4.5353,114.7277,220245,0,225,220020
8/27/22,Brunei,4.5353,114.7277,220245,0,225,220020
8/28/22,Brunei,4.5353,114.7277,220245,0,225,220020
8/29/22,Brunei,4.5353,114.7277,220245,0,225,220020
8/30/22,Brunei,4.5353,114.7277,220245,0,225,220020
8/31/22,Brunei,4.5353,114.7277,220245,0,225,220020
9/1/22,Brunei,4.5353,114.7277,220245,0,225,220020
9/2/22,Brunei,4.5353,114.7277,220245,0,225,220020
9/3/22,Brunei,4.5353,114.7277,220245,0,225,220020
9/4/22,Brunei,4.5353,114.7277,220245,0,225,220020
9/5/22,Brunei,4.5353,114.7277,220245,0,225,220020
9/6/22,Brunei,4.5353,114.7277,223059,0,225,222834
9/7/22,Brunei,4.5353,114.7277,223059,0,225,222834
9/8/22,Brunei,4.5353,114.7277,223059,0,225,222834
9/9/22,Brunei,4.5353,114.7277,223059,0,225,222834
9/10/22,Brunei,4.5353,114.7277,223059,0,225,222834
9/11/22,Brunei,4.5353,114.7277,223059,0,225,222834
9/12/22,Brunei,4.5353,114.7277,223059,0,225,222834
9/13/22,Brunei,4.5353,114.7277,223059,0,225,222834
9/14/22,Brunei,4.5353,114.7277,224610,0,225,224385
9/15/22,Brunei,4.5353,114.7277,224610,0,225,224385
9/16/22,Brunei,4.5353,114.7277,224610,0,225,224385
9/17/22,Brunei,4.5353,114.7277,224610,0,225,224385
9/18/22,Brunei,4.5353,114.7277,224610,0,225,224385
9/19/22,Brunei,4.5353,114.7277,224610,0,225,224385
9/20/22,Brunei,4.5353,114.7277,226237,0,225,226012
9/21/22,Brunei,4.5353,114.7277,226237,0,225,226012
9/22/22,Brunei,4.5353,114.7277,226237,0,225,226012
9/23/22,Brunei,4.5353,114.7277,226237,0,225,226012
9/24/22,Brunei,4.5353,114.7277,226237,0,225,226012
9/25/22,Brunei,4.5353,114.7277,226237,0,225,226012
9/26/22,Brunei,4.5353,114.7277,226237,0,225,226012
9/27/22,Brunei,4.5353,114.7277,226237,0,225,226012
9/28/22,Brunei,4.5353,114.7277,227756,0,225,227531
9/29/22,Brunei,4.5353,114.7277,227756,0,225,227531
9/30/22,Brunei,4.5353,114.7277,227756,0,225,227531
10/1/22,Brunei,4.5353,114.7277,227756,0,225,227531
10/2/22,Brunei,4.5353,114.7277,227756,0,225,227531
10/3/22,Brunei,4.5353,114.7277,227756,0,225,227531
10/4/22,Brunei,4.5353,114.7277,229665,0,225,229440
10/5/22,Brunei,4.5353,114.7277,229665,0,225,229440
10/6/22,Brunei,4.5353,114.7277,229665,0,225,229440
10/7/22,Brunei,4.5353,114.7277,229665,0,225,229440
10/8/22,Brunei,4.5353,114.7277,229665,0,225,229440
10/9/22,Brunei,4.5353,114.7277,229665,0,225,229440
10/10/22,Brunei,4.5353,114.7277,229665,0,225,229440
10/11/22,Brunei,4.5353,114.7277,231833,0,225,231608
10/12/22,Brunei,4.5353,114.7277,231833,0,225,231608
10/13/22,Brunei,4.5353,114.7277,231833,0,225,231608
10/14/22,Brunei,4.5353,114.7277,231833,0,225,231608
10/15/22,Brunei,4.5353,114.7277,231833,0,225,231608
10/16/22,Brunei,4.5353,114.7277,231833,0,225,231608
10/17/22,Brunei,4.5353,114.7277,231833,0,225,231608
10/18/22,Brunei,4.5353,114.7277,234582,0,225,234357
10/19/22,Brunei,4.5353,114.7277,234582,0,225,234357
10/20/22,Brunei,4.5353,114.7277,234582,0,225,234357
10/21/22,Brunei,4.5353,114.7277,234582,0,225,234357
10/22/22,Brunei,4.5353,114.7277,234582,0,225,234357
10/23/22,Brunei,4.5353,114.7277,234582,0,225,234357
10/24/22,Brunei,4.5353,114.7277,234582,0,225,234357
10/25/22,Brunei,4.5353,114.7277,237656,0,225,237431
10/26/22,Brunei,4.5353,114.7277,237656,0,225,237431
10/27/22,Brunei,4.5353,114.7277,237656,0,225,237431
10/28/22,Brunei,4.5353,114.7277,237656,0,225,237431
10/29/22,Brunei,4.5353,114.7277,237656,0,225,237431
10/30/22,Brunei,4.5353,114.7277,237656,0,225,237431
10/31/22,Brunei,4.5353,114.7277,237656,0,225,237431
11/1/22,Brunei,4.5353,114.7277,237656,0,225,237431
11/2/22,Brunei,4.5353,114.7277,241044,0,225,240819
11/3/22,Brunei,4.5353,114.7277,241044,0,225,240819
11/4/22,Brunei,4.5353,114.7277,241044,0,225,240819
11/5/22,Brunei,4.5353,114.7277,241044,0,225,240819
11/6/22,Brunei,4.5353,114.7277,241044,0,225,240819
11/7/22,Brunei,4.5353,114.7277,241044,0,225,240819
11/8/22,Brunei,4.5353,114.7277,241044,0,225,240819
11/9/22,Brunei,4.5353,114.7277,244599,0,225,244374
11/10/22,Brunei,4.5353,114.7277,244599,0,225,244374
11/11/22,Brunei,4.5353,114.7277,244599,0,225,244374
11/12/22,Brunei,4.5353,114.7277,244599,0,225,244374
11/13/22,Brunei,4.5353,114.7277,244599,0,225,244374
11/14/22,Brunei,4.5353,114.7277,244599,0,225,244374
11/15/22,Brunei,4.5353,114.7277,248861,0,225,248636
11/16/22,Brunei,4.5353,114.7277,248861,0,225,248636
11/17/22,Brunei,4.5353,114.7277,248861,0,225,248636
11/18/22,Brunei,4.5353,114.7277,248861,0,225,248636
11/19/22,Brunei,4.5353,114.7277,248861,0,225,248636
11/20/22,Brunei,4.5353,114.7277,248861,0,225,248636
11/21/22,Brunei,4.5353,114.7277,248861,0,225,248636
11/22/22,Brunei,4.5353,114.7277,248861,0,225,248636
11/23/22,Brunei,4.5353,114.7277,253406,0,225,253181
11/24/22,Brunei,4.5353,114.7277,253406,0,225,253181
11/25/22,Brunei,4.5353,114.7277,253406,0,225,253181
11/26/22,Brunei,4.5353,114.7277,253406,0,225,253181
11/27/22,Brunei,4.5353,114.7277,253406,0,225,253181
11/28/22,Brunei,4.5353,114.7277,253406,0,225,253181
11/29/22,Brunei,4.5353,114.7277,253406,0,225,253181
11/30/22,Brunei,4.5353,114.7277,257921,0,225,257696
12/1/22,Brunei,4.5353,114.7277,257921,0,225,257696
12/2/22,Brunei,4.5353,114.7277,257921,0,225,257696
12/3/22,Brunei,4.5353,114.7277,257921,0,225,257696
12/4/22,Brunei,4.5353,114.7277,257921,0,225,257696
12/5/22,Brunei,4.5353,114.7277,257921,0,225,257696
12/6/22,Brunei,4.5353,114.7277,257921,0,225,257696
12/7/22,Brunei,4.5353,114.7277,261440,0,225,261215
12/8/22,Brunei,4.5353,114.7277,261440,0,225,261215
12/9/22,Brunei,4.5353,114.7277,261440,0,225,261215
12/10/22,Brunei,4.5353,114.7277,261440,0,225,261215
12/11/22,Brunei,4.5353,114.7277,261440,0,225,261215
12/12/22,Brunei,4.5353,114.7277,261440,0,225,261215
12/13/22,Brunei,4.5353,114.7277,264490,0,225,264265
12/14/22,Brunei,4.5353,114.7277,264490,0,225,264265
12/15/22,Brunei,4.5353,114.7277,264490,0,225,264265
12/16/22,Brunei,4.5353,114.7277,264490,0,225,264265
12/17/22,Brunei,4.5353,114.7277,264490,0,225,264265
1/1/22,Bulgaria,42.7339,25.4858,748184,0,30983,717201
1/2/22,Bulgaria,42.7339,25.4858,749540,0,31027,718513
1/3/22,Bulgaria,42.7339,25.4858,751458,0,31080,720378
1/4/22,Bulgaria,42.7339,25.4858,757710,0,31237,726473
1/5/22,Bulgaria,42.7339,25.4858,764476,0,31303,733173
1/6/22,Bulgaria,42.7339,25.4858,770001,0,31375,738626
1/7/22,Bulgaria,42.7339,25.4858,775525,0,31471,744054
1/8/22,Bulgaria,42.7339,25.4858,778701,0,31516,747185
1/9/22,Bulgaria,42.7339,25.4858,780417,0,31556,748861
1/10/22,Bulgaria,42.7339,25.4858,787178,0,31672,755506
1/11/22,Bulgaria,42.7339,25.4858,794240,0,31761,762479
1/12/22,Bulgaria,42.7339,25.4858,799943,0,31838,768105
1/13/22,Bulgaria,42.7339,25.4858,806977,0,31922,775055
1/14/22,Bulgaria,42.7339,25.4858,813840,0,32002,781838
1/15/22,Bulgaria,42.7339,25.4858,818229,0,32042,786187
1/16/22,Bulgaria,42.7339,25.4858,820608,0,32086,788522
1/17/22,Bulgaria,42.7339,25.4858,830604,0,32247,798357
1/18/22,Bulgaria,42.7339,25.4858,841785,0,32338,809447
1/19/22,Bulgaria,42.7339,25.4858,851945,0,32431,819514
1/20/22,Bulgaria,42.7339,25.4858,860877,0,32518,828359
1/21/22,Bulgaria,42.7339,25.4858,870751,0,32604,838147
1/22/22,Bulgaria,42.7339,25.4858,877381,0,32636,844745
1/23/22,Bulgaria,42.7339,25.4858,880228,0,32664,847564
1/24/22,Bulgaria,42.7339,25.4858,891277,0,32796,858481
1/25/22,Bulgaria,42.7339,25.4858,903676,0,32869,870807
1/26/22,Bulgaria,42.7339,25.4858,913592,0,32939,880653
1/27/22,Bulgaria,42.7339,25.4858,923466,0,33017,890449
1/28/22,Bulgaria,42.7339,25.4858,933337,0,33088,900249
1/29/22,Bulgaria,42.7339,25.4858,939212,0,33121,906091
1/30/22,Bulgaria,42.7339,25.4858,941814,0,33160,908654
1/31/22,Bulgaria,42.7339,25.4858,951965,0,33318,918647
2/1/22,Bulgaria,42.7339,25.4858,963108,0,33405,929703
2/2/22,Bulgaria,42.7339,25.4858,972260,0,33492,938768
2/3/22,Bulgaria,42.7339,25.4858,980402,0,33588,946814
2/4/22,Bulgaria,42.7339,25.4858,988518,0,33688,954830
2/5/22,Bulgaria,42.7339,25.4858,993255,0,33728,959527
2/6/22,Bulgaria,42.7339,25.4858,995436,0,33770,961666
2/7/22,Bulgaria,42.7339,25.4858,1003448,0,33946,969502
2/8/22,Bulgaria,42.7339,25.4858,1011588,0,34044,977544
2/9/22,Bulgaria,42.7339,25.4858,1018851,0,34152,984699
2/10/22,Bulgaria,42.7339,25.4858,1025129,0,34228,990901
2/11/22,Bulgaria,42.7339,25.4858,1031660,0,34314,997346
2/12/22,Bulgaria,42.7339,25.4858,1035285,0,34359,1000926
2/13/22,Bulgaria,42.7339,25.4858,1036824,0,34404,1002420
2/14/22,Bulgaria,42.7339,25.4858,1042954,0,34591,1008363
2/15/22,Bulgaria,42.7339,25.4858,1049543,0,34686,1014857
2/16/22,Bulgaria,42.7339,25.4858,1054566,0,34779,1019787
2/17/22,Bulgaria,42.7339,25.4858,1059192,0,34884,1024308
2/18/22,Bulgaria,42.7339,25.4858,1063808,0,34973,1028835
2/19/22,Bulgaria,42.7339,25.4858,1066413,0,34998,1031415
2/20/22,Bulgaria,42.7339,25.4858,1067648,0,35042,1032606
2/21/22,Bulgaria,42.7339,25.4858,1072493,0,35185,1037308
2/22/22,Bulgaria,42.7339,25.4858,1077160,0,35245,1041915
2/23/22,Bulgaria,42.7339,25.4858,1080571,0,35298,1045273
2/24/22,Bulgaria,42.7339,25.4858,1083425,0,35357,1048068
2/25/22,Bulgaria,42.7339,25.4858,1086328,0,35433,1050895
2/26/22,Bulgaria,42.7339,25.4858,1087796,0,35458,1052338
2/27/22,Bulgaria,42.7339,25.4858,1088520,0,35482,1053038
2/28/22,Bulgaria,42.7339,25.4858,1091279,0,35581,1055698
3/1/22,Bulgaria,42.7339,25.4858,1093920,0,35637,1058283
3/2/22,Bulgaria,42.7339,25.4858,1096194,0,35696,1060498
3/3/22,Bulgaria,42.7339,25.4858,1097298,0,35716,1061582
3/4/22,Bulgaria,42.7339,25.4858,1099423,0,35790,1063633
3/5/22,Bulgaria,42.7339,25.4858,1100811,0,35811,1065000
3/6/22,Bulgaria,42.7339,25.4858,1101326,0,35832,1065494
3/7/22,Bulgaria,42.7339,25.4858,1103788,0,35923,1067865
3/8/22,Bulgaria,42.7339,25.4858,1105968,0,35964,1070004
3/9/22,Bulgaria,42.7339,25.4858,1107888,0,35995,1071893
3/10/22,Bulgaria,42.7339,25.4858,1109581,0,36028,1073553
3/11/22,Bulgaria,42.7339,25.4858,1111216,0,36069,1075147
3/12/22,Bulgaria,42.7339,25.4858,1112176,0,36084,1076092
3/13/22,Bulgaria,42.7339,25.4858,1112699,0,36098,1076601
3/14/22,Bulgaria,42.7339,25.4858,1115132,0,36162,1078970
3/15/22,Bulgaria,42.7339,25.4858,1117525,0,36196,1081329
3/16/22,Bulgaria,42.7339,25.4858,1119474,0,36222,1083252
3/17/22,Bulgaria,42.7339,25.4858,1121194,0,36248,1084946
3/18/22,Bulgaria,42.7339,25.4858,1122795,0,36266,1086529
3/19/22,Bulgaria,42.7339,25.4858,1123714,0,36272,1087442
3/20/22,Bulgaria,42.7339,25.4858,1124186,0,36282,1087904
3/21/22,Bulgaria,42.7339,25.4858,1126146,0,36330,1089816
3/22/22,Bulgaria,42.7339,25.4858,1128089,0,36350,1091739
3/23/22,Bulgaria,42.7339,25.4858,1129641,0,36375,1093266
3/24/22,Bulgaria,42.7339,25.4858,1131065,0,36396,1094669
3/25/22,Bulgaria,42.7339,25.4858,1132398,0,36425,1095973
3/26/22,Bulgaria,42.7339,25.4858,1133102,0,36429,1096673
3/27/22,Bulgaria,42.7339,25.4858,1133464,0,36437,1097027
3/28/22,Bulgaria,42.7339,25.4858,1134906,0,36480,1098426
3/29/22,Bulgaria,42.7339,25.4858,1136604,0,36498,1100106
3/30/22,Bulgaria,42.7339,25.4858,1137780,0,36512,1101268
3/31/22,Bulgaria,42.7339,25.4858,1138923,0,36529,1102394
4/1/22,Bulgaria,42.7339,25.4858,1139956,0,36554,1103402
4/2/22,Bulgaria,42.7339,25.4858,1140453,0,36565,1103888
4/3/22,Bulgaria,42.7339,25.4858,1140679,0,36568,1104111
4/4/22,Bulgaria,42.7339,25.4858,1141859,0,36608,1105251
4/5/22,Bulgaria,42.7339,25.4858,1142698,0,36636,1106062
4/6/22,Bulgaria,42.7339,25.4858,1143424,0,36655,1106769
4/7/22,Bulgaria,42.7339,25.4858,1144107,0,36672,1107435
4/8/22,Bulgaria,42.7339,25.4858,1144822,0,36685,1108137
4/9/22,Bulgaria,42.7339,25.4858,1145143,0,36692,1108451
4/10/22,Bulgaria,42.7339,25.4858,1145408,0,36700,1108708
4/11/22,Bulgaria,42.7339,25.4858,1146279,0,36730,1109549
4/12/22,Bulgaria,42.7339,25.4858,1147165,0,36740,1110425
4/13/22,Bulgaria,42.7339,25.4858,1147812,0,36756,1111056
4/14/22,Bulgaria,42.7339,25.4858,1148362,0,36764,1111598
4/15/22,Bulgaria,42.7339,25.4858,1148971,0,36781,1112190
4/16/22,Bulgaria,42.7339,25.4858,1149225,0,36782,1112443
4/17/22,Bulgaria,42.7339,25.4858,1149447,0,36784,1112663
4/18/22,Bulgaria,42.7339,25.4858,1150342,0,36810,1113532
4/19/22,Bulgaria,42.7339,25.4858,1151011,0,36816,1114195
4/20/22,Bulgaria,42.7339,25.4858,1151620,0,36827,1114793
4/21/22,Bulgaria,42.7339,25.4858,1152251,0,36838,1115413
4/22/22,Bulgaria,42.7339,25.4858,1152538,0,36842,1115696
4/23/22,Bulgaria,42.7339,25.4858,1152892,0,36849,1116043
4/24/22,Bulgaria,42.7339,25.4858,1153129,0,36854,1116275
4/25/22,Bulgaria,42.7339,25.4858,1153506,0,36856,1116650
4/26/22,Bulgaria,42.7339,25.4858,1154646,0,36879,1117767
4/27/22,Bulgaria,42.7339,25.4858,1155387,0,36887,1118500
4/28/22,Bulgaria,42.7339,25.4858,1155975,0,36901,1119074
4/29/22,Bulgaria,42.7339,25.4858,1156466,0,36911,1119555
4/30/22,Bulgaria,42.7339,25.4858,1156729,0,36913,1119816
5/1/22,Bulgaria,42.7339,25.4858,1156971,0,36918,1120053
5/2/22,Bulgaria,42.7339,25.4858,1157199,0,36920,1120279
5/3/22,Bulgaria,42.7339,25.4858,1157919,0,36947,1120972
5/4/22,Bulgaria,42.7339,25.4858,1158354,0,36953,1121401
5/5/22,Bulgaria,42.7339,25.4858,1158793,0,36965,1121828
5/6/22,Bulgaria,42.7339,25.4858,1158949,0,36965,1121984
5/7/22,Bulgaria,42.7339,25.4858,1159150,0,36966,1122184
5/8/22,Bulgaria,42.7339,25.4858,1159301,0,36973,1122328
5/9/22,Bulgaria,42.7339,25.4858,1159925,0,36994,1122931
5/10/22,Bulgaria,42.7339,25.4858,1160347,0,37007,1123340
5/11/22,Bulgaria,42.7339,25.4858,1160706,0,37019,1123687
5/12/22,Bulgaria,42.7339,25.4858,1161038,0,37035,1124003
5/13/22,Bulgaria,42.7339,25.4858,1161351,0,37043,1124308
5/14/22,Bulgaria,42.7339,25.4858,1161504,0,37045,1124459
5/15/22,Bulgaria,42.7339,25.4858,1161630,0,37048,1124582
5/16/22,Bulgaria,42.7339,25.4858,1161992,0,37059,1124933
5/17/22,Bulgaria,42.7339,25.4858,1162449,0,37065,1125384
5/18/22,Bulgaria,42.7339,25.4858,1162724,0,37071,1125653
5/19/22,Bulgaria,42.7339,25.4858,1162986,0,37078,1125908
5/20/22,Bulgaria,42.7339,25.4858,1163225,0,37087,1126138
5/21/22,Bulgaria,42.7339,25.4858,1163317,0,37090,1126227
5/22/22,Bulgaria,42.7339,25.4858,1163413,0,37093,1126320
5/23/22,Bulgaria,42.7339,25.4858,1163706,0,37106,1126600
5/24/22,Bulgaria,42.7339,25.4858,1163806,0,37109,1126697
5/25/22,Bulgaria,42.7339,25.4858,1164122,0,37115,1127007
5/26/22,Bulgaria,42.7339,25.4858,1164358,0,37121,1127237
5/27/22,Bulgaria,42.7339,25.4858,1164526,0,37132,1127394
5/28/22,Bulgaria,42.7339,25.4858,1164659,0,37133,1127526
5/29/22,Bulgaria,42.7339,25.4858,1164732,0,37134,1127598
5/30/22,Bulgaria,42.7339,25.4858,1164985,0,37145,1127840
5/31/22,Bulgaria,42.7339,25.4858,1165167,0,37148,1128019
6/1/22,Bulgaria,42.7339,25.4858,1165356,0,37150,1128206
6/2/22,Bulgaria,42.7339,25.4858,1165538,0,37153,1128385
6/3/22,Bulgaria,42.7339,25.4858,1165727,0,37163,1128564
6/4/22,Bulgaria,42.7339,25.4858,1165807,0,37163,1128644
6/5/22,Bulgaria,42.7339,25.4858,1165856,0,37163,1128693
6/6/22,Bulgaria,42.7339,25.4858,1166148,0,37182,1128966
6/7/22,Bulgaria,42.7339,25.4858,1166316,0,37184,1129132
6/8/22,Bulgaria,42.7339,25.4858,1166476,0,37188,1129288
6/9/22,Bulgaria,42.7339,25.4858,1166589,0,37194,1129395
6/10/22,Bulgaria,42.7339,25.4858,1166777,0,37196,1129581
6/11/22,Bulgaria,42.7339,25.4858,1166859,0,37196,1129663
6/12/22,Bulgaria,42.7339,25.4858,1166901,0,37196,1129705
6/13/22,Bulgaria,42.7339,25.4858,1167147,0,37204,1129943
6/14/22,Bulgaria,42.7339,25.4858,1167314,0,37206,1130108
6/15/22,Bulgaria,42.7339,25.4858,1167466,0,37210,1130256
6/16/22,Bulgaria,42.7339,25.4858,1167706,0,37219,1130487
6/17/22,Bulgaria,42.7339,25.4858,1167914,0,37223,1130691
6/18/22,Bulgaria,42.7339,25.4858,1168035,0,37224,1130811
6/19/22,Bulgaria,42.7339,25.4858,1168127,0,37224,1130903
6/20/22,Bulgaria,42.7339,25.4858,1168508,0,37227,1131281
6/21/22,Bulgaria,42.7339,25.4858,1168818,0,37230,1131588
6/22/22,Bulgaria,42.7339,25.4858,1169154,0,37235,1131919
6/23/22,Bulgaria,42.7339,25.4858,1169474,0,37238,1132236
6/24/22,Bulgaria,42.7339,25.4858,1169728,0,37246,1132482
6/25/22,Bulgaria,42.7339,25.4858,1169968,0,37246,1132722
6/26/22,Bulgaria,42.7339,25.4858,1170091,0,37246,1132845
6/27/22,Bulgaria,42.7339,25.4858,1170686,0,37247,1133439
6/28/22,Bulgaria,42.7339,25.4858,1171235,0,37249,1133986
6/29/22,Bulgaria,42.7339,25.4858,1171767,0,37251,1134516
6/30/22,Bulgaria,42.7339,25.4858,1172239,0,37255,1134984
7/1/22,Bulgaria,42.7339,25.4858,1172777,0,37257,1135520
7/2/22,Bulgaria,42.7339,25.4858,1173091,0,37257,1135834
7/3/22,Bulgaria,42.7339,25.4858,1173274,0,37257,1136017
7/4/22,Bulgaria,42.7339,25.4858,1174216,0,37260,1136956
7/5/22,Bulgaria,42.7339,25.4858,1175082,0,37261,1137821
7/6/22,Bulgaria,42.7339,25.4858,1175725,0,37263,1138462
7/7/22,Bulgaria,42.7339,25.4858,1176567,0,37264,1139303
7/8/22,Bulgaria,42.7339,25.4858,1177572,0,37266,1140306
7/9/22,Bulgaria,42.7339,25.4858,1177933,0,37266,1140667
7/10/22,Bulgaria,42.7339,25.4858,1178189,0,37272,1140917
7/11/22,Bulgaria,42.7339,25.4858,1179497,0,37277,1142220
7/12/22,Bulgaria,42.7339,25.4858,1180636,0,37279,1143357
7/13/22,Bulgaria,42.7339,25.4858,1181657,0,37281,1144376
7/14/22,Bulgaria,42.7339,25.4858,1182764,0,37283,1145481
7/15/22,Bulgaria,42.7339,25.4858,1183877,0,37289,1146588
7/16/22,Bulgaria,42.7339,25.4858,1184429,0,37291,1147138
7/17/22,Bulgaria,42.7339,25.4858,1184846,0,37294,1147552
7/18/22,Bulgaria,42.7339,25.4858,1187138,0,37301,1149837
7/19/22,Bulgaria,42.7339,25.4858,1189000,0,37307,1151693
7/20/22,Bulgaria,42.7339,25.4858,1190644,0,37313,1153331
7/21/22,Bulgaria,42.7339,25.4858,1192284,0,37319,1154965
7/22/22,Bulgaria,42.7339,25.4858,1194061,0,37329,1156732
7/23/22,Bulgaria,42.7339,25.4858,1194883,0,37329,1157554
7/24/22,Bulgaria,42.7339,25.4858,1195372,0,37330,1158042
7/25/22,Bulgaria,42.7339,25.4858,1198359,0,37342,1161017
7/26/22,Bulgaria,42.7339,25.4858,1200550,0,37350,1163200
7/27/22,Bulgaria,42.7339,25.4858,1202494,0,37356,1165138
7/28/22,Bulgaria,42.7339,25.4858,1204264,0,37360,1166904
7/29/22,Bulgaria,42.7339,25.4858,1205966,0,37372,1168594
7/30/22,Bulgaria,42.7339,25.4858,1206688,0,37377,1169311
7/31/22,Bulgaria,42.7339,25.4858,1206688,0,37377,1169311
8/1/22,Bulgaria,42.7339,25.4858,1209777,0,37404,1172373
8/2/22,Bulgaria,42.7339,25.4858,1211728,0,37414,1174314
8/3/22,Bulgaria,42.7339,25.4858,1213429,0,37420,1176009
8/4/22,Bulgaria,42.7339,25.4858,1214925,0,37424,1177501
8/5/22,Bulgaria,42.7339,25.4858,1216491,0,37429,1179062
8/6/22,Bulgaria,42.7339,25.4858,1217154,0,37431,1179723
8/7/22,Bulgaria,42.7339,25.4858,1217565,0,37435,1180130
8/8/22,Bulgaria,42.7339,25.4858,1219883,0,37451,1182432
8/9/22,Bulgaria,42.7339,25.4858,1221519,0,37460,1184059
8/10/22,Bulgaria,42.7339,25.4858,1222948,0,37469,1185479
8/11/22,Bulgaria,42.7339,25.4858,1224222,0,37475,1186747
8/12/22,Bulgaria,42.7339,25.4858,1225246,0,37485,1187761
8/13/22,Bulgaria,42.7339,25.4858,1226064,0,37486,1188578
8/14/22,Bulgaria,42.7339,25.4858,1226419,0,37488,1188931
8/15/22,Bulgaria,42.7339,25.4858,1228283,0,37501,1190782
8/16/22,Bulgaria,42.7339,25.4858,1229633,0,37514,1192119
8/17/22,Bulgaria,42.7339,25.4858,1230822,0,37517,1193305
8/18/22,Bulgaria,42.7339,25.4858,1231909,0,37527,1194382
8/19/22,Bulgaria,42.7339,25.4858,1233050,0,37539,1195511
8/20/22,Bulgaria,42.7339,25.4858,1233470,0,37541,1195929
8/21/22,Bulgaria,42.7339,25.4858,1233760,0,37544,1196216
8/22/22,Bulgaria,42.7339,25.4858,1235510,0,37560,1197950
8/23/22,Bulgaria,42.7339,25.4858,1236660,0,37562,1199098
8/24/22,Bulgaria,42.7339,25.4858,1237628,0,37570,1200058
8/25/22,Bulgaria,42.7339,25.4858,1238531,0,37578,1200953
8/26/22,Bulgaria,42.7339,25.4858,1239382,0,37584,1201798
8/27/22,Bulgaria,42.7339,25.4858,1239681,0,37585,1202096
8/28/22,Bulgaria,42.7339,25.4858,1239870,0,37588,1202282
8/29/22,Bulgaria,42.7339,25.4858,1241273,0,37599,1203674
8/30/22,Bulgaria,42.7339,25.4858,1242133,0,37600,1204533
8/31/22,Bulgaria,42.7339,25.4858,1242910,0,37603,1205307
9/1/22,Bulgaria,42.7339,25.4858,1243657,0,37607,1206050
9/2/22,Bulgaria,42.7339,25.4858,1244329,0,37611,1206718
9/3/22,Bulgaria,42.7339,25.4858,1244555,0,37611,1206944
9/4/22,Bulgaria,42.7339,25.4858,1244733,0,37613,1207120
9/5/22,Bulgaria,42.7339,25.4858,1245457,0,37620,1207837
9/6/22,Bulgaria,42.7339,25.4858,1245918,0,37621,1208297
9/7/22,Bulgaria,42.7339,25.4858,1246665,0,37632,1209033
9/8/22,Bulgaria,42.7339,25.4858,1247215,0,37638,1209577
9/9/22,Bulgaria,42.7339,25.4858,1247778,0,37645,1210133
9/10/22,Bulgaria,42.7339,25.4858,1248035,0,37646,1210389
9/11/22,Bulgaria,42.7339,25.4858,1248200,0,37646,1210554
9/12/22,Bulgaria,42.7339,25.4858,1248200,0,37646,1210554
9/13/22,Bulgaria,42.7339,25.4858,1249706,0,37658,1212048
9/14/22,Bulgaria,42.7339,25.4858,1250250,0,37663,1212587
9/15/22,Bulgaria,42.7339,25.4858,1250627,0,37667,1212960
9/16/22,Bulgaria,42.7339,25.4858,1251331,0,37675,1213656
9/17/22,Bulgaria,42.7339,25.4858,1251529,0,37676,1213853
9/18/22,Bulgaria,42.7339,25.4858,1251669,0,37676,1213993
9/19/22,Bulgaria,42.7339,25.4858,1252615,0,37682,1214933
9/20/22,Bulgaria,42.7339,25.4858,1253233,0,37688,1215545
9/21/22,Bulgaria,42.7339,25.4858,1253772,0,37694,1216078
9/22/22,Bulgaria,42.7339,25.4858,1253934,0,37694,1216240
9/23/22,Bulgaria,42.7339,25.4858,1254682,0,37697,1216985
9/24/22,Bulgaria,42.7339,25.4858,1254951,0,37697,1217254
9/25/22,Bulgaria,42.7339,25.4858,1255139,0,37698,1217441
9/26/22,Bulgaria,42.7339,25.4858,1256266,0,37704,1218562
9/27/22,Bulgaria,42.7339,25.4858,1257149,0,37708,1219441
9/28/22,Bulgaria,42.7339,25.4858,1257918,0,37711,1220207
9/29/22,Bulgaria,42.7339,25.4858,1258670,0,37714,1220956
9/30/22,Bulgaria,42.7339,25.4858,1259471,0,37718,1221753
10/1/22,Bulgaria,42.7339,25.4858,1259769,0,37718,1222051
10/2/22,Bulgaria,42.7339,25.4858,1259948,0,37718,1222230
10/3/22,Bulgaria,42.7339,25.4858,1261287,0,37727,1223560
10/4/22,Bulgaria,42.7339,25.4858,1262224,0,37733,1224491
10/5/22,Bulgaria,42.7339,25.4858,1262945,0,37737,1225208
10/6/22,Bulgaria,42.7339,25.4858,1263630,0,37741,1225889
10/7/22,Bulgaria,42.7339,25.4858,1264327,0,37745,1226582
10/8/22,Bulgaria,42.7339,25.4858,1264615,0,37746,1226869
10/9/22,Bulgaria,42.7339,25.4858,1264827,0,37747,1227080
10/10/22,Bulgaria,42.7339,25.4858,1266241,0,37758,1228483
10/11/22,Bulgaria,42.7339,25.4858,1267150,0,37764,1229386
10/12/22,Bulgaria,42.7339,25.4858,1268035,0,37771,1230264
10/13/22,Bulgaria,42.7339,25.4858,1268814,0,37773,1231041
10/14/22,Bulgaria,42.7339,25.4858,1269597,0,37782,1231815
10/15/22,Bulgaria,42.7339,25.4858,1269792,0,37784,1232008
10/16/22,Bulgaria,42.7339,25.4858,1270081,0,37784,1232297
10/17/22,Bulgaria,42.7339,25.4858,1271228,0,37795,1233433
10/18/22,Bulgaria,42.7339,25.4858,1272015,0,37801,1234214
10/19/22,Bulgaria,42.7339,25.4858,1272645,0,37812,1234833
10/20/22,Bulgaria,42.7339,25.4858,1273231,0,37816,1235415
10/21/22,Bulgaria,42.7339,25.4858,1273949,0,37820,1236129
10/22/22,Bulgaria,42.7339,25.4858,1274169,0,37821,1236348
10/23/22,Bulgaria,42.7339,25.4858,1274336,0,37821,1236515
10/24/22,Bulgaria,42.7339,25.4858,1275481,0,37840,1237641
10/25/22,Bulgaria,42.7339,25.4858,1276146,0,37847,1238299
10/26/22,Bulgaria,42.7339,25.4858,1276765,0,37853,1238912
10/27/22,Bulgaria,42.7339,25.4858,1277342,0,37857,1239485
10/28/22,Bulgaria,42.7339,25.4858,1277935,0,37860,1240075
10/29/22,Bulgaria,42.7339,25.4858,1278115,0,37860,1240255
10/30/22,Bulgaria,42.7339,25.4858,1278236,0,37860,1240376
10/31/22,Bulgaria,42.7339,25.4858,1279082,0,37880,1241202
11/1/22,Bulgaria,42.7339,25.4858,1279595,0,37888,1241707
11/2/22,Bulgaria,42.7339,25.4858,1280004,0,37898,1242106
11/3/22,Bulgaria,42.7339,25.4858,1280584,0,37903,1242681
11/4/22,Bulgaria,42.7339,25.4858,1280584,0,37903,1242681
11/5/22,Bulgaria,42.7339,25.4858,1281155,0,37916,1243239
11/6/22,Bulgaria,42.7339,25.4858,1281252,0,37920,1243332
11/7/22,Bulgaria,42.7339,25.4858,1281924,0,37931,1243993
11/8/22,Bulgaria,42.7339,25.4858,1281924,0,37931,1243993
11/9/22,Bulgaria,42.7339,25.4858,1282284,0,37936,1244348
11/10/22,Bulgaria,42.7339,25.4858,1282751,0,37940,1244811
11/11/22,Bulgaria,42.7339,25.4858,1283364,0,37952,1245412
11/12/22,Bulgaria,42.7339,25.4858,1283495,0,37953,1245542
11/13/22,Bulgaria,42.7339,25.4858,1283572,0,37954,1245618
11/14/22,Bulgaria,42.7339,25.4858,1284051,0,37965,1246086
11/15/22,Bulgaria,42.7339,25.4858,1284356,0,37970,1246386
11/16/22,Bulgaria,42.7339,25.4858,1284618,0,37978,1246640
11/17/22,Bulgaria,42.7339,25.4858,1284838,0,37988,1246850
11/18/22,Bulgaria,42.7339,25.4858,1285113,0,37996,1247117
11/19/22,Bulgaria,42.7339,25.4858,1285197,0,37997,1247200
11/20/22,Bulgaria,42.7339,25.4858,1285248,0,37997,1247251
11/21/22,Bulgaria,42.7339,25.4858,1285645,0,38010,1247635
11/22/22,Bulgaria,42.7339,25.4858,1285855,0,38015,1247840
11/23/22,Bulgaria,42.7339,25.4858,1286107,0,38020,1248087
11/24/22,Bulgaria,42.7339,25.4858,1286305,0,38022,1248283
11/25/22,Bulgaria,42.7339,25.4858,1286488,0,38027,1248461
11/26/22,Bulgaria,42.7339,25.4858,1286538,0,38027,1248511
11/27/22,Bulgaria,42.7339,25.4858,1286584,0,38027,1248557
11/28/22,Bulgaria,42.7339,25.4858,1286872,0,38033,1248839
11/29/22,Bulgaria,42.7339,25.4858,1287035,0,38039,1248996
11/30/22,Bulgaria,42.7339,25.4858,1287256,0,38039,1249217
12/1/22,Bulgaria,42.7339,25.4858,1287409,0,38044,1249365
12/2/22,Bulgaria,42.7339,25.4858,1287594,0,38048,1249546
12/3/22,Bulgaria,42.7339,25.4858,1287652,0,38049,1249603
12/4/22,Bulgaria,42.7339,25.4858,1287693,0,38050,1249643
12/5/22,Bulgaria,42.7339,25.4858,1287988,0,38053,1249935
12/6/22,Bulgaria,42.7339,25.4858,1288196,0,38053,1250143
12/7/22,Bulgaria,42.7339,25.4858,1288400,0,38054,1250346
12/8/22,Bulgaria,42.7339,25.4858,1288586,0,38056,1250530
12/9/22,Bulgaria,42.7339,25.4858,1288785,0,38060,1250725
12/10/22,Bulgaria,42.7339,25.4858,1288853,0,38061,1250792
12/11/22,Bulgaria,42.7339,25.4858,1288912,0,38062,1250850
12/12/22,Bulgaria,42.7339,25.4858,1289255,0,38067,1251188
12/13/22,Bulgaria,42.7339,25.4858,1289474,0,38072,1251402
12/14/22,Bulgaria,42.7339,25.4858,1289685,0,38076,1251609
12/15/22,Bulgaria,42.7339,25.4858,1289869,0,38077,1251792
12/16/22,Bulgaria,42.7339,25.4858,1289869,0,38077,1251792
12/17/22,Bulgaria,42.7339,25.4858,1290140,0,38081,1252059
1/1/22,Burkina Faso,12.2383,-1.5616,17632,0,318,17314
1/2/22,Burkina Faso,12.2383,-1.5616,17632,0,318,17314
1/3/22,Burkina Faso,12.2383,-1.5616,17632,0,318,17314
1/4/22,Burkina Faso,12.2383,-1.5616,18637,0,333,18304
1/5/22,Burkina Faso,12.2383,-1.5616,18637,0,333,18304
1/6/22,Burkina Faso,12.2383,-1.5616,18637,0,333,18304
1/7/22,Burkina Faso,12.2383,-1.5616,18878,0,333,18545
1/8/22,Burkina Faso,12.2383,-1.5616,19360,0,333,19027
1/9/22,Burkina Faso,12.2383,-1.5616,19636,0,333,19303
1/10/22,Burkina Faso,12.2383,-1.5616,19636,0,333,19303
1/11/22,Burkina Faso,12.2383,-1.5616,19636,0,333,19303
1/12/22,Burkina Faso,12.2383,-1.5616,19886,0,339,19547
1/13/22,Burkina Faso,12.2383,-1.5616,19972,0,339,19633
1/14/22,Burkina Faso,12.2383,-1.5616,19972,0,339,19633
1/15/22,Burkina Faso,12.2383,-1.5616,20127,0,339,19788
1/16/22,Burkina Faso,12.2383,-1.5616,20195,0,339,19856
1/17/22,Burkina Faso,12.2383,-1.5616,20249,0,339,19910
1/18/22,Burkina Faso,12.2383,-1.5616,20290,0,353,19937
1/19/22,Burkina Faso,12.2383,-1.5616,20414,0,353,20061
1/20/22,Burkina Faso,12.2383,-1.5616,20435,0,353,20082
1/21/22,Burkina Faso,12.2383,-1.5616,20435,0,353,20082
1/22/22,Burkina Faso,12.2383,-1.5616,20514,0,353,20161
1/23/22,Burkina Faso,12.2383,-1.5616,20514,0,353,20161
1/24/22,Burkina Faso,12.2383,-1.5616,20514,0,353,20161
1/25/22,Burkina Faso,12.2383,-1.5616,20514,0,353,20161
1/26/22,Burkina Faso,12.2383,-1.5616,20591,0,366,20225
1/27/22,Burkina Faso,12.2383,-1.5616,20591,0,366,20225
1/28/22,Burkina Faso,12.2383,-1.5616,20611,0,366,20245
1/29/22,Burkina Faso,12.2383,-1.5616,20611,0,366,20245
1/30/22,Burkina Faso,12.2383,-1.5616,20611,0,366,20245
1/31/22,Burkina Faso,12.2383,-1.5616,20624,0,366,20258
2/1/22,Burkina Faso,12.2383,-1.5616,20649,0,371,20278
2/2/22,Burkina Faso,12.2383,-1.5616,20649,0,371,20278
2/3/22,Burkina Faso,12.2383,-1.5616,20664,0,372,20292
2/4/22,Burkina Faso,12.2383,-1.5616,20673,0,372,20301
2/5/22,Burkina Faso,12.2383,-1.5616,20679,0,372,20307
2/6/22,Burkina Faso,12.2383,-1.5616,20679,0,372,20307
2/7/22,Burkina Faso,12.2383,-1.5616,20683,0,372,20311
2/8/22,Burkina Faso,12.2383,-1.5616,20685,0,375,20310
2/9/22,Burkina Faso,12.2383,-1.5616,20693,0,375,20318
2/10/22,Burkina Faso,12.2383,-1.5616,20696,0,375,20321
2/11/22,Burkina Faso,12.2383,-1.5616,20699,0,375,20324
2/12/22,Burkina Faso,12.2383,-1.5616,20705,0,375,20330
2/13/22,Burkina Faso,12.2383,-1.5616,20716,0,375,20341
2/14/22,Burkina Faso,12.2383,-1.5616,20721,0,375,20346
2/15/22,Burkina Faso,12.2383,-1.5616,20725,0,375,20350
2/16/22,Burkina Faso,12.2383,-1.5616,20729,0,375,20354
2/17/22,Burkina Faso,12.2383,-1.5616,20743,0,375,20368
2/18/22,Burkina Faso,12.2383,-1.5616,20744,0,375,20369
2/19/22,Burkina Faso,12.2383,-1.5616,20745,0,375,20370
2/20/22,Burkina Faso,12.2383,-1.5616,20751,0,375,20376
2/21/22,Burkina Faso,12.2383,-1.5616,20751,0,375,20376
2/22/22,Burkina Faso,12.2383,-1.5616,20751,0,375,20376
2/23/22,Burkina Faso,12.2383,-1.5616,20751,0,375,20376
2/24/22,Burkina Faso,12.2383,-1.5616,20751,0,375,20376
2/25/22,Burkina Faso,12.2383,-1.5616,20751,0,375,20376
2/26/22,Burkina Faso,12.2383,-1.5616,20751,0,375,20376
2/27/22,Burkina Faso,12.2383,-1.5616,20751,0,375,20376
2/28/22,Burkina Faso,12.2383,-1.5616,20751,0,375,20376
3/1/22,Burkina Faso,12.2383,-1.5616,20751,0,375,20376
3/2/22,Burkina Faso,12.2383,-1.5616,20751,0,375,20376
3/3/22,Burkina Faso,12.2383,-1.5616,20751,0,375,20376
3/4/22,Burkina Faso,12.2383,-1.5616,20751,0,375,20376
3/5/22,Burkina Faso,12.2383,-1.5616,20751,0,375,20376
3/6/22,Burkina Faso,12.2383,-1.5616,20751,0,375,20376
3/7/22,Burkina Faso,12.2383,-1.5616,20751,0,375,20376
3/8/22,Burkina Faso,12.2383,-1.5616,20751,0,375,20376
3/9/22,Burkina Faso,12.2383,-1.5616,20751,0,375,20376
3/10/22,Burkina Faso,12.2383,-1.5616,20751,0,375,20376
3/11/22,Burkina Faso,12.2383,-1.5616,20751,0,375,20376
3/12/22,Burkina Faso,12.2383,-1.5616,20751,0,375,20376
3/13/22,Burkina Faso,12.2383,-1.5616,20751,0,375,20376
3/14/22,Burkina Faso,12.2383,-1.5616,20751,0,375,20376
3/15/22,Burkina Faso,12.2383,-1.5616,20751,0,375,20376
3/16/22,Burkina Faso,12.2383,-1.5616,20751,0,375,20376
3/17/22,Burkina Faso,12.2383,-1.5616,20806,0,379,20427
3/18/22,Burkina Faso,12.2383,-1.5616,20813,0,379,20434
3/19/22,Burkina Faso,12.2383,-1.5616,20813,0,379,20434
3/20/22,Burkina Faso,12.2383,-1.5616,20813,0,379,20434
3/21/22,Burkina Faso,12.2383,-1.5616,20813,0,379,20434
3/22/22,Burkina Faso,12.2383,-1.5616,20813,0,379,20434
3/23/22,Burkina Faso,12.2383,-1.5616,20813,0,379,20434
3/24/22,Burkina Faso,12.2383,-1.5616,20813,0,379,20434
3/25/22,Burkina Faso,12.2383,-1.5616,20822,0,381,20441
3/26/22,Burkina Faso,12.2383,-1.5616,20822,0,381,20441
3/27/22,Burkina Faso,12.2383,-1.5616,20853,0,382,20471
3/28/22,Burkina Faso,12.2383,-1.5616,20853,0,382,20471
3/29/22,Burkina Faso,12.2383,-1.5616,20853,0,382,20471
3/30/22,Burkina Faso,12.2383,-1.5616,20853,0,382,20471
3/31/22,Burkina Faso,12.2383,-1.5616,20853,0,382,20471
4/1/22,Burkina Faso,12.2383,-1.5616,20858,0,382,20476
4/2/22,Burkina Faso,12.2383,-1.5616,20858,0,382,20476
4/3/22,Burkina Faso,12.2383,-1.5616,20858,0,382,20476
4/4/22,Burkina Faso,12.2383,-1.5616,20858,0,382,20476
4/5/22,Burkina Faso,12.2383,-1.5616,20858,0,382,20476
4/6/22,Burkina Faso,12.2383,-1.5616,20858,0,382,20476
4/7/22,Burkina Faso,12.2383,-1.5616,20858,0,382,20476
4/8/22,Burkina Faso,12.2383,-1.5616,20858,0,382,20476
4/9/22,Burkina Faso,12.2383,-1.5616,20858,0,382,20476
4/10/22,Burkina Faso,12.2383,-1.5616,20858,0,382,20476
4/11/22,Burkina Faso,12.2383,-1.5616,20865,0,383,20482
4/12/22,Burkina Faso,12.2383,-1.5616,20865,0,383,20482
4/13/22,Burkina Faso,12.2383,-1.5616,20865,0,383,20482
4/14/22,Burkina Faso,12.2383,-1.5616,20865,0,383,20482
4/15/22,Burkina Faso,12.2383,-1.5616,20865,0,383,20482
4/16/22,Burkina Faso,12.2383,-1.5616,20865,0,383,20482
4/17/22,Burkina Faso,12.2383,-1.5616,20865,0,383,20482
4/18/22,Burkina Faso,12.2383,-1.5616,20865,0,383,20482
4/19/22,Burkina Faso,12.2383,-1.5616,20865,0,383,20482
4/20/22,Burkina Faso,12.2383,-1.5616,20865,0,383,20482
4/21/22,Burkina Faso,12.2383,-1.5616,20865,0,383,20482
4/22/22,Burkina Faso,12.2383,-1.5616,20865,0,383,20482
4/23/22,Burkina Faso,12.2383,-1.5616,20865,0,383,20482
4/24/22,Burkina Faso,12.2383,-1.5616,20865,0,383,20482
4/25/22,Burkina Faso,12.2383,-1.5616,20865,0,383,20482
4/26/22,Burkina Faso,12.2383,-1.5616,20865,0,383,20482
4/27/22,Burkina Faso,12.2383,-1.5616,20865,0,383,20482
4/28/22,Burkina Faso,12.2383,-1.5616,20865,0,383,20482
4/29/22,Burkina Faso,12.2383,-1.5616,20865,0,383,20482
4/30/22,Burkina Faso,12.2383,-1.5616,20865,0,383,20482
5/1/22,Burkina Faso,12.2383,-1.5616,20865,0,383,20482
5/2/22,Burkina Faso,12.2383,-1.5616,20865,0,383,20482
5/3/22,Burkina Faso,12.2383,-1.5616,20865,0,383,20482
5/4/22,Burkina Faso,12.2383,-1.5616,20865,0,383,20482
5/5/22,Burkina Faso,12.2383,-1.5616,20865,0,383,20482
5/6/22,Burkina Faso,12.2383,-1.5616,20865,0,383,20482
5/7/22,Burkina Faso,12.2383,-1.5616,20865,0,383,20482
5/8/22,Burkina Faso,12.2383,-1.5616,20865,0,383,20482
5/9/22,Burkina Faso,12.2383,-1.5616,20899,0,384,20515
5/10/22,Burkina Faso,12.2383,-1.5616,20899,0,384,20515
5/11/22,Burkina Faso,12.2383,-1.5616,20899,0,384,20515
5/12/22,Burkina Faso,12.2383,-1.5616,20899,0,384,20515
5/13/22,Burkina Faso,12.2383,-1.5616,20899,0,384,20515
5/14/22,Burkina Faso,12.2383,-1.5616,20899,0,384,20515
5/15/22,Burkina Faso,12.2383,-1.5616,20899,0,384,20515
5/16/22,Burkina Faso,12.2383,-1.5616,20899,0,384,20515
5/17/22,Burkina Faso,12.2383,-1.5616,20899,0,384,20515
5/18/22,Burkina Faso,12.2383,-1.5616,20899,0,384,20515
5/19/22,Burkina Faso,12.2383,-1.5616,20899,0,384,20515
5/20/22,Burkina Faso,12.2383,-1.5616,20899,0,384,20515
5/21/22,Burkina Faso,12.2383,-1.5616,20899,0,384,20515
5/22/22,Burkina Faso,12.2383,-1.5616,20899,0,384,20515
5/23/22,Burkina Faso,12.2383,-1.5616,20899,0,384,20515
5/24/22,Burkina Faso,12.2383,-1.5616,20899,0,384,20515
5/25/22,Burkina Faso,12.2383,-1.5616,20899,0,384,20515
5/26/22,Burkina Faso,12.2383,-1.5616,20899,0,384,20515
5/27/22,Burkina Faso,12.2383,-1.5616,20899,0,384,20515
5/28/22,Burkina Faso,12.2383,-1.5616,20899,0,384,20515
5/29/22,Burkina Faso,12.2383,-1.5616,20899,0,384,20515
5/30/22,Burkina Faso,12.2383,-1.5616,20899,0,384,20515
5/31/22,Burkina Faso,12.2383,-1.5616,20899,0,384,20515
6/1/22,Burkina Faso,12.2383,-1.5616,20899,0,384,20515
6/2/22,Burkina Faso,12.2383,-1.5616,20899,0,384,20515
6/3/22,Burkina Faso,12.2383,-1.5616,20899,0,384,20515
6/4/22,Burkina Faso,12.2383,-1.5616,20899,0,384,20515
6/5/22,Burkina Faso,12.2383,-1.5616,20899,0,384,20515
6/6/22,Burkina Faso,12.2383,-1.5616,20899,0,384,20515
6/7/22,Burkina Faso,12.2383,-1.5616,20899,0,384,20515
6/8/22,Burkina Faso,12.2383,-1.5616,20899,0,384,20515
6/9/22,Burkina Faso,12.2383,-1.5616,20899,0,384,20515
6/10/22,Burkina Faso,12.2383,-1.5616,20899,0,384,20515
6/11/22,Burkina Faso,12.2383,-1.5616,20899,0,384,20515
6/12/22,Burkina Faso,12.2383,-1.5616,20899,0,384,20515
6/13/22,Burkina Faso,12.2383,-1.5616,20899,0,384,20515
6/14/22,Burkina Faso,12.2383,-1.5616,20899,0,384,20515
6/15/22,Burkina Faso,12.2383,-1.5616,20899,0,384,20515
6/16/22,Burkina Faso,12.2383,-1.5616,21044,0,387,20657
6/17/22,Burkina Faso,12.2383,-1.5616,21044,0,387,20657
6/18/22,Burkina Faso,12.2383,-1.5616,21044,0,387,20657
6/19/22,Burkina Faso,12.2383,-1.5616,21044,0,387,20657
6/20/22,Burkina Faso,12.2383,-1.5616,21044,0,387,20657
6/21/22,Burkina Faso,12.2383,-1.5616,21044,0,387,20657
6/22/22,Burkina Faso,12.2383,-1.5616,21044,0,387,20657
6/23/22,Burkina Faso,12.2383,-1.5616,21044,0,387,20657
6/24/22,Burkina Faso,12.2383,-1.5616,21044,0,387,20657
6/25/22,Burkina Faso,12.2383,-1.5616,21044,0,387,20657
6/26/22,Burkina Faso,12.2383,-1.5616,21044,0,387,20657
6/27/22,Burkina Faso,12.2383,-1.5616,21044,0,387,20657
6/28/22,Burkina Faso,12.2383,-1.5616,21044,0,387,20657
6/29/22,Burkina Faso,12.2383,-1.5616,21044,0,387,20657
6/30/22,Burkina Faso,12.2383,-1.5616,21044,0,387,20657
7/1/22,Burkina Faso,12.2383,-1.5616,21044,0,387,20657
7/2/22,Burkina Faso,12.2383,-1.5616,21044,0,387,20657
7/3/22,Burkina Faso,12.2383,-1.5616,21044,0,387,20657
7/4/22,Burkina Faso,12.2383,-1.5616,21044,0,387,20657
7/5/22,Burkina Faso,12.2383,-1.5616,21044,0,387,20657
7/6/22,Burkina Faso,12.2383,-1.5616,21044,0,387,20657
7/7/22,Burkina Faso,12.2383,-1.5616,21044,0,387,20657
7/8/22,Burkina Faso,12.2383,-1.5616,21044,0,387,20657
7/9/22,Burkina Faso,12.2383,-1.5616,21044,0,387,20657
7/10/22,Burkina Faso,12.2383,-1.5616,21044,0,387,20657
7/11/22,Burkina Faso,12.2383,-1.5616,21044,0,387,20657
7/12/22,Burkina Faso,12.2383,-1.5616,21044,0,387,20657
7/13/22,Burkina Faso,12.2383,-1.5616,21044,0,387,20657
7/14/22,Burkina Faso,12.2383,-1.5616,21044,0,387,20657
7/15/22,Burkina Faso,12.2383,-1.5616,21128,0,387,20741
7/16/22,Burkina Faso,12.2383,-1.5616,21128,0,387,20741
7/17/22,Burkina Faso,12.2383,-1.5616,21128,0,387,20741
7/18/22,Burkina Faso,12.2383,-1.5616,21128,0,387,20741
7/19/22,Burkina Faso,12.2383,-1.5616,21128,0,387,20741
7/20/22,Burkina Faso,12.2383,-1.5616,21128,0,387,20741
7/21/22,Burkina Faso,12.2383,-1.5616,21128,0,387,20741
7/22/22,Burkina Faso,12.2383,-1.5616,21128,0,387,20741
7/23/22,Burkina Faso,12.2383,-1.5616,21128,0,387,20741
7/24/22,Burkina Faso,12.2383,-1.5616,21128,0,387,20741
7/25/22,Burkina Faso,12.2383,-1.5616,21128,0,387,20741
7/26/22,Burkina Faso,12.2383,-1.5616,21128,0,387,20741
7/27/22,Burkina Faso,12.2383,-1.5616,21128,0,387,20741
7/28/22,Burkina Faso,12.2383,-1.5616,21128,0,387,20741
7/29/22,Burkina Faso,12.2383,-1.5616,21128,0,387,20741
7/30/22,Burkina Faso,12.2383,-1.5616,21128,0,387,20741
7/31/22,Burkina Faso,12.2383,-1.5616,21128,0,387,20741
8/1/22,Burkina Faso,12.2383,-1.5616,21128,0,387,20741
8/2/22,Burkina Faso,12.2383,-1.5616,21128,0,387,20741
8/3/22,Burkina Faso,12.2383,-1.5616,21128,0,387,20741
8/4/22,Burkina Faso,12.2383,-1.5616,21128,0,387,20741
8/5/22,Burkina Faso,12.2383,-1.5616,21128,0,387,20741
8/6/22,Burkina Faso,12.2383,-1.5616,21128,0,387,20741
8/7/22,Burkina Faso,12.2383,-1.5616,21128,0,387,20741
8/8/22,Burkina Faso,12.2383,-1.5616,21128,0,387,20741
8/9/22,Burkina Faso,12.2383,-1.5616,21128,0,387,20741
8/10/22,Burkina Faso,12.2383,-1.5616,21128,0,387,20741
8/11/22,Burkina Faso,12.2383,-1.5616,21128,0,387,20741
8/12/22,Burkina Faso,12.2383,-1.5616,21128,0,387,20741
8/13/22,Burkina Faso,12.2383,-1.5616,21128,0,387,20741
8/14/22,Burkina Faso,12.2383,-1.5616,21128,0,387,20741
8/15/22,Burkina Faso,12.2383,-1.5616,21128,0,387,20741
8/16/22,Burkina Faso,12.2383,-1.5616,21128,0,387,20741
8/17/22,Burkina Faso,12.2383,-1.5616,21128,0,387,20741
8/18/22,Burkina Faso,12.2383,-1.5616,21128,0,387,20741
8/19/22,Burkina Faso,12.2383,-1.5616,21128,0,387,20741
8/20/22,Burkina Faso,12.2383,-1.5616,21128,0,387,20741
8/21/22,Burkina Faso,12.2383,-1.5616,21128,0,387,20741
8/22/22,Burkina Faso,12.2383,-1.5616,21128,0,387,20741
8/23/22,Burkina Faso,12.2383,-1.5616,21128,0,387,20741
8/24/22,Burkina Faso,12.2383,-1.5616,21128,0,387,20741
8/25/22,Burkina Faso,12.2383,-1.5616,21128,0,387,20741
8/26/22,Burkina Faso,12.2383,-1.5616,21128,0,387,20741
8/27/22,Burkina Faso,12.2383,-1.5616,21128,0,387,20741
8/28/22,Burkina Faso,12.2383,-1.5616,21128,0,387,20741
8/29/22,Burkina Faso,12.2383,-1.5616,21128,0,387,20741
8/30/22,Burkina Faso,12.2383,-1.5616,21128,0,387,20741
8/31/22,Burkina Faso,12.2383,-1.5616,21128,0,387,20741
9/1/22,Burkina Faso,12.2383,-1.5616,21128,0,387,20741
9/2/22,Burkina Faso,12.2383,-1.5616,21128,0,387,20741
9/3/22,Burkina Faso,12.2383,-1.5616,21128,0,387,20741
9/4/22,Burkina Faso,12.2383,-1.5616,21128,0,387,20741
9/5/22,Burkina Faso,12.2383,-1.5616,21128,0,387,20741
9/6/22,Burkina Faso,12.2383,-1.5616,21128,0,387,20741
9/7/22,Burkina Faso,12.2383,-1.5616,21128,0,387,20741
9/8/22,Burkina Faso,12.2383,-1.5616,21128,0,387,20741
9/9/22,Burkina Faso,12.2383,-1.5616,21128,0,387,20741
9/10/22,Burkina Faso,12.2383,-1.5616,21128,0,387,20741
9/11/22,Burkina Faso,12.2383,-1.5616,21128,0,387,20741
9/12/22,Burkina Faso,12.2383,-1.5616,21128,0,387,20741
9/13/22,Burkina Faso,12.2383,-1.5616,21128,0,387,20741
9/14/22,Burkina Faso,12.2383,-1.5616,21128,0,387,20741
9/15/22,Burkina Faso,12.2383,-1.5616,21128,0,387,20741
9/16/22,Burkina Faso,12.2383,-1.5616,21128,0,387,20741
9/17/22,Burkina Faso,12.2383,-1.5616,21128,0,387,20741
9/18/22,Burkina Faso,12.2383,-1.5616,21128,0,387,20741
9/19/22,Burkina Faso,12.2383,-1.5616,21128,0,387,20741
9/20/22,Burkina Faso,12.2383,-1.5616,21128,0,387,20741
9/21/22,Burkina Faso,12.2383,-1.5616,21128,0,387,20741
9/22/22,Burkina Faso,12.2383,-1.5616,21128,0,387,20741
9/23/22,Burkina Faso,12.2383,-1.5616,21128,0,387,20741
9/24/22,Burkina Faso,12.2383,-1.5616,21128,0,387,20741
9/25/22,Burkina Faso,12.2383,-1.5616,21128,0,387,20741
9/26/22,Burkina Faso,12.2383,-1.5616,21128,0,387,20741
9/27/22,Burkina Faso,12.2383,-1.5616,21631,0,387,21244
9/28/22,Burkina Faso,12.2383,-1.5616,21631,0,387,21244
9/29/22,Burkina Faso,12.2383,-1.5616,21631,0,387,21244
9/30/22,Burkina Faso,12.2383,-1.5616,21631,0,387,21244
10/1/22,Burkina Faso,12.2383,-1.5616,21631,0,387,21244
10/2/22,Burkina Faso,12.2383,-1.5616,21631,0,387,21244
10/3/22,Burkina Faso,12.2383,-1.5616,21631,0,387,21244
10/4/22,Burkina Faso,12.2383,-1.5616,21631,0,387,21244
10/5/22,Burkina Faso,12.2383,-1.5616,21631,0,387,21244
10/6/22,Burkina Faso,12.2383,-1.5616,21631,0,387,21244
10/7/22,Burkina Faso,12.2383,-1.5616,21631,0,387,21244
10/8/22,Burkina Faso,12.2383,-1.5616,21631,0,387,21244
10/9/22,Burkina Faso,12.2383,-1.5616,21631,0,387,21244
10/10/22,Burkina Faso,12.2383,-1.5616,21631,0,387,21244
10/11/22,Burkina Faso,12.2383,-1.5616,21631,0,387,21244
10/12/22,Burkina Faso,12.2383,-1.5616,21631,0,387,21244
10/13/22,Burkina Faso,12.2383,-1.5616,21631,0,387,21244
10/14/22,Burkina Faso,12.2383,-1.5616,21631,0,387,21244
10/15/22,Burkina Faso,12.2383,-1.5616,21631,0,387,21244
10/16/22,Burkina Faso,12.2383,-1.5616,21631,0,387,21244
10/17/22,Burkina Faso,12.2383,-1.5616,21631,0,387,21244
10/18/22,Burkina Faso,12.2383,-1.5616,21631,0,387,21244
10/19/22,Burkina Faso,12.2383,-1.5616,21631,0,387,21244
10/20/22,Burkina Faso,12.2383,-1.5616,21631,0,387,21244
10/21/22,Burkina Faso,12.2383,-1.5616,21631,0,387,21244
10/22/22,Burkina Faso,12.2383,-1.5616,21631,0,387,21244
10/23/22,Burkina Faso,12.2383,-1.5616,21631,0,387,21244
10/24/22,Burkina Faso,12.2383,-1.5616,21631,0,387,21244
10/25/22,Burkina Faso,12.2383,-1.5616,21631,0,387,21244
10/26/22,Burkina Faso,12.2383,-1.5616,21631,0,387,21244
10/27/22,Burkina Faso,12.2383,-1.5616,21631,0,387,21244
10/28/22,Burkina Faso,12.2383,-1.5616,21631,0,387,21244
10/29/22,Burkina Faso,12.2383,-1.5616,21631,0,387,21244
10/30/22,Burkina Faso,12.2383,-1.5616,21631,0,387,21244
10/31/22,Burkina Faso,12.2383,-1.5616,21631,0,387,21244
11/1/22,Burkina Faso,12.2383,-1.5616,21631,0,387,21244
11/2/22,Burkina Faso,12.2383,-1.5616,21631,0,387,21244
11/3/22,Burkina Faso,12.2383,-1.5616,21631,0,387,21244
11/4/22,Burkina Faso,12.2383,-1.5616,21631,0,387,21244
11/5/22,Burkina Faso,12.2383,-1.5616,21631,0,387,21244
11/6/22,Burkina Faso,12.2383,-1.5616,21631,0,387,21244
11/7/22,Burkina Faso,12.2383,-1.5616,21631,0,387,21244
11/8/22,Burkina Faso,12.2383,-1.5616,21631,0,387,21244
11/9/22,Burkina Faso,12.2383,-1.5616,21631,0,387,21244
11/10/22,Burkina Faso,12.2383,-1.5616,21631,0,387,21244
11/11/22,Burkina Faso,12.2383,-1.5616,21631,0,387,21244
11/12/22,Burkina Faso,12.2383,-1.5616,21631,0,387,21244
11/13/22,Burkina Faso,12.2383,-1.5616,21631,0,387,21244
11/14/22,Burkina Faso,12.2383,-1.5616,21631,0,387,21244
11/15/22,Burkina Faso,12.2383,-1.5616,21631,0,387,21244
11/16/22,Burkina Faso,12.2383,-1.5616,21631,0,387,21244
11/17/22,Burkina Faso,12.2383,-1.5616,21631,0,387,21244
11/18/22,Burkina Faso,12.2383,-1.5616,21631,0,387,21244
11/19/22,Burkina Faso,12.2383,-1.5616,21631,0,387,21244
11/20/22,Burkina Faso,12.2383,-1.5616,21631,0,387,21244
11/21/22,Burkina Faso,12.2383,-1.5616,21631,0,387,21244
11/22/22,Burkina Faso,12.2383,-1.5616,21631,0,387,21244
11/23/22,Burkina Faso,12.2383,-1.5616,21631,0,387,21244
11/24/22,Burkina Faso,12.2383,-1.5616,21631,0,387,21244
11/25/22,Burkina Faso,12.2383,-1.5616,21631,0,387,21244
11/26/22,Burkina Faso,12.2383,-1.5616,21631,0,387,21244
11/27/22,Burkina Faso,12.2383,-1.5616,21631,0,387,21244
11/28/22,Burkina Faso,12.2383,-1.5616,21631,0,387,21244
11/29/22,Burkina Faso,12.2383,-1.5616,21631,0,387,21244
11/30/22,Burkina Faso,12.2383,-1.5616,21631,0,387,21244
12/1/22,Burkina Faso,12.2383,-1.5616,21631,0,387,21244
12/2/22,Burkina Faso,12.2383,-1.5616,21631,0,387,21244
12/3/22,Burkina Faso,12.2383,-1.5616,21631,0,387,21244
12/4/22,Burkina Faso,12.2383,-1.5616,21631,0,387,21244
12/5/22,Burkina Faso,12.2383,-1.5616,21631,0,387,21244
12/6/22,Burkina Faso,12.2383,-1.5616,21631,0,387,21244
12/7/22,Burkina Faso,12.2383,-1.5616,21631,0,387,21244
12/8/22,Burkina Faso,12.2383,-1.5616,21631,0,387,21244
12/9/22,Burkina Faso,12.2383,-1.5616,21631,0,387,21244
12/10/22,Burkina Faso,12.2383,-1.5616,21631,0,387,21244
12/11/22,Burkina Faso,12.2383,-1.5616,21631,0,387,21244
12/12/22,Burkina Faso,12.2383,-1.5616,21631,0,387,21244
12/13/22,Burkina Faso,12.2383,-1.5616,21631,0,387,21244
12/14/22,Burkina Faso,12.2383,-1.5616,21631,0,387,21244
12/15/22,Burkina Faso,12.2383,-1.5616,21631,0,387,21244
12/16/22,Burkina Faso,12.2383,-1.5616,21631,0,387,21244
12/17/22,Burkina Faso,12.2383,-1.5616,21631,0,387,21244
1/1/22,Burma,21.9162,95.956,530946,0,19272,511674
1/2/22,Burma,21.9162,95.956,531025,0,19274,511751
1/3/22,Burma,21.9162,95.956,531155,0,19277,511878
1/4/22,Burma,21.9162,95.956,531299,0,19278,512021
1/5/22,Burma,21.9162,95.956,531432,0,19282,512150
1/6/22,Burma,21.9162,95.956,531624,0,19284,512340
1/7/22,Burma,21.9162,95.956,531801,0,19288,512513
1/8/22,Burma,21.9162,95.956,531925,0,19290,512635
1/9/22,Burma,21.9162,95.956,532062,0,19291,512771
1/10/22,Burma,21.9162,95.956,532167,0,19293,512874
1/11/22,Burma,21.9162,95.956,532402,0,19295,513107
1/12/22,Burma,21.9162,95.956,532553,0,19297,513256
1/13/22,Burma,21.9162,95.956,532725,0,19298,513427
1/14/22,Burma,21.9162,95.956,532851,0,19299,513552
1/15/22,Burma,21.9162,95.956,533021,0,19301,513720
1/16/22,Burma,21.9162,95.956,533144,0,19302,513842
1/17/22,Burma,21.9162,95.956,533245,0,19304,513941
1/18/22,Burma,21.9162,95.956,533408,0,19305,514103
1/19/22,Burma,21.9162,95.956,533604,0,19306,514298
1/20/22,Burma,21.9162,95.956,533732,0,19307,514425
1/21/22,Burma,21.9162,95.956,533815,0,19308,514507
1/22/22,Burma,21.9162,95.956,533959,0,19309,514650
1/23/22,Burma,21.9162,95.956,534071,0,19310,514761
1/24/22,Burma,21.9162,95.956,534163,0,19310,514853
1/25/22,Burma,21.9162,95.956,534383,0,19310,515073
1/26/22,Burma,21.9162,95.956,534503,0,19310,515193
1/27/22,Burma,21.9162,95.956,534671,0,19310,515361
1/28/22,Burma,21.9162,95.956,534908,0,19310,515598
1/29/22,Burma,21.9162,95.956,535080,0,19310,515770
1/30/22,Burma,21.9162,95.956,535254,0,19310,515944
1/31/22,Burma,21.9162,95.956,535532,0,19310,516222
2/1/22,Burma,21.9162,95.956,536393,0,19310,517083
2/2/22,Burma,21.9162,95.956,536536,0,19310,517226
2/3/22,Burma,21.9162,95.956,536904,0,19310,517594
2/4/22,Burma,21.9162,95.956,537223,0,19310,517913
2/5/22,Burma,21.9162,95.956,537569,0,19310,518259
2/6/22,Burma,21.9162,95.956,537901,0,19310,518591
2/7/22,Burma,21.9162,95.956,538409,0,19310,519099
2/8/22,Burma,21.9162,95.956,539554,0,19310,520244
2/9/22,Burma,21.9162,95.956,540597,0,19310,521287
2/10/22,Burma,21.9162,95.956,541904,0,19310,522594
2/11/22,Burma,21.9162,95.956,543511,0,19310,524201
2/12/22,Burma,21.9162,95.956,545298,0,19310,525988
2/13/22,Burma,21.9162,95.956,546771,0,19310,527461
2/14/22,Burma,21.9162,95.956,548357,0,19311,529046
2/15/22,Burma,21.9162,95.956,550824,0,19314,531510
2/16/22,Burma,21.9162,95.956,553564,0,19318,534246
2/17/22,Burma,21.9162,95.956,556256,0,19319,536937
2/18/22,Burma,21.9162,95.956,559314,0,19322,539992
2/19/22,Burma,21.9162,95.956,562364,0,19327,543037
2/20/22,Burma,21.9162,95.956,565667,0,19331,546336
2/21/22,Burma,21.9162,95.956,568564,0,19338,549226
2/22/22,Burma,21.9162,95.956,572127,0,19344,552783
2/23/22,Burma,21.9162,95.956,575508,0,19349,556159
2/24/22,Burma,21.9162,95.956,578446,0,19353,559093
2/25/22,Burma,21.9162,95.956,581837,0,19356,562481
2/26/22,Burma,21.9162,95.956,584239,0,19360,564879
2/27/22,Burma,21.9162,95.956,586198,0,19365,566833
2/28/22,Burma,21.9162,95.956,587891,0,19368,568523
3/1/22,Burma,21.9162,95.956,590237,0,19372,570865
3/2/22,Burma,21.9162,95.956,592139,0,19375,572764
3/3/22,Burma,21.9162,95.956,593958,0,19379,574579
3/4/22,Burma,21.9162,95.956,595821,0,19383,576438
3/5/22,Burma,21.9162,95.956,597417,0,19386,578031
3/6/22,Burma,21.9162,95.956,598446,0,19389,579057
3/7/22,Burma,21.9162,95.956,599619,0,19391,580228
3/8/22,Burma,21.9162,95.956,601020,0,19394,581626
3/9/22,Burma,21.9162,95.956,602321,0,19398,582923
3/10/22,Burma,21.9162,95.956,603263,0,19401,583862
3/11/22,Burma,21.9162,95.956,604219,0,19403,584816
3/12/22,Burma,21.9162,95.956,604860,0,19406,585454
3/13/22,Burma,21.9162,95.956,605347,0,19409,585938
3/14/22,Burma,21.9162,95.956,606227,0,19411,586816
3/15/22,Burma,21.9162,95.956,606910,0,19414,587496
3/16/22,Burma,21.9162,95.956,607399,0,19417,587982
3/17/22,Burma,21.9162,95.956,607844,0,19418,588426
3/18/22,Burma,21.9162,95.956,608384,0,19420,588964
3/19/22,Burma,21.9162,95.956,608763,0,19423,589340
3/20/22,Burma,21.9162,95.956,608990,0,19425,589565
3/21/22,Burma,21.9162,95.956,609288,0,19425,589863
3/22/22,Burma,21.9162,95.956,609648,0,19427,590221
3/23/22,Burma,21.9162,95.956,609915,0,19428,590487
3/24/22,Burma,21.9162,95.956,610176,0,19428,590748
3/25/22,Burma,21.9162,95.956,610493,0,19428,591065
3/26/22,Burma,21.9162,95.956,610728,0,19429,591299
3/27/22,Burma,21.9162,95.956,610858,0,19430,591428
3/28/22,Burma,21.9162,95.956,611021,0,19430,591591
3/29/22,Burma,21.9162,95.956,611275,0,19430,591845
3/30/22,Burma,21.9162,95.956,611448,0,19430,592018
3/31/22,Burma,21.9162,95.956,611587,0,19430,592157
4/1/22,Burma,21.9162,95.956,611674,0,19431,592243
4/2/22,Burma,21.9162,95.956,611809,0,19432,592377
4/3/22,Burma,21.9162,95.956,611875,0,19433,592442
4/4/22,Burma,21.9162,95.956,611926,0,19433,592493
4/5/22,Burma,21.9162,95.956,611984,0,19433,592551
4/6/22,Burma,21.9162,95.956,612079,0,19434,592645
4/7/22,Burma,21.9162,95.956,612132,0,19434,592698
4/8/22,Burma,21.9162,95.956,612224,0,19434,592790
4/9/22,Burma,21.9162,95.956,612278,0,19434,592844
4/10/22,Burma,21.9162,95.956,612341,0,19434,592907
4/11/22,Burma,21.9162,95.956,612383,0,19434,592949
4/12/22,Burma,21.9162,95.956,612406,0,19434,592972
4/13/22,Burma,21.9162,95.956,612460,0,19434,593026
4/14/22,Burma,21.9162,95.956,612480,0,19434,593046
4/15/22,Burma,21.9162,95.956,612527,0,19434,593093
4/16/22,Burma,21.9162,95.956,612545,0,19434,593111
4/17/22,Burma,21.9162,95.956,612565,0,19434,593131
4/18/22,Burma,21.9162,95.956,612602,0,19434,593168
4/19/22,Burma,21.9162,95.956,612658,0,19434,593224
4/20/22,Burma,21.9162,95.956,612677,0,19434,593243
4/21/22,Burma,21.9162,95.956,612697,0,19434,593263
4/22/22,Burma,21.9162,95.956,612714,0,19434,593280
4/23/22,Burma,21.9162,95.956,612733,0,19434,593299
4/24/22,Burma,21.9162,95.956,612749,0,19434,593315
4/25/22,Burma,21.9162,95.956,612770,0,19434,593336
4/26/22,Burma,21.9162,95.956,612785,0,19434,593351
4/27/22,Burma,21.9162,95.956,612802,0,19434,593368
4/28/22,Burma,21.9162,95.956,612843,0,19434,593409
4/29/22,Burma,21.9162,95.956,612864,0,19434,593430
4/30/22,Burma,21.9162,95.956,612883,0,19434,593449
5/1/22,Burma,21.9162,95.956,612900,0,19434,593466
5/2/22,Burma,21.9162,95.956,612914,0,19434,593480
5/3/22,Burma,21.9162,95.956,612924,0,19434,593490
5/4/22,Burma,21.9162,95.956,612951,0,19434,593517
5/5/22,Burma,21.9162,95.956,612965,0,19434,593531
5/6/22,Burma,21.9162,95.956,613017,0,19434,593583
5/7/22,Burma,21.9162,95.956,613049,0,19434,593615
5/8/22,Burma,21.9162,95.956,613053,0,19434,593619
5/9/22,Burma,21.9162,95.956,613056,0,19434,593622
5/10/22,Burma,21.9162,95.956,613066,0,19434,593632
5/11/22,Burma,21.9162,95.956,613082,0,19434,593648
5/12/22,Burma,21.9162,95.956,613088,0,19434,593654
5/13/22,Burma,21.9162,95.956,613116,0,19434,593682
5/14/22,Burma,21.9162,95.956,613136,0,19434,593702
5/15/22,Burma,21.9162,95.956,613140,0,19434,593706
5/16/22,Burma,21.9162,95.956,613144,0,19434,593710
5/17/22,Burma,21.9162,95.956,613168,0,19434,593734
5/18/22,Burma,21.9162,95.956,613182,0,19434,593748
5/19/22,Burma,21.9162,95.956,613186,0,19434,593752
5/20/22,Burma,21.9162,95.956,613203,0,19434,593769
5/21/22,Burma,21.9162,95.956,613219,0,19434,593785
5/22/22,Burma,21.9162,95.956,613222,0,19434,593788
5/23/22,Burma,21.9162,95.956,613227,0,19434,593793
5/24/22,Burma,21.9162,95.956,613238,0,19434,593804
5/25/22,Burma,21.9162,95.956,613256,0,19434,593822
5/26/22,Burma,21.9162,95.956,613260,0,19434,593826
5/27/22,Burma,21.9162,95.956,613280,0,19434,593846
5/28/22,Burma,21.9162,95.956,613298,0,19434,593864
5/29/22,Burma,21.9162,95.956,613315,0,19434,593881
5/30/22,Burma,21.9162,95.956,613326,0,19434,593892
5/31/22,Burma,21.9162,95.956,613336,0,19434,593902
6/1/22,Burma,21.9162,95.956,613348,0,19434,593914
6/2/22,Burma,21.9162,95.956,613355,0,19434,593921
6/3/22,Burma,21.9162,95.956,613370,0,19434,593936
6/4/22,Burma,21.9162,95.956,613381,0,19434,593947
6/5/22,Burma,21.9162,95.956,613382,0,19434,593948
6/6/22,Burma,21.9162,95.956,613387,0,19434,593953
6/7/22,Burma,21.9162,95.956,613397,0,19434,593963
6/8/22,Burma,21.9162,95.956,613405,0,19434,593971
6/9/22,Burma,21.9162,95.956,613415,0,19434,593981
6/10/22,Burma,21.9162,95.956,613427,0,19434,593993
6/11/22,Burma,21.9162,95.956,613440,0,19434,594006
6/12/22,Burma,21.9162,95.956,613443,0,19434,594009
6/13/22,Burma,21.9162,95.956,613452,0,19434,594018
6/14/22,Burma,21.9162,95.956,613460,0,19434,594026
6/15/22,Burma,21.9162,95.956,613464,0,19434,594030
6/16/22,Burma,21.9162,95.956,613467,0,19434,594033
6/17/22,Burma,21.9162,95.956,613474,0,19434,594040
6/18/22,Burma,21.9162,95.956,613485,0,19434,594051
6/19/22,Burma,21.9162,95.956,613490,0,19434,594056
6/20/22,Burma,21.9162,95.956,613494,0,19434,594060
6/21/22,Burma,21.9162,95.956,613508,0,19434,594074
6/22/22,Burma,21.9162,95.956,613521,0,19434,594087
6/23/22,Burma,21.9162,95.956,613532,0,19434,594098
6/24/22,Burma,21.9162,95.956,613538,0,19434,594104
6/25/22,Burma,21.9162,95.956,613553,0,19434,594119
6/26/22,Burma,21.9162,95.956,613556,0,19434,594122
6/27/22,Burma,21.9162,95.956,613568,0,19434,594134
6/28/22,Burma,21.9162,95.956,613577,0,19434,594143
6/29/22,Burma,21.9162,95.956,613583,0,19434,594149
6/30/22,Burma,21.9162,95.956,613596,0,19434,594162
7/1/22,Burma,21.9162,95.956,613628,0,19434,594194
7/2/22,Burma,21.9162,95.956,613642,0,19434,594208
7/3/22,Burma,21.9162,95.956,613648,0,19434,594214
7/4/22,Burma,21.9162,95.956,613659,0,19434,594225
7/5/22,Burma,21.9162,95.956,613672,0,19434,594238
7/6/22,Burma,21.9162,95.956,613683,0,19434,594249
7/7/22,Burma,21.9162,95.956,613695,0,19434,594261
7/8/22,Burma,21.9162,95.956,613711,0,19434,594277
7/9/22,Burma,21.9162,95.956,613727,0,19434,594293
7/10/22,Burma,21.9162,95.956,613736,0,19434,594302
7/11/22,Burma,21.9162,95.956,613751,0,19434,594317
7/12/22,Burma,21.9162,95.956,613760,0,19434,594326
7/13/22,Burma,21.9162,95.956,613773,0,19434,594339
7/14/22,Burma,21.9162,95.956,613784,0,19434,594350
7/15/22,Burma,21.9162,95.956,613798,0,19434,594364
7/16/22,Burma,21.9162,95.956,613809,0,19434,594375
7/17/22,Burma,21.9162,95.956,613816,0,19434,594382
7/18/22,Burma,21.9162,95.956,613838,0,19434,594404
7/19/22,Burma,21.9162,95.956,613855,0,19434,594421
7/20/22,Burma,21.9162,95.956,613871,0,19434,594437
7/21/22,Burma,21.9162,95.956,613887,0,19434,594453
7/22/22,Burma,21.9162,95.956,613897,0,19434,594463
7/23/22,Burma,21.9162,95.956,613940,0,19434,594506
7/24/22,Burma,21.9162,95.956,613951,0,19434,594517
7/25/22,Burma,21.9162,95.956,613966,0,19434,594532
7/26/22,Burma,21.9162,95.956,613980,0,19434,594546
7/27/22,Burma,21.9162,95.956,613991,0,19434,594557
7/28/22,Burma,21.9162,95.956,614009,0,19434,594575
7/29/22,Burma,21.9162,95.956,614043,0,19434,594609
7/30/22,Burma,21.9162,95.956,614083,0,19434,594649
7/31/22,Burma,21.9162,95.956,614092,0,19434,594658
8/1/22,Burma,21.9162,95.956,614113,0,19434,594679
8/2/22,Burma,21.9162,95.956,614128,0,19434,594694
8/3/22,Burma,21.9162,95.956,614146,0,19434,594712
8/4/22,Burma,21.9162,95.956,614158,0,19434,594724
8/5/22,Burma,21.9162,95.956,614170,0,19434,594736
8/6/22,Burma,21.9162,95.956,614190,0,19434,594756
8/7/22,Burma,21.9162,95.956,614198,0,19434,594764
8/8/22,Burma,21.9162,95.956,614213,0,19434,594779
8/9/22,Burma,21.9162,95.956,614240,0,19434,594806
8/10/22,Burma,21.9162,95.956,614276,0,19434,594842
8/11/22,Burma,21.9162,95.956,614297,0,19434,594863
8/12/22,Burma,21.9162,95.956,614297,0,19434,594863
8/13/22,Burma,21.9162,95.956,614360,0,19435,594925
8/14/22,Burma,21.9162,95.956,614389,0,19435,594954
8/15/22,Burma,21.9162,95.956,614407,0,19435,594972
8/16/22,Burma,21.9162,95.956,614456,0,19435,595021
8/17/22,Burma,21.9162,95.956,614510,0,19437,595073
8/18/22,Burma,21.9162,95.956,614541,0,19437,595104
8/19/22,Burma,21.9162,95.956,614573,0,19437,595136
8/20/22,Burma,21.9162,95.956,614573,0,19437,595136
8/21/22,Burma,21.9162,95.956,614573,0,19437,595136
8/22/22,Burma,21.9162,95.956,614573,0,19437,595136
8/23/22,Burma,21.9162,95.956,614573,0,19437,595136
8/24/22,Burma,21.9162,95.956,614573,0,19437,595136
8/25/22,Burma,21.9162,95.956,614573,0,19437,595136
8/26/22,Burma,21.9162,95.956,614573,0,19437,595136
8/27/22,Burma,21.9162,95.956,614573,0,19437,595136
8/28/22,Burma,21.9162,95.956,614962,0,19437,595525
8/29/22,Burma,21.9162,95.956,615030,0,19437,595593
8/30/22,Burma,21.9162,95.956,615117,0,19437,595680
8/31/22,Burma,21.9162,95.956,615221,0,19438,595783
9/1/22,Burma,21.9162,95.956,615315,0,19439,595876
9/2/22,Burma,21.9162,95.956,615399,0,19439,595960
9/3/22,Burma,21.9162,95.956,615489,0,19439,596050
9/4/22,Burma,21.9162,95.956,615559,0,19440,596119
9/5/22,Burma,21.9162,95.956,615654,0,19441,596213
9/6/22,Burma,21.9162,95.956,615800,0,19442,596358
9/7/22,Burma,21.9162,95.956,616023,0,19442,596581
9/8/22,Burma,21.9162,95.956,616210,0,19442,596768
9/9/22,Burma,21.9162,95.956,616401,0,19442,596959
9/10/22,Burma,21.9162,95.956,616663,0,19442,597221
9/11/22,Burma,21.9162,95.956,616852,0,19442,597410
9/12/22,Burma,21.9162,95.956,617056,0,19442,597614
9/13/22,Burma,21.9162,95.956,617355,0,19443,597912
9/14/22,Burma,21.9162,95.956,617739,0,19444,598295
9/15/22,Burma,21.9162,95.956,617998,0,19444,598554
9/16/22,Burma,21.9162,95.956,618303,0,19444,598859
9/17/22,Burma,21.9162,95.956,618664,0,19444,599220
9/18/22,Burma,21.9162,95.956,618898,0,19446,599452
9/19/22,Burma,21.9162,95.956,619167,0,19448,599719
9/20/22,Burma,21.9162,95.956,619566,0,19450,600116
9/21/22,Burma,21.9162,95.956,620035,0,19451,600584
9/22/22,Burma,21.9162,95.956,620444,0,19452,600992
9/23/22,Burma,21.9162,95.956,620744,0,19453,601291
9/24/22,Burma,21.9162,95.956,621124,0,19455,601669
9/25/22,Burma,21.9162,95.956,621402,0,19455,601947
9/26/22,Burma,21.9162,95.956,621686,0,19455,602231
9/27/22,Burma,21.9162,95.956,622042,0,19455,602587
9/28/22,Burma,21.9162,95.956,622423,0,19457,602966
9/29/22,Burma,21.9162,95.956,622802,0,19458,603344
9/30/22,Burma,21.9162,95.956,622802,0,19459,603343
10/1/22,Burma,21.9162,95.956,622802,0,19459,603343
10/2/22,Burma,21.9162,95.956,622802,0,19459,603343
10/3/22,Burma,21.9162,95.956,622802,0,19459,603343
10/4/22,Burma,21.9162,95.956,622802,0,19459,603343
10/5/22,Burma,21.9162,95.956,625147,0,19463,605684
10/6/22,Burma,21.9162,95.956,625497,0,19464,606033
10/7/22,Burma,21.9162,95.956,625873,0,19466,606407
10/8/22,Burma,21.9162,95.956,626262,0,19467,606795
10/9/22,Burma,21.9162,95.956,626458,0,19467,606991
10/10/22,Burma,21.9162,95.956,626690,0,19467,607223
10/11/22,Burma,21.9162,95.956,626982,0,19467,607515
10/12/22,Burma,21.9162,95.956,627328,0,19468,607860
10/13/22,Burma,21.9162,95.956,627638,0,19469,608169
10/14/22,Burma,21.9162,95.956,627997,0,19470,608527
10/15/22,Burma,21.9162,95.956,628322,0,19470,608852
10/16/22,Burma,21.9162,95.956,628577,0,19470,609107
10/17/22,Burma,21.9162,95.956,628861,0,19471,609390
10/18/22,Burma,21.9162,95.956,629376,0,19471,609905
10/19/22,Burma,21.9162,95.956,629653,0,19472,610181
10/20/22,Burma,21.9162,95.956,629926,0,19472,610454
10/21/22,Burma,21.9162,95.956,630183,0,19473,610710
10/22/22,Burma,21.9162,95.956,630445,0,19475,610970
10/23/22,Burma,21.9162,95.956,630603,0,19476,611127
10/24/22,Burma,21.9162,95.956,630742,0,19477,611265
10/25/22,Burma,21.9162,95.956,630902,0,19478,611424
10/26/22,Burma,21.9162,95.956,631059,0,19480,611579
10/27/22,Burma,21.9162,95.956,631235,0,19480,611755
10/28/22,Burma,21.9162,95.956,631367,0,19481,611886
10/29/22,Burma,21.9162,95.956,631534,0,19481,612053
10/30/22,Burma,21.9162,95.956,631625,0,19482,612143
10/31/22,Burma,21.9162,95.956,631716,0,19482,612234
11/1/22,Burma,21.9162,95.956,631797,0,19483,612314
11/2/22,Burma,21.9162,95.956,631929,0,19483,612446
11/3/22,Burma,21.9162,95.956,632014,0,19484,612530
11/4/22,Burma,21.9162,95.956,632139,0,19484,612655
11/5/22,Burma,21.9162,95.956,632229,0,19485,612744
11/6/22,Burma,21.9162,95.956,632274,0,19485,612789
11/7/22,Burma,21.9162,95.956,632318,0,19485,612833
11/8/22,Burma,21.9162,95.956,632391,0,19486,612905
11/9/22,Burma,21.9162,95.956,632461,0,19486,612975
11/10/22,Burma,21.9162,95.956,632522,0,19486,613036
11/11/22,Burma,21.9162,95.956,632587,0,19486,613101
11/12/22,Burma,21.9162,95.956,632635,0,19486,613149
11/13/22,Burma,21.9162,95.956,632679,0,19486,613193
11/14/22,Burma,21.9162,95.956,632711,0,19486,613225
11/15/22,Burma,21.9162,95.956,632805,0,19486,613319
11/16/22,Burma,21.9162,95.956,632865,0,19486,613379
11/17/22,Burma,21.9162,95.956,632910,0,19486,613424
11/18/22,Burma,21.9162,95.956,632957,0,19487,613470
11/19/22,Burma,21.9162,95.956,632987,0,19487,613500
11/20/22,Burma,21.9162,95.956,633005,0,19487,613518
11/21/22,Burma,21.9162,95.956,633045,0,19487,613558
11/22/22,Burma,21.9162,95.956,633075,0,19487,613588
11/23/22,Burma,21.9162,95.956,633096,0,19488,613608
11/24/22,Burma,21.9162,95.956,633118,0,19488,613630
11/25/22,Burma,21.9162,95.956,633137,0,19488,613649
11/26/22,Burma,21.9162,95.956,633157,0,19488,613669
11/27/22,Burma,21.9162,95.956,633167,0,19488,613679
11/28/22,Burma,21.9162,95.956,633196,0,19488,613708
11/29/22,Burma,21.9162,95.956,633217,0,19488,613729
11/30/22,Burma,21.9162,95.956,633245,0,19488,613757
12/1/22,Burma,21.9162,95.956,633261,0,19488,613773
12/2/22,Burma,21.9162,95.956,633281,0,19488,613793
12/3/22,Burma,21.9162,95.956,633296,0,19488,613808
12/4/22,Burma,21.9162,95.956,633318,0,19488,613830
12/5/22,Burma,21.9162,95.956,633324,0,19488,613836
12/6/22,Burma,21.9162,95.956,633341,0,19488,613853
12/7/22,Burma,21.9162,95.956,633369,0,19488,613881
12/8/22,Burma,21.9162,95.956,633381,0,19488,613893
12/9/22,Burma,21.9162,95.956,633400,0,19488,613912
12/10/22,Burma,21.9162,95.956,633418,0,19488,613930
12/11/22,Burma,21.9162,95.956,633457,0,19488,613969
12/12/22,Burma,21.9162,95.956,633462,0,19488,613974
12/13/22,Burma,21.9162,95.956,633475,0,19488,613987
12/14/22,Burma,21.9162,95.956,633508,0,19488,614020
12/15/22,Burma,21.9162,95.956,633521,0,19488,614033
12/16/22,Burma,21.9162,95.956,633543,0,19488,614055
12/17/22,Burma,21.9162,95.956,633551,0,19488,614063
1/1/22,Burundi,-3.3731,29.9189,27366,0,38,27328
1/2/22,Burundi,-3.3731,29.9189,27366,0,38,27328
1/3/22,Burundi,-3.3731,29.9189,27366,0,38,27328
1/4/22,Burundi,-3.3731,29.9189,32076,0,38,32038
1/5/22,Burundi,-3.3731,29.9189,32076,0,38,32038
1/6/22,Burundi,-3.3731,29.9189,33551,0,38,33513
1/7/22,Burundi,-3.3731,29.9189,34722,0,38,34684
1/8/22,Burundi,-3.3731,29.9189,34722,0,38,34684
1/9/22,Burundi,-3.3731,29.9189,34722,0,38,34684
1/10/22,Burundi,-3.3731,29.9189,35500,0,38,35462
1/11/22,Burundi,-3.3731,29.9189,35755,0,38,35717
1/12/22,Burundi,-3.3731,29.9189,35755,0,38,35717
1/13/22,Burundi,-3.3731,29.9189,36115,0,38,36077
1/14/22,Burundi,-3.3731,29.9189,36257,0,38,36219
1/15/22,Burundi,-3.3731,29.9189,36257,0,38,36219
1/16/22,Burundi,-3.3731,29.9189,36257,0,38,36219
1/17/22,Burundi,-3.3731,29.9189,36654,0,38,36616
1/18/22,Burundi,-3.3731,29.9189,36736,0,38,36698
1/19/22,Burundi,-3.3731,29.9189,36785,0,38,36747
1/20/22,Burundi,-3.3731,29.9189,36868,0,38,36830
1/21/22,Burundi,-3.3731,29.9189,36868,0,38,36830
1/22/22,Burundi,-3.3731,29.9189,36868,0,38,36830
1/23/22,Burundi,-3.3731,29.9189,36868,0,38,36830
1/24/22,Burundi,-3.3731,29.9189,37042,0,38,37004
1/25/22,Burundi,-3.3731,29.9189,37138,0,38,37100
1/26/22,Burundi,-3.3731,29.9189,37170,0,38,37132
1/27/22,Burundi,-3.3731,29.9189,37265,0,38,37227
1/28/22,Burundi,-3.3731,29.9189,37299,0,38,37261
1/29/22,Burundi,-3.3731,29.9189,37299,0,38,37261
1/30/22,Burundi,-3.3731,29.9189,37299,0,38,37261
1/31/22,Burundi,-3.3731,29.9189,37432,0,38,37394
2/1/22,Burundi,-3.3731,29.9189,37432,0,38,37394
2/2/22,Burundi,-3.3731,29.9189,37469,0,38,37431
2/3/22,Burundi,-3.3731,29.9189,37562,0,38,37524
2/4/22,Burundi,-3.3731,29.9189,37562,0,38,37524
2/5/22,Burundi,-3.3731,29.9189,37562,0,38,37524
2/6/22,Burundi,-3.3731,29.9189,37562,0,38,37524
2/7/22,Burundi,-3.3731,29.9189,37742,0,38,37704
2/8/22,Burundi,-3.3731,29.9189,37756,0,38,37718
2/9/22,Burundi,-3.3731,29.9189,37756,0,38,37718
2/10/22,Burundi,-3.3731,29.9189,37816,0,38,37778
2/11/22,Burundi,-3.3731,29.9189,37856,0,38,37818
2/12/22,Burundi,-3.3731,29.9189,37856,0,38,37818
2/13/22,Burundi,-3.3731,29.9189,37856,0,38,37818
2/14/22,Burundi,-3.3731,29.9189,37902,0,38,37864
2/15/22,Burundi,-3.3731,29.9189,37923,0,38,37885
2/16/22,Burundi,-3.3731,29.9189,37947,0,38,37909
2/17/22,Burundi,-3.3731,29.9189,37947,0,38,37909
2/18/22,Burundi,-3.3731,29.9189,37947,0,38,37909
2/19/22,Burundi,-3.3731,29.9189,37947,0,38,37909
2/20/22,Burundi,-3.3731,29.9189,37947,0,38,37909
2/21/22,Burundi,-3.3731,29.9189,38011,0,38,37973
2/22/22,Burundi,-3.3731,29.9189,38018,0,38,37980
2/23/22,Burundi,-3.3731,29.9189,38027,0,38,37989
2/24/22,Burundi,-3.3731,29.9189,38047,0,38,38009
2/25/22,Burundi,-3.3731,29.9189,38063,0,38,38025
2/26/22,Burundi,-3.3731,29.9189,38063,0,38,38025
2/27/22,Burundi,-3.3731,29.9189,38063,0,38,38025
2/28/22,Burundi,-3.3731,29.9189,38127,0,38,38089
3/1/22,Burundi,-3.3731,29.9189,38127,0,38,38089
3/2/22,Burundi,-3.3731,29.9189,38127,0,38,38089
3/3/22,Burundi,-3.3731,29.9189,38134,0,38,38096
3/4/22,Burundi,-3.3731,29.9189,38150,0,38,38112
3/5/22,Burundi,-3.3731,29.9189,38150,0,38,38112
3/6/22,Burundi,-3.3731,29.9189,38150,0,38,38112
3/7/22,Burundi,-3.3731,29.9189,38178,0,38,38140
3/8/22,Burundi,-3.3731,29.9189,38178,0,38,38140
3/9/22,Burundi,-3.3731,29.9189,38209,0,38,38171
3/10/22,Burundi,-3.3731,29.9189,38238,0,38,38200
3/11/22,Burundi,-3.3731,29.9189,38248,0,38,38210
3/12/22,Burundi,-3.3731,29.9189,38248,0,38,38210
3/13/22,Burundi,-3.3731,29.9189,38248,0,38,38210
3/14/22,Burundi,-3.3731,29.9189,38274,0,38,38236
3/15/22,Burundi,-3.3731,29.9189,38279,0,38,38241
3/16/22,Burundi,-3.3731,29.9189,38296,0,38,38258
3/17/22,Burundi,-3.3731,29.9189,38296,0,38,38258
3/18/22,Burundi,-3.3731,29.9189,38308,0,38,38270
3/19/22,Burundi,-3.3731,29.9189,38308,0,38,38270
3/20/22,Burundi,-3.3731,29.9189,38308,0,38,38270
3/21/22,Burundi,-3.3731,29.9189,38372,0,38,38334
3/22/22,Burundi,-3.3731,29.9189,38372,0,38,38334
3/23/22,Burundi,-3.3731,29.9189,38406,0,38,38368
3/24/22,Burundi,-3.3731,29.9189,38406,0,38,38368
3/25/22,Burundi,-3.3731,29.9189,38440,0,38,38402
3/26/22,Burundi,-3.3731,29.9189,38440,0,38,38402
3/27/22,Burundi,-3.3731,29.9189,38440,0,38,38402
3/28/22,Burundi,-3.3731,29.9189,38463,0,38,38425
3/29/22,Burundi,-3.3731,29.9189,38482,0,38,38444
3/30/22,Burundi,-3.3731,29.9189,38490,0,38,38452
3/31/22,Burundi,-3.3731,29.9189,38509,0,38,38471
4/1/22,Burundi,-3.3731,29.9189,38519,0,38,38481
4/2/22,Burundi,-3.3731,29.9189,38519,0,38,38481
4/3/22,Burundi,-3.3731,29.9189,38519,0,38,38481
4/4/22,Burundi,-3.3731,29.9189,38588,0,38,38550
4/5/22,Burundi,-3.3731,29.9189,38588,0,38,38550
4/6/22,Burundi,-3.3731,29.9189,38609,0,38,38571
4/7/22,Burundi,-3.3731,29.9189,38609,0,38,38571
4/8/22,Burundi,-3.3731,29.9189,38663,0,38,38625
4/9/22,Burundi,-3.3731,29.9189,38663,0,38,38625
4/10/22,Burundi,-3.3731,29.9189,38663,0,38,38625
4/11/22,Burundi,-3.3731,29.9189,38698,0,38,38660
4/12/22,Burundi,-3.3731,29.9189,38698,0,38,38660
4/13/22,Burundi,-3.3731,29.9189,38722,0,38,38684
4/14/22,Burundi,-3.3731,29.9189,38722,0,38,38684
4/15/22,Burundi,-3.3731,29.9189,38722,0,38,38684
4/16/22,Burundi,-3.3731,29.9189,38722,0,38,38684
4/17/22,Burundi,-3.3731,29.9189,38722,0,38,38684
4/18/22,Burundi,-3.3731,29.9189,38722,0,38,38684
4/19/22,Burundi,-3.3731,29.9189,38812,0,38,38774
4/20/22,Burundi,-3.3731,29.9189,38812,0,38,38774
4/21/22,Burundi,-3.3731,29.9189,38853,0,38,38815
4/22/22,Burundi,-3.3731,29.9189,38887,0,38,38849
4/23/22,Burundi,-3.3731,29.9189,38887,0,38,38849
4/24/22,Burundi,-3.3731,29.9189,38887,0,38,38849
4/25/22,Burundi,-3.3731,29.9189,39632,0,38,39594
4/26/22,Burundi,-3.3731,29.9189,39634,0,38,39596
4/27/22,Burundi,-3.3731,29.9189,39634,0,38,39596
4/28/22,Burundi,-3.3731,29.9189,39794,0,38,39756
4/29/22,Burundi,-3.3731,29.9189,39998,0,38,39960
4/30/22,Burundi,-3.3731,29.9189,39998,0,38,39960
5/1/22,Burundi,-3.3731,29.9189,39998,0,38,39960
5/2/22,Burundi,-3.3731,29.9189,40397,0,38,40359
5/3/22,Burundi,-3.3731,29.9189,40552,0,38,40514
5/4/22,Burundi,-3.3731,29.9189,40675,0,38,40637
5/5/22,Burundi,-3.3731,29.9189,40736,0,38,40698
5/6/22,Burundi,-3.3731,29.9189,40736,0,38,40698
5/7/22,Burundi,-3.3731,29.9189,40736,0,38,40698
5/8/22,Burundi,-3.3731,29.9189,40736,0,38,40698
5/9/22,Burundi,-3.3731,29.9189,40845,0,38,40807
5/10/22,Burundi,-3.3731,29.9189,41216,0,38,41178
5/11/22,Burundi,-3.3731,29.9189,41216,0,38,41178
5/12/22,Burundi,-3.3731,29.9189,41235,0,38,41197
5/13/22,Burundi,-3.3731,29.9189,41235,0,38,41197
5/14/22,Burundi,-3.3731,29.9189,41235,0,38,41197
5/15/22,Burundi,-3.3731,29.9189,41235,0,38,41197
5/16/22,Burundi,-3.3731,29.9189,41530,0,38,41492
5/17/22,Burundi,-3.3731,29.9189,41530,0,38,41492
5/18/22,Burundi,-3.3731,29.9189,41606,0,38,41568
5/19/22,Burundi,-3.3731,29.9189,41606,0,38,41568
5/20/22,Burundi,-3.3731,29.9189,41606,0,38,41568
5/21/22,Burundi,-3.3731,29.9189,41606,0,38,41568
5/22/22,Burundi,-3.3731,29.9189,41606,0,38,41568
5/23/22,Burundi,-3.3731,29.9189,41850,0,38,41812
5/24/22,Burundi,-3.3731,29.9189,41897,0,38,41859
5/25/22,Burundi,-3.3731,29.9189,41927,0,38,41889
5/26/22,Burundi,-3.3731,29.9189,41927,0,38,41889
5/27/22,Burundi,-3.3731,29.9189,41987,0,38,41949
5/28/22,Burundi,-3.3731,29.9189,41987,0,38,41949
5/29/22,Burundi,-3.3731,29.9189,41987,0,38,41949
5/30/22,Burundi,-3.3731,29.9189,42034,0,38,41996
5/31/22,Burundi,-3.3731,29.9189,42034,0,38,41996
6/1/22,Burundi,-3.3731,29.9189,42034,0,38,41996
6/2/22,Burundi,-3.3731,29.9189,42084,0,38,42046
6/3/22,Burundi,-3.3731,29.9189,42129,0,38,42091
6/4/22,Burundi,-3.3731,29.9189,42129,0,38,42091
6/5/22,Burundi,-3.3731,29.9189,42129,0,38,42091
6/6/22,Burundi,-3.3731,29.9189,42248,0,38,42210
6/7/22,Burundi,-3.3731,29.9189,42248,0,38,42210
6/8/22,Burundi,-3.3731,29.9189,42248,0,38,42210
6/9/22,Burundi,-3.3731,29.9189,42248,0,38,42210
6/10/22,Burundi,-3.3731,29.9189,42248,0,38,42210
6/11/22,Burundi,-3.3731,29.9189,42248,0,38,42210
6/12/22,Burundi,-3.3731,29.9189,42248,0,38,42210
6/13/22,Burundi,-3.3731,29.9189,42297,0,38,42259
6/14/22,Burundi,-3.3731,29.9189,42330,0,38,42292
6/15/22,Burundi,-3.3731,29.9189,42330,0,38,42292
6/16/22,Burundi,-3.3731,29.9189,42385,0,38,42347
6/17/22,Burundi,-3.3731,29.9189,42398,0,38,42360
6/18/22,Burundi,-3.3731,29.9189,42398,0,38,42360
6/19/22,Burundi,-3.3731,29.9189,42398,0,38,42360
6/20/22,Burundi,-3.3731,29.9189,42472,0,38,42434
6/21/22,Burundi,-3.3731,29.9189,42472,0,38,42434
6/22/22,Burundi,-3.3731,29.9189,42472,0,38,42434
6/23/22,Burundi,-3.3731,29.9189,42542,0,38,42504
6/24/22,Burundi,-3.3731,29.9189,42542,0,38,42504
6/25/22,Burundi,-3.3731,29.9189,42542,0,38,42504
6/26/22,Burundi,-3.3731,29.9189,42542,0,38,42504
6/27/22,Burundi,-3.3731,29.9189,42542,0,38,42504
6/28/22,Burundi,-3.3731,29.9189,42542,0,38,42504
6/29/22,Burundi,-3.3731,29.9189,42542,0,38,42504
6/30/22,Burundi,-3.3731,29.9189,42658,0,38,42620
7/1/22,Burundi,-3.3731,29.9189,42698,0,38,42660
7/2/22,Burundi,-3.3731,29.9189,42698,0,38,42660
7/3/22,Burundi,-3.3731,29.9189,42698,0,38,42660
7/4/22,Burundi,-3.3731,29.9189,42731,0,38,42693
7/5/22,Burundi,-3.3731,29.9189,42794,0,38,42756
7/6/22,Burundi,-3.3731,29.9189,42836,0,38,42798
7/7/22,Burundi,-3.3731,29.9189,42836,0,38,42798
7/8/22,Burundi,-3.3731,29.9189,42836,0,38,42798
7/9/22,Burundi,-3.3731,29.9189,42836,0,38,42798
7/10/22,Burundi,-3.3731,29.9189,42836,0,38,42798
7/11/22,Burundi,-3.3731,29.9189,42963,0,38,42925
7/12/22,Burundi,-3.3731,29.9189,43060,0,38,43022
7/13/22,Burundi,-3.3731,29.9189,43060,0,38,43022
7/14/22,Burundi,-3.3731,29.9189,43060,0,38,43022
7/15/22,Burundi,-3.3731,29.9189,43222,0,38,43184
7/16/22,Burundi,-3.3731,29.9189,43222,0,38,43184
7/17/22,Burundi,-3.3731,29.9189,43222,0,38,43184
7/18/22,Burundi,-3.3731,29.9189,43414,0,38,43376
7/19/22,Burundi,-3.3731,29.9189,43593,0,38,43555
7/20/22,Burundi,-3.3731,29.9189,43593,0,38,43555
7/21/22,Burundi,-3.3731,29.9189,43850,0,38,43812
7/22/22,Burundi,-3.3731,29.9189,43850,0,38,43812
7/23/22,Burundi,-3.3731,29.9189,43850,0,38,43812
7/24/22,Burundi,-3.3731,29.9189,43850,0,38,43812
7/25/22,Burundi,-3.3731,29.9189,44437,0,38,44399
7/26/22,Burundi,-3.3731,29.9189,44437,0,38,44399
7/27/22,Burundi,-3.3731,29.9189,44437,0,38,44399
7/28/22,Burundi,-3.3731,29.9189,44860,0,38,44822
7/29/22,Burundi,-3.3731,29.9189,45308,0,38,45270
7/30/22,Burundi,-3.3731,29.9189,45308,0,38,45270
7/31/22,Burundi,-3.3731,29.9189,45308,0,38,45270
8/1/22,Burundi,-3.3731,29.9189,45308,0,38,45270
8/2/22,Burundi,-3.3731,29.9189,46151,0,38,46113
8/3/22,Burundi,-3.3731,29.9189,46275,0,38,46237
8/4/22,Burundi,-3.3731,29.9189,46275,0,38,46237
8/5/22,Burundi,-3.3731,29.9189,47008,0,38,46970
8/6/22,Burundi,-3.3731,29.9189,47008,0,38,46970
8/7/22,Burundi,-3.3731,29.9189,47008,0,38,46970
8/8/22,Burundi,-3.3731,29.9189,47247,0,38,47209
8/9/22,Burundi,-3.3731,29.9189,47247,0,38,47209
8/10/22,Burundi,-3.3731,29.9189,47762,0,38,47724
8/11/22,Burundi,-3.3731,29.9189,47762,0,38,47724
8/12/22,Burundi,-3.3731,29.9189,48002,0,38,47964
8/13/22,Burundi,-3.3731,29.9189,48002,0,38,47964
8/14/22,Burundi,-3.3731,29.9189,48002,0,38,47964
8/15/22,Burundi,-3.3731,29.9189,48002,0,38,47964
8/16/22,Burundi,-3.3731,29.9189,48548,0,38,48510
8/17/22,Burundi,-3.3731,29.9189,48548,0,38,48510
8/18/22,Burundi,-3.3731,29.9189,48548,0,38,48510
8/19/22,Burundi,-3.3731,29.9189,48808,0,38,48770
8/20/22,Burundi,-3.3731,29.9189,48808,0,38,48770
8/21/22,Burundi,-3.3731,29.9189,48808,0,38,48770
8/22/22,Burundi,-3.3731,29.9189,48975,0,38,48937
8/23/22,Burundi,-3.3731,29.9189,48975,0,38,48937
8/24/22,Burundi,-3.3731,29.9189,49063,0,38,49025
8/25/22,Burundi,-3.3731,29.9189,49063,0,38,49025
8/26/22,Burundi,-3.3731,29.9189,49063,0,38,49025
8/27/22,Burundi,-3.3731,29.9189,49063,0,38,49025
8/28/22,Burundi,-3.3731,29.9189,49063,0,38,49025
8/29/22,Burundi,-3.3731,29.9189,49212,0,38,49174
8/30/22,Burundi,-3.3731,29.9189,49258,0,38,49220
8/31/22,Burundi,-3.3731,29.9189,49287,0,38,49249
9/1/22,Burundi,-3.3731,29.9189,49287,0,38,49249
9/2/22,Burundi,-3.3731,29.9189,49370,0,38,49332
9/3/22,Burundi,-3.3731,29.9189,49370,0,38,49332
9/4/22,Burundi,-3.3731,29.9189,49370,0,38,49332
9/5/22,Burundi,-3.3731,29.9189,49370,0,38,49332
9/6/22,Burundi,-3.3731,29.9189,49370,0,38,49332
9/7/22,Burundi,-3.3731,29.9189,49370,0,38,49332
9/8/22,Burundi,-3.3731,29.9189,49370,0,38,49332
9/9/22,Burundi,-3.3731,29.9189,49370,0,38,49332
9/10/22,Burundi,-3.3731,29.9189,49370,0,38,49332
9/11/22,Burundi,-3.3731,29.9189,49370,0,38,49332
9/12/22,Burundi,-3.3731,29.9189,49370,0,38,49332
9/13/22,Burundi,-3.3731,29.9189,49370,0,38,49332
9/14/22,Burundi,-3.3731,29.9189,49370,0,38,49332
9/15/22,Burundi,-3.3731,29.9189,49882,0,38,49844
9/16/22,Burundi,-3.3731,29.9189,49882,0,38,49844
9/17/22,Burundi,-3.3731,29.9189,49882,0,38,49844
9/18/22,Burundi,-3.3731,29.9189,49882,0,38,49844
9/19/22,Burundi,-3.3731,29.9189,49957,0,38,49919
9/20/22,Burundi,-3.3731,29.9189,50026,0,38,49988
9/21/22,Burundi,-3.3731,29.9189,50026,0,38,49988
9/22/22,Burundi,-3.3731,29.9189,50040,0,38,50002
9/23/22,Burundi,-3.3731,29.9189,50066,0,38,50028
9/24/22,Burundi,-3.3731,29.9189,50066,0,38,50028
9/25/22,Burundi,-3.3731,29.9189,50066,0,38,50028
9/26/22,Burundi,-3.3731,29.9189,50129,0,38,50091
9/27/22,Burundi,-3.3731,29.9189,50129,0,38,50091
9/28/22,Burundi,-3.3731,29.9189,50129,0,38,50091
9/29/22,Burundi,-3.3731,29.9189,50129,0,38,50091
9/30/22,Burundi,-3.3731,29.9189,50193,0,38,50155
10/1/22,Burundi,-3.3731,29.9189,50193,0,38,50155
10/2/22,Burundi,-3.3731,29.9189,50193,0,38,50155
10/3/22,Burundi,-3.3731,29.9189,50193,0,38,50155
10/4/22,Burundi,-3.3731,29.9189,50193,0,38,50155
10/5/22,Burundi,-3.3731,29.9189,50193,0,38,50155
10/6/22,Burundi,-3.3731,29.9189,50225,0,38,50187
10/7/22,Burundi,-3.3731,29.9189,50225,0,38,50187
10/8/22,Burundi,-3.3731,29.9189,50225,0,38,50187
10/9/22,Burundi,-3.3731,29.9189,50225,0,38,50187
10/10/22,Burundi,-3.3731,29.9189,50225,0,38,50187
10/11/22,Burundi,-3.3731,29.9189,50289,0,38,50251
10/12/22,Burundi,-3.3731,29.9189,50289,0,38,50251
10/13/22,Burundi,-3.3731,29.9189,50289,0,38,50251
10/14/22,Burundi,-3.3731,29.9189,50289,0,38,50251
10/15/22,Burundi,-3.3731,29.9189,50289,0,38,50251
10/16/22,Burundi,-3.3731,29.9189,50289,0,38,50251
10/17/22,Burundi,-3.3731,29.9189,50372,0,38,50334
10/18/22,Burundi,-3.3731,29.9189,50372,0,38,50334
10/19/22,Burundi,-3.3731,29.9189,50372,0,38,50334
10/20/22,Burundi,-3.3731,29.9189,50372,0,38,50334
10/21/22,Burundi,-3.3731,29.9189,50413,0,38,50375
10/22/22,Burundi,-3.3731,29.9189,50413,0,38,50375
10/23/22,Burundi,-3.3731,29.9189,50413,0,38,50375
10/24/22,Burundi,-3.3731,29.9189,50452,0,38,50414
10/25/22,Burundi,-3.3731,29.9189,50452,0,38,50414
10/26/22,Burundi,-3.3731,29.9189,50470,0,38,50432
10/27/22,Burundi,-3.3731,29.9189,50470,0,38,50432
10/28/22,Burundi,-3.3731,29.9189,50470,0,38,50432
10/29/22,Burundi,-3.3731,29.9189,50470,0,38,50432
10/30/22,Burundi,-3.3731,29.9189,50470,0,38,50432
10/31/22,Burundi,-3.3731,29.9189,50470,0,38,50432
11/1/22,Burundi,-3.3731,29.9189,50470,0,38,50432
11/2/22,Burundi,-3.3731,29.9189,50470,0,38,50432
11/3/22,Burundi,-3.3731,29.9189,50470,0,38,50432
11/4/22,Burundi,-3.3731,29.9189,50470,0,38,50432
11/5/22,Burundi,-3.3731,29.9189,50470,0,38,50432
11/6/22,Burundi,-3.3731,29.9189,50470,0,38,50432
11/7/22,Burundi,-3.3731,29.9189,50517,0,38,50479
11/8/22,Burundi,-3.3731,29.9189,50574,0,38,50536
11/9/22,Burundi,-3.3731,29.9189,50574,0,38,50536
11/10/22,Burundi,-3.3731,29.9189,50574,0,38,50536
11/11/22,Burundi,-3.3731,29.9189,50574,0,38,50536
11/12/22,Burundi,-3.3731,29.9189,50574,0,38,50536
11/13/22,Burundi,-3.3731,29.9189,50574,0,38,50536
11/14/22,Burundi,-3.3731,29.9189,50574,0,38,50536
11/15/22,Burundi,-3.3731,29.9189,50574,0,38,50536
11/16/22,Burundi,-3.3731,29.9189,50639,0,38,50601
11/17/22,Burundi,-3.3731,29.9189,50639,0,38,50601
11/18/22,Burundi,-3.3731,29.9189,50639,0,38,50601
11/19/22,Burundi,-3.3731,29.9189,50639,0,38,50601
11/20/22,Burundi,-3.3731,29.9189,50639,0,38,50601
11/21/22,Burundi,-3.3731,29.9189,50639,0,38,50601
11/22/22,Burundi,-3.3731,29.9189,50639,0,38,50601
11/23/22,Burundi,-3.3731,29.9189,50778,0,38,50740
11/24/22,Burundi,-3.3731,29.9189,50778,0,38,50740
11/25/22,Burundi,-3.3731,29.9189,50778,0,38,50740
11/26/22,Burundi,-3.3731,29.9189,50778,0,38,50740
11/27/22,Burundi,-3.3731,29.9189,50778,0,38,50740
11/28/22,Burundi,-3.3731,29.9189,50778,0,38,50740
11/29/22,Burundi,-3.3731,29.9189,50778,0,38,50740
11/30/22,Burundi,-3.3731,29.9189,51018,0,38,50980
12/1/22,Burundi,-3.3731,29.9189,51018,0,38,50980
12/2/22,Burundi,-3.3731,29.9189,51018,0,38,50980
12/3/22,Burundi,-3.3731,29.9189,51018,0,38,50980
12/4/22,Burundi,-3.3731,29.9189,51018,0,38,50980
12/5/22,Burundi,-3.3731,29.9189,51018,0,38,50980
12/6/22,Burundi,-3.3731,29.9189,51018,0,38,50980
12/7/22,Burundi,-3.3731,29.9189,51276,0,38,51238
12/8/22,Burundi,-3.3731,29.9189,51276,0,38,51238
12/9/22,Burundi,-3.3731,29.9189,51276,0,38,51238
12/10/22,Burundi,-3.3731,29.9189,51276,0,38,51238
12/11/22,Burundi,-3.3731,29.9189,51276,0,38,51238
12/12/22,Burundi,-3.3731,29.9189,51276,0,38,51238
12/13/22,Burundi,-3.3731,29.9189,51276,0,38,51238
12/14/22,Burundi,-3.3731,29.9189,51481,0,38,51443
12/15/22,Burundi,-3.3731,29.9189,51481,0,38,51443
12/16/22,Burundi,-3.3731,29.9189,51481,0,38,51443
12/17/22,Burundi,-3.3731,29.9189,51481,0,38,51443
1/1/22,Cabo Verde,16.5388,-23.0418,42463,0,352,42111
1/2/22,Cabo Verde,16.5388,-23.0418,42811,0,352,42459
1/3/22,Cabo Verde,16.5388,-23.0418,43567,0,352,43215
1/4/22,Cabo Verde,16.5388,-23.0418,44592,0,354,44238
1/5/22,Cabo Verde,16.5388,-23.0418,45989,0,356,45633
1/6/22,Cabo Verde,16.5388,-23.0418,47376,0,358,47018
1/7/22,Cabo Verde,16.5388,-23.0418,48845,0,360,48485
1/8/22,Cabo Verde,16.5388,-23.0418,49850,0,360,49490
1/9/22,Cabo Verde,16.5388,-23.0418,50250,0,361,49889
1/10/22,Cabo Verde,16.5388,-23.0418,50959,0,364,50595
1/11/22,Cabo Verde,16.5388,-23.0418,52007,0,366,51641
1/12/22,Cabo Verde,16.5388,-23.0418,52729,0,368,52361
1/13/22,Cabo Verde,16.5388,-23.0418,52729,0,370,52359
1/14/22,Cabo Verde,16.5388,-23.0418,53784,0,370,53414
1/15/22,Cabo Verde,16.5388,-23.0418,53987,0,372,53615
1/16/22,Cabo Verde,16.5388,-23.0418,53987,0,372,53615
1/17/22,Cabo Verde,16.5388,-23.0418,54367,0,376,53991
1/18/22,Cabo Verde,16.5388,-23.0418,54637,0,378,54259
1/19/22,Cabo Verde,16.5388,-23.0418,54891,0,380,54511
1/20/22,Cabo Verde,16.5388,-23.0418,54891,0,382,54509
1/21/22,Cabo Verde,16.5388,-23.0418,55178,0,383,54795
1/22/22,Cabo Verde,16.5388,-23.0418,55256,0,387,54869
1/23/22,Cabo Verde,16.5388,-23.0418,55306,0,389,54917
1/24/22,Cabo Verde,16.5388,-23.0418,55401,0,391,55010
1/25/22,Cabo Verde,16.5388,-23.0418,55471,0,392,55079
1/26/22,Cabo Verde,16.5388,-23.0418,55543,0,393,55150
1/27/22,Cabo Verde,16.5388,-23.0418,55595,0,393,55202
1/28/22,Cabo Verde,16.5388,-23.0418,55635,0,395,55240
1/29/22,Cabo Verde,16.5388,-23.0418,55658,0,395,55263
1/30/22,Cabo Verde,16.5388,-23.0418,55677,0,395,55282
1/31/22,Cabo Verde,16.5388,-23.0418,55695,0,396,55299
2/1/22,Cabo Verde,16.5388,-23.0418,55721,0,396,55325
2/2/22,Cabo Verde,16.5388,-23.0418,55739,0,396,55343
2/3/22,Cabo Verde,16.5388,-23.0418,55754,0,396,55358
2/4/22,Cabo Verde,16.5388,-23.0418,55769,0,396,55373
2/5/22,Cabo Verde,16.5388,-23.0418,55772,0,396,55376
2/6/22,Cabo Verde,16.5388,-23.0418,55785,0,397,55388
2/7/22,Cabo Verde,16.5388,-23.0418,55802,0,398,55404
2/8/22,Cabo Verde,16.5388,-23.0418,55811,0,398,55413
2/9/22,Cabo Verde,16.5388,-23.0418,55820,0,398,55422
2/10/22,Cabo Verde,16.5388,-23.0418,55827,0,398,55429
2/11/22,Cabo Verde,16.5388,-23.0418,55833,0,398,55435
2/12/22,Cabo Verde,16.5388,-23.0418,55840,0,400,55440
2/13/22,Cabo Verde,16.5388,-23.0418,55842,0,400,55442
2/14/22,Cabo Verde,16.5388,-23.0418,55844,0,400,55444
2/15/22,Cabo Verde,16.5388,-23.0418,55846,0,400,55446
2/16/22,Cabo Verde,16.5388,-23.0418,55856,0,400,55456
2/17/22,Cabo Verde,16.5388,-23.0418,55856,0,400,55456
2/18/22,Cabo Verde,16.5388,-23.0418,55858,0,400,55458
2/19/22,Cabo Verde,16.5388,-23.0418,55860,0,400,55460
2/20/22,Cabo Verde,16.5388,-23.0418,55860,0,400,55460
2/21/22,Cabo Verde,16.5388,-23.0418,55863,0,400,55463
2/22/22,Cabo Verde,16.5388,-23.0418,55864,0,401,55463
2/23/22,Cabo Verde,16.5388,-23.0418,55870,0,401,55469
2/24/22,Cabo Verde,16.5388,-23.0418,55876,0,401,55475
2/25/22,Cabo Verde,16.5388,-23.0418,55880,0,401,55479
2/26/22,Cabo Verde,16.5388,-23.0418,55881,0,401,55480
2/27/22,Cabo Verde,16.5388,-23.0418,55882,0,401,55481
2/28/22,Cabo Verde,16.5388,-23.0418,55886,0,401,55485
3/1/22,Cabo Verde,16.5388,-23.0418,55887,0,401,55486
3/2/22,Cabo Verde,16.5388,-23.0418,55889,0,401,55488
3/3/22,Cabo Verde,16.5388,-23.0418,55889,0,401,55488
3/4/22,Cabo Verde,16.5388,-23.0418,55890,0,401,55489
3/5/22,Cabo Verde,16.5388,-23.0418,55892,0,401,55491
3/6/22,Cabo Verde,16.5388,-23.0418,55895,0,401,55494
3/7/22,Cabo Verde,16.5388,-23.0418,55898,0,401,55497
3/8/22,Cabo Verde,16.5388,-23.0418,55903,0,401,55502
3/9/22,Cabo Verde,16.5388,-23.0418,55904,0,401,55503
3/10/22,Cabo Verde,16.5388,-23.0418,55906,0,401,55505
3/11/22,Cabo Verde,16.5388,-23.0418,55906,0,401,55505
3/12/22,Cabo Verde,16.5388,-23.0418,55906,0,401,55505
3/13/22,Cabo Verde,16.5388,-23.0418,55906,0,401,55505
3/14/22,Cabo Verde,16.5388,-23.0418,55907,0,401,55506
3/15/22,Cabo Verde,16.5388,-23.0418,55911,0,401,55510
3/16/22,Cabo Verde,16.5388,-23.0418,55914,0,401,55513
3/17/22,Cabo Verde,16.5388,-23.0418,55917,0,401,55516
3/18/22,Cabo Verde,16.5388,-23.0418,55921,0,401,55520
3/19/22,Cabo Verde,16.5388,-23.0418,55925,0,401,55524
3/20/22,Cabo Verde,16.5388,-23.0418,55925,0,401,55524
3/21/22,Cabo Verde,16.5388,-23.0418,55927,0,401,55526
3/22/22,Cabo Verde,16.5388,-23.0418,55931,0,401,55530
3/23/22,Cabo Verde,16.5388,-23.0418,55934,0,401,55533
3/24/22,Cabo Verde,16.5388,-23.0418,55941,0,401,55540
3/25/22,Cabo Verde,16.5388,-23.0418,55945,0,401,55544
3/26/22,Cabo Verde,16.5388,-23.0418,55947,0,401,55546
3/27/22,Cabo Verde,16.5388,-23.0418,55948,0,401,55547
3/28/22,Cabo Verde,16.5388,-23.0418,55949,0,401,55548
3/29/22,Cabo Verde,16.5388,-23.0418,55950,0,401,55549
3/30/22,Cabo Verde,16.5388,-23.0418,55950,0,401,55549
3/31/22,Cabo Verde,16.5388,-23.0418,55952,0,401,55551
4/1/22,Cabo Verde,16.5388,-23.0418,55957,0,401,55556
4/2/22,Cabo Verde,16.5388,-23.0418,55958,0,401,55557
4/3/22,Cabo Verde,16.5388,-23.0418,55960,0,401,55559
4/4/22,Cabo Verde,16.5388,-23.0418,55961,0,401,55560
4/5/22,Cabo Verde,16.5388,-23.0418,55961,0,401,55560
4/6/22,Cabo Verde,16.5388,-23.0418,55963,0,401,55562
4/7/22,Cabo Verde,16.5388,-23.0418,55963,0,401,55562
4/8/22,Cabo Verde,16.5388,-23.0418,55970,0,401,55569
4/9/22,Cabo Verde,16.5388,-23.0418,55971,0,401,55570
4/10/22,Cabo Verde,16.5388,-23.0418,55972,0,401,55571
4/11/22,Cabo Verde,16.5388,-23.0418,55973,0,401,55572
4/12/22,Cabo Verde,16.5388,-23.0418,55974,0,401,55573
4/13/22,Cabo Verde,16.5388,-23.0418,55978,0,401,55577
4/14/22,Cabo Verde,16.5388,-23.0418,55986,0,401,55585
4/15/22,Cabo Verde,16.5388,-23.0418,55986,0,401,55585
4/16/22,Cabo Verde,16.5388,-23.0418,55988,0,401,55587
4/17/22,Cabo Verde,16.5388,-23.0418,55990,0,401,55589
4/18/22,Cabo Verde,16.5388,-23.0418,55991,0,401,55590
4/19/22,Cabo Verde,16.5388,-23.0418,55993,0,401,55592
4/20/22,Cabo Verde,16.5388,-23.0418,55998,0,401,55597
4/21/22,Cabo Verde,16.5388,-23.0418,55999,0,401,55598
4/22/22,Cabo Verde,16.5388,-23.0418,56001,0,401,55600
4/23/22,Cabo Verde,16.5388,-23.0418,56004,0,401,55603
4/24/22,Cabo Verde,16.5388,-23.0418,56004,0,401,55603
4/25/22,Cabo Verde,16.5388,-23.0418,56008,0,401,55607
4/26/22,Cabo Verde,16.5388,-23.0418,56010,0,401,55609
4/27/22,Cabo Verde,16.5388,-23.0418,56014,0,401,55613
4/28/22,Cabo Verde,16.5388,-23.0418,56016,0,401,55615
4/29/22,Cabo Verde,16.5388,-23.0418,56020,0,401,55619
4/30/22,Cabo Verde,16.5388,-23.0418,56022,0,401,55621
5/1/22,Cabo Verde,16.5388,-23.0418,56025,0,401,55624
5/2/22,Cabo Verde,16.5388,-23.0418,56028,0,401,55627
5/3/22,Cabo Verde,16.5388,-23.0418,56031,0,401,55630
5/4/22,Cabo Verde,16.5388,-23.0418,56036,0,401,55635
5/5/22,Cabo Verde,16.5388,-23.0418,56046,0,401,55645
5/6/22,Cabo Verde,16.5388,-23.0418,56056,0,401,55655
5/7/22,Cabo Verde,16.5388,-23.0418,56062,0,401,55661
5/8/22,Cabo Verde,16.5388,-23.0418,56065,0,401,55664
5/9/22,Cabo Verde,16.5388,-23.0418,56075,0,401,55674
5/10/22,Cabo Verde,16.5388,-23.0418,56080,0,401,55679
5/11/22,Cabo Verde,16.5388,-23.0418,56093,0,401,55692
5/12/22,Cabo Verde,16.5388,-23.0418,56099,0,401,55698
5/13/22,Cabo Verde,16.5388,-23.0418,56105,0,401,55704
5/14/22,Cabo Verde,16.5388,-23.0418,56105,0,401,55704
5/15/22,Cabo Verde,16.5388,-23.0418,56115,0,401,55714
5/16/22,Cabo Verde,16.5388,-23.0418,56115,0,401,55714
5/17/22,Cabo Verde,16.5388,-23.0418,56127,0,401,55726
5/18/22,Cabo Verde,16.5388,-23.0418,56127,0,401,55726
5/19/22,Cabo Verde,16.5388,-23.0418,56127,0,401,55726
5/20/22,Cabo Verde,16.5388,-23.0418,56156,0,401,55755
5/21/22,Cabo Verde,16.5388,-23.0418,56167,0,401,55766
5/22/22,Cabo Verde,16.5388,-23.0418,56172,0,401,55771
5/23/22,Cabo Verde,16.5388,-23.0418,56172,0,401,55771
5/24/22,Cabo Verde,16.5388,-23.0418,56172,0,401,55771
5/25/22,Cabo Verde,16.5388,-23.0418,56177,0,401,55776
5/26/22,Cabo Verde,16.5388,-23.0418,56177,0,401,55776
5/27/22,Cabo Verde,16.5388,-23.0418,56264,0,401,55863
5/28/22,Cabo Verde,16.5388,-23.0418,56264,0,401,55863
5/29/22,Cabo Verde,16.5388,-23.0418,56290,0,401,55889
5/30/22,Cabo Verde,16.5388,-23.0418,56294,0,401,55893
5/31/22,Cabo Verde,16.5388,-23.0418,56324,0,402,55922
6/1/22,Cabo Verde,16.5388,-23.0418,56384,0,402,55982
6/2/22,Cabo Verde,16.5388,-23.0418,56425,0,402,56023
6/3/22,Cabo Verde,16.5388,-23.0418,56475,0,402,56073
6/4/22,Cabo Verde,16.5388,-23.0418,56532,0,402,56130
6/5/22,Cabo Verde,16.5388,-23.0418,56556,0,402,56154
6/6/22,Cabo Verde,16.5388,-23.0418,56590,0,402,56188
6/7/22,Cabo Verde,16.5388,-23.0418,56635,0,402,56233
6/8/22,Cabo Verde,16.5388,-23.0418,56738,0,402,56336
6/9/22,Cabo Verde,16.5388,-23.0418,56738,0,402,56336
6/10/22,Cabo Verde,16.5388,-23.0418,56936,0,402,56534
6/11/22,Cabo Verde,16.5388,-23.0418,57040,0,402,56638
6/12/22,Cabo Verde,16.5388,-23.0418,57096,0,402,56694
6/13/22,Cabo Verde,16.5388,-23.0418,57096,0,402,56694
6/14/22,Cabo Verde,16.5388,-23.0418,57262,0,402,56860
6/15/22,Cabo Verde,16.5388,-23.0418,57464,0,402,57062
6/16/22,Cabo Verde,16.5388,-23.0418,57643,0,402,57241
6/17/22,Cabo Verde,16.5388,-23.0418,57808,0,402,57406
6/18/22,Cabo Verde,16.5388,-23.0418,58029,0,402,57627
6/19/22,Cabo Verde,16.5388,-23.0418,58176,0,402,57774
6/20/22,Cabo Verde,16.5388,-23.0418,58271,0,402,57869
6/21/22,Cabo Verde,16.5388,-23.0418,58467,0,402,58065
6/22/22,Cabo Verde,16.5388,-23.0418,58770,0,403,58367
6/23/22,Cabo Verde,16.5388,-23.0418,58995,0,403,58592
6/24/22,Cabo Verde,16.5388,-23.0418,59265,0,403,58862
6/25/22,Cabo Verde,16.5388,-23.0418,59265,0,403,58862
6/26/22,Cabo Verde,16.5388,-23.0418,59416,0,403,59013
6/27/22,Cabo Verde,16.5388,-23.0418,59416,0,403,59013
6/28/22,Cabo Verde,16.5388,-23.0418,59533,0,403,59130
6/29/22,Cabo Verde,16.5388,-23.0418,60227,0,404,59823
6/30/22,Cabo Verde,16.5388,-23.0418,60542,0,405,60137
7/1/22,Cabo Verde,16.5388,-23.0418,60770,0,405,60365
7/2/22,Cabo Verde,16.5388,-23.0418,60940,0,405,60535
7/3/22,Cabo Verde,16.5388,-23.0418,61002,0,405,60597
7/4/22,Cabo Verde,16.5388,-23.0418,61105,0,405,60700
7/5/22,Cabo Verde,16.5388,-23.0418,61105,0,405,60700
7/6/22,Cabo Verde,16.5388,-23.0418,61264,0,407,60857
7/7/22,Cabo Verde,16.5388,-23.0418,61411,0,407,61004
7/8/22,Cabo Verde,16.5388,-23.0418,61517,0,407,61110
7/9/22,Cabo Verde,16.5388,-23.0418,61592,0,409,61183
7/10/22,Cabo Verde,16.5388,-23.0418,61623,0,409,61214
7/11/22,Cabo Verde,16.5388,-23.0418,61669,0,409,61260
7/12/22,Cabo Verde,16.5388,-23.0418,61669,0,409,61260
7/13/22,Cabo Verde,16.5388,-23.0418,61776,0,409,61367
7/14/22,Cabo Verde,16.5388,-23.0418,61776,0,409,61367
7/15/22,Cabo Verde,16.5388,-23.0418,61776,0,409,61367
7/16/22,Cabo Verde,16.5388,-23.0418,61913,0,409,61504
7/17/22,Cabo Verde,16.5388,-23.0418,61922,0,409,61513
7/18/22,Cabo Verde,16.5388,-23.0418,61922,0,409,61513
7/19/22,Cabo Verde,16.5388,-23.0418,61964,0,409,61555
7/20/22,Cabo Verde,16.5388,-23.0418,61994,0,409,61585
7/21/22,Cabo Verde,16.5388,-23.0418,62017,0,409,61608
7/22/22,Cabo Verde,16.5388,-23.0418,62017,0,409,61608
7/23/22,Cabo Verde,16.5388,-23.0418,62055,0,409,61646
7/24/22,Cabo Verde,16.5388,-23.0418,62072,0,409,61663
7/25/22,Cabo Verde,16.5388,-23.0418,62078,0,409,61669
7/26/22,Cabo Verde,16.5388,-23.0418,62095,0,409,61686
7/27/22,Cabo Verde,16.5388,-23.0418,62114,0,410,61704
7/28/22,Cabo Verde,16.5388,-23.0418,62114,0,410,61704
7/29/22,Cabo Verde,16.5388,-23.0418,62138,0,410,61728
7/30/22,Cabo Verde,16.5388,-23.0418,62149,0,410,61739
7/31/22,Cabo Verde,16.5388,-23.0418,62159,0,410,61749
8/1/22,Cabo Verde,16.5388,-23.0418,62163,0,410,61753
8/2/22,Cabo Verde,16.5388,-23.0418,62172,0,410,61762
8/3/22,Cabo Verde,16.5388,-23.0418,62184,0,410,61774
8/4/22,Cabo Verde,16.5388,-23.0418,62191,0,410,61781
8/5/22,Cabo Verde,16.5388,-23.0418,62200,0,410,61790
8/6/22,Cabo Verde,16.5388,-23.0418,62206,0,410,61796
8/7/22,Cabo Verde,16.5388,-23.0418,62207,0,410,61797
8/8/22,Cabo Verde,16.5388,-23.0418,62214,0,410,61804
8/9/22,Cabo Verde,16.5388,-23.0418,62221,0,410,61811
8/10/22,Cabo Verde,16.5388,-23.0418,62235,0,410,61825
8/11/22,Cabo Verde,16.5388,-23.0418,62244,0,410,61834
8/12/22,Cabo Verde,16.5388,-23.0418,62249,0,410,61839
8/13/22,Cabo Verde,16.5388,-23.0418,62253,0,410,61843
8/14/22,Cabo Verde,16.5388,-23.0418,62253,0,410,61843
8/15/22,Cabo Verde,16.5388,-23.0418,62253,0,410,61843
8/16/22,Cabo Verde,16.5388,-23.0418,62254,0,410,61844
8/17/22,Cabo Verde,16.5388,-23.0418,62266,0,410,61856
8/18/22,Cabo Verde,16.5388,-23.0418,62266,0,410,61856
8/19/22,Cabo Verde,16.5388,-23.0418,62282,0,410,61872
8/20/22,Cabo Verde,16.5388,-23.0418,62282,0,410,61872
8/21/22,Cabo Verde,16.5388,-23.0418,62288,0,410,61878
8/22/22,Cabo Verde,16.5388,-23.0418,62289,0,410,61879
8/23/22,Cabo Verde,16.5388,-23.0418,62294,0,410,61884
8/24/22,Cabo Verde,16.5388,-23.0418,62297,0,410,61887
8/25/22,Cabo Verde,16.5388,-23.0418,62301,0,410,61891
8/26/22,Cabo Verde,16.5388,-23.0418,62306,0,410,61896
8/27/22,Cabo Verde,16.5388,-23.0418,62309,0,410,61899
8/28/22,Cabo Verde,16.5388,-23.0418,62310,0,410,61900
8/29/22,Cabo Verde,16.5388,-23.0418,62310,0,410,61900
8/30/22,Cabo Verde,16.5388,-23.0418,62310,0,410,61900
8/31/22,Cabo Verde,16.5388,-23.0418,62320,0,410,61910
9/1/22,Cabo Verde,16.5388,-23.0418,62322,0,410,61912
9/2/22,Cabo Verde,16.5388,-23.0418,62322,0,410,61912
9/3/22,Cabo Verde,16.5388,-23.0418,62326,0,410,61916
9/4/22,Cabo Verde,16.5388,-23.0418,62328,0,410,61918
9/5/22,Cabo Verde,16.5388,-23.0418,62328,0,410,61918
9/6/22,Cabo Verde,16.5388,-23.0418,62330,0,410,61920
9/7/22,Cabo Verde,16.5388,-23.0418,62331,0,410,61921
9/8/22,Cabo Verde,16.5388,-23.0418,62331,0,410,61921
9/9/22,Cabo Verde,16.5388,-23.0418,62339,0,410,61929
9/10/22,Cabo Verde,16.5388,-23.0418,62341,0,410,61931
9/11/22,Cabo Verde,16.5388,-23.0418,62344,0,410,61934
9/12/22,Cabo Verde,16.5388,-23.0418,62344,0,410,61934
9/13/22,Cabo Verde,16.5388,-23.0418,62346,0,410,61936
9/14/22,Cabo Verde,16.5388,-23.0418,62350,0,410,61940
9/15/22,Cabo Verde,16.5388,-23.0418,62350,0,410,61940
9/16/22,Cabo Verde,16.5388,-23.0418,62352,0,410,61942
9/17/22,Cabo Verde,16.5388,-23.0418,62352,0,410,61942
9/18/22,Cabo Verde,16.5388,-23.0418,62354,0,410,61944
9/19/22,Cabo Verde,16.5388,-23.0418,62354,0,410,61944
9/20/22,Cabo Verde,16.5388,-23.0418,62356,0,410,61946
9/21/22,Cabo Verde,16.5388,-23.0418,62356,0,410,61946
9/22/22,Cabo Verde,16.5388,-23.0418,62356,0,410,61946
9/23/22,Cabo Verde,16.5388,-23.0418,62358,0,410,61948
9/24/22,Cabo Verde,16.5388,-23.0418,62359,0,410,61949
9/25/22,Cabo Verde,16.5388,-23.0418,62359,0,410,61949
9/26/22,Cabo Verde,16.5388,-23.0418,62360,0,410,61950
9/27/22,Cabo Verde,16.5388,-23.0418,62368,0,410,61958
9/28/22,Cabo Verde,16.5388,-23.0418,62370,0,410,61960
9/29/22,Cabo Verde,16.5388,-23.0418,62371,0,410,61961
9/30/22,Cabo Verde,16.5388,-23.0418,62374,0,410,61964
10/1/22,Cabo Verde,16.5388,-23.0418,62374,0,410,61964
10/2/22,Cabo Verde,16.5388,-23.0418,62376,0,410,61966
10/3/22,Cabo Verde,16.5388,-23.0418,62376,0,410,61966
10/4/22,Cabo Verde,16.5388,-23.0418,62383,0,410,61973
10/5/22,Cabo Verde,16.5388,-23.0418,62384,0,410,61974
10/6/22,Cabo Verde,16.5388,-23.0418,62384,0,410,61974
10/7/22,Cabo Verde,16.5388,-23.0418,62387,0,410,61977
10/8/22,Cabo Verde,16.5388,-23.0418,62387,0,410,61977
10/9/22,Cabo Verde,16.5388,-23.0418,62389,0,410,61979
10/10/22,Cabo Verde,16.5388,-23.0418,62389,0,410,61979
10/11/22,Cabo Verde,16.5388,-23.0418,62390,0,410,61980
10/12/22,Cabo Verde,16.5388,-23.0418,62390,0,410,61980
10/13/22,Cabo Verde,16.5388,-23.0418,62394,0,410,61984
10/14/22,Cabo Verde,16.5388,-23.0418,62395,0,410,61985
10/15/22,Cabo Verde,16.5388,-23.0418,62397,0,410,61987
10/16/22,Cabo Verde,16.5388,-23.0418,62397,0,410,61987
10/17/22,Cabo Verde,16.5388,-23.0418,62397,0,410,61987
10/18/22,Cabo Verde,16.5388,-23.0418,62397,0,410,61987
10/19/22,Cabo Verde,16.5388,-23.0418,62397,0,410,61987
10/20/22,Cabo Verde,16.5388,-23.0418,62397,0,410,61987
10/21/22,Cabo Verde,16.5388,-23.0418,62397,0,410,61987
10/22/22,Cabo Verde,16.5388,-23.0418,62397,0,410,61987
10/23/22,Cabo Verde,16.5388,-23.0418,62397,0,410,61987
10/24/22,Cabo Verde,16.5388,-23.0418,62397,0,410,61987
10/25/22,Cabo Verde,16.5388,-23.0418,62397,0,410,61987
10/26/22,Cabo Verde,16.5388,-23.0418,62397,0,410,61987
10/27/22,Cabo Verde,16.5388,-23.0418,62397,0,410,61987
10/28/22,Cabo Verde,16.5388,-23.0418,62397,0,410,61987
10/29/22,Cabo Verde,16.5388,-23.0418,62397,0,410,61987
10/30/22,Cabo Verde,16.5388,-23.0418,62397,0,410,61987
10/31/22,Cabo Verde,16.5388,-23.0418,62397,0,410,61987
11/1/22,Cabo Verde,16.5388,-23.0418,62397,0,410,61987
11/2/22,Cabo Verde,16.5388,-23.0418,62397,0,410,61987
11/3/22,Cabo Verde,16.5388,-23.0418,62516,0,410,62106
11/4/22,Cabo Verde,16.5388,-23.0418,62529,0,410,62119
11/5/22,Cabo Verde,16.5388,-23.0418,62553,0,410,62143
11/6/22,Cabo Verde,16.5388,-23.0418,62561,0,410,62151
11/7/22,Cabo Verde,16.5388,-23.0418,62561,0,410,62151
11/8/22,Cabo Verde,16.5388,-23.0418,62566,0,410,62156
11/9/22,Cabo Verde,16.5388,-23.0418,62619,0,410,62209
11/10/22,Cabo Verde,16.5388,-23.0418,62646,0,410,62236
11/11/22,Cabo Verde,16.5388,-23.0418,62646,0,410,62236
11/12/22,Cabo Verde,16.5388,-23.0418,62672,0,410,62262
11/13/22,Cabo Verde,16.5388,-23.0418,62693,0,410,62283
11/14/22,Cabo Verde,16.5388,-23.0418,62693,0,410,62283
11/15/22,Cabo Verde,16.5388,-23.0418,62710,0,410,62300
11/16/22,Cabo Verde,16.5388,-23.0418,62740,0,410,62330
11/17/22,Cabo Verde,16.5388,-23.0418,62758,0,410,62348
11/18/22,Cabo Verde,16.5388,-23.0418,62783,0,410,62373
11/19/22,Cabo Verde,16.5388,-23.0418,62802,0,410,62392
11/20/22,Cabo Verde,16.5388,-23.0418,62802,0,410,62392
11/21/22,Cabo Verde,16.5388,-23.0418,62828,0,410,62418
11/22/22,Cabo Verde,16.5388,-23.0418,62862,0,411,62451
11/23/22,Cabo Verde,16.5388,-23.0418,62862,0,412,62450
11/24/22,Cabo Verde,16.5388,-23.0418,62892,0,412,62480
11/25/22,Cabo Verde,16.5388,-23.0418,62927,0,412,62515
11/26/22,Cabo Verde,16.5388,-23.0418,62948,0,412,62536
11/27/22,Cabo Verde,16.5388,-23.0418,62969,0,412,62557
11/28/22,Cabo Verde,16.5388,-23.0418,62991,0,412,62579
11/29/22,Cabo Verde,16.5388,-23.0418,63015,0,412,62603
11/30/22,Cabo Verde,16.5388,-23.0418,63037,0,412,62625
12/1/22,Cabo Verde,16.5388,-23.0418,63051,0,412,62639
12/2/22,Cabo Verde,16.5388,-23.0418,63068,0,412,62656
12/3/22,Cabo Verde,16.5388,-23.0418,63078,0,412,62666
12/4/22,Cabo Verde,16.5388,-23.0418,63078,0,412,62666
12/5/22,Cabo Verde,16.5388,-23.0418,63085,0,412,62673
12/6/22,Cabo Verde,16.5388,-23.0418,63095,0,412,62683
12/7/22,Cabo Verde,16.5388,-23.0418,63107,0,412,62695
12/8/22,Cabo Verde,16.5388,-23.0418,63107,0,412,62695
12/9/22,Cabo Verde,16.5388,-23.0418,63107,0,412,62695
12/10/22,Cabo Verde,16.5388,-23.0418,63119,0,412,62707
12/11/22,Cabo Verde,16.5388,-23.0418,63119,0,412,62707
12/12/22,Cabo Verde,16.5388,-23.0418,63130,0,412,62718
12/13/22,Cabo Verde,16.5388,-23.0418,63144,0,412,62732
12/14/22,Cabo Verde,16.5388,-23.0418,63150,0,412,62738
12/15/22,Cabo Verde,16.5388,-23.0418,63150,0,412,62738
12/16/22,Cabo Verde,16.5388,-23.0418,63159,0,412,62747
12/17/22,Cabo Verde,16.5388,-23.0418,63159,0,412,62747
1/1/22,Cambodia,11.55,104.9167,120507,0,3012,117495
1/2/22,Cambodia,11.55,104.9167,120510,0,3013,117497
1/3/22,Cambodia,11.55,104.9167,120516,0,3014,117502
1/4/22,Cambodia,11.55,104.9167,120526,0,3015,117511
1/5/22,Cambodia,11.55,104.9167,120535,0,3015,117520
1/6/22,Cambodia,11.55,104.9167,120553,0,3015,117538
1/7/22,Cambodia,11.55,104.9167,120564,0,3015,117549
1/8/22,Cambodia,11.55,104.9167,120591,0,3015,117576
1/9/22,Cambodia,11.55,104.9167,120621,0,3015,117606
1/10/22,Cambodia,11.55,104.9167,120636,0,3015,117621
1/11/22,Cambodia,11.55,104.9167,120670,0,3015,117655
1/12/22,Cambodia,11.55,104.9167,120718,0,3015,117703
1/13/22,Cambodia,11.55,104.9167,120718,0,3015,117703
1/14/22,Cambodia,11.55,104.9167,120728,0,3015,117713
1/15/22,Cambodia,11.55,104.9167,120773,0,3015,117758
1/16/22,Cambodia,11.55,104.9167,120796,0,3015,117781
1/17/22,Cambodia,11.55,104.9167,120825,0,3015,117810
1/18/22,Cambodia,11.55,104.9167,120847,0,3015,117832
1/19/22,Cambodia,11.55,104.9167,120877,0,3015,117862
1/20/22,Cambodia,11.55,104.9167,120914,0,3015,117899
1/21/22,Cambodia,11.55,104.9167,120956,0,3015,117941
1/22/22,Cambodia,11.55,104.9167,121000,0,3015,117985
1/23/22,Cambodia,11.55,104.9167,121026,0,3015,118011
1/24/22,Cambodia,11.55,104.9167,121066,0,3015,118051
1/25/22,Cambodia,11.55,104.9167,121094,0,3015,118079
1/26/22,Cambodia,11.55,104.9167,121116,0,3015,118101
1/27/22,Cambodia,11.55,104.9167,121150,0,3015,118135
1/28/22,Cambodia,11.55,104.9167,121188,0,3015,118173
1/29/22,Cambodia,11.55,104.9167,121242,0,3015,118227
1/30/22,Cambodia,11.55,104.9167,121299,0,3015,118284
1/31/22,Cambodia,11.55,104.9167,121355,0,3015,118340
2/1/22,Cambodia,11.55,104.9167,121390,0,3015,118375
2/2/22,Cambodia,11.55,104.9167,121438,0,3015,118423
2/3/22,Cambodia,11.55,104.9167,121484,0,3015,118469
2/4/22,Cambodia,11.55,104.9167,121550,0,3015,118535
2/5/22,Cambodia,11.55,104.9167,121662,0,3015,118647
2/6/22,Cambodia,11.55,104.9167,121773,0,3015,118758
2/7/22,Cambodia,11.55,104.9167,121881,0,3015,118866
2/8/22,Cambodia,11.55,104.9167,121983,0,3015,118968
2/9/22,Cambodia,11.55,104.9167,122206,0,3015,119191
2/10/22,Cambodia,11.55,104.9167,122468,0,3015,119453
2/11/22,Cambodia,11.55,104.9167,122742,0,3015,119727
2/12/22,Cambodia,11.55,104.9167,123042,0,3015,120027
2/13/22,Cambodia,11.55,104.9167,123443,0,3015,120428
2/14/22,Cambodia,11.55,104.9167,123955,0,3015,120940
2/15/22,Cambodia,11.55,104.9167,124139,0,3015,121124
2/16/22,Cambodia,11.55,104.9167,124343,0,3015,121328
2/17/22,Cambodia,11.55,104.9167,124787,0,3015,121772
2/18/22,Cambodia,11.55,104.9167,125201,0,3015,122186
2/19/22,Cambodia,11.55,104.9167,125753,0,3015,122738
2/20/22,Cambodia,11.55,104.9167,126489,0,3017,123472
2/21/22,Cambodia,11.55,104.9167,126977,0,3020,123957
2/22/22,Cambodia,11.55,104.9167,127575,0,3022,124553
2/23/22,Cambodia,11.55,104.9167,128133,0,3023,125110
2/24/22,Cambodia,11.55,104.9167,128599,0,3026,125573
2/25/22,Cambodia,11.55,104.9167,129078,0,3027,126051
2/26/22,Cambodia,11.55,104.9167,129548,0,3032,126516
2/27/22,Cambodia,11.55,104.9167,129920,0,3032,126888
2/28/22,Cambodia,11.55,104.9167,130276,0,3032,127244
3/1/22,Cambodia,11.55,104.9167,130589,0,3032,127557
3/2/22,Cambodia,11.55,104.9167,131004,0,3032,127972
3/3/22,Cambodia,11.55,104.9167,131372,0,3033,128339
3/4/22,Cambodia,11.55,104.9167,131738,0,3038,128700
3/5/22,Cambodia,11.55,104.9167,132072,0,3040,129032
3/6/22,Cambodia,11.55,104.9167,132402,0,3041,129361
3/7/22,Cambodia,11.55,104.9167,132708,0,3042,129666
3/8/22,Cambodia,11.55,104.9167,133065,0,3043,130022
3/9/22,Cambodia,11.55,104.9167,133263,0,3043,130220
3/10/22,Cambodia,11.55,104.9167,133501,0,3044,130457
3/11/22,Cambodia,11.55,104.9167,133738,0,3045,130693
3/12/22,Cambodia,11.55,104.9167,133943,0,3046,130897
3/13/22,Cambodia,11.55,104.9167,134068,0,3047,131021
3/14/22,Cambodia,11.55,104.9167,134213,0,3047,131166
3/15/22,Cambodia,11.55,104.9167,134352,0,3048,131304
3/16/22,Cambodia,11.55,104.9167,134492,0,3049,131443
3/17/22,Cambodia,11.55,104.9167,134624,0,3049,131575
3/18/22,Cambodia,11.55,104.9167,134772,0,3049,131723
3/19/22,Cambodia,11.55,104.9167,134889,0,3050,131839
3/20/22,Cambodia,11.55,104.9167,134986,0,3051,131935
3/21/22,Cambodia,11.55,104.9167,135085,0,3052,132033
3/22/22,Cambodia,11.55,104.9167,135158,0,3052,132106
3/23/22,Cambodia,11.55,104.9167,135222,0,3052,132170
3/24/22,Cambodia,11.55,104.9167,135285,0,3054,132231
3/25/22,Cambodia,11.55,104.9167,135344,0,3054,132290
3/26/22,Cambodia,11.55,104.9167,135402,0,3054,132348
3/27/22,Cambodia,11.55,104.9167,135461,0,3054,132407
3/28/22,Cambodia,11.55,104.9167,135513,0,3054,132459
3/29/22,Cambodia,11.55,104.9167,135552,0,3054,132498
3/30/22,Cambodia,11.55,104.9167,135585,0,3054,132531
3/31/22,Cambodia,11.55,104.9167,135625,0,3054,132571
4/1/22,Cambodia,11.55,104.9167,135682,0,3054,132628
4/2/22,Cambodia,11.55,104.9167,135714,0,3054,132660
4/3/22,Cambodia,11.55,104.9167,135747,0,3054,132693
4/4/22,Cambodia,11.55,104.9167,135782,0,3054,132728
4/5/22,Cambodia,11.55,104.9167,135812,0,3055,132757
4/6/22,Cambodia,11.55,104.9167,135834,0,3055,132779
4/7/22,Cambodia,11.55,104.9167,135861,0,3055,132806
4/8/22,Cambodia,11.55,104.9167,135889,0,3055,132834
4/9/22,Cambodia,11.55,104.9167,135914,0,3055,132859
4/10/22,Cambodia,11.55,104.9167,135947,0,3055,132892
4/11/22,Cambodia,11.55,104.9167,135963,0,3055,132908
4/12/22,Cambodia,11.55,104.9167,135980,0,3055,132925
4/13/22,Cambodia,11.55,104.9167,136013,0,3055,132958
4/14/22,Cambodia,11.55,104.9167,136013,0,3055,132958
4/15/22,Cambodia,11.55,104.9167,136032,0,3055,132977
4/16/22,Cambodia,11.55,104.9167,136044,0,3055,132989
4/17/22,Cambodia,11.55,104.9167,136060,0,3055,133005
4/18/22,Cambodia,11.55,104.9167,136076,0,3055,133021
4/19/22,Cambodia,11.55,104.9167,136090,0,3055,133035
4/20/22,Cambodia,11.55,104.9167,136117,0,3056,133061
4/21/22,Cambodia,11.55,104.9167,136146,0,3056,133090
4/22/22,Cambodia,11.55,104.9167,136172,0,3056,133116
4/23/22,Cambodia,11.55,104.9167,136200,0,3056,133144
4/24/22,Cambodia,11.55,104.9167,136216,0,3056,133160
4/25/22,Cambodia,11.55,104.9167,136228,0,3056,133172
4/26/22,Cambodia,11.55,104.9167,136230,0,3056,133174
4/27/22,Cambodia,11.55,104.9167,136235,0,3056,133179
4/28/22,Cambodia,11.55,104.9167,136240,0,3056,133184
4/29/22,Cambodia,11.55,104.9167,136246,0,3056,133190
4/30/22,Cambodia,11.55,104.9167,136251,0,3056,133195
5/1/22,Cambodia,11.55,104.9167,136252,0,3056,133196
5/2/22,Cambodia,11.55,104.9167,136254,0,3056,133198
5/3/22,Cambodia,11.55,104.9167,136257,0,3056,133201
5/4/22,Cambodia,11.55,104.9167,136258,0,3056,133202
5/5/22,Cambodia,11.55,104.9167,136259,0,3056,133203
5/6/22,Cambodia,11.55,104.9167,136260,0,3056,133204
5/7/22,Cambodia,11.55,104.9167,136262,0,3056,133206
5/8/22,Cambodia,11.55,104.9167,136262,0,3056,133206
5/9/22,Cambodia,11.55,104.9167,136262,0,3056,133206
5/10/22,Cambodia,11.55,104.9167,136262,0,3056,133206
5/11/22,Cambodia,11.55,104.9167,136262,0,3056,133206
5/12/22,Cambodia,11.55,104.9167,136262,0,3056,133206
5/13/22,Cambodia,11.55,104.9167,136262,0,3056,133206
5/14/22,Cambodia,11.55,104.9167,136262,0,3056,133206
5/15/22,Cambodia,11.55,104.9167,136262,0,3056,133206
5/16/22,Cambodia,11.55,104.9167,136262,0,3056,133206
5/17/22,Cambodia,11.55,104.9167,136262,0,3056,133206
5/18/22,Cambodia,11.55,104.9167,136262,0,3056,133206
5/19/22,Cambodia,11.55,104.9167,136262,0,3056,133206
5/20/22,Cambodia,11.55,104.9167,136262,0,3056,133206
5/21/22,Cambodia,11.55,104.9167,136262,0,3056,133206
5/22/22,Cambodia,11.55,104.9167,136262,0,3056,133206
5/23/22,Cambodia,11.55,104.9167,136262,0,3056,133206
5/24/22,Cambodia,11.55,104.9167,136262,0,3056,133206
5/25/22,Cambodia,11.55,104.9167,136262,0,3056,133206
5/26/22,Cambodia,11.55,104.9167,136262,0,3056,133206
5/27/22,Cambodia,11.55,104.9167,136262,0,3056,133206
5/28/22,Cambodia,11.55,104.9167,136262,0,3056,133206
5/29/22,Cambodia,11.55,104.9167,136262,0,3056,133206
5/30/22,Cambodia,11.55,104.9167,136262,0,3056,133206
5/31/22,Cambodia,11.55,104.9167,136262,0,3056,133206
6/1/22,Cambodia,11.55,104.9167,136262,0,3056,133206
6/2/22,Cambodia,11.55,104.9167,136262,0,3056,133206
6/3/22,Cambodia,11.55,104.9167,136262,0,3056,133206
6/4/22,Cambodia,11.55,104.9167,136262,0,3056,133206
6/5/22,Cambodia,11.55,104.9167,136262,0,3056,133206
6/6/22,Cambodia,11.55,104.9167,136262,0,3056,133206
6/7/22,Cambodia,11.55,104.9167,136262,0,3056,133206
6/8/22,Cambodia,11.55,104.9167,136262,0,3056,133206
6/9/22,Cambodia,11.55,104.9167,136262,0,3056,133206
6/10/22,Cambodia,11.55,104.9167,136262,0,3056,133206
6/11/22,Cambodia,11.55,104.9167,136262,0,3056,133206
6/12/22,Cambodia,11.55,104.9167,136262,0,3056,133206
6/13/22,Cambodia,11.55,104.9167,136262,0,3056,133206
6/14/22,Cambodia,11.55,104.9167,136262,0,3056,133206
6/15/22,Cambodia,11.55,104.9167,136262,0,3056,133206
6/16/22,Cambodia,11.55,104.9167,136262,0,3056,133206
6/17/22,Cambodia,11.55,104.9167,136262,0,3056,133206
6/18/22,Cambodia,11.55,104.9167,136262,0,3056,133206
6/19/22,Cambodia,11.55,104.9167,136262,0,3056,133206
6/20/22,Cambodia,11.55,104.9167,136262,0,3056,133206
6/21/22,Cambodia,11.55,104.9167,136262,0,3056,133206
6/22/22,Cambodia,11.55,104.9167,136262,0,3056,133206
6/23/22,Cambodia,11.55,104.9167,136262,0,3056,133206
6/24/22,Cambodia,11.55,104.9167,136262,0,3056,133206
6/25/22,Cambodia,11.55,104.9167,136262,0,3056,133206
6/26/22,Cambodia,11.55,104.9167,136262,0,3056,133206
6/27/22,Cambodia,11.55,104.9167,136262,0,3056,133206
6/28/22,Cambodia,11.55,104.9167,136262,0,3056,133206
6/29/22,Cambodia,11.55,104.9167,136272,0,3056,133216
6/30/22,Cambodia,11.55,104.9167,136279,0,3056,133223
7/1/22,Cambodia,11.55,104.9167,136282,0,3056,133226
7/2/22,Cambodia,11.55,104.9167,136290,0,3056,133234
7/3/22,Cambodia,11.55,104.9167,136296,0,3056,133240
7/4/22,Cambodia,11.55,104.9167,136296,0,3056,133240
7/5/22,Cambodia,11.55,104.9167,136301,0,3056,133245
7/6/22,Cambodia,11.55,104.9167,136308,0,3056,133252
7/7/22,Cambodia,11.55,104.9167,136314,0,3056,133258
7/8/22,Cambodia,11.55,104.9167,136326,0,3056,133270
7/9/22,Cambodia,11.55,104.9167,136343,0,3056,133287
7/10/22,Cambodia,11.55,104.9167,136359,0,3056,133303
7/11/22,Cambodia,11.55,104.9167,136362,0,3056,133306
7/12/22,Cambodia,11.55,104.9167,136374,0,3056,133318
7/13/22,Cambodia,11.55,104.9167,136390,0,3056,133334
7/14/22,Cambodia,11.55,104.9167,136407,0,3056,133351
7/15/22,Cambodia,11.55,104.9167,136421,0,3056,133365
7/16/22,Cambodia,11.55,104.9167,136437,0,3056,133381
7/17/22,Cambodia,11.55,104.9167,136455,0,3056,133399
7/18/22,Cambodia,11.55,104.9167,136477,0,3056,133421
7/19/22,Cambodia,11.55,104.9167,136499,0,3056,133443
7/20/22,Cambodia,11.55,104.9167,136512,0,3056,133456
7/21/22,Cambodia,11.55,104.9167,136532,0,3056,133476
7/22/22,Cambodia,11.55,104.9167,136545,0,3056,133489
7/23/22,Cambodia,11.55,104.9167,136565,0,3056,133509
7/24/22,Cambodia,11.55,104.9167,136588,0,3056,133532
7/25/22,Cambodia,11.55,104.9167,136612,0,3056,133556
7/26/22,Cambodia,11.55,104.9167,136631,0,3056,133575
7/27/22,Cambodia,11.55,104.9167,136631,0,3056,133575
7/28/22,Cambodia,11.55,104.9167,136680,0,3056,133624
7/29/22,Cambodia,11.55,104.9167,136706,0,3056,133650
7/30/22,Cambodia,11.55,104.9167,136753,0,3056,133697
7/31/22,Cambodia,11.55,104.9167,136789,0,3056,133733
8/1/22,Cambodia,11.55,104.9167,136829,0,3056,133773
8/2/22,Cambodia,11.55,104.9167,136868,0,3056,133812
8/3/22,Cambodia,11.55,104.9167,136908,0,3056,133852
8/4/22,Cambodia,11.55,104.9167,136937,0,3056,133881
8/5/22,Cambodia,11.55,104.9167,136959,0,3056,133903
8/6/22,Cambodia,11.55,104.9167,136977,0,3056,133921
8/7/22,Cambodia,11.55,104.9167,137021,0,3056,133965
8/8/22,Cambodia,11.55,104.9167,137056,0,3056,134000
8/9/22,Cambodia,11.55,104.9167,137081,0,3056,134025
8/10/22,Cambodia,11.55,104.9167,137117,0,3056,134061
8/11/22,Cambodia,11.55,104.9167,137138,0,3056,134082
8/12/22,Cambodia,11.55,104.9167,137179,0,3056,134123
8/13/22,Cambodia,11.55,104.9167,137207,0,3056,134151
8/14/22,Cambodia,11.55,104.9167,137236,0,3056,134180
8/15/22,Cambodia,11.55,104.9167,137264,0,3056,134208
8/16/22,Cambodia,11.55,104.9167,137300,0,3056,134244
8/17/22,Cambodia,11.55,104.9167,137326,0,3056,134270
8/18/22,Cambodia,11.55,104.9167,137349,0,3056,134293
8/19/22,Cambodia,11.55,104.9167,137377,0,3056,134321
8/20/22,Cambodia,11.55,104.9167,137394,0,3056,134338
8/21/22,Cambodia,11.55,104.9167,137426,0,3056,134370
8/22/22,Cambodia,11.55,104.9167,137448,0,3056,134392
8/23/22,Cambodia,11.55,104.9167,137476,0,3056,134420
8/24/22,Cambodia,11.55,104.9167,137482,0,3056,134426
8/25/22,Cambodia,11.55,104.9167,137497,0,3056,134441
8/26/22,Cambodia,11.55,104.9167,137519,0,3056,134463
8/27/22,Cambodia,11.55,104.9167,137538,0,3056,134482
8/28/22,Cambodia,11.55,104.9167,137555,0,3056,134499
8/29/22,Cambodia,11.55,104.9167,137581,0,3056,134525
8/30/22,Cambodia,11.55,104.9167,137596,0,3056,134540
8/31/22,Cambodia,11.55,104.9167,137620,0,3056,134564
9/1/22,Cambodia,11.55,104.9167,137629,0,3056,134573
9/2/22,Cambodia,11.55,104.9167,137637,0,3056,134581
9/3/22,Cambodia,11.55,104.9167,137650,0,3056,134594
9/4/22,Cambodia,11.55,104.9167,137661,0,3056,134605
9/5/22,Cambodia,11.55,104.9167,137668,0,3056,134612
9/6/22,Cambodia,11.55,104.9167,137679,0,3056,134623
9/7/22,Cambodia,11.55,104.9167,137687,0,3056,134631
9/8/22,Cambodia,11.55,104.9167,137689,0,3056,134633
9/9/22,Cambodia,11.55,104.9167,137696,0,3056,134640
9/10/22,Cambodia,11.55,104.9167,137705,0,3056,134649
9/11/22,Cambodia,11.55,104.9167,137710,0,3056,134654
9/12/22,Cambodia,11.55,104.9167,137719,0,3056,134663
9/13/22,Cambodia,11.55,104.9167,137735,0,3056,134679
9/14/22,Cambodia,11.55,104.9167,137739,0,3056,134683
9/15/22,Cambodia,11.55,104.9167,137745,0,3056,134689
9/16/22,Cambodia,11.55,104.9167,137752,0,3056,134696
9/17/22,Cambodia,11.55,104.9167,137755,0,3056,134699
9/18/22,Cambodia,11.55,104.9167,137767,0,3056,134711
9/19/22,Cambodia,11.55,104.9167,137771,0,3056,134715
9/20/22,Cambodia,11.55,104.9167,137778,0,3056,134722
9/21/22,Cambodia,11.55,104.9167,137813,0,3056,134757
9/22/22,Cambodia,11.55,104.9167,137824,0,3056,134768
9/23/22,Cambodia,11.55,104.9167,137827,0,3056,134771
9/24/22,Cambodia,11.55,104.9167,137833,0,3056,134777
9/25/22,Cambodia,11.55,104.9167,137833,0,3056,134777
9/26/22,Cambodia,11.55,104.9167,137849,0,3056,134793
9/27/22,Cambodia,11.55,104.9167,137856,0,3056,134800
9/28/22,Cambodia,11.55,104.9167,137861,0,3056,134805
9/29/22,Cambodia,11.55,104.9167,137870,0,3056,134814
9/30/22,Cambodia,11.55,104.9167,137877,0,3056,134821
10/1/22,Cambodia,11.55,104.9167,137881,0,3056,134825
10/2/22,Cambodia,11.55,104.9167,137885,0,3056,134829
10/3/22,Cambodia,11.55,104.9167,137893,0,3056,134837
10/4/22,Cambodia,11.55,104.9167,137897,0,3056,134841
10/5/22,Cambodia,11.55,104.9167,137899,0,3056,134843
10/6/22,Cambodia,11.55,104.9167,137906,0,3056,134850
10/7/22,Cambodia,11.55,104.9167,137912,0,3056,134856
10/8/22,Cambodia,11.55,104.9167,137921,0,3056,134865
10/9/22,Cambodia,11.55,104.9167,137927,0,3056,134871
10/10/22,Cambodia,11.55,104.9167,137936,0,3056,134880
10/11/22,Cambodia,11.55,104.9167,137937,0,3056,134881
10/12/22,Cambodia,11.55,104.9167,137941,0,3056,134885
10/13/22,Cambodia,11.55,104.9167,137952,0,3056,134896
10/14/22,Cambodia,11.55,104.9167,137957,0,3056,134901
10/15/22,Cambodia,11.55,104.9167,137963,0,3056,134907
10/16/22,Cambodia,11.55,104.9167,137965,0,3056,134909
10/17/22,Cambodia,11.55,104.9167,137970,0,3056,134914
10/18/22,Cambodia,11.55,104.9167,137975,0,3056,134919
10/19/22,Cambodia,11.55,104.9167,137976,0,3056,134920
10/20/22,Cambodia,11.55,104.9167,137979,0,3056,134923
10/21/22,Cambodia,11.55,104.9167,137979,0,3056,134923
10/22/22,Cambodia,11.55,104.9167,137979,0,3056,134923
10/23/22,Cambodia,11.55,104.9167,137979,0,3056,134923
10/24/22,Cambodia,11.55,104.9167,137979,0,3056,134923
10/25/22,Cambodia,11.55,104.9167,137979,0,3056,134923
10/26/22,Cambodia,11.55,104.9167,137979,0,3056,134923
10/27/22,Cambodia,11.55,104.9167,137979,0,3056,134923
10/28/22,Cambodia,11.55,104.9167,137981,0,3056,134925
10/29/22,Cambodia,11.55,104.9167,137985,0,3056,134929
10/30/22,Cambodia,11.55,104.9167,137988,0,3056,134932
10/31/22,Cambodia,11.55,104.9167,137991,0,3056,134935
11/1/22,Cambodia,11.55,104.9167,137992,0,3056,134936
11/2/22,Cambodia,11.55,104.9167,137993,0,3056,134937
11/3/22,Cambodia,11.55,104.9167,137995,0,3056,134939
11/4/22,Cambodia,11.55,104.9167,137995,0,3056,134939
11/5/22,Cambodia,11.55,104.9167,137995,0,3056,134939
11/6/22,Cambodia,11.55,104.9167,137995,0,3056,134939
11/7/22,Cambodia,11.55,104.9167,137996,0,3056,134940
11/8/22,Cambodia,11.55,104.9167,137996,0,3056,134940
11/9/22,Cambodia,11.55,104.9167,137996,0,3056,134940
11/10/22,Cambodia,11.55,104.9167,137996,0,3056,134940
11/11/22,Cambodia,11.55,104.9167,137996,0,3056,134940
11/12/22,Cambodia,11.55,104.9167,137996,0,3056,134940
11/13/22,Cambodia,11.55,104.9167,137996,0,3056,134940
11/14/22,Cambodia,11.55,104.9167,137999,0,3056,134943
11/15/22,Cambodia,11.55,104.9167,138003,0,3056,134947
11/16/22,Cambodia,11.55,104.9167,138007,0,3056,134951
11/17/22,Cambodia,11.55,104.9167,138010,0,3056,134954
11/18/22,Cambodia,11.55,104.9167,138019,0,3056,134963
11/19/22,Cambodia,11.55,104.9167,138019,0,3056,134963
11/20/22,Cambodia,11.55,104.9167,138028,0,3056,134972
11/21/22,Cambodia,11.55,104.9167,138032,0,3056,134976
11/22/22,Cambodia,11.55,104.9167,138035,0,3056,134979
11/23/22,Cambodia,11.55,104.9167,138039,0,3056,134983
11/24/22,Cambodia,11.55,104.9167,138046,0,3056,134990
11/25/22,Cambodia,11.55,104.9167,138055,0,3056,134999
11/26/22,Cambodia,11.55,104.9167,138059,0,3056,135003
11/27/22,Cambodia,11.55,104.9167,138063,0,3056,135007
11/28/22,Cambodia,11.55,104.9167,138073,0,3056,135017
11/29/22,Cambodia,11.55,104.9167,138082,0,3056,135026
11/30/22,Cambodia,11.55,104.9167,138099,0,3056,135043
12/1/22,Cambodia,11.55,104.9167,138106,0,3056,135050
12/2/22,Cambodia,11.55,104.9167,138120,0,3056,135064
12/3/22,Cambodia,11.55,104.9167,138131,0,3056,135075
12/4/22,Cambodia,11.55,104.9167,138142,0,3056,135086
12/5/22,Cambodia,11.55,104.9167,138157,0,3056,135101
12/6/22,Cambodia,11.55,104.9167,138176,0,3056,135120
12/7/22,Cambodia,11.55,104.9167,138188,0,3056,135132
12/8/22,Cambodia,11.55,104.9167,138202,0,3056,135146
12/9/22,Cambodia,11.55,104.9167,138202,0,3056,135146
12/10/22,Cambodia,11.55,104.9167,138238,0,3056,135182
12/11/22,Cambodia,11.55,104.9167,138251,0,3056,135195
12/12/22,Cambodia,11.55,104.9167,138276,0,3056,135220
12/13/22,Cambodia,11.55,104.9167,138302,0,3056,135246
12/14/22,Cambodia,11.55,104.9167,138320,0,3056,135264
12/15/22,Cambodia,11.55,104.9167,138347,0,3056,135291
12/16/22,Cambodia,11.55,104.9167,138362,0,3056,135306
12/17/22,Cambodia,11.55,104.9167,138362,0,3056,135306
1/1/22,Cameroon,3.848,11.5021,109367,0,1851,107516
1/2/22,Cameroon,3.848,11.5021,109367,0,1851,107516
1/3/22,Cameroon,3.848,11.5021,109367,0,1851,107516
1/4/22,Cameroon,3.848,11.5021,109367,0,1851,107516
1/5/22,Cameroon,3.848,11.5021,109367,0,1851,107516
1/6/22,Cameroon,3.848,11.5021,109367,0,1851,107516
1/7/22,Cameroon,3.848,11.5021,109666,0,1853,107813
1/8/22,Cameroon,3.848,11.5021,109666,0,1853,107813
1/9/22,Cameroon,3.848,11.5021,109666,0,1853,107813
1/10/22,Cameroon,3.848,11.5021,109666,0,1853,107813
1/11/22,Cameroon,3.848,11.5021,109666,0,1853,107813
1/12/22,Cameroon,3.848,11.5021,109666,0,1853,107813
1/13/22,Cameroon,3.848,11.5021,109666,0,1853,107813
1/14/22,Cameroon,3.848,11.5021,109666,0,1853,107813
1/15/22,Cameroon,3.848,11.5021,109666,0,1853,107813
1/16/22,Cameroon,3.848,11.5021,109666,0,1853,107813
1/17/22,Cameroon,3.848,11.5021,109666,0,1853,107813
1/18/22,Cameroon,3.848,11.5021,109666,0,1853,107813
1/19/22,Cameroon,3.848,11.5021,109666,0,1853,107813
1/20/22,Cameroon,3.848,11.5021,109666,0,1853,107813
1/21/22,Cameroon,3.848,11.5021,114113,0,1867,112246
1/22/22,Cameroon,3.848,11.5021,114113,0,1867,112246
1/23/22,Cameroon,3.848,11.5021,114113,0,1867,112246
1/24/22,Cameroon,3.848,11.5021,114113,0,1867,112246
1/25/22,Cameroon,3.848,11.5021,114113,0,1867,112246
1/26/22,Cameroon,3.848,11.5021,114113,0,1867,112246
1/27/22,Cameroon,3.848,11.5021,114113,0,1867,112246
1/28/22,Cameroon,3.848,11.5021,114113,0,1867,112246
1/29/22,Cameroon,3.848,11.5021,114113,0,1867,112246
1/30/22,Cameroon,3.848,11.5021,114113,0,1867,112246
1/31/22,Cameroon,3.848,11.5021,116718,0,1880,114838
2/1/22,Cameroon,3.848,11.5021,116718,0,1880,114838
2/2/22,Cameroon,3.848,11.5021,116718,0,1880,114838
2/3/22,Cameroon,3.848,11.5021,116718,0,1880,114838
2/4/22,Cameroon,3.848,11.5021,116718,0,1880,114838
2/5/22,Cameroon,3.848,11.5021,116718,0,1880,114838
2/6/22,Cameroon,3.848,11.5021,116718,0,1880,114838
2/7/22,Cameroon,3.848,11.5021,117676,0,1907,115769
2/8/22,Cameroon,3.848,11.5021,117676,0,1907,115769
2/9/22,Cameroon,3.848,11.5021,117676,0,1907,115769
2/10/22,Cameroon,3.848,11.5021,117676,0,1907,115769
2/11/22,Cameroon,3.848,11.5021,118675,0,1915,116760
2/12/22,Cameroon,3.848,11.5021,118675,0,1915,116760
2/13/22,Cameroon,3.848,11.5021,118675,0,1915,116760
2/14/22,Cameroon,3.848,11.5021,118675,0,1915,116760
2/15/22,Cameroon,3.848,11.5021,118675,0,1915,116760
2/16/22,Cameroon,3.848,11.5021,118675,0,1915,116760
2/17/22,Cameroon,3.848,11.5021,119107,0,1920,117187
2/18/22,Cameroon,3.848,11.5021,119107,0,1920,117187
2/19/22,Cameroon,3.848,11.5021,119107,0,1920,117187
2/20/22,Cameroon,3.848,11.5021,119107,0,1920,117187
2/21/22,Cameroon,3.848,11.5021,119107,0,1920,117187
2/22/22,Cameroon,3.848,11.5021,119107,0,1920,117187
2/23/22,Cameroon,3.848,11.5021,119107,0,1920,117187
2/24/22,Cameroon,3.848,11.5021,119240,0,1923,117317
2/25/22,Cameroon,3.848,11.5021,119240,0,1923,117317
2/26/22,Cameroon,3.848,11.5021,119240,0,1923,117317
2/27/22,Cameroon,3.848,11.5021,119240,0,1923,117317
2/28/22,Cameroon,3.848,11.5021,119240,0,1923,117317
3/1/22,Cameroon,3.848,11.5021,119240,0,1923,117317
3/2/22,Cameroon,3.848,11.5021,119240,0,1923,117317
3/3/22,Cameroon,3.848,11.5021,119322,0,1926,117396
3/4/22,Cameroon,3.848,11.5021,119322,0,1926,117396
3/5/22,Cameroon,3.848,11.5021,119322,0,1926,117396
3/6/22,Cameroon,3.848,11.5021,119322,0,1926,117396
3/7/22,Cameroon,3.848,11.5021,119322,0,1926,117396
3/8/22,Cameroon,3.848,11.5021,119322,0,1926,117396
3/9/22,Cameroon,3.848,11.5021,119322,0,1926,117396
3/10/22,Cameroon,3.848,11.5021,119322,0,1926,117396
3/11/22,Cameroon,3.848,11.5021,119322,0,1926,117396
3/12/22,Cameroon,3.848,11.5021,119322,0,1926,117396
3/13/22,Cameroon,3.848,11.5021,119322,0,1926,117396
3/14/22,Cameroon,3.848,11.5021,119322,0,1926,117396
3/15/22,Cameroon,3.848,11.5021,119322,0,1926,117396
3/16/22,Cameroon,3.848,11.5021,119414,0,1926,117488
3/17/22,Cameroon,3.848,11.5021,119414,0,1926,117488
3/18/22,Cameroon,3.848,11.5021,119414,0,1926,117488
3/19/22,Cameroon,3.848,11.5021,119414,0,1926,117488
3/20/22,Cameroon,3.848,11.5021,119544,0,1927,117617
3/21/22,Cameroon,3.848,11.5021,119544,0,1927,117617
3/22/22,Cameroon,3.848,11.5021,119544,0,1927,117617
3/23/22,Cameroon,3.848,11.5021,119544,0,1927,117617
3/24/22,Cameroon,3.848,11.5021,119544,0,1927,117617
3/25/22,Cameroon,3.848,11.5021,119544,0,1927,117617
3/26/22,Cameroon,3.848,11.5021,119544,0,1927,117617
3/27/22,Cameroon,3.848,11.5021,119544,0,1927,117617
3/28/22,Cameroon,3.848,11.5021,119544,0,1927,117617
3/29/22,Cameroon,3.848,11.5021,119544,0,1927,117617
3/30/22,Cameroon,3.848,11.5021,119544,0,1927,117617
3/31/22,Cameroon,3.848,11.5021,119544,0,1927,117617
4/1/22,Cameroon,3.848,11.5021,119544,0,1927,117617
4/2/22,Cameroon,3.848,11.5021,119544,0,1927,117617
4/3/22,Cameroon,3.848,11.5021,119544,0,1927,117617
4/4/22,Cameroon,3.848,11.5021,119544,0,1927,117617
4/5/22,Cameroon,3.848,11.5021,119544,0,1927,117617
4/6/22,Cameroon,3.848,11.5021,119544,0,1927,117617
4/7/22,Cameroon,3.848,11.5021,119544,0,1927,117617
4/8/22,Cameroon,3.848,11.5021,119780,0,1927,117853
4/9/22,Cameroon,3.848,11.5021,119780,0,1927,117853
4/10/22,Cameroon,3.848,11.5021,119780,0,1927,117853
4/11/22,Cameroon,3.848,11.5021,119780,0,1927,117853
4/12/22,Cameroon,3.848,11.5021,119780,0,1927,117853
4/13/22,Cameroon,3.848,11.5021,119780,0,1927,117853
4/14/22,Cameroon,3.848,11.5021,119780,0,1927,117853
4/15/22,Cameroon,3.848,11.5021,119780,0,1927,117853
4/16/22,Cameroon,3.848,11.5021,119780,0,1927,117853
4/17/22,Cameroon,3.848,11.5021,119780,0,1927,117853
4/18/22,Cameroon,3.848,11.5021,119780,0,1927,117853
4/19/22,Cameroon,3.848,11.5021,119780,0,1927,117853
4/20/22,Cameroon,3.848,11.5021,119780,0,1927,117853
4/21/22,Cameroon,3.848,11.5021,119780,0,1927,117853
4/22/22,Cameroon,3.848,11.5021,119780,0,1927,117853
4/23/22,Cameroon,3.848,11.5021,119780,0,1927,117853
4/24/22,Cameroon,3.848,11.5021,119780,0,1927,117853
4/25/22,Cameroon,3.848,11.5021,119780,0,1927,117853
4/26/22,Cameroon,3.848,11.5021,119780,0,1927,117853
4/27/22,Cameroon,3.848,11.5021,119780,0,1927,117853
4/28/22,Cameroon,3.848,11.5021,119780,0,1927,117853
4/29/22,Cameroon,3.848,11.5021,119780,0,1927,117853
4/30/22,Cameroon,3.848,11.5021,119780,0,1927,117853
5/1/22,Cameroon,3.848,11.5021,119780,0,1927,117853
5/2/22,Cameroon,3.848,11.5021,119780,0,1927,117853
5/3/22,Cameroon,3.848,11.5021,119780,0,1927,117853
5/4/22,Cameroon,3.848,11.5021,119780,0,1927,117853
5/5/22,Cameroon,3.848,11.5021,119780,0,1927,117853
5/6/22,Cameroon,3.848,11.5021,119780,0,1927,117853
5/7/22,Cameroon,3.848,11.5021,119780,0,1927,117853
5/8/22,Cameroon,3.848,11.5021,119780,0,1927,117853
5/9/22,Cameroon,3.848,11.5021,119780,0,1927,117853
5/10/22,Cameroon,3.848,11.5021,119780,0,1927,117853
5/11/22,Cameroon,3.848,11.5021,119780,0,1927,117853
5/12/22,Cameroon,3.848,11.5021,119780,0,1927,117853
5/13/22,Cameroon,3.848,11.5021,119780,0,1927,117853
5/14/22,Cameroon,3.848,11.5021,119780,0,1927,117853
5/15/22,Cameroon,3.848,11.5021,119780,0,1927,117853
5/16/22,Cameroon,3.848,11.5021,119780,0,1927,117853
5/17/22,Cameroon,3.848,11.5021,119780,0,1927,117853
5/18/22,Cameroon,3.848,11.5021,119780,0,1927,117853
5/19/22,Cameroon,3.848,11.5021,119780,0,1927,117853
5/20/22,Cameroon,3.848,11.5021,119780,0,1927,117853
5/21/22,Cameroon,3.848,11.5021,119780,0,1927,117853
5/22/22,Cameroon,3.848,11.5021,119780,0,1927,117853
5/23/22,Cameroon,3.848,11.5021,119780,0,1927,117853
5/24/22,Cameroon,3.848,11.5021,119780,0,1927,117853
5/25/22,Cameroon,3.848,11.5021,119947,0,1930,118017
5/26/22,Cameroon,3.848,11.5021,119947,0,1930,118017
5/27/22,Cameroon,3.848,11.5021,119947,0,1930,118017
5/28/22,Cameroon,3.848,11.5021,119947,0,1930,118017
5/29/22,Cameroon,3.848,11.5021,119947,0,1930,118017
5/30/22,Cameroon,3.848,11.5021,119947,0,1930,118017
5/31/22,Cameroon,3.848,11.5021,119947,0,1930,118017
6/1/22,Cameroon,3.848,11.5021,119947,0,1930,118017
6/2/22,Cameroon,3.848,11.5021,119947,0,1930,118017
6/3/22,Cameroon,3.848,11.5021,119947,0,1930,118017
6/4/22,Cameroon,3.848,11.5021,119947,0,1930,118017
6/5/22,Cameroon,3.848,11.5021,119947,0,1930,118017
6/6/22,Cameroon,3.848,11.5021,119947,0,1930,118017
6/7/22,Cameroon,3.848,11.5021,119947,0,1930,118017
6/8/22,Cameroon,3.848,11.5021,119947,0,1930,118017
6/9/22,Cameroon,3.848,11.5021,119947,0,1930,118017
6/10/22,Cameroon,3.848,11.5021,119947,0,1930,118017
6/11/22,Cameroon,3.848,11.5021,119947,0,1930,118017
6/12/22,Cameroon,3.848,11.5021,119947,0,1930,118017
6/13/22,Cameroon,3.848,11.5021,119947,0,1930,118017
6/14/22,Cameroon,3.848,11.5021,119947,0,1930,118017
6/15/22,Cameroon,3.848,11.5021,119947,0,1930,118017
6/16/22,Cameroon,3.848,11.5021,119947,0,1930,118017
6/17/22,Cameroon,3.848,11.5021,119947,0,1930,118017
6/18/22,Cameroon,3.848,11.5021,119947,0,1930,118017
6/19/22,Cameroon,3.848,11.5021,119947,0,1930,118017
6/20/22,Cameroon,3.848,11.5021,119947,0,1930,118017
6/21/22,Cameroon,3.848,11.5021,119947,0,1930,118017
6/22/22,Cameroon,3.848,11.5021,119947,0,1930,118017
6/23/22,Cameroon,3.848,11.5021,120002,0,1930,118072
6/24/22,Cameroon,3.848,11.5021,120002,0,1930,118072
6/25/22,Cameroon,3.848,11.5021,120002,0,1930,118072
6/26/22,Cameroon,3.848,11.5021,120002,0,1930,118072
6/27/22,Cameroon,3.848,11.5021,120002,0,1930,118072
6/28/22,Cameroon,3.848,11.5021,120068,0,1931,118137
6/29/22,Cameroon,3.848,11.5021,120068,0,1931,118137
6/30/22,Cameroon,3.848,11.5021,120068,0,1931,118137
7/1/22,Cameroon,3.848,11.5021,120068,0,1931,118137
7/2/22,Cameroon,3.848,11.5021,120068,0,1931,118137
7/3/22,Cameroon,3.848,11.5021,120068,0,1931,118137
7/4/22,Cameroon,3.848,11.5021,120068,0,1931,118137
7/5/22,Cameroon,3.848,11.5021,120068,0,1931,118137
7/6/22,Cameroon,3.848,11.5021,120068,0,1931,118137
7/7/22,Cameroon,3.848,11.5021,120068,0,1931,118137
7/8/22,Cameroon,3.848,11.5021,120068,0,1931,118137
7/9/22,Cameroon,3.848,11.5021,120068,0,1931,118137
7/10/22,Cameroon,3.848,11.5021,120068,0,1931,118137
7/11/22,Cameroon,3.848,11.5021,120068,0,1931,118137
7/12/22,Cameroon,3.848,11.5021,120068,0,1931,118137
7/13/22,Cameroon,3.848,11.5021,120068,0,1931,118137
7/14/22,Cameroon,3.848,11.5021,120068,0,1931,118137
7/15/22,Cameroon,3.848,11.5021,120068,0,1931,118137
7/16/22,Cameroon,3.848,11.5021,120068,0,1931,118137
7/17/22,Cameroon,3.848,11.5021,120068,0,1931,118137
7/18/22,Cameroon,3.848,11.5021,120068,0,1931,118137
7/19/22,Cameroon,3.848,11.5021,120068,0,1931,118137
7/20/22,Cameroon,3.848,11.5021,120068,0,1931,118137
7/21/22,Cameroon,3.848,11.5021,120068,0,1931,118137
7/22/22,Cameroon,3.848,11.5021,120068,0,1931,118137
7/23/22,Cameroon,3.848,11.5021,120068,0,1931,118137
7/24/22,Cameroon,3.848,11.5021,120068,0,1931,118137
7/25/22,Cameroon,3.848,11.5021,120068,0,1931,118137
7/26/22,Cameroon,3.848,11.5021,120215,0,1931,118284
7/27/22,Cameroon,3.848,11.5021,120215,0,1931,118284
7/28/22,Cameroon,3.848,11.5021,120215,0,1931,118284
7/29/22,Cameroon,3.848,11.5021,120215,0,1931,118284
7/30/22,Cameroon,3.848,11.5021,120215,0,1931,118284
7/31/22,Cameroon,3.848,11.5021,120215,0,1931,118284
8/1/22,Cameroon,3.848,11.5021,120215,0,1931,118284
8/2/22,Cameroon,3.848,11.5021,120215,0,1931,118284
8/3/22,Cameroon,3.848,11.5021,120215,0,1931,118284
8/4/22,Cameroon,3.848,11.5021,120215,0,1931,118284
8/5/22,Cameroon,3.848,11.5021,120215,0,1931,118284
8/6/22,Cameroon,3.848,11.5021,120215,0,1931,118284
8/7/22,Cameroon,3.848,11.5021,120215,0,1931,118284
8/8/22,Cameroon,3.848,11.5021,120215,0,1931,118284
8/9/22,Cameroon,3.848,11.5021,120215,0,1931,118284
8/10/22,Cameroon,3.848,11.5021,120215,0,1931,118284
8/11/22,Cameroon,3.848,11.5021,120215,0,1931,118284
8/12/22,Cameroon,3.848,11.5021,120967,0,1933,119034
8/13/22,Cameroon,3.848,11.5021,120967,0,1933,119034
8/14/22,Cameroon,3.848,11.5021,120967,0,1933,119034
8/15/22,Cameroon,3.848,11.5021,120967,0,1933,119034
8/16/22,Cameroon,3.848,11.5021,120967,0,1933,119034
8/17/22,Cameroon,3.848,11.5021,120967,0,1933,119034
8/18/22,Cameroon,3.848,11.5021,120967,0,1933,119034
8/19/22,Cameroon,3.848,11.5021,120967,0,1933,119034
8/20/22,Cameroon,3.848,11.5021,120967,0,1933,119034
8/21/22,Cameroon,3.848,11.5021,120967,0,1933,119034
8/22/22,Cameroon,3.848,11.5021,120967,0,1933,119034
8/23/22,Cameroon,3.848,11.5021,120967,0,1933,119034
8/24/22,Cameroon,3.848,11.5021,120967,0,1933,119034
8/25/22,Cameroon,3.848,11.5021,120967,0,1933,119034
8/26/22,Cameroon,3.848,11.5021,121652,0,1935,119717
8/27/22,Cameroon,3.848,11.5021,121652,0,1935,119717
8/28/22,Cameroon,3.848,11.5021,121652,0,1935,119717
8/29/22,Cameroon,3.848,11.5021,121652,0,1935,119717
8/30/22,Cameroon,3.848,11.5021,121652,0,1935,119717
8/31/22,Cameroon,3.848,11.5021,121652,0,1935,119717
9/1/22,Cameroon,3.848,11.5021,121652,0,1935,119717
9/2/22,Cameroon,3.848,11.5021,121652,0,1935,119717
9/3/22,Cameroon,3.848,11.5021,121652,0,1935,119717
9/4/22,Cameroon,3.848,11.5021,121652,0,1935,119717
9/5/22,Cameroon,3.848,11.5021,121652,0,1935,119717
9/6/22,Cameroon,3.848,11.5021,121652,0,1935,119717
9/7/22,Cameroon,3.848,11.5021,121652,0,1935,119717
9/8/22,Cameroon,3.848,11.5021,121652,0,1935,119717
9/9/22,Cameroon,3.848,11.5021,121652,0,1935,119717
9/10/22,Cameroon,3.848,11.5021,121652,0,1935,119717
9/11/22,Cameroon,3.848,11.5021,121652,0,1935,119717
9/12/22,Cameroon,3.848,11.5021,121652,0,1935,119717
9/13/22,Cameroon,3.848,11.5021,121652,0,1935,119717
9/14/22,Cameroon,3.848,11.5021,121652,0,1935,119717
9/15/22,Cameroon,3.848,11.5021,121652,0,1935,119717
9/16/22,Cameroon,3.848,11.5021,121652,0,1935,119717
9/17/22,Cameroon,3.848,11.5021,121652,0,1935,119717
9/18/22,Cameroon,3.848,11.5021,121652,0,1935,119717
9/19/22,Cameroon,3.848,11.5021,121652,0,1935,119717
9/20/22,Cameroon,3.848,11.5021,121652,0,1935,119717
9/21/22,Cameroon,3.848,11.5021,121652,0,1935,119717
9/22/22,Cameroon,3.848,11.5021,121652,0,1935,119717
9/23/22,Cameroon,3.848,11.5021,121652,0,1935,119717
9/24/22,Cameroon,3.848,11.5021,121652,0,1935,119717
9/25/22,Cameroon,3.848,11.5021,121652,0,1935,119717
9/26/22,Cameroon,3.848,11.5021,121652,0,1935,119717
9/27/22,Cameroon,3.848,11.5021,121652,0,1935,119717
9/28/22,Cameroon,3.848,11.5021,121652,0,1935,119717
9/29/22,Cameroon,3.848,11.5021,121652,0,1935,119717
9/30/22,Cameroon,3.848,11.5021,121652,0,1935,119717
10/1/22,Cameroon,3.848,11.5021,121652,0,1935,119717
10/2/22,Cameroon,3.848,11.5021,121652,0,1935,119717
10/3/22,Cameroon,3.848,11.5021,121652,0,1935,119717
10/4/22,Cameroon,3.848,11.5021,121652,0,1935,119717
10/5/22,Cameroon,3.848,11.5021,121652,0,1935,119717
10/6/22,Cameroon,3.848,11.5021,121652,0,1935,119717
10/7/22,Cameroon,3.848,11.5021,121652,0,1935,119717
10/8/22,Cameroon,3.848,11.5021,121652,0,1935,119717
10/9/22,Cameroon,3.848,11.5021,121652,0,1935,119717
10/10/22,Cameroon,3.848,11.5021,121652,0,1935,119717
10/11/22,Cameroon,3.848,11.5021,121652,0,1935,119717
10/12/22,Cameroon,3.848,11.5021,121652,0,1935,119717
10/13/22,Cameroon,3.848,11.5021,121652,0,1935,119717
10/14/22,Cameroon,3.848,11.5021,121652,0,1935,119717
10/15/22,Cameroon,3.848,11.5021,121652,0,1935,119717
10/16/22,Cameroon,3.848,11.5021,121652,0,1935,119717
10/17/22,Cameroon,3.848,11.5021,121652,0,1935,119717
10/18/22,Cameroon,3.848,11.5021,121652,0,1935,119717
10/19/22,Cameroon,3.848,11.5021,121652,0,1935,119717
10/20/22,Cameroon,3.848,11.5021,121652,0,1935,119717
10/21/22,Cameroon,3.848,11.5021,121652,0,1935,119717
10/22/22,Cameroon,3.848,11.5021,121652,0,1935,119717
10/23/22,Cameroon,3.848,11.5021,121652,0,1935,119717
10/24/22,Cameroon,3.848,11.5021,123629,0,1960,121669
10/25/22,Cameroon,3.848,11.5021,123629,0,1960,121669
10/26/22,Cameroon,3.848,11.5021,123629,0,1960,121669
10/27/22,Cameroon,3.848,11.5021,123629,0,1960,121669
10/28/22,Cameroon,3.848,11.5021,123629,0,1960,121669
10/29/22,Cameroon,3.848,11.5021,123629,0,1960,121669
10/30/22,Cameroon,3.848,11.5021,123629,0,1960,121669
10/31/22,Cameroon,3.848,11.5021,123629,0,1960,121669
11/1/22,Cameroon,3.848,11.5021,123629,0,1960,121669
11/2/22,Cameroon,3.848,11.5021,123629,0,1960,121669
11/3/22,Cameroon,3.848,11.5021,123629,0,1960,121669
11/4/22,Cameroon,3.848,11.5021,123629,0,1960,121669
11/5/22,Cameroon,3.848,11.5021,123629,0,1960,121669
11/6/22,Cameroon,3.848,11.5021,123629,0,1960,121669
11/7/22,Cameroon,3.848,11.5021,123993,0,1965,122028
11/8/22,Cameroon,3.848,11.5021,123993,0,1965,122028
11/9/22,Cameroon,3.848,11.5021,123993,0,1965,122028
11/10/22,Cameroon,3.848,11.5021,123993,0,1965,122028
11/11/22,Cameroon,3.848,11.5021,123993,0,1965,122028
11/12/22,Cameroon,3.848,11.5021,123993,0,1965,122028
11/13/22,Cameroon,3.848,11.5021,123993,0,1965,122028
11/14/22,Cameroon,3.848,11.5021,123993,0,1965,122028
11/15/22,Cameroon,3.848,11.5021,123993,0,1965,122028
11/16/22,Cameroon,3.848,11.5021,123993,0,1965,122028
11/17/22,Cameroon,3.848,11.5021,123993,0,1965,122028
11/18/22,Cameroon,3.848,11.5021,123993,0,1965,122028
11/19/22,Cameroon,3.848,11.5021,123993,0,1965,122028
11/20/22,Cameroon,3.848,11.5021,123993,0,1965,122028
11/21/22,Cameroon,3.848,11.5021,123993,0,1965,122028
11/22/22,Cameroon,3.848,11.5021,123993,0,1965,122028
11/23/22,Cameroon,3.848,11.5021,123993,0,1965,122028
11/24/22,Cameroon,3.848,11.5021,123993,0,1965,122028
11/25/22,Cameroon,3.848,11.5021,123993,0,1965,122028
11/26/22,Cameroon,3.848,11.5021,123993,0,1965,122028
11/27/22,Cameroon,3.848,11.5021,123993,0,1965,122028
11/28/22,Cameroon,3.848,11.5021,123993,0,1965,122028
11/29/22,Cameroon,3.848,11.5021,123993,0,1965,122028
11/30/22,Cameroon,3.848,11.5021,123993,0,1965,122028
12/1/22,Cameroon,3.848,11.5021,123993,0,1965,122028
12/2/22,Cameroon,3.848,11.5021,123993,0,1965,122028
12/3/22,Cameroon,3.848,11.5021,123993,0,1965,122028
12/4/22,Cameroon,3.848,11.5021,123993,0,1965,122028
12/5/22,Cameroon,3.848,11.5021,123993,0,1965,122028
12/6/22,Cameroon,3.848,11.5021,123993,0,1965,122028
12/7/22,Cameroon,3.848,11.5021,123993,0,1965,122028
12/8/22,Cameroon,3.848,11.5021,123993,0,1965,122028
12/9/22,Cameroon,3.848,11.5021,123993,0,1965,122028
12/10/22,Cameroon,3.848,11.5021,123993,0,1965,122028
12/11/22,Cameroon,3.848,11.5021,123993,0,1965,122028
12/12/22,Cameroon,3.848,11.5021,123993,0,1965,122028
12/13/22,Cameroon,3.848,11.5021,123993,0,1965,122028
12/14/22,Cameroon,3.848,11.5021,123993,0,1965,122028
12/15/22,Cameroon,3.848,11.5021,123993,0,1965,122028
12/16/22,Cameroon,3.848,11.5021,123993,0,1965,122028
12/17/22,Cameroon,3.848,11.5021,123993,0,1965,122028
1/1/22,Canada,56.1304,-106.3468,2256747,0,30340,2226407
1/2/22,Canada,56.1304,-106.3468,2286735,0,30370,2256365
1/3/22,Canada,56.1304,-106.3468,2323056,0,30400,2292656
1/4/22,Canada,56.1304,-106.3468,2372323,0,30436,2341887
1/5/22,Canada,56.1304,-106.3468,2412242,0,30525,2381717
1/6/22,Canada,56.1304,-106.3468,2454121,0,30585,2423536
1/7/22,Canada,56.1304,-106.3468,2499612,0,30668,2468944
1/8/22,Canada,56.1304,-106.3468,2528644,0,30699,2497945
1/9/22,Canada,56.1304,-106.3468,2554916,0,30765,2524151
1/10/22,Canada,56.1304,-106.3468,2613377,0,30861,2582516
1/11/22,Canada,56.1304,-106.3468,2646228,0,30957,2615271
1/12/22,Canada,56.1304,-106.3468,2681101,0,31081,2650020
1/13/22,Canada,56.1304,-106.3468,2712688,0,31191,2681497
1/14/22,Canada,56.1304,-106.3468,2753198,0,31324,2721874
1/15/22,Canada,56.1304,-106.3468,2771345,0,31465,2739880
1/16/22,Canada,56.1304,-106.3468,2786622,0,31531,2755091
1/17/22,Canada,56.1304,-106.3468,2828029,0,31676,2796353
1/18/22,Canada,56.1304,-106.3468,2848893,0,31827,2817066
1/19/22,Canada,56.1304,-106.3468,2872365,0,32006,2840359
1/20/22,Canada,56.1304,-106.3468,2895331,0,32217,2863114
1/21/22,Canada,56.1304,-106.3468,2916524,0,32380,2884144
1/22/22,Canada,56.1304,-106.3468,2930307,0,32504,2897803
1/23/22,Canada,56.1304,-106.3468,2935575,0,32560,2903015
1/24/22,Canada,56.1304,-106.3468,2955087,0,32716,2922371
1/25/22,Canada,56.1304,-106.3468,2984054,0,32962,2951092
1/26/22,Canada,56.1304,-106.3468,2991708,0,33068,2958640
1/27/22,Canada,56.1304,-106.3468,3020108,0,33368,2986740
1/28/22,Canada,56.1304,-106.3468,3036647,0,33523,3003124
1/29/22,Canada,56.1304,-106.3468,3045083,0,33647,3011436
1/30/22,Canada,56.1304,-106.3468,3052373,0,33722,3018651
1/31/22,Canada,56.1304,-106.3468,3073654,0,33870,3039784
2/1/22,Canada,56.1304,-106.3468,3085591,0,34032,3051559
2/2/22,Canada,56.1304,-106.3468,3100943,0,34207,3066736
2/3/22,Canada,56.1304,-106.3468,3114115,0,34378,3079737
2/4/22,Canada,56.1304,-106.3468,3127213,0,34537,3092676
2/5/22,Canada,56.1304,-106.3468,3133836,0,34636,3099200
2/6/22,Canada,56.1304,-106.3468,3139239,0,34720,3104519
2/7/22,Canada,56.1304,-106.3468,3155289,0,34845,3120444
2/8/22,Canada,56.1304,-106.3468,3165329,0,34969,3130360
2/9/22,Canada,56.1304,-106.3468,3175654,0,35114,3140540
2/10/22,Canada,56.1304,-106.3468,3186035,0,35231,3150804
2/11/22,Canada,56.1304,-106.3468,3193438,0,35372,3158066
2/12/22,Canada,56.1304,-106.3468,3203282,0,35481,3167801
2/13/22,Canada,56.1304,-106.3468,3206897,0,35512,3171385
2/14/22,Canada,56.1304,-106.3468,3219086,0,35614,3183472
2/15/22,Canada,56.1304,-106.3468,3225542,0,35716,3189826
2/16/22,Canada,56.1304,-106.3468,3233298,0,35829,3197469
2/17/22,Canada,56.1304,-106.3468,3240493,0,35918,3204575
2/18/22,Canada,56.1304,-106.3468,3247240,0,35997,3211243
2/19/22,Canada,56.1304,-106.3468,3250784,0,36013,3214771
2/20/22,Canada,56.1304,-106.3468,3253232,0,36042,3217190
2/21/22,Canada,56.1304,-106.3468,3256889,0,36062,3220827
2/22/22,Canada,56.1304,-106.3468,3264880,0,36159,3228721
2/23/22,Canada,56.1304,-106.3468,3274692,0,36255,3238437
2/24/22,Canada,56.1304,-106.3468,3280453,0,36332,3244121
2/25/22,Canada,56.1304,-106.3468,3289085,0,36473,3252612
2/26/22,Canada,56.1304,-106.3468,3290897,0,36507,3254390
2/27/22,Canada,56.1304,-106.3468,3294481,0,36536,3257945
2/28/22,Canada,56.1304,-106.3468,3302400,0,36594,3265806
3/1/22,Canada,56.1304,-106.3468,3307510,0,36630,3270880
3/2/22,Canada,56.1304,-106.3468,3313423,0,36726,3276697
3/3/22,Canada,56.1304,-106.3468,3321778,0,36798,3284980
3/4/22,Canada,56.1304,-106.3468,3331281,0,36909,3294372
3/5/22,Canada,56.1304,-106.3468,3334478,0,36953,3297525
3/6/22,Canada,56.1304,-106.3468,3337091,0,36983,3300108
3/7/22,Canada,56.1304,-106.3468,3345546,0,37040,3308506
3/8/22,Canada,56.1304,-106.3468,3349699,0,37095,3312604
3/9/22,Canada,56.1304,-106.3468,3356440,0,37158,3319282
3/10/22,Canada,56.1304,-106.3468,3362047,0,37211,3324836
3/11/22,Canada,56.1304,-106.3468,3370105,0,36853,3333252
3/12/22,Canada,56.1304,-106.3468,3371929,0,36887,3335042
3/13/22,Canada,56.1304,-106.3468,3373322,0,36901,3336421
3/14/22,Canada,56.1304,-106.3468,3377844,0,36945,3340899
3/15/22,Canada,56.1304,-106.3468,3386875,0,36991,3349884
3/16/22,Canada,56.1304,-106.3468,3392165,0,37029,3355136
3/17/22,Canada,56.1304,-106.3468,3396364,0,37074,3359290
3/18/22,Canada,56.1304,-106.3468,3399704,0,37134,3362570
3/19/22,Canada,56.1304,-106.3468,3402711,0,37157,3365554
3/20/22,Canada,56.1304,-106.3468,3404964,0,37168,3367796
3/21/22,Canada,56.1304,-106.3468,3413117,0,37208,3375909
3/22/22,Canada,56.1304,-106.3468,3422583,0,37241,3385342
3/23/22,Canada,56.1304,-106.3468,3429407,0,37282,3392125
3/24/22,Canada,56.1304,-106.3468,3436460,0,37354,3399106
3/25/22,Canada,56.1304,-106.3468,3445404,0,37403,3408001
3/26/22,Canada,56.1304,-106.3468,3449778,0,37431,3412347
3/27/22,Canada,56.1304,-106.3468,3453432,0,37440,3415992
3/28/22,Canada,56.1304,-106.3468,3459582,0,37460,3422122
3/29/22,Canada,56.1304,-106.3468,3470143,0,37495,3432648
3/30/22,Canada,56.1304,-106.3468,3481119,0,37555,3443564
3/31/22,Canada,56.1304,-106.3468,3489910,0,37597,3452313
4/1/22,Canada,56.1304,-106.3468,3502380,0,37666,3464714
4/2/22,Canada,56.1304,-106.3468,3509394,0,37699,3471695
4/3/22,Canada,56.1304,-106.3468,3511975,0,37716,3474259
4/4/22,Canada,56.1304,-106.3468,3512535,0,37729,3474806
4/5/22,Canada,56.1304,-106.3468,3521439,0,37772,3483667
4/6/22,Canada,56.1304,-106.3468,3530991,0,37847,3493144
4/7/22,Canada,56.1304,-106.3468,3537010,0,37904,3499106
4/8/22,Canada,56.1304,-106.3468,3537010,0,37914,3499096
4/9/22,Canada,56.1304,-106.3468,3552577,0,37997,3514580
4/10/22,Canada,56.1304,-106.3468,3552577,0,38012,3514565
4/11/22,Canada,56.1304,-106.3468,3552709,0,38015,3514694
4/12/22,Canada,56.1304,-106.3468,3552709,0,38019,3514690
4/13/22,Canada,56.1304,-106.3468,3616387,0,38159,3578228
4/14/22,Canada,56.1304,-106.3468,3635332,0,38289,3597043
4/15/22,Canada,56.1304,-106.3468,3627286,0,38329,3588957
4/16/22,Canada,56.1304,-106.3468,3643973,0,38368,3605605
4/17/22,Canada,56.1304,-106.3468,3645911,0,38390,3607521
4/18/22,Canada,56.1304,-106.3468,3657885,0,38403,3619482
4/19/22,Canada,56.1304,-106.3468,3665778,0,38428,3627350
4/20/22,Canada,56.1304,-106.3468,3679211,0,38533,3640678
4/21/22,Canada,56.1304,-106.3468,3689726,0,38654,3651072
4/22/22,Canada,56.1304,-106.3468,3707016,0,38749,3668267
4/23/22,Canada,56.1304,-106.3468,3711767,0,38807,3672960
4/24/22,Canada,56.1304,-106.3468,3716424,0,38833,3677591
4/25/22,Canada,56.1304,-106.3468,3720307,0,38848,3681459
4/26/22,Canada,56.1304,-106.3468,3727897,0,38894,3689003
4/27/22,Canada,56.1304,-106.3468,3740982,0,39008,3701974
4/28/22,Canada,56.1304,-106.3468,3749479,0,39145,3710334
4/29/22,Canada,56.1304,-106.3468,3761708,0,39229,3722479
4/30/22,Canada,56.1304,-106.3468,3765164,0,39265,3725899
5/1/22,Canada,56.1304,-106.3468,3767783,0,39288,3728495
5/2/22,Canada,56.1304,-106.3468,3770449,0,39293,3731156
5/3/22,Canada,56.1304,-106.3468,3776005,0,39337,3736668
5/4/22,Canada,56.1304,-106.3468,3786803,0,39483,3747320
5/5/22,Canada,56.1304,-106.3468,3793942,0,39642,3754300
5/6/22,Canada,56.1304,-106.3468,3802912,0,39717,3763195
5/7/22,Canada,56.1304,-106.3468,3805370,0,39772,3765598
5/8/22,Canada,56.1304,-106.3468,3807514,0,39784,3767730
5/9/22,Canada,56.1304,-106.3468,3809685,0,39788,3769897
5/10/22,Canada,56.1304,-106.3468,3814073,0,39843,3774230
5/11/22,Canada,56.1304,-106.3468,3822281,0,39978,3782303
5/12/22,Canada,56.1304,-106.3468,3827766,0,40133,3787633
5/13/22,Canada,56.1304,-106.3468,3835537,0,40218,3795319
5/14/22,Canada,56.1304,-106.3468,3836335,0,40249,3796086
5/15/22,Canada,56.1304,-106.3468,3836969,0,40259,3796710
5/16/22,Canada,56.1304,-106.3468,3837943,0,40266,3797677
5/17/22,Canada,56.1304,-106.3468,3844271,0,40291,3803980
5/18/22,Canada,56.1304,-106.3468,3850312,0,40388,3809924
5/19/22,Canada,56.1304,-106.3468,3854742,0,40583,3814159
5/20/22,Canada,56.1304,-106.3468,3860575,0,40665,3819910
5/21/22,Canada,56.1304,-106.3468,3861958,0,40689,3821269
5/22/22,Canada,56.1304,-106.3468,3863053,0,40696,3822357
5/23/22,Canada,56.1304,-106.3468,3863389,0,40698,3822691
5/24/22,Canada,56.1304,-106.3468,3865444,0,40702,3824742
5/25/22,Canada,56.1304,-106.3468,3869993,0,40795,3829198
5/26/22,Canada,56.1304,-106.3468,3873780,0,40918,3832862
5/27/22,Canada,56.1304,-106.3468,3879050,0,40968,3838082
5/28/22,Canada,56.1304,-106.3468,3880240,0,40992,3839248
5/29/22,Canada,56.1304,-106.3468,3881220,0,40995,3840225
5/30/22,Canada,56.1304,-106.3468,3882134,0,40996,3841138
5/31/22,Canada,56.1304,-106.3468,3884160,0,41019,3843141
6/1/22,Canada,56.1304,-106.3468,3888672,0,41104,3847568
6/2/22,Canada,56.1304,-106.3468,3891759,0,41244,3850515
6/3/22,Canada,56.1304,-106.3468,3895259,0,41272,3853987
6/4/22,Canada,56.1304,-106.3468,3896919,0,41293,3855626
6/5/22,Canada,56.1304,-106.3468,3897791,0,41299,3856492
6/6/22,Canada,56.1304,-106.3468,3898661,0,41301,3857360
6/7/22,Canada,56.1304,-106.3468,3901597,0,41311,3860286
6/8/22,Canada,56.1304,-106.3468,3905339,0,41346,3863993
6/9/22,Canada,56.1304,-106.3468,3907653,0,41450,3866203
6/10/22,Canada,56.1304,-106.3468,3912417,0,41508,3870909
6/11/22,Canada,56.1304,-106.3468,3916335,0,41513,3874822
6/12/22,Canada,56.1304,-106.3468,3917756,0,41517,3876239
6/13/22,Canada,56.1304,-106.3468,3918616,0,41518,3877098
6/14/22,Canada,56.1304,-106.3468,3921033,0,41530,3879503
6/15/22,Canada,56.1304,-106.3468,3923353,0,41580,3881773
6/16/22,Canada,56.1304,-106.3468,3926127,0,41674,3884453
6/17/22,Canada,56.1304,-106.3468,3927884,0,41680,3886204
6/18/22,Canada,56.1304,-106.3468,3931364,0,41701,3889663
6/19/22,Canada,56.1304,-106.3468,3931364,0,41705,3889659
6/20/22,Canada,56.1304,-106.3468,3932637,0,41708,3890929
6/21/22,Canada,56.1304,-106.3468,3935067,0,41718,3893349
6/22/22,Canada,56.1304,-106.3468,3938040,0,41744,3896296
6/23/22,Canada,56.1304,-106.3468,3942808,0,41808,3901000
6/24/22,Canada,56.1304,-106.3468,3945083,0,41816,3903267
6/25/22,Canada,56.1304,-106.3468,3948562,0,41835,3906727
6/26/22,Canada,56.1304,-106.3468,3949244,0,41838,3907406
6/27/22,Canada,56.1304,-106.3468,3950117,0,41838,3908279
6/28/22,Canada,56.1304,-106.3468,3953552,0,41850,3911702
6/29/22,Canada,56.1304,-106.3468,3956171,0,41887,3914284
6/30/22,Canada,56.1304,-106.3468,3962334,0,41952,3920382
7/1/22,Canada,56.1304,-106.3468,3963763,0,41968,3921795
7/2/22,Canada,56.1304,-106.3468,3967805,0,41982,3925823
7/3/22,Canada,56.1304,-106.3468,3968731,0,41983,3926748
7/4/22,Canada,56.1304,-106.3468,3969063,0,41983,3927080
7/5/22,Canada,56.1304,-106.3468,3975062,0,42006,3933056
7/6/22,Canada,56.1304,-106.3468,3976097,0,42045,3934052
7/7/22,Canada,56.1304,-106.3468,3984864,0,42115,3942749
7/8/22,Canada,56.1304,-106.3468,3988430,0,42140,3946290
7/9/22,Canada,56.1304,-106.3468,3989890,0,42150,3947740
7/10/22,Canada,56.1304,-106.3468,3990961,0,42156,3948805
7/11/22,Canada,56.1304,-106.3468,3991994,0,42163,3949831
7/12/22,Canada,56.1304,-106.3468,3995331,0,42168,3953163
7/13/22,Canada,56.1304,-106.3468,4000304,0,42212,3958092
7/14/22,Canada,56.1304,-106.3468,4018403,0,42278,3976125
7/15/22,Canada,56.1304,-106.3468,4024060,0,42328,3981732
7/16/22,Canada,56.1304,-106.3468,4026044,0,42356,3983688
7/17/22,Canada,56.1304,-106.3468,4026044,0,42364,3983680
7/18/22,Canada,56.1304,-106.3468,4026069,0,42364,3983705
7/19/22,Canada,56.1304,-106.3468,4036848,0,42414,3994434
7/20/22,Canada,56.1304,-106.3468,4040958,0,42466,3998492
7/21/22,Canada,56.1304,-106.3468,4051382,0,42536,4008846
7/22/22,Canada,56.1304,-106.3468,4059876,0,42668,4017208
7/23/22,Canada,56.1304,-106.3468,4061530,0,42683,4018847
7/24/22,Canada,56.1304,-106.3468,4062808,0,42691,4020117
7/25/22,Canada,56.1304,-106.3468,4064084,0,42695,4021389
7/26/22,Canada,56.1304,-106.3468,4071469,0,42739,4028730
7/27/22,Canada,56.1304,-106.3468,4074977,0,42777,4032200
7/28/22,Canada,56.1304,-106.3468,4084973,0,42905,4042068
7/29/22,Canada,56.1304,-106.3468,4090442,0,42937,4047505
7/30/22,Canada,56.1304,-106.3468,4091778,0,42949,4048829
7/31/22,Canada,56.1304,-106.3468,4092722,0,42951,4049771
8/1/22,Canada,56.1304,-106.3468,4093713,0,42951,4050762
8/2/22,Canada,56.1304,-106.3468,4099374,0,42969,4056405
8/3/22,Canada,56.1304,-106.3468,4102536,0,43000,4059536
8/4/22,Canada,56.1304,-106.3468,4094621,0,43066,4051555
8/5/22,Canada,56.1304,-106.3468,4115965,0,43142,4072823
8/6/22,Canada,56.1304,-106.3468,4117035,0,43154,4073881
8/7/22,Canada,56.1304,-106.3468,4117788,0,43158,4074630
8/8/22,Canada,56.1304,-106.3468,4118564,0,43163,4075401
8/9/22,Canada,56.1304,-106.3468,4120585,0,43188,4077397
8/10/22,Canada,56.1304,-106.3468,4123562,0,43228,4080334
8/11/22,Canada,56.1304,-106.3468,4136552,0,43408,4093144
8/12/22,Canada,56.1304,-106.3468,4141368,0,43440,4097928
8/13/22,Canada,56.1304,-106.3468,4141368,0,43440,4097928
8/14/22,Canada,56.1304,-106.3468,4141368,0,43440,4097928
8/15/22,Canada,56.1304,-106.3468,4141368,0,43440,4097928
8/16/22,Canada,56.1304,-106.3468,4148442,0,43498,4104944
8/17/22,Canada,56.1304,-106.3468,4151317,0,43539,4107778
8/18/22,Canada,56.1304,-106.3468,4160497,0,43658,4116839
8/19/22,Canada,56.1304,-106.3468,4166257,0,43740,4122517
8/20/22,Canada,56.1304,-106.3468,4167111,0,43755,4123356
8/21/22,Canada,56.1304,-106.3468,4167732,0,43755,4123977
8/22/22,Canada,56.1304,-106.3468,4168380,0,43756,4124624
8/23/22,Canada,56.1304,-106.3468,4171952,0,43777,4128175
8/24/22,Canada,56.1304,-106.3468,4175729,0,43859,4131870
8/25/22,Canada,56.1304,-106.3468,4183162,0,44003,4139159
8/26/22,Canada,56.1304,-106.3468,4187139,0,44049,4143090
8/27/22,Canada,56.1304,-106.3468,4187887,0,44058,4143829
8/28/22,Canada,56.1304,-106.3468,4188437,0,44059,4144378
8/29/22,Canada,56.1304,-106.3468,4188917,0,44059,4144858
8/30/22,Canada,56.1304,-106.3468,4192880,0,44112,4148768
8/31/22,Canada,56.1304,-106.3468,4194892,0,44165,4150727
9/1/22,Canada,56.1304,-106.3468,4204312,0,44317,4159995
9/2/22,Canada,56.1304,-106.3468,4207961,0,44360,4163601
9/3/22,Canada,56.1304,-106.3468,4208622,0,44364,4164258
9/4/22,Canada,56.1304,-106.3468,4209096,0,44369,4164727
9/5/22,Canada,56.1304,-106.3468,4209542,0,44370,4165172
9/6/22,Canada,56.1304,-106.3468,4212439,0,44379,4168060
9/7/22,Canada,56.1304,-106.3468,4214431,0,44434,4169997
9/8/22,Canada,56.1304,-106.3468,4221439,0,44545,4176894
9/9/22,Canada,56.1304,-106.3468,4224759,0,44599,4180160
9/10/22,Canada,56.1304,-106.3468,4225396,0,44607,4180789
9/11/22,Canada,56.1304,-106.3468,4225396,0,44607,4180789
9/12/22,Canada,56.1304,-106.3468,4226515,0,44611,4181904
9/13/22,Canada,56.1304,-106.3468,4229986,0,44646,4185340
9/14/22,Canada,56.1304,-106.3468,4231064,0,44662,4186402
9/15/22,Canada,56.1304,-106.3468,4239075,0,44919,4194156
9/16/22,Canada,56.1304,-106.3468,4244008,0,44996,4199012
9/17/22,Canada,56.1304,-106.3468,4244622,0,45003,4199619
9/18/22,Canada,56.1304,-106.3468,4245082,0,45011,4200071
9/19/22,Canada,56.1304,-106.3468,4245666,0,45012,4200654
9/20/22,Canada,56.1304,-106.3468,4249798,0,45033,4204765
9/21/22,Canada,56.1304,-106.3468,4251898,0,45067,4206831
9/22/22,Canada,56.1304,-106.3468,4259383,0,45181,4214202
9/23/22,Canada,56.1304,-106.3468,4262446,0,45218,4217228
9/24/22,Canada,56.1304,-106.3468,4263179,0,45233,4217946
9/25/22,Canada,56.1304,-106.3468,4263800,0,45234,4218566
9/26/22,Canada,56.1304,-106.3468,4264425,0,45236,4219189
9/27/22,Canada,56.1304,-106.3468,4267612,0,45263,4222349
9/28/22,Canada,56.1304,-106.3468,4270276,0,45304,4224972
9/29/22,Canada,56.1304,-106.3468,4278430,0,45407,4233023
9/30/22,Canada,56.1304,-106.3468,4279316,0,45421,4233895
10/1/22,Canada,56.1304,-106.3468,4280161,0,45430,4234731
10/2/22,Canada,56.1304,-106.3468,4280759,0,45434,4235325
10/3/22,Canada,56.1304,-106.3468,4283165,0,45455,4237710
10/4/22,Canada,56.1304,-106.3468,4287508,0,45486,4242022
10/5/22,Canada,56.1304,-106.3468,4288593,0,45486,4243107
10/6/22,Canada,56.1304,-106.3468,4297151,0,45606,4251545
10/7/22,Canada,56.1304,-106.3468,4300442,0,45640,4254802
10/8/22,Canada,56.1304,-106.3468,4301375,0,45646,4255729
10/9/22,Canada,56.1304,-106.3468,4302006,0,45648,4256358
10/10/22,Canada,56.1304,-106.3468,4302719,0,45649,4257070
10/11/22,Canada,56.1304,-106.3468,4306156,0,45662,4260494
10/12/22,Canada,56.1304,-106.3468,4309992,0,45724,4264268
10/13/22,Canada,56.1304,-106.3468,4319103,0,45833,4273270
10/14/22,Canada,56.1304,-106.3468,4324361,0,45928,4278433
10/15/22,Canada,56.1304,-106.3468,4325384,0,45936,4279448
10/16/22,Canada,56.1304,-106.3468,4326086,0,45940,4280146
10/17/22,Canada,56.1304,-106.3468,4326726,0,45941,4280785
10/18/22,Canada,56.1304,-106.3468,4330359,0,45978,4284381
10/19/22,Canada,56.1304,-106.3468,4332828,0,46020,4286808
10/20/22,Canada,56.1304,-106.3468,4341692,0,46170,4295522
10/21/22,Canada,56.1304,-106.3468,4344504,0,46218,4298286
10/22/22,Canada,56.1304,-106.3468,4345265,0,46230,4299035
10/23/22,Canada,56.1304,-106.3468,4345847,0,46232,4299615
10/24/22,Canada,56.1304,-106.3468,4347202,0,46319,4300883
10/25/22,Canada,56.1304,-106.3468,4351286,0,46354,4304932
10/26/22,Canada,56.1304,-106.3468,4353606,0,46406,4307200
10/27/22,Canada,56.1304,-106.3468,4362298,0,46563,4315735
10/28/22,Canada,56.1304,-106.3468,4366909,0,46657,4320252
10/29/22,Canada,56.1304,-106.3468,4367727,0,46669,4321058
10/30/22,Canada,56.1304,-106.3468,4368284,0,46672,4321612
10/31/22,Canada,56.1304,-106.3468,4368845,0,46674,4322171
11/1/22,Canada,56.1304,-106.3468,4372182,0,46705,4325477
11/2/22,Canada,56.1304,-106.3468,4374755,0,46747,4328008
11/3/22,Canada,56.1304,-106.3468,4383367,0,46905,4336462
11/4/22,Canada,56.1304,-106.3468,4384773,0,46931,4337842
11/5/22,Canada,56.1304,-106.3468,4384773,0,46931,4337842
11/6/22,Canada,56.1304,-106.3468,4384773,0,46931,4337842
11/7/22,Canada,56.1304,-106.3468,4388506,0,46972,4341534
11/8/22,Canada,56.1304,-106.3468,4391389,0,47030,4344359
11/9/22,Canada,56.1304,-106.3468,4393414,0,47087,4346327
11/10/22,Canada,56.1304,-106.3468,4401096,0,47240,4353856
11/11/22,Canada,56.1304,-106.3468,4402177,0,47272,4354905
11/12/22,Canada,56.1304,-106.3468,4402857,0,47281,4355576
11/13/22,Canada,56.1304,-106.3468,4403371,0,47282,4356089
11/14/22,Canada,56.1304,-106.3468,4403891,0,47284,4356607
11/15/22,Canada,56.1304,-106.3468,4408841,0,47419,4361422
11/16/22,Canada,56.1304,-106.3468,4411356,0,47517,4363839
11/17/22,Canada,56.1304,-106.3468,4417357,0,47661,4369696
11/18/22,Canada,56.1304,-106.3468,4418363,0,47682,4370681
11/19/22,Canada,56.1304,-106.3468,4419028,0,47688,4371340
11/20/22,Canada,56.1304,-106.3468,4419612,0,47688,4371924
11/21/22,Canada,56.1304,-106.3468,4421434,0,47717,4373717
11/22/22,Canada,56.1304,-106.3468,4422890,0,47741,4375149
11/23/22,Canada,56.1304,-106.3468,4425570,0,47783,4377787
11/24/22,Canada,56.1304,-106.3468,4427242,0,47850,4379392
11/25/22,Canada,56.1304,-106.3468,4428546,0,47862,4380684
11/26/22,Canada,56.1304,-106.3468,4428546,0,47862,4380684
11/27/22,Canada,56.1304,-106.3468,4428546,0,47862,4380684
11/28/22,Canada,56.1304,-106.3468,4430558,0,47923,4382635
11/29/22,Canada,56.1304,-106.3468,4431111,0,47923,4383188
11/30/22,Canada,56.1304,-106.3468,4432426,0,48002,4384424
12/1/22,Canada,56.1304,-106.3468,4444843,0,48133,4396710
12/2/22,Canada,56.1304,-106.3468,4444912,0,48133,4396779
12/3/22,Canada,56.1304,-106.3468,4444912,0,48133,4396779
12/4/22,Canada,56.1304,-106.3468,4444912,0,48133,4396779
12/5/22,Canada,56.1304,-106.3468,4453001,0,48297,4404704
12/6/22,Canada,56.1304,-106.3468,4453001,0,48297,4404704
12/7/22,Canada,56.1304,-106.3468,4455849,0,48349,4407500
12/8/22,Canada,56.1304,-106.3468,4461131,0,48418,4412713
12/9/22,Canada,56.1304,-106.3468,4463034,0,48474,4414560
12/10/22,Canada,56.1304,-106.3468,4463982,0,48493,4415489
12/11/22,Canada,56.1304,-106.3468,4464788,0,48494,4416294
12/12/22,Canada,56.1304,-106.3468,4467899,0,48574,4419325
12/13/22,Canada,56.1304,-106.3468,4469719,0,48599,4421120
12/14/22,Canada,56.1304,-106.3468,4472056,0,48657,4423399
12/15/22,Canada,56.1304,-106.3468,4474287,0,48781,4425506
12/16/22,Canada,56.1304,-106.3468,4475933,0,48800,4427133
12/17/22,Canada,56.1304,-106.3468,4476968,0,48804,4428164
1/1/22,Central African Republic,6.6111,20.9394,12163,0,101,12062
1/2/22,Central African Republic,6.6111,20.9394,12163,0,101,12062
1/3/22,Central African Republic,6.6111,20.9394,12163,0,101,12062
1/4/22,Central African Republic,6.6111,20.9394,12163,0,101,12062
1/5/22,Central African Republic,6.6111,20.9394,12454,0,101,12353
1/6/22,Central African Republic,6.6111,20.9394,12454,0,101,12353
1/7/22,Central African Republic,6.6111,20.9394,12454,0,101,12353
1/8/22,Central African Republic,6.6111,20.9394,12454,0,101,12353
1/9/22,Central African Republic,6.6111,20.9394,12454,0,101,12353
1/10/22,Central African Republic,6.6111,20.9394,12454,0,101,12353
1/11/22,Central African Republic,6.6111,20.9394,12650,0,106,12544
1/12/22,Central African Republic,6.6111,20.9394,12650,0,106,12544
1/13/22,Central African Republic,6.6111,20.9394,12650,0,106,12544
1/14/22,Central African Republic,6.6111,20.9394,13319,0,108,13211
1/15/22,Central African Republic,6.6111,20.9394,13319,0,108,13211
1/16/22,Central African Republic,6.6111,20.9394,13319,0,108,13211
1/17/22,Central African Republic,6.6111,20.9394,13319,0,108,13211
1/18/22,Central African Republic,6.6111,20.9394,13319,0,108,13211
1/19/22,Central African Republic,6.6111,20.9394,13319,0,108,13211
1/20/22,Central African Republic,6.6111,20.9394,13509,0,109,13400
1/21/22,Central African Republic,6.6111,20.9394,13509,0,109,13400
1/22/22,Central African Republic,6.6111,20.9394,13611,0,109,13502
1/23/22,Central African Republic,6.6111,20.9394,13611,0,109,13502
1/24/22,Central African Republic,6.6111,20.9394,13611,0,109,13502
1/25/22,Central African Republic,6.6111,20.9394,13840,0,109,13731
1/26/22,Central African Republic,6.6111,20.9394,13840,0,109,13731
1/27/22,Central African Republic,6.6111,20.9394,13898,0,110,13788
1/28/22,Central African Republic,6.6111,20.9394,13898,0,110,13788
1/29/22,Central African Republic,6.6111,20.9394,13898,0,110,13788
1/30/22,Central African Republic,6.6111,20.9394,13898,0,110,13788
1/31/22,Central African Republic,6.6111,20.9394,13919,0,110,13809
2/1/22,Central African Republic,6.6111,20.9394,13919,0,110,13809
2/2/22,Central African Republic,6.6111,20.9394,14023,0,110,13913
2/3/22,Central African Republic,6.6111,20.9394,14023,0,110,13913
2/4/22,Central African Republic,6.6111,20.9394,14023,0,110,13913
2/5/22,Central African Republic,6.6111,20.9394,14023,0,110,13913
2/6/22,Central African Republic,6.6111,20.9394,14023,0,110,13913
2/7/22,Central African Republic,6.6111,20.9394,14023,0,110,13913
2/8/22,Central African Republic,6.6111,20.9394,14023,0,110,13913
2/9/22,Central African Republic,6.6111,20.9394,14110,0,110,14000
2/10/22,Central African Republic,6.6111,20.9394,14110,0,110,14000
2/11/22,Central African Republic,6.6111,20.9394,14154,0,111,14043
2/12/22,Central African Republic,6.6111,20.9394,14154,0,111,14043
2/13/22,Central African Republic,6.6111,20.9394,14154,0,111,14043
2/14/22,Central African Republic,6.6111,20.9394,14187,0,113,14074
2/15/22,Central African Republic,6.6111,20.9394,14187,0,113,14074
2/16/22,Central African Republic,6.6111,20.9394,14187,0,113,14074
2/17/22,Central African Republic,6.6111,20.9394,14187,0,113,14074
2/18/22,Central African Republic,6.6111,20.9394,14187,0,113,14074
2/19/22,Central African Republic,6.6111,20.9394,14187,0,113,14074
2/20/22,Central African Republic,6.6111,20.9394,14187,0,113,14074
2/21/22,Central African Republic,6.6111,20.9394,14187,0,113,14074
2/22/22,Central African Republic,6.6111,20.9394,14187,0,113,14074
2/23/22,Central African Republic,6.6111,20.9394,14187,0,113,14074
2/24/22,Central African Republic,6.6111,20.9394,14187,0,113,14074
2/25/22,Central African Republic,6.6111,20.9394,14187,0,113,14074
2/26/22,Central African Republic,6.6111,20.9394,14187,0,113,14074
2/27/22,Central African Republic,6.6111,20.9394,14187,0,113,14074
2/28/22,Central African Republic,6.6111,20.9394,14225,0,113,14112
3/1/22,Central African Republic,6.6111,20.9394,14225,0,113,14112
3/2/22,Central African Republic,6.6111,20.9394,14225,0,113,14112
3/3/22,Central African Republic,6.6111,20.9394,14225,0,113,14112
3/4/22,Central African Republic,6.6111,20.9394,14320,0,113,14207
3/5/22,Central African Republic,6.6111,20.9394,14320,0,113,14207
3/6/22,Central African Republic,6.6111,20.9394,14320,0,113,14207
3/7/22,Central African Republic,6.6111,20.9394,14320,0,113,14207
3/8/22,Central African Republic,6.6111,20.9394,14320,0,113,14207
3/9/22,Central African Republic,6.6111,20.9394,14320,0,113,14207
3/10/22,Central African Republic,6.6111,20.9394,14320,0,113,14207
3/11/22,Central African Republic,6.6111,20.9394,14320,0,113,14207
3/12/22,Central African Republic,6.6111,20.9394,14320,0,113,14207
3/13/22,Central African Republic,6.6111,20.9394,14320,0,113,14207
3/14/22,Central African Republic,6.6111,20.9394,14320,0,113,14207
3/15/22,Central African Republic,6.6111,20.9394,14649,0,113,14536
3/16/22,Central African Republic,6.6111,20.9394,14649,0,113,14536
3/17/22,Central African Republic,6.6111,20.9394,14649,0,113,14536
3/18/22,Central African Republic,6.6111,20.9394,14649,0,113,14536
3/19/22,Central African Republic,6.6111,20.9394,14649,0,113,14536
3/20/22,Central African Republic,6.6111,20.9394,14649,0,113,14536
3/21/22,Central African Republic,6.6111,20.9394,14649,0,113,14536
3/22/22,Central African Republic,6.6111,20.9394,14649,0,113,14536
3/23/22,Central African Republic,6.6111,20.9394,14649,0,113,14536
3/24/22,Central African Republic,6.6111,20.9394,14649,0,113,14536
3/25/22,Central African Republic,6.6111,20.9394,14649,0,113,14536
3/26/22,Central African Republic,6.6111,20.9394,14649,0,113,14536
3/27/22,Central African Republic,6.6111,20.9394,14649,0,113,14536
3/28/22,Central African Republic,6.6111,20.9394,14649,0,113,14536
3/29/22,Central African Republic,6.6111,20.9394,14649,0,113,14536
3/30/22,Central African Republic,6.6111,20.9394,14649,0,113,14536
3/31/22,Central African Republic,6.6111,20.9394,14649,0,113,14536
4/1/22,Central African Republic,6.6111,20.9394,14649,0,113,14536
4/2/22,Central African Republic,6.6111,20.9394,14649,0,113,14536
4/3/22,Central African Republic,6.6111,20.9394,14649,0,113,14536
4/4/22,Central African Republic,6.6111,20.9394,14649,0,113,14536
4/5/22,Central African Republic,6.6111,20.9394,14649,0,113,14536
4/6/22,Central African Republic,6.6111,20.9394,14649,0,113,14536
4/7/22,Central African Republic,6.6111,20.9394,14649,0,113,14536
4/8/22,Central African Republic,6.6111,20.9394,14649,0,113,14536
4/9/22,Central African Republic,6.6111,20.9394,14649,0,113,14536
4/10/22,Central African Republic,6.6111,20.9394,14649,0,113,14536
4/11/22,Central African Republic,6.6111,20.9394,14649,0,113,14536
4/12/22,Central African Republic,6.6111,20.9394,14649,0,113,14536
4/13/22,Central African Republic,6.6111,20.9394,14649,0,113,14536
4/14/22,Central African Republic,6.6111,20.9394,14649,0,113,14536
4/15/22,Central African Republic,6.6111,20.9394,14649,0,113,14536
4/16/22,Central African Republic,6.6111,20.9394,14649,0,113,14536
4/17/22,Central African Republic,6.6111,20.9394,14649,0,113,14536
4/18/22,Central African Republic,6.6111,20.9394,14649,0,113,14536
4/19/22,Central African Republic,6.6111,20.9394,14649,0,113,14536
4/20/22,Central African Republic,6.6111,20.9394,14649,0,113,14536
4/21/22,Central African Republic,6.6111,20.9394,14649,0,113,14536
4/22/22,Central African Republic,6.6111,20.9394,14649,0,113,14536
4/23/22,Central African Republic,6.6111,20.9394,14649,0,113,14536
4/24/22,Central African Republic,6.6111,20.9394,14649,0,113,14536
4/25/22,Central African Republic,6.6111,20.9394,14649,0,113,14536
4/26/22,Central African Republic,6.6111,20.9394,14649,0,113,14536
4/27/22,Central African Republic,6.6111,20.9394,14649,0,113,14536
4/28/22,Central African Republic,6.6111,20.9394,14649,0,113,14536
4/29/22,Central African Republic,6.6111,20.9394,14649,0,113,14536
4/30/22,Central African Republic,6.6111,20.9394,14649,0,113,14536
5/1/22,Central African Republic,6.6111,20.9394,14649,0,113,14536
5/2/22,Central African Republic,6.6111,20.9394,14649,0,113,14536
5/3/22,Central African Republic,6.6111,20.9394,14649,0,113,14536
5/4/22,Central African Republic,6.6111,20.9394,14649,0,113,14536
5/5/22,Central African Republic,6.6111,20.9394,14649,0,113,14536
5/6/22,Central African Republic,6.6111,20.9394,14649,0,113,14536
5/7/22,Central African Republic,6.6111,20.9394,14649,0,113,14536
5/8/22,Central African Republic,6.6111,20.9394,14649,0,113,14536
5/9/22,Central African Republic,6.6111,20.9394,14649,0,113,14536
5/10/22,Central African Republic,6.6111,20.9394,14649,0,113,14536
5/11/22,Central African Republic,6.6111,20.9394,14649,0,113,14536
5/12/22,Central African Republic,6.6111,20.9394,14649,0,113,14536
5/13/22,Central African Republic,6.6111,20.9394,14649,0,113,14536
5/14/22,Central African Republic,6.6111,20.9394,14649,0,113,14536
5/15/22,Central African Republic,6.6111,20.9394,14649,0,113,14536
5/16/22,Central African Republic,6.6111,20.9394,14649,0,113,14536
5/17/22,Central African Republic,6.6111,20.9394,14649,0,113,14536
5/18/22,Central African Republic,6.6111,20.9394,14649,0,113,14536
5/19/22,Central African Republic,6.6111,20.9394,14649,0,113,14536
5/20/22,Central African Republic,6.6111,20.9394,14649,0,113,14536
5/21/22,Central African Republic,6.6111,20.9394,14649,0,113,14536
5/22/22,Central African Republic,6.6111,20.9394,14649,0,113,14536
5/23/22,Central African Republic,6.6111,20.9394,14649,0,113,14536
5/24/22,Central African Republic,6.6111,20.9394,14649,0,113,14536
5/25/22,Central African Republic,6.6111,20.9394,14649,0,113,14536
5/26/22,Central African Republic,6.6111,20.9394,14649,0,113,14536
5/27/22,Central African Republic,6.6111,20.9394,14649,0,113,14536
5/28/22,Central African Republic,6.6111,20.9394,14649,0,113,14536
5/29/22,Central African Republic,6.6111,20.9394,14649,0,113,14536
5/30/22,Central African Republic,6.6111,20.9394,14649,0,113,14536
5/31/22,Central African Republic,6.6111,20.9394,14649,0,113,14536
6/1/22,Central African Republic,6.6111,20.9394,14649,0,113,14536
6/2/22,Central African Republic,6.6111,20.9394,14649,0,113,14536
6/3/22,Central African Republic,6.6111,20.9394,14649,0,113,14536
6/4/22,Central African Republic,6.6111,20.9394,14649,0,113,14536
6/5/22,Central African Republic,6.6111,20.9394,14649,0,113,14536
6/6/22,Central African Republic,6.6111,20.9394,14649,0,113,14536
6/7/22,Central African Republic,6.6111,20.9394,14649,0,113,14536
6/8/22,Central African Republic,6.6111,20.9394,14649,0,113,14536
6/9/22,Central African Republic,6.6111,20.9394,14649,0,113,14536
6/10/22,Central African Republic,6.6111,20.9394,14649,0,113,14536
6/11/22,Central African Republic,6.6111,20.9394,14649,0,113,14536
6/12/22,Central African Republic,6.6111,20.9394,14649,0,113,14536
6/13/22,Central African Republic,6.6111,20.9394,14649,0,113,14536
6/14/22,Central African Republic,6.6111,20.9394,14649,0,113,14536
6/15/22,Central African Republic,6.6111,20.9394,14649,0,113,14536
6/16/22,Central African Republic,6.6111,20.9394,14649,0,113,14536
6/17/22,Central African Republic,6.6111,20.9394,14649,0,113,14536
6/18/22,Central African Republic,6.6111,20.9394,14649,0,113,14536
6/19/22,Central African Republic,6.6111,20.9394,14649,0,113,14536
6/20/22,Central African Republic,6.6111,20.9394,14649,0,113,14536
6/21/22,Central African Republic,6.6111,20.9394,14649,0,113,14536
6/22/22,Central African Republic,6.6111,20.9394,14649,0,113,14536
6/23/22,Central African Republic,6.6111,20.9394,14649,0,113,14536
6/24/22,Central African Republic,6.6111,20.9394,14649,0,113,14536
6/25/22,Central African Republic,6.6111,20.9394,14649,0,113,14536
6/26/22,Central African Republic,6.6111,20.9394,14649,0,113,14536
6/27/22,Central African Republic,6.6111,20.9394,14649,0,113,14536
6/28/22,Central African Republic,6.6111,20.9394,14649,0,113,14536
6/29/22,Central African Republic,6.6111,20.9394,14649,0,113,14536
6/30/22,Central African Republic,6.6111,20.9394,14649,0,113,14536
7/1/22,Central African Republic,6.6111,20.9394,14649,0,113,14536
7/2/22,Central African Republic,6.6111,20.9394,14649,0,113,14536
7/3/22,Central African Republic,6.6111,20.9394,14649,0,113,14536
7/4/22,Central African Republic,6.6111,20.9394,14649,0,113,14536
7/5/22,Central African Republic,6.6111,20.9394,14675,0,113,14562
7/6/22,Central African Republic,6.6111,20.9394,14675,0,113,14562
7/7/22,Central African Republic,6.6111,20.9394,14675,0,113,14562
7/8/22,Central African Republic,6.6111,20.9394,14675,0,113,14562
7/9/22,Central African Republic,6.6111,20.9394,14675,0,113,14562
7/10/22,Central African Republic,6.6111,20.9394,14675,0,113,14562
7/11/22,Central African Republic,6.6111,20.9394,14675,0,113,14562
7/12/22,Central African Republic,6.6111,20.9394,14712,0,113,14599
7/13/22,Central African Republic,6.6111,20.9394,14712,0,113,14599
7/14/22,Central African Republic,6.6111,20.9394,14712,0,113,14599
7/15/22,Central African Republic,6.6111,20.9394,14712,0,113,14599
7/16/22,Central African Republic,6.6111,20.9394,14712,0,113,14599
7/17/22,Central African Republic,6.6111,20.9394,14712,0,113,14599
7/18/22,Central African Republic,6.6111,20.9394,14712,0,113,14599
7/19/22,Central African Republic,6.6111,20.9394,14712,0,113,14599
7/20/22,Central African Republic,6.6111,20.9394,14712,0,113,14599
7/21/22,Central African Republic,6.6111,20.9394,14712,0,113,14599
7/22/22,Central African Republic,6.6111,20.9394,14712,0,113,14599
7/23/22,Central African Republic,6.6111,20.9394,14712,0,113,14599
7/24/22,Central African Republic,6.6111,20.9394,14712,0,113,14599
7/25/22,Central African Republic,6.6111,20.9394,14712,0,113,14599
7/26/22,Central African Republic,6.6111,20.9394,14712,0,113,14599
7/27/22,Central African Republic,6.6111,20.9394,14712,0,113,14599
7/28/22,Central African Republic,6.6111,20.9394,14764,0,113,14651
7/29/22,Central African Republic,6.6111,20.9394,14764,0,113,14651
7/30/22,Central African Republic,6.6111,20.9394,14764,0,113,14651
7/31/22,Central African Republic,6.6111,20.9394,14764,0,113,14651
8/1/22,Central African Republic,6.6111,20.9394,14764,0,113,14651
8/2/22,Central African Republic,6.6111,20.9394,14772,0,113,14659
8/3/22,Central African Republic,6.6111,20.9394,14772,0,113,14659
8/4/22,Central African Republic,6.6111,20.9394,14772,0,113,14659
8/5/22,Central African Republic,6.6111,20.9394,14781,0,113,14668
8/6/22,Central African Republic,6.6111,20.9394,14781,0,113,14668
8/7/22,Central African Republic,6.6111,20.9394,14781,0,113,14668
8/8/22,Central African Republic,6.6111,20.9394,14781,0,113,14668
8/9/22,Central African Republic,6.6111,20.9394,14781,0,113,14668
8/10/22,Central African Republic,6.6111,20.9394,14781,0,113,14668
8/11/22,Central African Republic,6.6111,20.9394,14781,0,113,14668
8/12/22,Central African Republic,6.6111,20.9394,14803,0,113,14690
8/13/22,Central African Republic,6.6111,20.9394,14803,0,113,14690
8/14/22,Central African Republic,6.6111,20.9394,14803,0,113,14690
8/15/22,Central African Republic,6.6111,20.9394,14803,0,113,14690
8/16/22,Central African Republic,6.6111,20.9394,14803,0,113,14690
8/17/22,Central African Republic,6.6111,20.9394,14803,0,113,14690
8/18/22,Central African Republic,6.6111,20.9394,14803,0,113,14690
8/19/22,Central African Republic,6.6111,20.9394,14803,0,113,14690
8/20/22,Central African Republic,6.6111,20.9394,14803,0,113,14690
8/21/22,Central African Republic,6.6111,20.9394,14803,0,113,14690
8/22/22,Central African Republic,6.6111,20.9394,14803,0,113,14690
8/23/22,Central African Republic,6.6111,20.9394,14803,0,113,14690
8/24/22,Central African Republic,6.6111,20.9394,14862,0,113,14749
8/25/22,Central African Republic,6.6111,20.9394,14862,0,113,14749
8/26/22,Central African Republic,6.6111,20.9394,14862,0,113,14749
8/27/22,Central African Republic,6.6111,20.9394,14862,0,113,14749
8/28/22,Central African Republic,6.6111,20.9394,14862,0,113,14749
8/29/22,Central African Republic,6.6111,20.9394,14862,0,113,14749
8/30/22,Central African Republic,6.6111,20.9394,14862,0,113,14749
8/31/22,Central African Republic,6.6111,20.9394,14862,0,113,14749
9/1/22,Central African Republic,6.6111,20.9394,14862,0,113,14749
9/2/22,Central African Republic,6.6111,20.9394,14862,0,113,14749
9/3/22,Central African Republic,6.6111,20.9394,14862,0,113,14749
9/4/22,Central African Republic,6.6111,20.9394,14862,0,113,14749
9/5/22,Central African Republic,6.6111,20.9394,14874,0,113,14761
9/6/22,Central African Republic,6.6111,20.9394,14882,0,113,14769
9/7/22,Central African Republic,6.6111,20.9394,14883,0,113,14770
9/8/22,Central African Republic,6.6111,20.9394,14883,0,113,14770
9/9/22,Central African Republic,6.6111,20.9394,14883,0,113,14770
9/10/22,Central African Republic,6.6111,20.9394,14883,0,113,14770
9/11/22,Central African Republic,6.6111,20.9394,14883,0,113,14770
9/12/22,Central African Republic,6.6111,20.9394,14883,0,113,14770
9/13/22,Central African Republic,6.6111,20.9394,14883,0,113,14770
9/14/22,Central African Republic,6.6111,20.9394,14904,0,113,14791
9/15/22,Central African Republic,6.6111,20.9394,14904,0,113,14791
9/16/22,Central African Republic,6.6111,20.9394,14904,0,113,14791
9/17/22,Central African Republic,6.6111,20.9394,14904,0,113,14791
9/18/22,Central African Republic,6.6111,20.9394,14904,0,113,14791
9/19/22,Central African Republic,6.6111,20.9394,14904,0,113,14791
9/20/22,Central African Republic,6.6111,20.9394,14904,0,113,14791
9/21/22,Central African Republic,6.6111,20.9394,14904,0,113,14791
9/22/22,Central African Republic,6.6111,20.9394,14904,0,113,14791
9/23/22,Central African Republic,6.6111,20.9394,14904,0,113,14791
9/24/22,Central African Republic,6.6111,20.9394,14904,0,113,14791
9/25/22,Central African Republic,6.6111,20.9394,14904,0,113,14791
9/26/22,Central African Republic,6.6111,20.9394,14913,0,113,14800
9/27/22,Central African Republic,6.6111,20.9394,14913,0,113,14800
9/28/22,Central African Republic,6.6111,20.9394,14913,0,113,14800
9/29/22,Central African Republic,6.6111,20.9394,14913,0,113,14800
9/30/22,Central African Republic,6.6111,20.9394,14913,0,113,14800
10/1/22,Central African Republic,6.6111,20.9394,14913,0,113,14800
10/2/22,Central African Republic,6.6111,20.9394,14913,0,113,14800
10/3/22,Central African Republic,6.6111,20.9394,14923,0,113,14810
10/4/22,Central African Republic,6.6111,20.9394,14923,0,113,14810
10/5/22,Central African Republic,6.6111,20.9394,14923,0,113,14810
10/6/22,Central African Republic,6.6111,20.9394,14957,0,113,14844
10/7/22,Central African Republic,6.6111,20.9394,14957,0,113,14844
10/8/22,Central African Republic,6.6111,20.9394,14957,0,113,14844
10/9/22,Central African Republic,6.6111,20.9394,14957,0,113,14844
10/10/22,Central African Republic,6.6111,20.9394,14957,0,113,14844
10/11/22,Central African Republic,6.6111,20.9394,14957,0,113,14844
10/12/22,Central African Republic,6.6111,20.9394,14957,0,113,14844
10/13/22,Central African Republic,6.6111,20.9394,14957,0,113,14844
10/14/22,Central African Republic,6.6111,20.9394,14957,0,113,14844
10/15/22,Central African Republic,6.6111,20.9394,14957,0,113,14844
10/16/22,Central African Republic,6.6111,20.9394,14957,0,113,14844
10/17/22,Central African Republic,6.6111,20.9394,15151,0,113,15038
10/18/22,Central African Republic,6.6111,20.9394,15151,0,113,15038
10/19/22,Central African Republic,6.6111,20.9394,15151,0,113,15038
10/20/22,Central African Republic,6.6111,20.9394,15151,0,113,15038
10/21/22,Central African Republic,6.6111,20.9394,15151,0,113,15038
10/22/22,Central African Republic,6.6111,20.9394,15151,0,113,15038
10/23/22,Central African Republic,6.6111,20.9394,15151,0,113,15038
10/24/22,Central African Republic,6.6111,20.9394,15228,0,113,15115
10/25/22,Central African Republic,6.6111,20.9394,15229,0,113,15116
10/26/22,Central African Republic,6.6111,20.9394,15260,0,113,15147
10/27/22,Central African Republic,6.6111,20.9394,15260,0,113,15147
10/28/22,Central African Republic,6.6111,20.9394,15260,0,113,15147
10/29/22,Central African Republic,6.6111,20.9394,15260,0,113,15147
10/30/22,Central African Republic,6.6111,20.9394,15260,0,113,15147
10/31/22,Central African Republic,6.6111,20.9394,15260,0,113,15147
11/1/22,Central African Republic,6.6111,20.9394,15260,0,113,15147
11/2/22,Central African Republic,6.6111,20.9394,15260,0,113,15147
11/3/22,Central African Republic,6.6111,20.9394,15260,0,113,15147
11/4/22,Central African Republic,6.6111,20.9394,15260,0,113,15147
11/5/22,Central African Republic,6.6111,20.9394,15260,0,113,15147
11/6/22,Central African Republic,6.6111,20.9394,15260,0,113,15147
11/7/22,Central African Republic,6.6111,20.9394,15289,0,113,15176
11/8/22,Central African Republic,6.6111,20.9394,15289,0,113,15176
11/9/22,Central African Republic,6.6111,20.9394,15289,0,113,15176
11/10/22,Central African Republic,6.6111,20.9394,15289,0,113,15176
11/11/22,Central African Republic,6.6111,20.9394,15289,0,113,15176
11/12/22,Central African Republic,6.6111,20.9394,15289,0,113,15176
11/13/22,Central African Republic,6.6111,20.9394,15289,0,113,15176
11/14/22,Central African Republic,6.6111,20.9394,15289,0,113,15176
11/15/22,Central African Republic,6.6111,20.9394,15289,0,113,15176
11/16/22,Central African Republic,6.6111,20.9394,15289,0,113,15176
11/17/22,Central African Republic,6.6111,20.9394,15289,0,113,15176
11/18/22,Central African Republic,6.6111,20.9394,15289,0,113,15176
11/19/22,Central African Republic,6.6111,20.9394,15289,0,113,15176
11/20/22,Central African Republic,6.6111,20.9394,15289,0,113,15176
11/21/22,Central African Republic,6.6111,20.9394,15289,0,113,15176
11/22/22,Central African Republic,6.6111,20.9394,15311,0,113,15198
11/23/22,Central African Republic,6.6111,20.9394,15311,0,113,15198
11/24/22,Central African Republic,6.6111,20.9394,15311,0,113,15198
11/25/22,Central African Republic,6.6111,20.9394,15311,0,113,15198
11/26/22,Central African Republic,6.6111,20.9394,15311,0,113,15198
11/27/22,Central African Republic,6.6111,20.9394,15311,0,113,15198
11/28/22,Central African Republic,6.6111,20.9394,15311,0,113,15198
11/29/22,Central African Republic,6.6111,20.9394,15311,0,113,15198
11/30/22,Central African Republic,6.6111,20.9394,15311,0,113,15198
12/1/22,Central African Republic,6.6111,20.9394,15311,0,113,15198
12/2/22,Central African Republic,6.6111,20.9394,15311,0,113,15198
12/3/22,Central African Republic,6.6111,20.9394,15311,0,113,15198
12/4/22,Central African Republic,6.6111,20.9394,15311,0,113,15198
12/5/22,Central African Republic,6.6111,20.9394,15311,0,113,15198
12/6/22,Central African Republic,6.6111,20.9394,15311,0,113,15198
12/7/22,Central African Republic,6.6111,20.9394,15311,0,113,15198
12/8/22,Central African Republic,6.6111,20.9394,15311,0,113,15198
12/9/22,Central African Republic,6.6111,20.9394,15311,0,113,15198
12/10/22,Central African Republic,6.6111,20.9394,15311,0,113,15198
12/11/22,Central African Republic,6.6111,20.9394,15311,0,113,15198
12/12/22,Central African Republic,6.6111,20.9394,15311,0,113,15198
12/13/22,Central African Republic,6.6111,20.9394,15311,0,113,15198
12/14/22,Central African Republic,6.6111,20.9394,15311,0,113,15198
12/15/22,Central African Republic,6.6111,20.9394,15311,0,113,15198
12/16/22,Central African Republic,6.6111,20.9394,15311,0,113,15198
12/17/22,Central African Republic,6.6111,20.9394,15311,0,113,15198
1/1/22,Chad,15.4542,18.7322,6183,0,184,5999
1/2/22,Chad,15.4542,18.7322,6183,0,184,5999
1/3/22,Chad,15.4542,18.7322,6183,0,184,5999
1/4/22,Chad,15.4542,18.7322,6185,0,184,6001
1/5/22,Chad,15.4542,18.7322,6185,0,184,6001
1/6/22,Chad,15.4542,18.7322,6185,0,184,6001
1/7/22,Chad,15.4542,18.7322,6185,0,184,6001
1/8/22,Chad,15.4542,18.7322,6185,0,184,6001
1/9/22,Chad,15.4542,18.7322,6185,0,184,6001
1/10/22,Chad,15.4542,18.7322,6556,0,185,6371
1/11/22,Chad,15.4542,18.7322,6558,0,185,6373
1/12/22,Chad,15.4542,18.7322,6558,0,185,6373
1/13/22,Chad,15.4542,18.7322,6558,0,185,6373
1/14/22,Chad,15.4542,18.7322,6558,0,185,6373
1/15/22,Chad,15.4542,18.7322,6558,0,185,6373
1/16/22,Chad,15.4542,18.7322,6558,0,185,6373
1/17/22,Chad,15.4542,18.7322,6887,0,185,6702
1/18/22,Chad,15.4542,18.7322,6889,0,185,6704
1/19/22,Chad,15.4542,18.7322,6889,0,185,6704
1/20/22,Chad,15.4542,18.7322,6889,0,185,6704
1/21/22,Chad,15.4542,18.7322,6889,0,185,6704
1/22/22,Chad,15.4542,18.7322,6889,0,185,6704
1/23/22,Chad,15.4542,18.7322,6889,0,185,6704
1/24/22,Chad,15.4542,18.7322,7073,0,190,6883
1/25/22,Chad,15.4542,18.7322,7075,0,190,6885
1/26/22,Chad,15.4542,18.7322,7075,0,190,6885
1/27/22,Chad,15.4542,18.7322,7075,0,190,6885
1/28/22,Chad,15.4542,18.7322,7075,0,190,6885
1/29/22,Chad,15.4542,18.7322,7075,0,190,6885
1/30/22,Chad,15.4542,18.7322,7075,0,190,6885
1/31/22,Chad,15.4542,18.7322,7155,0,190,6965
2/1/22,Chad,15.4542,18.7322,7155,0,190,6965
2/2/22,Chad,15.4542,18.7322,7157,0,190,6967
2/3/22,Chad,15.4542,18.7322,7157,0,190,6967
2/4/22,Chad,15.4542,18.7322,7157,0,190,6967
2/5/22,Chad,15.4542,18.7322,7157,0,190,6967
2/6/22,Chad,15.4542,18.7322,7157,0,190,6967
2/7/22,Chad,15.4542,18.7322,7214,0,190,7024
2/8/22,Chad,15.4542,18.7322,7216,0,190,7026
2/9/22,Chad,15.4542,18.7322,7216,0,190,7026
2/10/22,Chad,15.4542,18.7322,7216,0,190,7026
2/11/22,Chad,15.4542,18.7322,7216,0,190,7026
2/12/22,Chad,15.4542,18.7322,7216,0,190,7026
2/13/22,Chad,15.4542,18.7322,7216,0,190,7026
2/14/22,Chad,15.4542,18.7322,7216,0,190,7026
2/15/22,Chad,15.4542,18.7322,7216,0,190,7026
2/16/22,Chad,15.4542,18.7322,7216,0,190,7026
2/17/22,Chad,15.4542,18.7322,7216,0,190,7026
2/18/22,Chad,15.4542,18.7322,7216,0,190,7026
2/19/22,Chad,15.4542,18.7322,7216,0,190,7026
2/20/22,Chad,15.4542,18.7322,7216,0,190,7026
2/21/22,Chad,15.4542,18.7322,7246,0,190,7056
2/22/22,Chad,15.4542,18.7322,7248,0,190,7058
2/23/22,Chad,15.4542,18.7322,7248,0,190,7058
2/24/22,Chad,15.4542,18.7322,7248,0,190,7058
2/25/22,Chad,15.4542,18.7322,7248,0,190,7058
2/26/22,Chad,15.4542,18.7322,7248,0,190,7058
2/27/22,Chad,15.4542,18.7322,7248,0,190,7058
2/28/22,Chad,15.4542,18.7322,7255,0,190,7065
3/1/22,Chad,15.4542,18.7322,7257,0,190,7067
3/2/22,Chad,15.4542,18.7322,7257,0,190,7067
3/3/22,Chad,15.4542,18.7322,7257,0,190,7067
3/4/22,Chad,15.4542,18.7322,7257,0,190,7067
3/5/22,Chad,15.4542,18.7322,7257,0,190,7067
3/6/22,Chad,15.4542,18.7322,7257,0,190,7067
3/7/22,Chad,15.4542,18.7322,7258,0,190,7068
3/8/22,Chad,15.4542,18.7322,7258,0,190,7068
3/9/22,Chad,15.4542,18.7322,7260,0,190,7070
3/10/22,Chad,15.4542,18.7322,7260,0,190,7070
3/11/22,Chad,15.4542,18.7322,7260,0,190,7070
3/12/22,Chad,15.4542,18.7322,7260,0,190,7070
3/13/22,Chad,15.4542,18.7322,7260,0,190,7070
3/14/22,Chad,15.4542,18.7322,7267,0,190,7077
3/15/22,Chad,15.4542,18.7322,7269,0,190,7079
3/16/22,Chad,15.4542,18.7322,7269,0,190,7079
3/17/22,Chad,15.4542,18.7322,7269,0,190,7079
3/18/22,Chad,15.4542,18.7322,7269,0,190,7079
3/19/22,Chad,15.4542,18.7322,7269,0,190,7079
3/20/22,Chad,15.4542,18.7322,7269,0,190,7079
3/21/22,Chad,15.4542,18.7322,7286,0,190,7096
3/22/22,Chad,15.4542,18.7322,7288,0,190,7098
3/23/22,Chad,15.4542,18.7322,7288,0,190,7098
3/24/22,Chad,15.4542,18.7322,7288,0,190,7098
3/25/22,Chad,15.4542,18.7322,7288,0,190,7098
3/26/22,Chad,15.4542,18.7322,7288,0,190,7098
3/27/22,Chad,15.4542,18.7322,7288,0,190,7098
3/28/22,Chad,15.4542,18.7322,7308,0,191,7117
3/29/22,Chad,15.4542,18.7322,7310,0,191,7119
3/30/22,Chad,15.4542,18.7322,7310,0,191,7119
3/31/22,Chad,15.4542,18.7322,7310,0,191,7119
4/1/22,Chad,15.4542,18.7322,7310,0,191,7119
4/2/22,Chad,15.4542,18.7322,7310,0,191,7119
4/3/22,Chad,15.4542,18.7322,7310,0,191,7119
4/4/22,Chad,15.4542,18.7322,7347,0,192,7155
4/5/22,Chad,15.4542,18.7322,7347,0,192,7155
4/6/22,Chad,15.4542,18.7322,7349,0,192,7157
4/7/22,Chad,15.4542,18.7322,7349,0,192,7157
4/8/22,Chad,15.4542,18.7322,7349,0,192,7157
4/9/22,Chad,15.4542,18.7322,7349,0,192,7157
4/10/22,Chad,15.4542,18.7322,7349,0,192,7157
4/11/22,Chad,15.4542,18.7322,7378,0,192,7186
4/12/22,Chad,15.4542,18.7322,7378,0,192,7186
4/13/22,Chad,15.4542,18.7322,7378,0,192,7186
4/14/22,Chad,15.4542,18.7322,7378,0,192,7186
4/15/22,Chad,15.4542,18.7322,7378,0,192,7186
4/16/22,Chad,15.4542,18.7322,7378,0,192,7186
4/17/22,Chad,15.4542,18.7322,7378,0,192,7186
4/18/22,Chad,15.4542,18.7322,7396,0,193,7203
4/19/22,Chad,15.4542,18.7322,7396,0,193,7203
4/20/22,Chad,15.4542,18.7322,7396,0,193,7203
4/21/22,Chad,15.4542,18.7322,7396,0,193,7203
4/22/22,Chad,15.4542,18.7322,7396,0,193,7203
4/23/22,Chad,15.4542,18.7322,7396,0,193,7203
4/24/22,Chad,15.4542,18.7322,7396,0,193,7203
4/25/22,Chad,15.4542,18.7322,7411,0,193,7218
4/26/22,Chad,15.4542,18.7322,7411,0,193,7218
4/27/22,Chad,15.4542,18.7322,7411,0,193,7218
4/28/22,Chad,15.4542,18.7322,7411,0,193,7218
4/29/22,Chad,15.4542,18.7322,7411,0,193,7218
4/30/22,Chad,15.4542,18.7322,7411,0,193,7218
5/1/22,Chad,15.4542,18.7322,7411,0,193,7218
5/2/22,Chad,15.4542,18.7322,7412,0,193,7219
5/3/22,Chad,15.4542,18.7322,7412,0,193,7219
5/4/22,Chad,15.4542,18.7322,7412,0,193,7219
5/5/22,Chad,15.4542,18.7322,7412,0,193,7219
5/6/22,Chad,15.4542,18.7322,7412,0,193,7219
5/7/22,Chad,15.4542,18.7322,7412,0,193,7219
5/8/22,Chad,15.4542,18.7322,7412,0,193,7219
5/9/22,Chad,15.4542,18.7322,7414,0,193,7221
5/10/22,Chad,15.4542,18.7322,7414,0,193,7221
5/11/22,Chad,15.4542,18.7322,7414,0,193,7221
5/12/22,Chad,15.4542,18.7322,7414,0,193,7221
5/13/22,Chad,15.4542,18.7322,7414,0,193,7221
5/14/22,Chad,15.4542,18.7322,7414,0,193,7221
5/15/22,Chad,15.4542,18.7322,7414,0,193,7221
5/16/22,Chad,15.4542,18.7322,7415,0,193,7222
5/17/22,Chad,15.4542,18.7322,7415,0,193,7222
5/18/22,Chad,15.4542,18.7322,7415,0,193,7222
5/19/22,Chad,15.4542,18.7322,7415,0,193,7222
5/20/22,Chad,15.4542,18.7322,7415,0,193,7222
5/21/22,Chad,15.4542,18.7322,7415,0,193,7222
5/22/22,Chad,15.4542,18.7322,7415,0,193,7222
5/23/22,Chad,15.4542,18.7322,7417,0,193,7224
5/24/22,Chad,15.4542,18.7322,7417,0,193,7224
5/25/22,Chad,15.4542,18.7322,7417,0,193,7224
5/26/22,Chad,15.4542,18.7322,7417,0,193,7224
5/27/22,Chad,15.4542,18.7322,7417,0,193,7224
5/28/22,Chad,15.4542,18.7322,7417,0,193,7224
5/29/22,Chad,15.4542,18.7322,7417,0,193,7224
5/30/22,Chad,15.4542,18.7322,7417,0,193,7224
5/31/22,Chad,15.4542,18.7322,7417,0,193,7224
6/1/22,Chad,15.4542,18.7322,7417,0,193,7224
6/2/22,Chad,15.4542,18.7322,7417,0,193,7224
6/3/22,Chad,15.4542,18.7322,7417,0,193,7224
6/4/22,Chad,15.4542,18.7322,7417,0,193,7224
6/5/22,Chad,15.4542,18.7322,7417,0,193,7224
6/6/22,Chad,15.4542,18.7322,7418,0,193,7225
6/7/22,Chad,15.4542,18.7322,7418,0,193,7225
6/8/22,Chad,15.4542,18.7322,7418,0,193,7225
6/9/22,Chad,15.4542,18.7322,7418,0,193,7225
6/10/22,Chad,15.4542,18.7322,7418,0,193,7225
6/11/22,Chad,15.4542,18.7322,7418,0,193,7225
6/12/22,Chad,15.4542,18.7322,7418,0,193,7225
6/13/22,Chad,15.4542,18.7322,7420,0,193,7227
6/14/22,Chad,15.4542,18.7322,7420,0,193,7227
6/15/22,Chad,15.4542,18.7322,7420,0,193,7227
6/16/22,Chad,15.4542,18.7322,7420,0,193,7227
6/17/22,Chad,15.4542,18.7322,7420,0,193,7227
6/18/22,Chad,15.4542,18.7322,7420,0,193,7227
6/19/22,Chad,15.4542,18.7322,7420,0,193,7227
6/20/22,Chad,15.4542,18.7322,7424,0,193,7231
6/21/22,Chad,15.4542,18.7322,7424,0,193,7231
6/22/22,Chad,15.4542,18.7322,7424,0,193,7231
6/23/22,Chad,15.4542,18.7322,7424,0,193,7231
6/24/22,Chad,15.4542,18.7322,7424,0,193,7231
6/25/22,Chad,15.4542,18.7322,7424,0,193,7231
6/26/22,Chad,15.4542,18.7322,7424,0,193,7231
6/27/22,Chad,15.4542,18.7322,7425,0,193,7232
6/28/22,Chad,15.4542,18.7322,7425,0,193,7232
6/29/22,Chad,15.4542,18.7322,7425,0,193,7232
6/30/22,Chad,15.4542,18.7322,7425,0,193,7232
7/1/22,Chad,15.4542,18.7322,7425,0,193,7232
7/2/22,Chad,15.4542,18.7322,7425,0,193,7232
7/3/22,Chad,15.4542,18.7322,7425,0,193,7232
7/4/22,Chad,15.4542,18.7322,7426,0,193,7233
7/5/22,Chad,15.4542,18.7322,7426,0,193,7233
7/6/22,Chad,15.4542,18.7322,7426,0,193,7233
7/7/22,Chad,15.4542,18.7322,7426,0,193,7233
7/8/22,Chad,15.4542,18.7322,7426,0,193,7233
7/9/22,Chad,15.4542,18.7322,7426,0,193,7233
7/10/22,Chad,15.4542,18.7322,7426,0,193,7233
7/11/22,Chad,15.4542,18.7322,7427,0,193,7234
7/12/22,Chad,15.4542,18.7322,7427,0,193,7234
7/13/22,Chad,15.4542,18.7322,7427,0,193,7234
7/14/22,Chad,15.4542,18.7322,7427,0,193,7234
7/15/22,Chad,15.4542,18.7322,7427,0,193,7234
7/16/22,Chad,15.4542,18.7322,7427,0,193,7234
7/17/22,Chad,15.4542,18.7322,7427,0,193,7234
7/18/22,Chad,15.4542,18.7322,7430,0,193,7237
7/19/22,Chad,15.4542,18.7322,7430,0,193,7237
7/20/22,Chad,15.4542,18.7322,7430,0,193,7237
7/21/22,Chad,15.4542,18.7322,7430,0,193,7237
7/22/22,Chad,15.4542,18.7322,7430,0,193,7237
7/23/22,Chad,15.4542,18.7322,7430,0,193,7237
7/24/22,Chad,15.4542,18.7322,7430,0,193,7237
7/25/22,Chad,15.4542,18.7322,7432,0,193,7239
7/26/22,Chad,15.4542,18.7322,7432,0,193,7239
7/27/22,Chad,15.4542,18.7322,7432,0,193,7239
7/28/22,Chad,15.4542,18.7322,7432,0,193,7239
7/29/22,Chad,15.4542,18.7322,7432,0,193,7239
7/30/22,Chad,15.4542,18.7322,7432,0,193,7239
7/31/22,Chad,15.4542,18.7322,7432,0,193,7239
8/1/22,Chad,15.4542,18.7322,7437,0,193,7244
8/2/22,Chad,15.4542,18.7322,7437,0,193,7244
8/3/22,Chad,15.4542,18.7322,7437,0,193,7244
8/4/22,Chad,15.4542,18.7322,7437,0,193,7244
8/5/22,Chad,15.4542,18.7322,7437,0,193,7244
8/6/22,Chad,15.4542,18.7322,7437,0,193,7244
8/7/22,Chad,15.4542,18.7322,7437,0,193,7244
8/8/22,Chad,15.4542,18.7322,7442,0,193,7249
8/9/22,Chad,15.4542,18.7322,7442,0,193,7249
8/10/22,Chad,15.4542,18.7322,7442,0,193,7249
8/11/22,Chad,15.4542,18.7322,7442,0,193,7249
8/12/22,Chad,15.4542,18.7322,7444,0,193,7251
8/13/22,Chad,15.4542,18.7322,7444,0,193,7251
8/14/22,Chad,15.4542,18.7322,7444,0,193,7251
8/15/22,Chad,15.4542,18.7322,7456,0,193,7263
8/16/22,Chad,15.4542,18.7322,7458,0,193,7265
8/17/22,Chad,15.4542,18.7322,7458,0,193,7265
8/18/22,Chad,15.4542,18.7322,7458,0,193,7265
8/19/22,Chad,15.4542,18.7322,7458,0,193,7265
8/20/22,Chad,15.4542,18.7322,7458,0,193,7265
8/21/22,Chad,15.4542,18.7322,7458,0,193,7265
8/22/22,Chad,15.4542,18.7322,7489,0,193,7296
8/23/22,Chad,15.4542,18.7322,7491,0,193,7298
8/24/22,Chad,15.4542,18.7322,7491,0,193,7298
8/25/22,Chad,15.4542,18.7322,7491,0,193,7298
8/26/22,Chad,15.4542,18.7322,7491,0,193,7298
8/27/22,Chad,15.4542,18.7322,7491,0,193,7298
8/28/22,Chad,15.4542,18.7322,7491,0,193,7298
8/29/22,Chad,15.4542,18.7322,7536,0,193,7343
8/30/22,Chad,15.4542,18.7322,7538,0,193,7345
8/31/22,Chad,15.4542,18.7322,7538,0,193,7345
9/1/22,Chad,15.4542,18.7322,7538,0,193,7345
9/2/22,Chad,15.4542,18.7322,7538,0,193,7345
9/3/22,Chad,15.4542,18.7322,7538,0,193,7345
9/4/22,Chad,15.4542,18.7322,7538,0,193,7345
9/5/22,Chad,15.4542,18.7322,7547,0,193,7354
9/6/22,Chad,15.4542,18.7322,7547,0,193,7354
9/7/22,Chad,15.4542,18.7322,7549,0,193,7356
9/8/22,Chad,15.4542,18.7322,7549,0,193,7356
9/9/22,Chad,15.4542,18.7322,7549,0,193,7356
9/10/22,Chad,15.4542,18.7322,7549,0,193,7356
9/11/22,Chad,15.4542,18.7322,7549,0,193,7356
9/12/22,Chad,15.4542,18.7322,7558,0,193,7365
9/13/22,Chad,15.4542,18.7322,7560,0,193,7367
9/14/22,Chad,15.4542,18.7322,7560,0,193,7367
9/15/22,Chad,15.4542,18.7322,7560,0,193,7367
9/16/22,Chad,15.4542,18.7322,7560,0,193,7367
9/17/22,Chad,15.4542,18.7322,7560,0,193,7367
9/18/22,Chad,15.4542,18.7322,7560,0,193,7367
9/19/22,Chad,15.4542,18.7322,7571,0,193,7378
9/20/22,Chad,15.4542,18.7322,7573,0,193,7380
9/21/22,Chad,15.4542,18.7322,7573,0,193,7380
9/22/22,Chad,15.4542,18.7322,7573,0,193,7380
9/23/22,Chad,15.4542,18.7322,7573,0,193,7380
9/24/22,Chad,15.4542,18.7322,7573,0,193,7380
9/25/22,Chad,15.4542,18.7322,7573,0,193,7380
9/26/22,Chad,15.4542,18.7322,7581,0,193,7388
9/27/22,Chad,15.4542,18.7322,7581,0,193,7388
9/28/22,Chad,15.4542,18.7322,7583,0,193,7390
9/29/22,Chad,15.4542,18.7322,7583,0,193,7390
9/30/22,Chad,15.4542,18.7322,7583,0,193,7390
10/1/22,Chad,15.4542,18.7322,7583,0,193,7390
10/2/22,Chad,15.4542,18.7322,7583,0,193,7390
10/3/22,Chad,15.4542,18.7322,7590,0,193,7397
10/4/22,Chad,15.4542,18.7322,7590,0,193,7397
10/5/22,Chad,15.4542,18.7322,7590,0,193,7397
10/6/22,Chad,15.4542,18.7322,7590,0,193,7397
10/7/22,Chad,15.4542,18.7322,7590,0,193,7397
10/8/22,Chad,15.4542,18.7322,7590,0,193,7397
10/9/22,Chad,15.4542,18.7322,7590,0,193,7397
10/10/22,Chad,15.4542,18.7322,7590,0,193,7397
10/11/22,Chad,15.4542,18.7322,7605,0,193,7412
10/12/22,Chad,15.4542,18.7322,7605,0,193,7412
10/13/22,Chad,15.4542,18.7322,7605,0,193,7412
10/14/22,Chad,15.4542,18.7322,7605,0,193,7412
10/15/22,Chad,15.4542,18.7322,7605,0,193,7412
10/16/22,Chad,15.4542,18.7322,7605,0,193,7412
10/17/22,Chad,15.4542,18.7322,7613,0,193,7420
10/18/22,Chad,15.4542,18.7322,7613,0,193,7420
10/19/22,Chad,15.4542,18.7322,7613,0,193,7420
10/20/22,Chad,15.4542,18.7322,7613,0,193,7420
10/21/22,Chad,15.4542,18.7322,7613,0,193,7420
10/22/22,Chad,15.4542,18.7322,7613,0,193,7420
10/23/22,Chad,15.4542,18.7322,7613,0,193,7420
10/24/22,Chad,15.4542,18.7322,7620,0,194,7426
10/25/22,Chad,15.4542,18.7322,7620,0,194,7426
10/26/22,Chad,15.4542,18.7322,7620,0,194,7426
10/27/22,Chad,15.4542,18.7322,7620,0,194,7426
10/28/22,Chad,15.4542,18.7322,7620,0,194,7426
10/29/22,Chad,15.4542,18.7322,7620,0,194,7426
10/30/22,Chad,15.4542,18.7322,7620,0,194,7426
10/31/22,Chad,15.4542,18.7322,7627,0,194,7433
11/1/22,Chad,15.4542,18.7322,7627,0,194,7433
11/2/22,Chad,15.4542,18.7322,7627,0,194,7433
11/3/22,Chad,15.4542,18.7322,7627,0,194,7433
11/4/22,Chad,15.4542,18.7322,7627,0,194,7433
11/5/22,Chad,15.4542,18.7322,7627,0,194,7433
11/6/22,Chad,15.4542,18.7322,7627,0,194,7433
11/7/22,Chad,15.4542,18.7322,7631,0,194,7437
11/8/22,Chad,15.4542,18.7322,7631,0,194,7437
11/9/22,Chad,15.4542,18.7322,7631,0,194,7437
11/10/22,Chad,15.4542,18.7322,7631,0,194,7437
11/11/22,Chad,15.4542,18.7322,7631,0,194,7437
11/12/22,Chad,15.4542,18.7322,7631,0,194,7437
11/13/22,Chad,15.4542,18.7322,7631,0,194,7437
11/14/22,Chad,15.4542,18.7322,7637,0,194,7443
11/15/22,Chad,15.4542,18.7322,7637,0,194,7443
11/16/22,Chad,15.4542,18.7322,7637,0,194,7443
11/17/22,Chad,15.4542,18.7322,7637,0,194,7443
11/18/22,Chad,15.4542,18.7322,7637,0,194,7443
11/19/22,Chad,15.4542,18.7322,7637,0,194,7443
11/20/22,Chad,15.4542,18.7322,7637,0,194,7443
11/21/22,Chad,15.4542,18.7322,7641,0,194,7447
11/22/22,Chad,15.4542,18.7322,7641,0,194,7447
11/23/22,Chad,15.4542,18.7322,7641,0,194,7447
11/24/22,Chad,15.4542,18.7322,7641,0,194,7447
11/25/22,Chad,15.4542,18.7322,7641,0,194,7447
11/26/22,Chad,15.4542,18.7322,7641,0,194,7447
11/27/22,Chad,15.4542,18.7322,7641,0,194,7447
11/28/22,Chad,15.4542,18.7322,7646,0,194,7452
11/29/22,Chad,15.4542,18.7322,7646,0,194,7452
11/30/22,Chad,15.4542,18.7322,7646,0,194,7452
12/1/22,Chad,15.4542,18.7322,7646,0,194,7452
12/2/22,Chad,15.4542,18.7322,7646,0,194,7452
12/3/22,Chad,15.4542,18.7322,7646,0,194,7452
12/4/22,Chad,15.4542,18.7322,7646,0,194,7452
12/5/22,Chad,15.4542,18.7322,7647,0,194,7453
12/6/22,Chad,15.4542,18.7322,7647,0,194,7453
12/7/22,Chad,15.4542,18.7322,7647,0,194,7453
12/8/22,Chad,15.4542,18.7322,7647,0,194,7453
12/9/22,Chad,15.4542,18.7322,7647,0,194,7453
12/10/22,Chad,15.4542,18.7322,7647,0,194,7453
12/11/22,Chad,15.4542,18.7322,7647,0,194,7453
12/12/22,Chad,15.4542,18.7322,7648,0,194,7454
12/13/22,Chad,15.4542,18.7322,7648,0,194,7454
12/14/22,Chad,15.4542,18.7322,7648,0,194,7454
12/15/22,Chad,15.4542,18.7322,7648,0,194,7454
12/16/22,Chad,15.4542,18.7322,7648,0,194,7454
12/17/22,Chad,15.4542,18.7322,7648,0,194,7454
1/1/22,Chile,-35.6751,-71.543,1808398,0,39140,1769258
1/2/22,Chile,-35.6751,-71.543,1810302,0,39162,1771140
1/3/22,Chile,-35.6751,-71.543,1811297,0,39173,1772124
1/4/22,Chile,-35.6751,-71.543,1812348,0,39174,1773174
1/5/22,Chile,-35.6751,-71.543,1814188,0,39177,1775011
1/6/22,Chile,-35.6751,-71.543,1817300,0,39207,1778093
1/7/22,Chile,-35.6751,-71.543,1821071,0,39232,1781839
1/8/22,Chile,-35.6751,-71.543,1825417,0,39251,1786166
1/9/22,Chile,-35.6751,-71.543,1829437,0,39272,1790165
1/10/22,Chile,-35.6751,-71.543,1833478,0,39285,1794193
1/11/22,Chile,-35.6751,-71.543,1837390,0,39289,1798101
1/12/22,Chile,-35.6751,-71.543,1842218,0,39290,1802928
1/13/22,Chile,-35.6751,-71.543,1849465,0,39331,1810134
1/14/22,Chile,-35.6751,-71.543,1857764,0,39355,1818409
1/15/22,Chile,-35.6751,-71.543,1867101,0,39376,1827725
1/16/22,Chile,-35.6751,-71.543,1876610,0,39394,1837216
1/17/22,Chile,-35.6751,-71.543,1885540,0,39426,1846114
1/18/22,Chile,-35.6751,-71.543,1893115,0,39427,1853688
1/19/22,Chile,-35.6751,-71.543,1902657,0,39431,1863226
1/20/22,Chile,-35.6751,-71.543,1916522,0,39456,1877066
1/21/22,Chile,-35.6751,-71.543,1934204,0,39474,1894730
1/22/22,Chile,-35.6751,-71.543,1949675,0,39497,1910178
1/23/22,Chile,-35.6751,-71.543,1965393,0,39512,1925881
1/24/22,Chile,-35.6751,-71.543,1984190,0,39535,1944655
1/25/22,Chile,-35.6751,-71.543,2001346,0,39543,1961803
1/26/22,Chile,-35.6751,-71.543,2020082,0,39547,1980535
1/27/22,Chile,-35.6751,-71.543,2045874,0,39594,2006280
1/28/22,Chile,-35.6751,-71.543,2075703,0,39620,2036083
1/29/22,Chile,-35.6751,-71.543,2107612,0,39653,2067959
1/30/22,Chile,-35.6751,-71.543,2137743,0,39684,2098059
1/31/22,Chile,-35.6751,-71.543,2165984,0,39721,2126263
2/1/22,Chile,-35.6751,-71.543,2190561,0,39733,2150828
2/2/22,Chile,-35.6751,-71.543,2221276,0,39742,2181534
2/3/22,Chile,-35.6751,-71.543,2258005,0,39824,2218181
2/4/22,Chile,-35.6751,-71.543,2296712,0,39867,2256845
2/5/22,Chile,-35.6751,-71.543,2335034,0,39930,2295104
2/6/22,Chile,-35.6751,-71.543,2371833,0,39987,2331846
2/7/22,Chile,-35.6751,-71.543,2405672,0,40060,2365612
2/8/22,Chile,-35.6751,-71.543,2431845,0,40087,2391758
2/9/22,Chile,-35.6751,-71.543,2466098,0,40111,2425987
2/10/22,Chile,-35.6751,-71.543,2504168,0,40273,2463895
2/11/22,Chile,-35.6751,-71.543,2545819,0,40370,2505449
2/12/22,Chile,-35.6751,-71.543,2582934,0,40464,2542470
2/13/22,Chile,-35.6751,-71.543,2621427,0,40558,2580869
2/14/22,Chile,-35.6751,-71.543,2652713,0,40666,2612047
2/15/22,Chile,-35.6751,-71.543,2677692,0,40698,2636994
2/16/22,Chile,-35.6751,-71.543,2709854,0,40735,2669119
2/17/22,Chile,-35.6751,-71.543,2747552,0,40936,2706616
2/18/22,Chile,-35.6751,-71.543,2783458,0,41067,2742391
2/19/22,Chile,-35.6751,-71.543,2819246,0,41196,2778050
2/20/22,Chile,-35.6751,-71.543,2851382,0,41347,2810035
2/21/22,Chile,-35.6751,-71.543,2876455,0,41491,2834964
2/22/22,Chile,-35.6751,-71.543,2895931,0,41526,2854405
2/23/22,Chile,-35.6751,-71.543,2921131,0,41571,2879560
2/24/22,Chile,-35.6751,-71.543,2953895,0,41795,2912100
2/25/22,Chile,-35.6751,-71.543,2985873,0,41919,2943954
2/26/22,Chile,-35.6751,-71.543,3015630,0,42070,2973560
2/27/22,Chile,-35.6751,-71.543,3041400,0,42200,2999200
2/28/22,Chile,-35.6751,-71.543,3061019,0,42353,3018666
3/1/22,Chile,-35.6751,-71.543,3061019,0,42353,3018666
3/2/22,Chile,-35.6751,-71.543,3098110,0,42411,3055699
3/3/22,Chile,-35.6751,-71.543,3122802,0,42683,3080119
3/4/22,Chile,-35.6751,-71.543,3147434,0,42809,3104625
3/5/22,Chile,-35.6751,-71.543,3168335,0,42955,3125380
3/6/22,Chile,-35.6751,-71.543,3188448,0,43077,3145371
3/7/22,Chile,-35.6751,-71.543,3202562,0,43226,3159336
3/8/22,Chile,-35.6751,-71.543,3214326,0,43260,3171066
3/9/22,Chile,-35.6751,-71.543,3230793,0,43283,3187510
3/10/22,Chile,-35.6751,-71.543,3249890,0,43527,3206363
3/11/22,Chile,-35.6751,-71.543,3269062,0,43659,3225403
3/12/22,Chile,-35.6751,-71.543,3286476,0,43785,3242691
3/13/22,Chile,-35.6751,-71.543,3301747,0,43879,3257868
3/14/22,Chile,-35.6751,-71.543,3313242,0,44005,3269237
3/15/22,Chile,-35.6751,-71.543,3323324,0,44039,3279285
3/16/22,Chile,-35.6751,-71.543,3336614,0,44062,3292552
3/17/22,Chile,-35.6751,-71.543,3353259,0,44246,3309013
3/18/22,Chile,-35.6751,-71.543,3368704,0,44339,3324365
3/19/22,Chile,-35.6751,-71.543,3381681,0,44440,3337241
3/20/22,Chile,-35.6751,-71.543,3392978,0,44518,3348460
3/21/22,Chile,-35.6751,-71.543,3401145,0,55965,3345180
3/22/22,Chile,-35.6751,-71.543,3406540,0,55976,3350564
3/23/22,Chile,-35.6751,-71.543,3415989,0,55992,3359997
3/24/22,Chile,-35.6751,-71.543,3426147,0,56147,3370000
3/25/22,Chile,-35.6751,-71.543,3434908,0,56222,3378686
3/26/22,Chile,-35.6751,-71.543,3443018,0,56298,3386720
3/27/22,Chile,-35.6751,-71.543,3450094,0,56381,3393713
3/28/22,Chile,-35.6751,-71.543,3455060,0,56446,3398614
3/29/22,Chile,-35.6751,-71.543,3458499,0,56464,3402035
3/30/22,Chile,-35.6751,-71.543,3464425,0,56467,3407958
3/31/22,Chile,-35.6751,-71.543,3470936,0,56580,3414356
4/1/22,Chile,-35.6751,-71.543,3476914,0,56637,3420277
4/2/22,Chile,-35.6751,-71.543,3482175,0,56689,3425486
4/3/22,Chile,-35.6751,-71.543,3486653,0,56750,3429903
4/4/22,Chile,-35.6751,-71.543,3489913,0,56798,3433115
4/5/22,Chile,-35.6751,-71.543,3491962,0,56809,3435153
4/6/22,Chile,-35.6751,-71.543,3495889,0,56822,3439067
4/7/22,Chile,-35.6751,-71.543,3500670,0,56912,3443758
4/8/22,Chile,-35.6751,-71.543,3504783,0,56955,3447828
4/9/22,Chile,-35.6751,-71.543,3508556,0,56997,3451559
4/10/22,Chile,-35.6751,-71.543,3512020,0,57041,3454979
4/11/22,Chile,-35.6751,-71.543,3514291,0,57081,3457210
4/12/22,Chile,-35.6751,-71.543,3515878,0,57094,3458784
4/13/22,Chile,-35.6751,-71.543,3518800,0,57098,3461702
4/14/22,Chile,-35.6751,-71.543,3522422,0,57167,3465255
4/15/22,Chile,-35.6751,-71.543,3525845,0,57205,3468640
4/16/22,Chile,-35.6751,-71.543,3528626,0,57231,3471395
4/17/22,Chile,-35.6751,-71.543,3530258,0,57263,3472995
4/18/22,Chile,-35.6751,-71.543,3531529,0,57270,3474259
4/19/22,Chile,-35.6751,-71.543,3532649,0,57275,3475374
4/20/22,Chile,-35.6751,-71.543,3535534,0,57283,3478251
4/21/22,Chile,-35.6751,-71.543,3538843,0,57325,3481518
4/22/22,Chile,-35.6751,-71.543,3541792,0,57351,3484441
4/23/22,Chile,-35.6751,-71.543,3544463,0,57375,3487088
4/24/22,Chile,-35.6751,-71.543,3546493,0,57375,3489118
4/25/22,Chile,-35.6751,-71.543,3547977,0,57376,3490601
4/26/22,Chile,-35.6751,-71.543,3549327,0,57387,3491940
4/27/22,Chile,-35.6751,-71.543,3551383,0,57468,3493915
4/28/22,Chile,-35.6751,-71.543,3553956,0,57495,3496461
4/29/22,Chile,-35.6751,-71.543,3556333,0,57509,3498824
4/30/22,Chile,-35.6751,-71.543,3558631,0,57527,3501104
5/1/22,Chile,-35.6751,-71.543,3561016,0,57539,3503477
5/2/22,Chile,-35.6751,-71.543,3562521,0,57541,3504980
5/3/22,Chile,-35.6751,-71.543,3563650,0,57544,3506106
5/4/22,Chile,-35.6751,-71.543,3566183,0,57580,3508603
5/5/22,Chile,-35.6751,-71.543,3569492,0,57597,3511895
5/6/22,Chile,-35.6751,-71.543,3572817,0,57614,3515203
5/7/22,Chile,-35.6751,-71.543,3576139,0,57629,3518510
5/8/22,Chile,-35.6751,-71.543,3576139,0,57629,3518510
5/9/22,Chile,-35.6751,-71.543,3581374,0,57639,3523735
5/10/22,Chile,-35.6751,-71.543,3583227,0,57642,3525585
5/11/22,Chile,-35.6751,-71.543,3586522,0,57667,3528855
5/12/22,Chile,-35.6751,-71.543,3591097,0,57680,3533417
5/13/22,Chile,-35.6751,-71.543,3595968,0,57697,3538271
5/14/22,Chile,-35.6751,-71.543,3600896,0,57714,3543182
5/15/22,Chile,-35.6751,-71.543,3605522,0,57722,3547800
5/16/22,Chile,-35.6751,-71.543,3609338,0,57725,3551613
5/17/22,Chile,-35.6751,-71.543,3611813,0,57733,3554080
5/18/22,Chile,-35.6751,-71.543,3616950,0,57754,3559196
5/19/22,Chile,-35.6751,-71.543,3623889,0,57767,3566122
5/20/22,Chile,-35.6751,-71.543,3630741,0,57782,3572959
5/21/22,Chile,-35.6751,-71.543,3636993,0,57794,3579199
5/22/22,Chile,-35.6751,-71.543,3643136,0,57802,3585334
5/23/22,Chile,-35.6751,-71.543,3647361,0,57810,3589551
5/24/22,Chile,-35.6751,-71.543,3651076,0,57813,3593263
5/25/22,Chile,-35.6751,-71.543,3657188,0,57835,3599353
5/26/22,Chile,-35.6751,-71.543,3665862,0,57851,3608011
5/27/22,Chile,-35.6751,-71.543,3675085,0,57867,3617218
5/28/22,Chile,-35.6751,-71.543,3684585,0,57877,3626708
5/29/22,Chile,-35.6751,-71.543,3693241,0,57877,3635364
5/30/22,Chile,-35.6751,-71.543,3698667,0,57887,3640780
5/31/22,Chile,-35.6751,-71.543,3702941,0,57892,3645049
6/1/22,Chile,-35.6751,-71.543,3710521,0,57897,3652624
6/2/22,Chile,-35.6751,-71.543,3720334,0,57920,3662414
6/3/22,Chile,-35.6751,-71.543,3729906,0,57932,3671974
6/4/22,Chile,-35.6751,-71.543,3739796,0,57955,3681841
6/5/22,Chile,-35.6751,-71.543,3748619,0,57973,3690646
6/6/22,Chile,-35.6751,-71.543,3756220,0,57991,3698229
6/7/22,Chile,-35.6751,-71.543,3760891,0,57997,3702894
6/8/22,Chile,-35.6751,-71.543,3771509,0,58005,3713504
6/9/22,Chile,-35.6751,-71.543,3783945,0,58036,3725909
6/10/22,Chile,-35.6751,-71.543,3796909,0,58054,3738855
6/11/22,Chile,-35.6751,-71.543,3808970,0,58076,3750894
6/12/22,Chile,-35.6751,-71.543,3820009,0,58095,3761914
6/13/22,Chile,-35.6751,-71.543,3829119,0,58109,3771010
6/14/22,Chile,-35.6751,-71.543,3834020,0,58119,3775901
6/15/22,Chile,-35.6751,-71.543,3844668,0,58135,3786533
6/16/22,Chile,-35.6751,-71.543,3857643,0,58171,3799472
6/17/22,Chile,-35.6751,-71.543,3870747,0,58194,3812553
6/18/22,Chile,-35.6751,-71.543,3882425,0,58226,3824199
6/19/22,Chile,-35.6751,-71.543,3893726,0,58251,3835475
6/20/22,Chile,-35.6751,-71.543,3901215,0,58277,3842938
6/21/22,Chile,-35.6751,-71.543,3906107,0,58286,3847821
6/22/22,Chile,-35.6751,-71.543,3915653,0,58296,3857357
6/23/22,Chile,-35.6751,-71.543,3924247,0,58335,3865912
6/24/22,Chile,-35.6751,-71.543,3935375,0,58346,3877029
6/25/22,Chile,-35.6751,-71.543,3948012,0,58385,3889627
6/26/22,Chile,-35.6751,-71.543,3959325,0,58416,3900909
6/27/22,Chile,-35.6751,-71.543,3967774,0,58445,3909329
6/28/22,Chile,-35.6751,-71.543,3973291,0,58459,3914832
6/29/22,Chile,-35.6751,-71.543,3979797,0,58467,3921330
6/30/22,Chile,-35.6751,-71.543,3990693,0,58479,3932214
7/1/22,Chile,-35.6751,-71.543,4002538,0,58525,3944013
7/2/22,Chile,-35.6751,-71.543,4013903,0,58563,3955340
7/3/22,Chile,-35.6751,-71.543,4023697,0,58589,3965108
7/4/22,Chile,-35.6751,-71.543,4030267,0,58617,3971650
7/5/22,Chile,-35.6751,-71.543,4035379,0,58631,3976748
7/6/22,Chile,-35.6751,-71.543,4044611,0,58649,3985962
7/7/22,Chile,-35.6751,-71.543,4055693,0,58717,3996976
7/8/22,Chile,-35.6751,-71.543,4065878,0,58757,4007121
7/9/22,Chile,-35.6751,-71.543,4075533,0,58787,4016746
7/10/22,Chile,-35.6751,-71.543,4084308,0,58818,4025490
7/11/22,Chile,-35.6751,-71.543,4090523,0,58860,4031663
7/12/22,Chile,-35.6751,-71.543,4095096,0,58878,4036218
7/13/22,Chile,-35.6751,-71.543,4103590,0,58884,4044706
7/14/22,Chile,-35.6751,-71.543,4113288,0,58955,4054333
7/15/22,Chile,-35.6751,-71.543,4122401,0,58990,4063411
7/16/22,Chile,-35.6751,-71.543,4130232,0,59039,4071193
7/17/22,Chile,-35.6751,-71.543,4137152,0,59086,4078066
7/18/22,Chile,-35.6751,-71.543,4141778,0,59126,4082652
7/19/22,Chile,-35.6751,-71.543,4145452,0,59140,4086312
7/20/22,Chile,-35.6751,-71.543,4152475,0,59146,4093329
7/21/22,Chile,-35.6751,-71.543,4161478,0,59216,4102262
7/22/22,Chile,-35.6751,-71.543,4169554,0,59263,4110291
7/23/22,Chile,-35.6751,-71.543,4177517,0,59303,4118214
7/24/22,Chile,-35.6751,-71.543,4185247,0,59332,4125915
7/25/22,Chile,-35.6751,-71.543,4191347,0,59383,4131964
7/26/22,Chile,-35.6751,-71.543,4195780,0,59393,4136387
7/27/22,Chile,-35.6751,-71.543,4204824,0,59405,4145419
7/28/22,Chile,-35.6751,-71.543,4214769,0,59477,4155292
7/29/22,Chile,-35.6751,-71.543,4224361,0,59521,4164840
7/30/22,Chile,-35.6751,-71.543,4233549,0,59552,4173997
7/31/22,Chile,-35.6751,-71.543,4241546,0,59577,4181969
8/1/22,Chile,-35.6751,-71.543,4248048,0,59622,4188426
8/2/22,Chile,-35.6751,-71.543,4253056,0,59629,4193427
8/3/22,Chile,-35.6751,-71.543,4262916,0,59633,4203283
8/4/22,Chile,-35.6751,-71.543,4274613,0,59698,4214915
8/5/22,Chile,-35.6751,-71.543,4286216,0,59741,4226475
8/6/22,Chile,-35.6751,-71.543,4297144,0,59773,4237371
8/7/22,Chile,-35.6751,-71.543,4306955,0,59800,4247155
8/8/22,Chile,-35.6751,-71.543,4314459,0,59835,4254624
8/9/22,Chile,-35.6751,-71.543,4320173,0,59840,4260333
8/10/22,Chile,-35.6751,-71.543,4331416,0,59845,4271571
8/11/22,Chile,-35.6751,-71.543,4344910,0,59896,4285014
8/12/22,Chile,-35.6751,-71.543,4357818,0,59930,4297888
8/13/22,Chile,-35.6751,-71.543,4369706,0,59961,4309745
8/14/22,Chile,-35.6751,-71.543,4380148,0,59989,4320159
8/15/22,Chile,-35.6751,-71.543,4387731,0,60023,4327708
8/16/22,Chile,-35.6751,-71.543,4393244,0,60028,4333216
8/17/22,Chile,-35.6751,-71.543,4399408,0,60036,4339372
8/18/22,Chile,-35.6751,-71.543,4409873,0,60043,4349830
8/19/22,Chile,-35.6751,-71.543,4421815,0,60135,4361680
8/20/22,Chile,-35.6751,-71.543,4432586,0,60174,4372412
8/21/22,Chile,-35.6751,-71.543,4442073,0,60202,4381871
8/22/22,Chile,-35.6751,-71.543,4449016,0,60236,4388780
8/23/22,Chile,-35.6751,-71.543,4453557,0,60248,4393309
8/24/22,Chile,-35.6751,-71.543,4461869,0,60254,4401615
8/25/22,Chile,-35.6751,-71.543,4471118,0,60321,4410797
8/26/22,Chile,-35.6751,-71.543,4479644,0,60353,4419291
8/27/22,Chile,-35.6751,-71.543,4487453,0,60382,4427071
8/28/22,Chile,-35.6751,-71.543,4494404,0,60412,4433992
8/29/22,Chile,-35.6751,-71.543,4499223,0,60435,4438788
8/30/22,Chile,-35.6751,-71.543,4502674,0,60445,4442229
8/31/22,Chile,-35.6751,-71.543,4508422,0,60451,4447971
9/1/22,Chile,-35.6751,-71.543,4508422,0,60451,4447971
9/2/22,Chile,-35.6751,-71.543,4522295,0,60543,4461752
9/3/22,Chile,-35.6751,-71.543,4527533,0,60571,4466962
9/4/22,Chile,-35.6751,-71.543,4532562,0,60610,4471952
9/5/22,Chile,-35.6751,-71.543,4536380,0,60639,4475741
9/6/22,Chile,-35.6751,-71.543,4538858,0,60645,4478213
9/7/22,Chile,-35.6751,-71.543,4543982,0,60648,4483334
9/8/22,Chile,-35.6751,-71.543,4549927,0,60696,4489231
9/9/22,Chile,-35.6751,-71.543,4555253,0,60721,4494532
9/10/22,Chile,-35.6751,-71.543,4559801,0,60749,4499052
9/11/22,Chile,-35.6751,-71.543,4563807,0,60776,4503031
9/12/22,Chile,-35.6751,-71.543,4566548,0,60812,4505736
9/13/22,Chile,-35.6751,-71.543,4568495,0,60822,4507673
9/14/22,Chile,-35.6751,-71.543,4568495,0,60822,4507673
9/15/22,Chile,-35.6751,-71.543,4568495,0,60822,4507673
9/16/22,Chile,-35.6751,-71.543,4568495,0,60822,4507673
9/17/22,Chile,-35.6751,-71.543,4568495,0,60822,4507673
9/18/22,Chile,-35.6751,-71.543,4568495,0,60822,4507673
9/19/22,Chile,-35.6751,-71.543,4568495,0,60822,4507673
9/20/22,Chile,-35.6751,-71.543,4588533,0,60950,4527583
9/21/22,Chile,-35.6751,-71.543,4590421,0,60966,4529455
9/22/22,Chile,-35.6751,-71.543,4594519,0,60974,4533545
9/23/22,Chile,-35.6751,-71.543,4599179,0,61017,4538162
9/24/22,Chile,-35.6751,-71.543,4603514,0,61046,4542468
9/25/22,Chile,-35.6751,-71.543,4607566,0,61062,4546504
9/26/22,Chile,-35.6751,-71.543,4610353,0,61085,4549268
9/27/22,Chile,-35.6751,-71.543,4612278,0,61087,4551191
9/28/22,Chile,-35.6751,-71.543,4616294,0,61092,4555202
9/29/22,Chile,-35.6751,-71.543,4620377,0,61141,4559236
9/30/22,Chile,-35.6751,-71.543,4624307,0,61154,4563153
10/1/22,Chile,-35.6751,-71.543,4627923,0,61178,4566745
10/2/22,Chile,-35.6751,-71.543,4630935,0,61200,4569735
10/3/22,Chile,-35.6751,-71.543,4633128,0,61219,4571909
10/4/22,Chile,-35.6751,-71.543,4634889,0,61227,4573662
10/5/22,Chile,-35.6751,-71.543,4638238,0,61233,4577005
10/6/22,Chile,-35.6751,-71.543,4642033,0,61268,4580765
10/7/22,Chile,-35.6751,-71.543,4645610,0,61290,4584320
10/8/22,Chile,-35.6751,-71.543,4649348,0,61306,4588042
10/9/22,Chile,-35.6751,-71.543,4652776,0,61325,4591451
10/10/22,Chile,-35.6751,-71.543,4655058,0,61339,4593719
10/11/22,Chile,-35.6751,-71.543,4656842,0,61345,4595497
10/12/22,Chile,-35.6751,-71.543,4659201,0,61350,4597851
10/13/22,Chile,-35.6751,-71.543,4664095,0,61355,4602740
10/14/22,Chile,-35.6751,-71.543,4669403,0,61397,4608006
10/15/22,Chile,-35.6751,-71.543,4674373,0,61412,4612961
10/16/22,Chile,-35.6751,-71.543,4678644,0,61433,4617211
10/17/22,Chile,-35.6751,-71.543,4682067,0,61448,4620619
10/18/22,Chile,-35.6751,-71.543,4684770,0,61455,4623315
10/19/22,Chile,-35.6751,-71.543,4690513,0,61459,4629054
10/20/22,Chile,-35.6751,-71.543,4696888,0,61495,4635393
10/21/22,Chile,-35.6751,-71.543,4702881,0,61513,4641368
10/22/22,Chile,-35.6751,-71.543,4708870,0,61535,4647335
10/23/22,Chile,-35.6751,-71.543,4715098,0,61549,4653549
10/24/22,Chile,-35.6751,-71.543,4718965,0,61549,4657416
10/25/22,Chile,-35.6751,-71.543,4722184,0,61577,4660607
10/26/22,Chile,-35.6751,-71.543,4728938,0,61584,4667354
10/27/22,Chile,-35.6751,-71.543,4737212,0,61607,4675605
10/28/22,Chile,-35.6751,-71.543,4744343,0,61632,4682711
10/29/22,Chile,-35.6751,-71.543,4750775,0,61652,4689123
10/30/22,Chile,-35.6751,-71.543,4756206,0,61677,4694529
10/31/22,Chile,-35.6751,-71.543,4760186,0,61677,4698509
11/1/22,Chile,-35.6751,-71.543,4762773,0,61677,4701096
11/2/22,Chile,-35.6751,-71.543,4765929,0,61677,4704252
11/3/22,Chile,-35.6751,-71.543,4769638,0,61725,4707913
11/4/22,Chile,-35.6751,-71.543,4777208,0,61737,4715471
11/5/22,Chile,-35.6751,-71.543,4786198,0,61789,4724409
11/6/22,Chile,-35.6751,-71.543,4793902,0,61813,4732089
11/7/22,Chile,-35.6751,-71.543,4799221,0,61853,4737368
11/8/22,Chile,-35.6751,-71.543,4803251,0,61868,4741383
11/9/22,Chile,-35.6751,-71.543,4810774,0,61870,4748904
11/10/22,Chile,-35.6751,-71.543,4818999,0,61923,4757076
11/11/22,Chile,-35.6751,-71.543,4826234,0,61953,4764281
11/12/22,Chile,-35.6751,-71.543,4832838,0,61983,4770855
11/13/22,Chile,-35.6751,-71.543,4838658,0,62008,4776650
11/14/22,Chile,-35.6751,-71.543,4842632,0,62032,4780600
11/15/22,Chile,-35.6751,-71.543,4845748,0,62045,4783703
11/16/22,Chile,-35.6751,-71.543,4852337,0,62052,4790285
11/17/22,Chile,-35.6751,-71.543,4859241,0,62102,4797139
11/18/22,Chile,-35.6751,-71.543,4865698,0,62130,4803568
11/19/22,Chile,-35.6751,-71.543,4871851,0,62165,4809686
11/20/22,Chile,-35.6751,-71.543,4877248,0,62187,4815061
11/21/22,Chile,-35.6751,-71.543,4880884,0,62211,4818673
11/22/22,Chile,-35.6751,-71.543,4883582,0,62217,4821365
11/23/22,Chile,-35.6751,-71.543,4889186,0,62231,4826955
11/24/22,Chile,-35.6751,-71.543,4895292,0,62288,4833004
11/25/22,Chile,-35.6751,-71.543,4900851,0,62332,4838519
11/26/22,Chile,-35.6751,-71.543,4905535,0,62357,4843178
11/27/22,Chile,-35.6751,-71.543,4909878,0,62377,4847501
11/28/22,Chile,-35.6751,-71.543,4912805,0,62407,4850398
11/29/22,Chile,-35.6751,-71.543,4915134,0,62417,4852717
11/30/22,Chile,-35.6751,-71.543,4920010,0,62422,4857588
12/1/22,Chile,-35.6751,-71.543,4925051,0,62484,4862567
12/2/22,Chile,-35.6751,-71.543,4929498,0,62510,4866988
12/3/22,Chile,-35.6751,-71.543,4933525,0,62543,4870982
12/4/22,Chile,-35.6751,-71.543,4937047,0,62571,4874476
12/5/22,Chile,-35.6751,-71.543,4939304,0,62587,4876717
12/6/22,Chile,-35.6751,-71.543,4941227,0,62597,4878630
12/7/22,Chile,-35.6751,-71.543,4945425,0,62605,4882820
12/8/22,Chile,-35.6751,-71.543,4949655,0,62659,4886996
12/9/22,Chile,-35.6751,-71.543,4953194,0,62683,4890511
12/10/22,Chile,-35.6751,-71.543,4955536,0,62708,4892828
12/11/22,Chile,-35.6751,-71.543,4958816,0,62715,4896101
12/12/22,Chile,-35.6751,-71.543,4961151,0,62745,4898406
12/13/22,Chile,-35.6751,-71.543,4963204,0,62749,4900455
12/14/22,Chile,-35.6751,-71.543,4967494,0,62753,4904741
12/15/22,Chile,-35.6751,-71.543,4971853,0,62795,4909058
12/16/22,Chile,-35.6751,-71.543,4975862,0,62822,4913040
12/17/22,Chile,-35.6751,-71.543,4979633,0,62850,4916783
1/1/22,China,32.887645454545456,111.78599090909091,128132,0,5103,123029
1/2/22,China,32.887645454545456,111.78599090909091,128259,0,5103,123156
1/3/22,China,32.887645454545456,111.78599090909091,128596,0,5104,123492
1/4/22,China,32.887645454545456,111.78599090909091,128771,0,5104,123667
1/5/22,China,32.887645454545456,111.78599090909091,129064,0,5104,123960
1/6/22,China,32.887645454545456,111.78599090909091,129280,0,5105,124175
1/7/22,China,32.887645454545456,111.78599090909091,129491,0,5106,124385
1/8/22,China,32.887645454545456,111.78599090909091,129738,0,5107,124631
1/9/22,China,32.887645454545456,111.78599090909091,129959,0,5109,124850
1/10/22,China,32.887645454545456,111.78599090909091,130213,0,5109,125104
1/11/22,China,32.887645454545456,111.78599090909091,130497,0,5111,125386
1/12/22,China,32.887645454545456,111.78599090909091,130737,0,5111,125626
1/13/22,China,32.887645454545456,111.78599090909091,130977,0,5111,125866
1/14/22,China,32.887645454545456,111.78599090909091,131184,0,5112,126072
1/15/22,China,32.887645454545456,111.78599090909091,131327,0,5113,126214
1/16/22,China,32.887645454545456,111.78599090909091,131601,0,5114,126487
1/17/22,China,32.887645454545456,111.78599090909091,131796,0,5114,126682
1/18/22,China,32.887645454545456,111.78599090909091,131928,0,5115,126813
1/19/22,China,32.887645454545456,111.78599090909091,132043,0,5115,126928
1/20/22,China,32.887645454545456,111.78599090909091,132148,0,5116,127032
1/21/22,China,32.887645454545456,111.78599090909091,132264,0,5116,127148
1/22/22,China,32.887645454545456,111.78599090909091,132383,0,5116,127267
1/23/22,China,32.887645454545456,111.78599090909091,132597,0,5116,127481
1/24/22,China,32.887645454545456,111.78599090909091,132772,0,5116,127656
1/25/22,China,32.887645454545456,111.78599090909091,132978,0,5117,127861
1/26/22,China,32.887645454545456,111.78599090909091,133209,0,5117,128092
1/27/22,China,32.887645454545456,111.78599090909091,133484,0,5117,128367
1/28/22,China,32.887645454545456,111.78599090909091,133709,0,5117,128592
1/29/22,China,32.887645454545456,111.78599090909091,133939,0,5117,128822
1/30/22,China,32.887645454545456,111.78599090909091,134139,0,5118,129021
1/31/22,China,32.887645454545456,111.78599090909091,134345,0,5119,129226
2/1/22,China,32.887645454545456,111.78599090909091,134564,0,5119,129445
2/2/22,China,32.887645454545456,111.78599090909091,134745,0,5119,129626
2/3/22,China,32.887645454545456,111.78599090909091,135008,0,5119,129889
2/4/22,China,32.887645454545456,111.78599090909091,135216,0,5119,130097
2/5/22,China,32.887645454545456,111.78599090909091,135663,0,5120,130543
2/6/22,China,32.887645454545456,111.78599090909091,136115,0,5120,130995
2/7/22,China,32.887645454545456,111.78599090909091,136880,0,5120,131760
2/8/22,China,32.887645454545456,111.78599090909091,137648,0,5121,132527
2/9/22,China,32.887645454545456,111.78599090909091,138855,0,5123,133732
2/10/22,China,32.887645454545456,111.78599090909091,139968,0,5124,134844
2/11/22,China,32.887645454545456,111.78599090909091,141448,0,5125,136323
2/12/22,China,32.887645454545456,111.78599090909091,143060,0,5128,137932
2/13/22,China,32.887645454545456,111.78599090909091,144519,0,5128,139391
2/14/22,China,32.887645454545456,111.78599090909091,146700,0,5130,141570
2/15/22,China,32.887645454545456,111.78599090909091,148461,0,5133,143328
2/16/22,China,32.887645454545456,111.78599090909091,152856,0,5136,147720
2/17/22,China,32.887645454545456,111.78599090909091,159083,0,5148,153935
2/18/22,China,32.887645454545456,111.78599090909091,162889,0,5169,157720
2/19/22,China,32.887645454545456,111.78599090909091,169170,0,5186,163984
2/20/22,China,32.887645454545456,111.78599090909091,175417,0,5198,170219
2/21/22,China,32.887645454545456,111.78599090909091,183114,0,5210,177904
2/22/22,China,32.887645454545456,111.78599090909091,189565,0,5246,184319
2/23/22,China,32.887645454545456,111.78599090909091,198478,0,5295,193183
2/24/22,China,32.887645454545456,111.78599090909091,207599,0,5335,202264
2/25/22,China,32.887645454545456,111.78599090909091,217932,0,5408,212524
2/26/22,China,32.887645454545456,111.78599090909091,292792,0,5488,287304
2/27/22,China,32.887645454545456,111.78599090909091,344032,0,5570,338462
2/28/22,China,32.887645454545456,111.78599090909091,400569,0,5655,394914
3/1/22,China,32.887645454545456,111.78599090909091,456582,0,5901,450681
3/2/22,China,32.887645454545456,111.78599090909091,533295,0,6079,527216
3/3/22,China,32.887645454545456,111.78599090909091,610697,0,6279,604418
3/4/22,China,32.887645454545456,111.78599090909091,683791,0,6467,677324
3/5/22,China,32.887645454545456,111.78599090909091,751844,0,6687,745157
3/6/22,China,32.887645454545456,111.78599090909091,792163,0,6920,785243
3/7/22,China,32.887645454545456,111.78599090909091,829306,0,7201,822105
3/8/22,China,32.887645454545456,111.78599090909091,868818,0,7492,861326
3/9/22,China,32.887645454545456,111.78599090909091,899945,0,7784,892161
3/10/22,China,32.887645454545456,111.78599090909091,932696,0,8066,924630
3/11/22,China,32.887645454545456,111.78599090909091,963302,0,8361,954941
3/12/22,China,32.887645454545456,111.78599090909091,992569,0,8646,983923
3/13/22,China,32.887645454545456,111.78599090909091,1028437,0,8910,1019527
3/14/22,China,32.887645454545456,111.78599090909091,1057573,0,9196,1048377
3/15/22,China,32.887645454545456,111.78599090909091,1090400,0,9485,1080915
3/16/22,China,32.887645454545456,111.78599090909091,1123895,0,9764,1114131
3/17/22,China,32.887645454545456,111.78599090909091,1147435,0,10054,1137381
3/18/22,China,32.887645454545456,111.78599090909091,1171570,0,10319,1161251
3/19/22,China,32.887645454545456,111.78599090909091,1193563,0,10571,1182992
3/20/22,China,32.887645454545456,111.78599090909091,1210422,0,10817,1199605
3/21/22,China,32.887645454545456,111.78599090909091,1228883,0,11040,1217843
3/22/22,China,32.887645454545456,111.78599090909091,1249958,0,11285,1238673
3/23/22,China,32.887645454545456,111.78599090909091,1266606,0,11490,1255116
3/24/22,China,32.887645454545456,111.78599090909091,1283788,0,11691,1272097
3/25/22,China,32.887645454545456,111.78599090909091,1299036,0,11883,1287153
3/26/22,China,32.887645454545456,111.78599090909091,1313471,0,12024,1301447
3/27/22,China,32.887645454545456,111.78599090909091,1327092,0,12175,1314917
3/28/22,China,32.887645454545456,111.78599090909091,1340972,0,12344,1328628
3/29/22,China,32.887645454545456,111.78599090909091,1355883,0,12495,1343388
3/30/22,China,32.887645454545456,111.78599090909091,1371807,0,12630,1359177
3/31/22,China,32.887645454545456,111.78599090909091,1385495,0,12749,1372746
4/1/22,China,32.887645454545456,111.78599090909091,1400358,0,12869,1387489
4/2/22,China,32.887645454545456,111.78599090909091,1414142,0,12985,1401157
4/3/22,China,32.887645454545456,111.78599090909091,1430893,0,13097,1417796
4/4/22,China,32.887645454545456,111.78599090909091,1446956,0,13187,1433769
4/5/22,China,32.887645454545456,111.78599090909091,1466859,0,13274,1453585
4/6/22,China,32.887645454545456,111.78599090909091,1490014,0,13385,1476629
4/7/22,China,32.887645454545456,111.78599090909091,1515913,0,13482,1502431
4/8/22,China,32.887645454545456,111.78599090909091,1541981,0,13568,1528413
4/9/22,China,32.887645454545456,111.78599090909091,1569185,0,13630,1555555
4/10/22,China,32.887645454545456,111.78599090909091,1597094,0,13695,1583399
4/11/22,China,32.887645454545456,111.78599090909091,1626085,0,13752,1612333
4/12/22,China,32.887645454545456,111.78599090909091,1652078,0,13812,1638266
4/13/22,China,32.887645454545456,111.78599090909091,1682737,0,13874,1668863
4/14/22,China,32.887645454545456,111.78599090909091,1713300,0,13928,1699372
4/15/22,China,32.887645454545456,111.78599090909091,1738527,0,13995,1724532
4/16/22,China,32.887645454545456,111.78599090909091,1762757,0,14037,1748720
4/17/22,China,32.887645454545456,111.78599090909091,1787635,0,14066,1773569
4/18/22,China,32.887645454545456,111.78599090909091,1811382,0,14096,1797286
4/19/22,China,32.887645454545456,111.78599090909091,1832597,0,14120,1818477
4/20/22,China,32.887645454545456,111.78599090909091,1849430,0,14131,1835299
4/21/22,China,32.887645454545456,111.78599090909091,1869000,0,14166,1854834
4/22/22,China,32.887645454545456,111.78599090909091,1888027,0,14192,1873835
4/23/22,China,32.887645454545456,111.78599090909091,1911669,0,14213,1897456
4/24/22,China,32.887645454545456,111.78599090909091,1933414,0,14265,1919149
4/25/22,China,32.887645454545456,111.78599090909091,1953258,0,14334,1938924
4/26/22,China,32.887645454545456,111.78599090909091,1970377,0,14393,1955984
4/27/22,China,32.887645454545456,111.78599090909091,1983788,0,14449,1969339
4/28/22,China,32.887645454545456,111.78599090909091,1994593,0,14501,1980092
4/29/22,China,32.887645454545456,111.78599090909091,2005524,0,14564,1990960
4/30/22,China,32.887645454545456,111.78599090909091,2015624,0,14621,2001003
5/1/22,China,32.887645454545456,111.78599090909091,2024284,0,14697,2009587
5/2/22,China,32.887645454545456,111.78599090909091,2031342,0,14722,2016620
5/3/22,China,32.887645454545456,111.78599090909091,2037518,0,14745,2022773
5/4/22,China,32.887645454545456,111.78599090909091,2043178,0,14761,2028417
5/5/22,China,32.887645454545456,111.78599090909091,2048423,0,14778,2033645
5/6/22,China,32.887645454545456,111.78599090909091,2053250,0,14802,2038448
5/7/22,China,32.887645454545456,111.78599090909091,2057995,0,14810,2043185
5/8/22,China,32.887645454545456,111.78599090909091,2062668,0,14823,2047845
5/9/22,China,32.887645454545456,111.78599090909091,2066938,0,14830,2052108
5/10/22,China,32.887645454545456,111.78599090909091,2070480,0,14842,2055638
5/11/22,China,32.887645454545456,111.78599090909091,2072376,0,14850,2057526
5/12/22,China,32.887645454545456,111.78599090909091,2074583,0,14854,2059729
5/13/22,China,32.887645454545456,111.78599090909091,2077182,0,14858,2062324
5/14/22,China,32.887645454545456,111.78599090909091,2079353,0,14862,2064491
5/15/22,China,32.887645454545456,111.78599090909091,2081192,0,14867,2066325
5/16/22,China,32.887645454545456,111.78599090909091,2082624,0,14868,2067756
5/17/22,China,32.887645454545456,111.78599090909091,2084058,0,14871,2069187
5/18/22,China,32.887645454545456,111.78599090909091,2085584,0,14876,2070708
5/19/22,China,32.887645454545456,111.78599090909091,2086877,0,14877,2072000
5/20/22,China,32.887645454545456,111.78599090909091,2088229,0,14882,2073347
5/21/22,China,32.887645454545456,111.78599090909091,2089569,0,14885,2074684
5/22/22,China,32.887645454545456,111.78599090909091,2090677,0,14886,2075791
5/23/22,China,32.887645454545456,111.78599090909091,2091649,0,14887,2076762
5/24/22,China,32.887645454545456,111.78599090909091,2092491,0,14887,2077604
5/25/22,China,32.887645454545456,111.78599090909091,2093305,0,14890,2078415
5/26/22,China,32.887645454545456,111.78599090909091,2094030,0,14893,2079137
5/27/22,China,32.887645454545456,111.78599090909091,2094679,0,14894,2079785
5/28/22,China,32.887645454545456,111.78599090909091,2095275,0,14895,2080380
5/29/22,China,32.887645454545456,111.78599090909091,2095730,0,14895,2080835
5/30/22,China,32.887645454545456,111.78599090909091,2096200,0,14897,2081303
5/31/22,China,32.887645454545456,111.78599090909091,2096684,0,14897,2081787
6/1/22,China,32.887645454545456,111.78599090909091,2097282,0,14899,2082383
6/2/22,China,32.887645454545456,111.78599090909091,2097925,0,14900,2083025
6/3/22,China,32.887645454545456,111.78599090909091,2098595,0,14902,2083693
6/4/22,China,32.887645454545456,111.78599090909091,2099041,0,14903,2084138
6/5/22,China,32.887645454545456,111.78599090909091,2099865,0,14907,2084958
6/6/22,China,32.887645454545456,111.78599090909091,2100607,0,14907,2085700
6/7/22,China,32.887645454545456,111.78599090909091,2101049,0,14910,2086139
6/8/22,China,32.887645454545456,111.78599090909091,2101560,0,14910,2086650
6/9/22,China,32.887645454545456,111.78599090909091,2102379,0,14911,2087468
6/10/22,China,32.887645454545456,111.78599090909091,2103227,0,14912,2088315
6/11/22,China,32.887645454545456,111.78599090909091,2104341,0,14913,2089428
6/12/22,China,32.887645454545456,111.78599090909091,2105331,0,14913,2090418
6/13/22,China,32.887645454545456,111.78599090909091,2106288,0,14913,2091375
6/14/22,China,32.887645454545456,111.78599090909091,2107342,0,14914,2092428
6/15/22,China,32.887645454545456,111.78599090909091,2108598,0,14915,2093683
6/16/22,China,32.887645454545456,111.78599090909091,2109935,0,14915,2095020
6/17/22,China,32.887645454545456,111.78599090909091,2111214,0,14916,2096298
6/18/22,China,32.887645454545456,111.78599090909091,2112692,0,14916,2097776
6/19/22,China,32.887645454545456,111.78599090909091,2114127,0,14918,2099209
6/20/22,China,32.887645454545456,111.78599090909091,2115561,0,14919,2100642
6/21/22,China,32.887645454545456,111.78599090909091,2116897,0,14919,2101978
6/22/22,China,32.887645454545456,111.78599090909091,2118491,0,14920,2103571
6/23/22,China,32.887645454545456,111.78599090909091,2120269,0,14921,2105348
6/24/22,China,32.887645454545456,111.78599090909091,2122283,0,14921,2107362
6/25/22,China,32.887645454545456,111.78599090909091,2124209,0,14922,2109287
6/26/22,China,32.887645454545456,111.78599090909091,2126233,0,14922,2111311
6/27/22,China,32.887645454545456,111.78599090909091,2128225,0,14922,2113303
6/28/22,China,32.887645454545456,111.78599090909091,2130033,0,14923,2115110
6/29/22,China,32.887645454545456,111.78599090909091,2132190,0,14924,2117266
6/30/22,China,32.887645454545456,111.78599090909091,2134718,0,14927,2119791
7/1/22,China,32.887645454545456,111.78599090909091,2137169,0,14928,2122241
7/2/22,China,32.887645454545456,111.78599090909091,2139919,0,14932,2124987
7/3/22,China,32.887645454545456,111.78599090909091,2142216,0,14934,2127282
7/4/22,China,32.887645454545456,111.78599090909091,2144566,0,14934,2129632
7/5/22,China,32.887645454545456,111.78599090909091,2147330,0,14934,2132396
7/6/22,China,32.887645454545456,111.78599090909091,2150503,0,14935,2135568
7/7/22,China,32.887645454545456,111.78599090909091,2153986,0,14936,2139050
7/8/22,China,32.887645454545456,111.78599090909091,2157433,0,14939,2142494
7/9/22,China,32.887645454545456,111.78599090909091,2160884,0,14940,2145944
7/10/22,China,32.887645454545456,111.78599090909091,2164305,0,14943,2149362
7/11/22,China,32.887645454545456,111.78599090909091,2167619,0,14950,2152669
7/12/22,China,32.887645454545456,111.78599090909091,2170811,0,14952,2155859
7/13/22,China,32.887645454545456,111.78599090909091,2174317,0,14955,2159362
7/14/22,China,32.887645454545456,111.78599090909091,2178366,0,14963,2163403
7/15/22,China,32.887645454545456,111.78599090909091,2182488,0,14968,2167520
7/16/22,China,32.887645454545456,111.78599090909091,2186813,0,14969,2171844
7/17/22,China,32.887645454545456,111.78599090909091,2190992,0,14973,2176019
7/18/22,China,32.887645454545456,111.78599090909091,2195056,0,14976,2180080
7/19/22,China,32.887645454545456,111.78599090909091,2198945,0,14980,2183965
7/20/22,China,32.887645454545456,111.78599090909091,2203789,0,14981,2188808
7/21/22,China,32.887645454545456,111.78599090909091,2209013,0,14986,2194027
7/22/22,China,32.887645454545456,111.78599090909091,2214254,0,14992,2199262
7/23/22,China,32.887645454545456,111.78599090909091,2219264,0,15000,2204264
7/24/22,China,32.887645454545456,111.78599090909091,2224482,0,15009,2209473
7/25/22,China,32.887645454545456,111.78599090909091,2229362,0,15012,2214350
7/26/22,China,32.887645454545456,111.78599090909091,2234541,0,15019,2219522
7/27/22,China,32.887645454545456,111.78599090909091,2240160,0,15029,2225131
7/28/22,China,32.887645454545456,111.78599090909091,2245156,0,15034,2230122
7/29/22,China,32.887645454545456,111.78599090909091,2250565,0,15039,2235526
7/30/22,China,32.887645454545456,111.78599090909091,2255689,0,15045,2240644
7/31/22,China,32.887645454545456,111.78599090909091,2260777,0,15046,2245731
8/1/22,China,32.887645454545456,111.78599090909091,2265424,0,15052,2250372
8/2/22,China,32.887645454545456,111.78599090909091,2270011,0,15063,2254948
8/3/22,China,32.887645454545456,111.78599090909091,2274979,0,15067,2259912
8/4/22,China,32.887645454545456,111.78599090909091,2280418,0,15070,2265348
8/5/22,China,32.887645454545456,111.78599090909091,2285355,0,15074,2270281
8/6/22,China,32.887645454545456,111.78599090909091,2290634,0,15079,2275555
8/7/22,China,32.887645454545456,111.78599090909091,2295769,0,15084,2280685
8/8/22,China,32.887645454545456,111.78599090909091,2300466,0,15091,2285375
8/9/22,China,32.887645454545456,111.78599090909091,2304661,0,15094,2289567
8/10/22,China,32.887645454545456,111.78599090909091,2311307,0,15099,2296208
8/11/22,China,32.887645454545456,111.78599090909091,2316346,0,15101,2301245
8/12/22,China,32.887645454545456,111.78599090909091,2322331,0,15106,2307225
8/13/22,China,32.887645454545456,111.78599090909091,2330459,0,15109,2315350
8/14/22,China,32.887645454545456,111.78599090909091,2339195,0,15112,2324083
8/15/22,China,32.887645454545456,111.78599090909091,2345333,0,15116,2330217
8/16/22,China,32.887645454545456,111.78599090909091,2354676,0,15127,2339549
8/17/22,China,32.887645454545456,111.78599090909091,2363469,0,15131,2348338
8/18/22,China,32.887645454545456,111.78599090909091,2372972,0,15136,2357836
8/19/22,China,32.887645454545456,111.78599090909091,2382169,0,15144,2367025
8/20/22,China,32.887645454545456,111.78599090909091,2390686,0,15149,2375537
8/21/22,China,32.887645454545456,111.78599090909091,2397571,0,15152,2382419
8/22/22,China,32.887645454545456,111.78599090909091,2407635,0,15157,2392478
8/23/22,China,32.887645454545456,111.78599090909091,2416140,0,15167,2400973
8/24/22,China,32.887645454545456,111.78599090909091,2425558,0,15182,2410376
8/25/22,China,32.887645454545456,111.78599090909091,2435598,0,15192,2420406
8/26/22,China,32.887645454545456,111.78599090909091,2443816,0,15199,2428617
8/27/22,China,32.887645454545456,111.78599090909091,2452580,0,15203,2437377
8/28/22,China,32.887645454545456,111.78599090909091,2466054,0,15213,2450841
8/29/22,China,32.887645454545456,111.78599090909091,2476316,0,15217,2461099
8/30/22,China,32.887645454545456,111.78599090909091,2486863,0,15231,2471632
8/31/22,China,32.887645454545456,111.78599090909091,2498088,0,15240,2482848
9/1/22,China,32.887645454545456,111.78599090909091,2510703,0,15251,2495452
9/2/22,China,32.887645454545456,111.78599090909091,2522721,0,15259,2507462
9/3/22,China,32.887645454545456,111.78599090909091,2533531,0,15266,2518265
9/4/22,China,32.887645454545456,111.78599090909091,2547297,0,15275,2532022
9/5/22,China,32.887645454545456,111.78599090909091,2558905,0,15283,2543622
9/6/22,China,32.887645454545456,111.78599090909091,2569910,0,15292,2554618
9/7/22,China,32.887645454545456,111.78599090909091,2581660,0,15308,2566352
9/8/22,China,32.887645454545456,111.78599090909091,2594190,0,15320,2578870
9/9/22,China,32.887645454545456,111.78599090909091,2605616,0,15331,2590285
9/10/22,China,32.887645454545456,111.78599090909091,2616674,0,15339,2601335
9/11/22,China,32.887645454545456,111.78599090909091,2626983,0,15350,2611633
9/12/22,China,32.887645454545456,111.78599090909091,2635990,0,15361,2620629
9/13/22,China,32.887645454545456,111.78599090909091,2644191,0,15371,2628820
9/14/22,China,32.887645454545456,111.78599090909091,2652714,0,15381,2637333
9/15/22,China,32.887645454545456,111.78599090909091,2661940,0,15387,2646553
9/16/22,China,32.887645454545456,111.78599090909091,2671881,0,15403,2656478
9/17/22,China,32.887645454545456,111.78599090909091,2680816,0,15419,2665397
9/18/22,China,32.887645454545456,111.78599090909091,2689291,0,15442,2673849
9/19/22,China,32.887645454545456,111.78599090909091,2696527,0,15452,2681075
9/20/22,China,32.887645454545456,111.78599090909091,2702866,0,15459,2687407
9/21/22,China,32.887645454545456,111.78599090909091,2709291,0,15468,2693823
9/22/22,China,32.887645454545456,111.78599090909091,2716077,0,15485,2700592
9/23/22,China,32.887645454545456,111.78599090909091,2722353,0,15650,2706703
9/24/22,China,32.887645454545456,111.78599090909091,2728374,0,15657,2712717
9/25/22,China,32.887645454545456,111.78599090909091,2733103,0,15667,2717436
9/26/22,China,32.887645454545456,111.78599090909091,2737936,0,15679,2722257
9/27/22,China,32.887645454545456,111.78599090909091,2742421,0,15686,2726735
9/28/22,China,32.887645454545456,111.78599090909091,2747530,0,15700,2731830
9/29/22,China,32.887645454545456,111.78599090909091,2752556,0,15705,2736851
9/30/22,China,32.887645454545456,111.78599090909091,2757442,0,15713,2741729
10/1/22,China,32.887645454545456,111.78599090909091,2762150,0,15719,2746431
10/2/22,China,32.887645454545456,111.78599090909091,2766475,0,15725,2750750
10/3/22,China,32.887645454545456,111.78599090909091,2770859,0,15728,2755131
10/4/22,China,32.887645454545456,111.78599090909091,2775058,0,15736,2759322
10/5/22,China,32.887645454545456,111.78599090909091,2779780,0,15746,2764034
10/6/22,China,32.887645454545456,111.78599090909091,2785437,0,15752,2769685
10/7/22,China,32.887645454545456,111.78599090909091,2791596,0,15754,2775842
10/8/22,China,32.887645454545456,111.78599090909091,2799588,0,15767,2783821
10/9/22,China,32.887645454545456,111.78599090909091,2804912,0,15770,2789142
10/10/22,China,32.887645454545456,111.78599090909091,2811879,0,15781,2796098
10/11/22,China,32.887645454545456,111.78599090909091,2820009,0,15790,2804219
10/12/22,China,32.887645454545456,111.78599090909091,2825166,0,15799,2809367
10/13/22,China,32.887645454545456,111.78599090909091,2832279,0,15807,2816472
10/14/22,China,32.887645454545456,111.78599090909091,2838844,0,15814,2823030
10/15/22,China,32.887645454545456,111.78599090909091,2845461,0,15821,2829640
10/16/22,China,32.887645454545456,111.78599090909091,2852031,0,15827,2836204
10/17/22,China,32.887645454545456,111.78599090909091,2858293,0,15832,2842461
10/18/22,China,32.887645454545456,111.78599090909091,2864168,0,15839,2848329
10/19/22,China,32.887645454545456,111.78599090909091,2870228,0,15852,2854376
10/20/22,China,32.887645454545456,111.78599090909091,2876602,0,15861,2860741
10/21/22,China,32.887645454545456,111.78599090909091,2882971,0,15870,2867101
10/22/22,China,32.887645454545456,111.78599090909091,2889897,0,15877,2874020
10/23/22,China,32.887645454545456,111.78599090909091,2896422,0,15881,2880541
10/24/22,China,32.887645454545456,111.78599090909091,2902917,0,15888,2887029
10/25/22,China,32.887645454545456,111.78599090909091,2909352,0,15898,2893454
10/26/22,China,32.887645454545456,111.78599090909091,2916167,0,15905,2900262
10/27/22,China,32.887645454545456,111.78599090909091,2923470,0,15913,2907557
10/28/22,China,32.887645454545456,111.78599090909091,2930381,0,15920,2914461
10/29/22,China,32.887645454545456,111.78599090909091,2937389,0,15928,2921461
10/30/22,China,32.887645454545456,111.78599090909091,2944653,0,15940,2928713
10/31/22,China,32.887645454545456,111.78599090909091,2952291,0,15952,2936339
11/1/22,China,32.887645454545456,111.78599090909091,2959481,0,15965,2943516
11/2/22,China,32.887645454545456,111.78599090909091,2967572,0,15973,2951599
11/3/22,China,32.887645454545456,111.78599090909091,2976228,0,15983,2960245
11/4/22,China,32.887645454545456,111.78599090909091,2984649,0,15994,2968655
11/5/22,China,32.887645454545456,111.78599090909091,2997306,0,16012,2981294
11/6/22,China,32.887645454545456,111.78599090909091,3002843,0,16025,2986818
11/7/22,China,32.887645454545456,111.78599090909091,3013968,0,16030,2997938
11/8/22,China,32.887645454545456,111.78599090909091,3026615,0,16034,3010581
11/9/22,China,32.887645454545456,111.78599090909091,3046538,0,16047,3030491
11/10/22,China,32.887645454545456,111.78599090909091,3053673,0,16056,3037617
11/11/22,China,32.887645454545456,111.78599090909091,3070130,0,16066,3054064
11/12/22,China,32.887645454545456,111.78599090909091,3100114,0,16072,3084042
11/13/22,China,32.887645454545456,111.78599090909091,3108324,0,16081,3092243
11/14/22,China,32.887645454545456,111.78599090909091,3129859,0,16091,3113768
11/15/22,China,32.887645454545456,111.78599090909091,3153405,0,15781,3137624
11/16/22,China,32.887645454545456,111.78599090909091,3200035,0,15789,3184246
11/17/22,China,32.887645454545456,111.78599090909091,3210359,0,15801,3194558
11/18/22,China,32.887645454545456,111.78599090909091,3242270,0,15809,3226461
11/19/22,China,32.887645454545456,111.78599090909091,3295792,0,15819,3279973
11/20/22,China,32.887645454545456,111.78599090909091,3329533,0,15834,3313699
11/21/22,China,32.887645454545456,111.78599090909091,3364415,0,15847,3348568
11/22/22,China,32.887645454545456,111.78599090909091,3373507,0,15860,3357647
11/23/22,China,32.887645454545456,111.78599090909091,3437108,0,15872,3421236
11/24/22,China,32.887645454545456,111.78599090909091,3449676,0,15885,3433791
11/25/22,China,32.887645454545456,111.78599090909091,3490482,0,15901,3474581
11/26/22,China,32.887645454545456,111.78599090909091,3533755,0,15910,3517845
11/27/22,China,32.887645454545456,111.78599090909091,3580291,0,15930,3564361
11/28/22,China,32.887645454545456,111.78599090909091,3627131,0,15957,3611174
11/29/22,China,32.887645454545456,111.78599090909091,3705990,0,15970,3690020
11/30/22,China,32.887645454545456,111.78599090909091,3719252,0,15986,3703266
12/1/22,China,32.887645454545456,111.78599090909091,3764783,0,16001,3748782
12/2/22,China,32.887645454545456,111.78599090909091,3837220,0,16012,3821208
12/3/22,China,32.887645454545456,111.78599090909091,3851748,0,16031,3835717
12/4/22,China,32.887645454545456,111.78599090909091,3892221,0,16047,3876174
12/5/22,China,32.887645454545456,111.78599090909091,3931982,0,16067,3915915
12/6/22,China,32.887645454545456,111.78599090909091,3967054,0,16083,3950971
12/7/22,China,32.887645454545456,111.78599090909091,4004311,0,16105,3988206
12/8/22,China,32.887645454545456,111.78599090909091,4039789,0,16132,4023657
12/9/22,China,32.887645454545456,111.78599090909091,4070575,0,16155,4054420
12/10/22,China,32.887645454545456,111.78599090909091,4097741,0,16176,4081565
12/11/22,China,32.887645454545456,111.78599090909091,4123336,0,16200,4107136
12/12/22,China,32.887645454545456,111.78599090909091,4146984,0,16225,4130759
12/13/22,China,32.887645454545456,111.78599090909091,4167941,0,16262,4151679
12/14/22,China,32.887645454545456,111.78599090909091,4182811,0,16297,4166514
12/15/22,China,32.887645454545456,111.78599090909091,4199891,0,16316,4183575
12/16/22,China,32.887645454545456,111.78599090909091,4215617,0,16348,4199269
12/17/22,China,32.887645454545456,111.78599090909091,4215617,0,16348,4199269
1/1/22,Colombia,4.5709,-74.2973,5169855,0,129986,5039869
1/2/22,Colombia,4.5709,-74.2973,5181173,0,130026,5051147
1/3/22,Colombia,4.5709,-74.2973,5191021,0,130061,5060960
1/4/22,Colombia,4.5709,-74.2973,5203374,0,130100,5073274
1/5/22,Colombia,4.5709,-74.2973,5219633,0,130140,5089493
1/6/22,Colombia,4.5709,-74.2973,5242672,0,130191,5112481
1/7/22,Colombia,4.5709,-74.2973,5268862,0,130250,5138612
1/8/22,Colombia,4.5709,-74.2973,5300032,0,130288,5169744
1/9/22,Colombia,4.5709,-74.2973,5330662,0,130338,5200324
1/10/22,Colombia,4.5709,-74.2973,5357767,0,130395,5227372
1/11/22,Colombia,4.5709,-74.2973,5380841,0,130460,5250381
1/12/22,Colombia,4.5709,-74.2973,5410698,0,130529,5280169
1/13/22,Colombia,4.5709,-74.2973,5440981,0,130625,5310356
1/14/22,Colombia,4.5709,-74.2973,5475904,0,130731,5345173
1/15/22,Colombia,4.5709,-74.2973,5511479,0,130860,5380619
1/16/22,Colombia,4.5709,-74.2973,5543796,0,130996,5412800
1/17/22,Colombia,4.5709,-74.2973,5568068,0,131130,5436938
1/18/22,Colombia,4.5709,-74.2973,5596917,0,131268,5465649
1/19/22,Colombia,4.5709,-74.2973,5624520,0,131437,5493083
1/20/22,Colombia,4.5709,-74.2973,5655026,0,131627,5523399
1/21/22,Colombia,4.5709,-74.2973,5686065,0,131824,5554241
1/22/22,Colombia,4.5709,-74.2973,5714092,0,132023,5582069
1/23/22,Colombia,4.5709,-74.2973,5740179,0,132240,5607939
1/24/22,Colombia,4.5709,-74.2973,5761398,0,132477,5628921
1/25/22,Colombia,4.5709,-74.2973,5780910,0,132737,5648173
1/26/22,Colombia,4.5709,-74.2973,5798799,0,133019,5665780
1/27/22,Colombia,4.5709,-74.2973,5816462,0,133292,5683170
1/28/22,Colombia,4.5709,-74.2973,5837408,0,133560,5703848
1/29/22,Colombia,4.5709,-74.2973,5855858,0,133832,5722026
1/30/22,Colombia,4.5709,-74.2973,5871977,0,134079,5737898
1/31/22,Colombia,4.5709,-74.2973,5887261,0,134300,5752961
2/1/22,Colombia,4.5709,-74.2973,5901715,0,134551,5767164
2/2/22,Colombia,4.5709,-74.2973,5916825,0,134781,5782044
2/3/22,Colombia,4.5709,-74.2973,5930393,0,135043,5795350
2/4/22,Colombia,4.5709,-74.2973,5943783,0,135282,5808501
2/5/22,Colombia,4.5709,-74.2973,5956350,0,135518,5820832
2/6/22,Colombia,4.5709,-74.2973,5966706,0,135757,5830949
2/7/22,Colombia,4.5709,-74.2973,5975786,0,135992,5839794
2/8/22,Colombia,4.5709,-74.2973,5985516,0,136197,5849319
2/9/22,Colombia,4.5709,-74.2973,5994301,0,136404,5857897
2/10/22,Colombia,4.5709,-74.2973,6002570,0,136583,5865987
2/11/22,Colombia,4.5709,-74.2973,6007991,0,136764,5871227
2/12/22,Colombia,4.5709,-74.2973,6014563,0,136953,5877610
2/13/22,Colombia,4.5709,-74.2973,6020095,0,137115,5882980
2/14/22,Colombia,4.5709,-74.2973,6023257,0,137301,5885956
2/15/22,Colombia,4.5709,-74.2973,6026988,0,137439,5889549
2/16/22,Colombia,4.5709,-74.2973,6031130,0,137586,5893544
2/17/22,Colombia,4.5709,-74.2973,6035143,0,137733,5897410
2/18/22,Colombia,4.5709,-74.2973,6039163,0,137869,5901294
2/19/22,Colombia,4.5709,-74.2973,6043661,0,137996,5905665
2/20/22,Colombia,4.5709,-74.2973,6047042,0,138106,5908936
2/21/22,Colombia,4.5709,-74.2973,6049952,0,138205,5911747
2/22/22,Colombia,4.5709,-74.2973,6052126,0,138285,5913841
2/23/22,Colombia,4.5709,-74.2973,6054307,0,138364,5915943
2/24/22,Colombia,4.5709,-74.2973,6056556,0,138421,5918135
2/25/22,Colombia,4.5709,-74.2973,6058715,0,138501,5920214
2/26/22,Colombia,4.5709,-74.2973,6060793,0,138598,5922195
2/27/22,Colombia,4.5709,-74.2973,6062701,0,138693,5924008
2/28/22,Colombia,4.5709,-74.2973,6064583,0,138767,5925816
3/1/22,Colombia,4.5709,-74.2973,6065801,0,138854,5926947
3/2/22,Colombia,4.5709,-74.2973,6067023,0,138899,5928124
3/3/22,Colombia,4.5709,-74.2973,6068074,0,138939,5929135
3/4/22,Colombia,4.5709,-74.2973,6069425,0,138984,5930441
3/5/22,Colombia,4.5709,-74.2973,6070616,0,139037,5931579
3/6/22,Colombia,4.5709,-74.2973,6071704,0,139091,5932613
3/7/22,Colombia,4.5709,-74.2973,6072656,0,139120,5933536
3/8/22,Colombia,4.5709,-74.2973,6073416,0,139154,5934262
3/9/22,Colombia,4.5709,-74.2973,6074155,0,139189,5934966
3/10/22,Colombia,4.5709,-74.2973,6074874,0,139220,5935654
3/11/22,Colombia,4.5709,-74.2973,6075656,0,139255,5936401
3/12/22,Colombia,4.5709,-74.2973,6076333,0,139283,5937050
3/13/22,Colombia,4.5709,-74.2973,6076819,0,139297,5937522
3/14/22,Colombia,4.5709,-74.2973,6077288,0,139315,5937973
3/15/22,Colombia,4.5709,-74.2973,6077861,0,139335,5938526
3/16/22,Colombia,4.5709,-74.2973,6078487,0,139361,5939126
3/17/22,Colombia,4.5709,-74.2973,6079231,0,139386,5939845
3/18/22,Colombia,4.5709,-74.2973,6079896,0,139415,5940481
3/19/22,Colombia,4.5709,-74.2973,6080589,0,139434,5941155
3/20/22,Colombia,4.5709,-74.2973,6081131,0,139452,5941679
3/21/22,Colombia,4.5709,-74.2973,6081639,0,139471,5942168
3/22/22,Colombia,4.5709,-74.2973,6081933,0,139489,5942444
3/23/22,Colombia,4.5709,-74.2973,6082226,0,139508,5942718
3/24/22,Colombia,4.5709,-74.2973,6082577,0,139531,5943046
3/25/22,Colombia,4.5709,-74.2973,6082943,0,139544,5943399
3/26/22,Colombia,4.5709,-74.2973,6083291,0,139558,5943733
3/27/22,Colombia,4.5709,-74.2973,6083643,0,139573,5944070
3/28/22,Colombia,4.5709,-74.2973,6083939,0,139585,5944354
3/29/22,Colombia,4.5709,-74.2973,6084240,0,139595,5944645
3/30/22,Colombia,4.5709,-74.2973,6084551,0,139595,5944956
3/31/22,Colombia,4.5709,-74.2973,6084916,0,139621,5945295
4/1/22,Colombia,4.5709,-74.2973,6085270,0,139636,5945634
4/2/22,Colombia,4.5709,-74.2973,6085618,0,139650,5945968
4/3/22,Colombia,4.5709,-74.2973,6085926,0,139660,5946266
4/4/22,Colombia,4.5709,-74.2973,6086233,0,139670,5946563
4/5/22,Colombia,4.5709,-74.2973,6086484,0,139678,5946806
4/6/22,Colombia,4.5709,-74.2973,6086811,0,139687,5947124
4/7/22,Colombia,4.5709,-74.2973,6087123,0,139693,5947430
4/8/22,Colombia,4.5709,-74.2973,6087443,0,139703,5947740
4/9/22,Colombia,4.5709,-74.2973,6087737,0,139713,5948024
4/10/22,Colombia,4.5709,-74.2973,6088034,0,139719,5948315
4/11/22,Colombia,4.5709,-74.2973,6088335,0,139725,5948610
4/12/22,Colombia,4.5709,-74.2973,6088619,0,139729,5948890
4/13/22,Colombia,4.5709,-74.2973,6088912,0,139734,5949178
4/14/22,Colombia,4.5709,-74.2973,6089176,0,139738,5949438
4/15/22,Colombia,4.5709,-74.2973,6089381,0,139741,5949640
4/16/22,Colombia,4.5709,-74.2973,6089540,0,139745,5949795
4/17/22,Colombia,4.5709,-74.2973,6089662,0,139749,5949913
4/18/22,Colombia,4.5709,-74.2973,6089791,0,139751,5950040
4/19/22,Colombia,4.5709,-74.2973,6089998,0,139754,5950244
4/20/22,Colombia,4.5709,-74.2973,6090246,0,139755,5950491
4/21/22,Colombia,4.5709,-74.2973,6090520,0,139759,5950761
4/22/22,Colombia,4.5709,-74.2973,6090803,0,139765,5951038
4/23/22,Colombia,4.5709,-74.2973,6091094,0,139771,5951323
4/24/22,Colombia,4.5709,-74.2973,6091343,0,139778,5951565
4/25/22,Colombia,4.5709,-74.2973,6091551,0,139780,5951771
4/26/22,Colombia,4.5709,-74.2973,6091753,0,139783,5951970
4/27/22,Colombia,4.5709,-74.2973,6091959,0,139785,5952174
4/28/22,Colombia,4.5709,-74.2973,6092167,0,139789,5952378
4/29/22,Colombia,4.5709,-74.2973,6092403,0,139793,5952610
4/30/22,Colombia,4.5709,-74.2973,6092667,0,139797,5952870
5/1/22,Colombia,4.5709,-74.2973,6092667,0,139797,5952870
5/2/22,Colombia,4.5709,-74.2973,6092667,0,139797,5952870
5/3/22,Colombia,4.5709,-74.2973,6092667,0,139797,5952870
5/4/22,Colombia,4.5709,-74.2973,6092667,0,139797,5952870
5/5/22,Colombia,4.5709,-74.2973,6093645,0,139809,5953836
5/6/22,Colombia,4.5709,-74.2973,6093645,0,139809,5953836
5/7/22,Colombia,4.5709,-74.2973,6093645,0,139809,5953836
5/8/22,Colombia,4.5709,-74.2973,6093645,0,139809,5953836
5/9/22,Colombia,4.5709,-74.2973,6093645,0,139809,5953836
5/10/22,Colombia,4.5709,-74.2973,6093645,0,139809,5953836
5/11/22,Colombia,4.5709,-74.2973,6093645,0,139809,5953836
5/12/22,Colombia,4.5709,-74.2973,6095316,0,139821,5955495
5/13/22,Colombia,4.5709,-74.2973,6095316,0,139821,5955495
5/14/22,Colombia,4.5709,-74.2973,6095316,0,139821,5955495
5/15/22,Colombia,4.5709,-74.2973,6095316,0,139821,5955495
5/16/22,Colombia,4.5709,-74.2973,6095316,0,139821,5955495
5/17/22,Colombia,4.5709,-74.2973,6095316,0,139821,5955495
5/18/22,Colombia,4.5709,-74.2973,6095316,0,139821,5955495
5/19/22,Colombia,4.5709,-74.2973,6099111,0,139833,5959278
5/20/22,Colombia,4.5709,-74.2973,6099111,0,139833,5959278
5/21/22,Colombia,4.5709,-74.2973,6099111,0,139833,5959278
5/22/22,Colombia,4.5709,-74.2973,6099111,0,139833,5959278
5/23/22,Colombia,4.5709,-74.2973,6099111,0,139833,5959278
5/24/22,Colombia,4.5709,-74.2973,6099111,0,139833,5959278
5/25/22,Colombia,4.5709,-74.2973,6099111,0,139833,5959278
5/26/22,Colombia,4.5709,-74.2973,6103455,0,139854,5963601
5/27/22,Colombia,4.5709,-74.2973,6103455,0,139854,5963601
5/28/22,Colombia,4.5709,-74.2973,6103455,0,139854,5963601
5/29/22,Colombia,4.5709,-74.2973,6103455,0,139854,5963601
5/30/22,Colombia,4.5709,-74.2973,6103455,0,139854,5963601
5/31/22,Colombia,4.5709,-74.2973,6103455,0,139854,5963601
6/1/22,Colombia,4.5709,-74.2973,6103455,0,139854,5963601
6/2/22,Colombia,4.5709,-74.2973,6109105,0,139867,5969238
6/3/22,Colombia,4.5709,-74.2973,6109105,0,139867,5969238
6/4/22,Colombia,4.5709,-74.2973,6109105,0,139867,5969238
6/5/22,Colombia,4.5709,-74.2973,6109105,0,139867,5969238
6/6/22,Colombia,4.5709,-74.2973,6109105,0,139867,5969238
6/7/22,Colombia,4.5709,-74.2973,6109105,0,139867,5969238
6/8/22,Colombia,4.5709,-74.2973,6109105,0,139867,5969238
6/9/22,Colombia,4.5709,-74.2973,6117847,0,139894,5977953
6/10/22,Colombia,4.5709,-74.2973,6117847,0,139894,5977953
6/11/22,Colombia,4.5709,-74.2973,6117847,0,139894,5977953
6/12/22,Colombia,4.5709,-74.2973,6117847,0,139894,5977953
6/13/22,Colombia,4.5709,-74.2973,6117847,0,139894,5977953
6/14/22,Colombia,4.5709,-74.2973,6117847,0,139894,5977953
6/15/22,Colombia,4.5709,-74.2973,6117847,0,139894,5977953
6/16/22,Colombia,4.5709,-74.2973,6131657,0,139918,5991739
6/17/22,Colombia,4.5709,-74.2973,6131657,0,139918,5991739
6/18/22,Colombia,4.5709,-74.2973,6131657,0,139918,5991739
6/19/22,Colombia,4.5709,-74.2973,6131657,0,139918,5991739
6/20/22,Colombia,4.5709,-74.2973,6131657,0,139918,5991739
6/21/22,Colombia,4.5709,-74.2973,6131657,0,139918,5991739
6/22/22,Colombia,4.5709,-74.2973,6131657,0,139918,5991739
6/23/22,Colombia,4.5709,-74.2973,6151354,0,139970,6011384
6/24/22,Colombia,4.5709,-74.2973,6151354,0,139970,6011384
6/25/22,Colombia,4.5709,-74.2973,6151354,0,139970,6011384
6/26/22,Colombia,4.5709,-74.2973,6151354,0,139970,6011384
6/27/22,Colombia,4.5709,-74.2973,6151354,0,139970,6011384
6/28/22,Colombia,4.5709,-74.2973,6151354,0,139970,6011384
6/29/22,Colombia,4.5709,-74.2973,6151354,0,139970,6011384
6/30/22,Colombia,4.5709,-74.2973,6175181,0,140070,6035111
7/1/22,Colombia,4.5709,-74.2973,6175181,0,140070,6035111
7/2/22,Colombia,4.5709,-74.2973,6175181,0,140070,6035111
7/3/22,Colombia,4.5709,-74.2973,6175181,0,140070,6035111
7/4/22,Colombia,4.5709,-74.2973,6175181,0,140070,6035111
7/5/22,Colombia,4.5709,-74.2973,6175181,0,140070,6035111
7/6/22,Colombia,4.5709,-74.2973,6175181,0,140070,6035111
7/7/22,Colombia,4.5709,-74.2973,6198848,0,140202,6058646
7/8/22,Colombia,4.5709,-74.2973,6198848,0,140202,6058646
7/9/22,Colombia,4.5709,-74.2973,6198848,0,140202,6058646
7/10/22,Colombia,4.5709,-74.2973,6198848,0,140202,6058646
7/11/22,Colombia,4.5709,-74.2973,6198848,0,140202,6058646
7/12/22,Colombia,4.5709,-74.2973,6198848,0,140202,6058646
7/13/22,Colombia,4.5709,-74.2973,6198848,0,140202,6058646
7/14/22,Colombia,4.5709,-74.2973,6223497,0,140365,6083132
7/15/22,Colombia,4.5709,-74.2973,6223497,0,140365,6083132
7/16/22,Colombia,4.5709,-74.2973,6223497,0,140365,6083132
7/17/22,Colombia,4.5709,-74.2973,6223497,0,140365,6083132
7/18/22,Colombia,4.5709,-74.2973,6223497,0,140365,6083132
7/19/22,Colombia,4.5709,-74.2973,6223497,0,140365,6083132
7/20/22,Colombia,4.5709,-74.2973,6223497,0,140365,6083132
7/21/22,Colombia,4.5709,-74.2973,6247634,0,140603,6107031
7/22/22,Colombia,4.5709,-74.2973,6247634,0,140603,6107031
7/23/22,Colombia,4.5709,-74.2973,6247634,0,140603,6107031
7/24/22,Colombia,4.5709,-74.2973,6247634,0,140603,6107031
7/25/22,Colombia,4.5709,-74.2973,6247634,0,140603,6107031
7/26/22,Colombia,4.5709,-74.2973,6247634,0,140603,6107031
7/27/22,Colombia,4.5709,-74.2973,6247634,0,140603,6107031
7/28/22,Colombia,4.5709,-74.2973,6265798,0,140845,6124953
7/29/22,Colombia,4.5709,-74.2973,6265798,0,140845,6124953
7/30/22,Colombia,4.5709,-74.2973,6265798,0,140845,6124953
7/31/22,Colombia,4.5709,-74.2973,6265798,0,140845,6124953
8/1/22,Colombia,4.5709,-74.2973,6265798,0,140845,6124953
8/2/22,Colombia,4.5709,-74.2973,6265798,0,140845,6124953
8/3/22,Colombia,4.5709,-74.2973,6265798,0,140845,6124953
8/4/22,Colombia,4.5709,-74.2973,6278998,0,141075,6137923
8/5/22,Colombia,4.5709,-74.2973,6278998,0,141075,6137923
8/6/22,Colombia,4.5709,-74.2973,6278998,0,141075,6137923
8/7/22,Colombia,4.5709,-74.2973,6278998,0,141075,6137923
8/8/22,Colombia,4.5709,-74.2973,6278998,0,141075,6137923
8/9/22,Colombia,4.5709,-74.2973,6278998,0,141075,6137923
8/10/22,Colombia,4.5709,-74.2973,6278998,0,141075,6137923
8/11/22,Colombia,4.5709,-74.2973,6286392,0,141287,6145105
8/12/22,Colombia,4.5709,-74.2973,6286392,0,141287,6145105
8/13/22,Colombia,4.5709,-74.2973,6286392,0,141287,6145105
8/14/22,Colombia,4.5709,-74.2973,6286392,0,141287,6145105
8/15/22,Colombia,4.5709,-74.2973,6286392,0,141287,6145105
8/16/22,Colombia,4.5709,-74.2973,6286392,0,141287,6145105
8/17/22,Colombia,4.5709,-74.2973,6286392,0,141287,6145105
8/18/22,Colombia,4.5709,-74.2973,6293130,0,141406,6151724
8/19/22,Colombia,4.5709,-74.2973,6293130,0,141406,6151724
8/20/22,Colombia,4.5709,-74.2973,6293130,0,141406,6151724
8/21/22,Colombia,4.5709,-74.2973,6293130,0,141406,6151724
8/22/22,Colombia,4.5709,-74.2973,6293130,0,141406,6151724
8/23/22,Colombia,4.5709,-74.2973,6293130,0,141406,6151724
8/24/22,Colombia,4.5709,-74.2973,6293130,0,141406,6151724
8/25/22,Colombia,4.5709,-74.2973,6299595,0,141519,6158076
8/26/22,Colombia,4.5709,-74.2973,6299595,0,141519,6158076
8/27/22,Colombia,4.5709,-74.2973,6299595,0,141519,6158076
8/28/22,Colombia,4.5709,-74.2973,6299595,0,141519,6158076
8/29/22,Colombia,4.5709,-74.2973,6299595,0,141519,6158076
8/30/22,Colombia,4.5709,-74.2973,6299595,0,141519,6158076
8/31/22,Colombia,4.5709,-74.2973,6299595,0,141519,6158076
9/1/22,Colombia,4.5709,-74.2973,6302809,0,141646,6161163
9/2/22,Colombia,4.5709,-74.2973,6302809,0,141646,6161163
9/3/22,Colombia,4.5709,-74.2973,6302809,0,141646,6161163
9/4/22,Colombia,4.5709,-74.2973,6302809,0,141646,6161163
9/5/22,Colombia,4.5709,-74.2973,6302809,0,141646,6161163
9/6/22,Colombia,4.5709,-74.2973,6302809,0,141646,6161163
9/7/22,Colombia,4.5709,-74.2973,6302809,0,141646,6161163
9/8/22,Colombia,4.5709,-74.2973,6304317,0,141708,6162609
9/9/22,Colombia,4.5709,-74.2973,6304317,0,141708,6162609
9/10/22,Colombia,4.5709,-74.2973,6304317,0,141708,6162609
9/11/22,Colombia,4.5709,-74.2973,6304317,0,141708,6162609
9/12/22,Colombia,4.5709,-74.2973,6304317,0,141708,6162609
9/13/22,Colombia,4.5709,-74.2973,6304317,0,141708,6162609
9/14/22,Colombia,4.5709,-74.2973,6304317,0,141708,6162609
9/15/22,Colombia,4.5709,-74.2973,6305562,0,141746,6163816
9/16/22,Colombia,4.5709,-74.2973,6305562,0,141746,6163816
9/17/22,Colombia,4.5709,-74.2973,6305562,0,141746,6163816
9/18/22,Colombia,4.5709,-74.2973,6305562,0,141746,6163816
9/19/22,Colombia,4.5709,-74.2973,6305562,0,141746,6163816
9/20/22,Colombia,4.5709,-74.2973,6305562,0,141746,6163816
9/21/22,Colombia,4.5709,-74.2973,6305562,0,141746,6163816
9/22/22,Colombia,4.5709,-74.2973,6306552,0,141769,6164783
9/23/22,Colombia,4.5709,-74.2973,6306552,0,141769,6164783
9/24/22,Colombia,4.5709,-74.2973,6306552,0,141769,6164783
9/25/22,Colombia,4.5709,-74.2973,6306552,0,141769,6164783
9/26/22,Colombia,4.5709,-74.2973,6306552,0,141769,6164783
9/27/22,Colombia,4.5709,-74.2973,6306552,0,141769,6164783
9/28/22,Colombia,4.5709,-74.2973,6306552,0,141769,6164783
9/29/22,Colombia,4.5709,-74.2973,6307372,0,141794,6165578
9/30/22,Colombia,4.5709,-74.2973,6307372,0,141794,6165578
10/1/22,Colombia,4.5709,-74.2973,6307372,0,141794,6165578
10/2/22,Colombia,4.5709,-74.2973,6307372,0,141794,6165578
10/3/22,Colombia,4.5709,-74.2973,6307372,0,141794,6165578
10/4/22,Colombia,4.5709,-74.2973,6307372,0,141794,6165578
10/5/22,Colombia,4.5709,-74.2973,6307372,0,141794,6165578
10/6/22,Colombia,4.5709,-74.2973,6308087,0,141807,6166280
10/7/22,Colombia,4.5709,-74.2973,6308087,0,141807,6166280
10/8/22,Colombia,4.5709,-74.2973,6308087,0,141807,6166280
10/9/22,Colombia,4.5709,-74.2973,6308087,0,141807,6166280
10/10/22,Colombia,4.5709,-74.2973,6308087,0,141807,6166280
10/11/22,Colombia,4.5709,-74.2973,6308087,0,141807,6166280
10/12/22,Colombia,4.5709,-74.2973,6308087,0,141807,6166280
10/13/22,Colombia,4.5709,-74.2973,6308558,0,141820,6166738
10/14/22,Colombia,4.5709,-74.2973,6308558,0,141820,6166738
10/15/22,Colombia,4.5709,-74.2973,6308558,0,141820,6166738
10/16/22,Colombia,4.5709,-74.2973,6308558,0,141820,6166738
10/17/22,Colombia,4.5709,-74.2973,6308558,0,141820,6166738
10/18/22,Colombia,4.5709,-74.2973,6308558,0,141820,6166738
10/19/22,Colombia,4.5709,-74.2973,6308558,0,141820,6166738
10/20/22,Colombia,4.5709,-74.2973,6309168,0,141827,6167341
10/21/22,Colombia,4.5709,-74.2973,6309168,0,141827,6167341
10/22/22,Colombia,4.5709,-74.2973,6309168,0,141827,6167341
10/23/22,Colombia,4.5709,-74.2973,6309168,0,141827,6167341
10/24/22,Colombia,4.5709,-74.2973,6309168,0,141827,6167341
10/25/22,Colombia,4.5709,-74.2973,6309168,0,141827,6167341
10/26/22,Colombia,4.5709,-74.2973,6309168,0,141827,6167341
10/27/22,Colombia,4.5709,-74.2973,6309716,0,141837,6167879
10/28/22,Colombia,4.5709,-74.2973,6309716,0,141837,6167879
10/29/22,Colombia,4.5709,-74.2973,6309716,0,141837,6167879
10/30/22,Colombia,4.5709,-74.2973,6309716,0,141837,6167879
10/31/22,Colombia,4.5709,-74.2973,6309716,0,141837,6167879
11/1/22,Colombia,4.5709,-74.2973,6309716,0,141837,6167879
11/2/22,Colombia,4.5709,-74.2973,6309716,0,141837,6167879
11/3/22,Colombia,4.5709,-74.2973,6310332,0,141850,6168482
11/4/22,Colombia,4.5709,-74.2973,6310332,0,141850,6168482
11/5/22,Colombia,4.5709,-74.2973,6310332,0,141850,6168482
11/6/22,Colombia,4.5709,-74.2973,6310332,0,141850,6168482
11/7/22,Colombia,4.5709,-74.2973,6310332,0,141850,6168482
11/8/22,Colombia,4.5709,-74.2973,6310332,0,141850,6168482
11/9/22,Colombia,4.5709,-74.2973,6310332,0,141850,6168482
11/10/22,Colombia,4.5709,-74.2973,6311359,0,141862,6169497
11/11/22,Colombia,4.5709,-74.2973,6311359,0,141862,6169497
11/12/22,Colombia,4.5709,-74.2973,6311359,0,141862,6169497
11/13/22,Colombia,4.5709,-74.2973,6311359,0,141862,6169497
11/14/22,Colombia,4.5709,-74.2973,6311359,0,141862,6169497
11/15/22,Colombia,4.5709,-74.2973,6311359,0,141862,6169497
11/16/22,Colombia,4.5709,-74.2973,6311359,0,141862,6169497
11/17/22,Colombia,4.5709,-74.2973,6312657,0,141881,6170776
11/18/22,Colombia,4.5709,-74.2973,6312657,0,141881,6170776
11/19/22,Colombia,4.5709,-74.2973,6312657,0,141881,6170776
11/20/22,Colombia,4.5709,-74.2973,6312657,0,141881,6170776
11/21/22,Colombia,4.5709,-74.2973,6312657,0,141881,6170776
11/22/22,Colombia,4.5709,-74.2973,6312657,0,141881,6170776
11/23/22,Colombia,4.5709,-74.2973,6312657,0,141881,6170776
11/24/22,Colombia,4.5709,-74.2973,6312657,0,141881,6170776
11/25/22,Colombia,4.5709,-74.2973,6312657,0,141881,6170776
11/26/22,Colombia,4.5709,-74.2973,6312657,0,141881,6170776
11/27/22,Colombia,4.5709,-74.2973,6312657,0,141881,6170776
11/28/22,Colombia,4.5709,-74.2973,6312657,0,141881,6170776
11/29/22,Colombia,4.5709,-74.2973,6312657,0,141881,6170776
11/30/22,Colombia,4.5709,-74.2973,6312657,0,141881,6170776
12/1/22,Colombia,4.5709,-74.2973,6312657,0,141881,6170776
12/2/22,Colombia,4.5709,-74.2973,6314107,0,141881,6172226
12/3/22,Colombia,4.5709,-74.2973,6314107,0,141881,6172226
12/4/22,Colombia,4.5709,-74.2973,6314107,0,141881,6172226
12/5/22,Colombia,4.5709,-74.2973,6314107,0,141881,6172226
12/6/22,Colombia,4.5709,-74.2973,6314107,0,141881,6172226
12/7/22,Colombia,4.5709,-74.2973,6317010,0,141881,6175129
12/8/22,Colombia,4.5709,-74.2973,6317010,0,141881,6175129
12/9/22,Colombia,4.5709,-74.2973,6317010,0,141881,6175129
12/10/22,Colombia,4.5709,-74.2973,6317010,0,141881,6175129
12/11/22,Colombia,4.5709,-74.2973,6317010,0,141881,6175129
12/12/22,Colombia,4.5709,-74.2973,6317010,0,141881,6175129
12/13/22,Colombia,4.5709,-74.2973,6317010,0,141881,6175129
12/14/22,Colombia,4.5709,-74.2973,6317010,0,141881,6175129
12/15/22,Colombia,4.5709,-74.2973,6322281,0,141881,6180400
12/16/22,Colombia,4.5709,-74.2973,6322281,0,141881,6180400
12/17/22,Colombia,4.5709,-74.2973,6322281,0,141881,6180400
1/1/22,Comoros,-11.6455,43.3333,6688,0,157,6531
1/2/22,Comoros,-11.6455,43.3333,6835,0,158,6677
1/3/22,Comoros,-11.6455,43.3333,6907,0,158,6749
1/4/22,Comoros,-11.6455,43.3333,7068,0,159,6909
1/5/22,Comoros,-11.6455,43.3333,7283,0,159,7124
1/6/22,Comoros,-11.6455,43.3333,7405,0,159,7246
1/7/22,Comoros,-11.6455,43.3333,7497,0,159,7338
1/8/22,Comoros,-11.6455,43.3333,7554,0,159,7395
1/9/22,Comoros,-11.6455,43.3333,7594,0,159,7435
1/10/22,Comoros,-11.6455,43.3333,7622,0,158,7464
1/11/22,Comoros,-11.6455,43.3333,7655,0,158,7497
1/12/22,Comoros,-11.6455,43.3333,7715,0,159,7556
1/13/22,Comoros,-11.6455,43.3333,7715,0,159,7556
1/14/22,Comoros,-11.6455,43.3333,7745,0,159,7586
1/15/22,Comoros,-11.6455,43.3333,7745,0,159,7586
1/16/22,Comoros,-11.6455,43.3333,7756,0,159,7597
1/17/22,Comoros,-11.6455,43.3333,7767,0,159,7608
1/18/22,Comoros,-11.6455,43.3333,7771,0,159,7612
1/19/22,Comoros,-11.6455,43.3333,7784,0,159,7625
1/20/22,Comoros,-11.6455,43.3333,7784,0,159,7625
1/21/22,Comoros,-11.6455,43.3333,7793,0,159,7634
1/22/22,Comoros,-11.6455,43.3333,7801,0,159,7642
1/23/22,Comoros,-11.6455,43.3333,7812,0,159,7653
1/24/22,Comoros,-11.6455,43.3333,7814,0,159,7655
1/25/22,Comoros,-11.6455,43.3333,7814,0,159,7655
1/26/22,Comoros,-11.6455,43.3333,7821,0,159,7662
1/27/22,Comoros,-11.6455,43.3333,7824,0,159,7665
1/28/22,Comoros,-11.6455,43.3333,7827,0,159,7668
1/29/22,Comoros,-11.6455,43.3333,7829,0,160,7669
1/30/22,Comoros,-11.6455,43.3333,7832,0,160,7672
1/31/22,Comoros,-11.6455,43.3333,7832,0,160,7672
2/1/22,Comoros,-11.6455,43.3333,7832,0,160,7672
2/2/22,Comoros,-11.6455,43.3333,7833,0,160,7673
2/3/22,Comoros,-11.6455,43.3333,7870,0,160,7710
2/4/22,Comoros,-11.6455,43.3333,7870,0,160,7710
2/5/22,Comoros,-11.6455,43.3333,7928,0,160,7768
2/6/22,Comoros,-11.6455,43.3333,7944,0,160,7784
2/7/22,Comoros,-11.6455,43.3333,7964,0,160,7804
2/8/22,Comoros,-11.6455,43.3333,7965,0,160,7805
2/9/22,Comoros,-11.6455,43.3333,7978,0,160,7818
2/10/22,Comoros,-11.6455,43.3333,7989,0,160,7829
2/11/22,Comoros,-11.6455,43.3333,7998,0,160,7838
2/12/22,Comoros,-11.6455,43.3333,7998,0,160,7838
2/13/22,Comoros,-11.6455,43.3333,8005,0,160,7845
2/14/22,Comoros,-11.6455,43.3333,8005,0,160,7845
2/15/22,Comoros,-11.6455,43.3333,8005,0,160,7845
2/16/22,Comoros,-11.6455,43.3333,8010,0,160,7850
2/17/22,Comoros,-11.6455,43.3333,8012,0,160,7852
2/18/22,Comoros,-11.6455,43.3333,8014,0,160,7854
2/19/22,Comoros,-11.6455,43.3333,8016,0,160,7856
2/20/22,Comoros,-11.6455,43.3333,8020,0,160,7860
2/21/22,Comoros,-11.6455,43.3333,8021,0,160,7861
2/22/22,Comoros,-11.6455,43.3333,8024,0,160,7864
2/23/22,Comoros,-11.6455,43.3333,8024,0,160,7864
2/24/22,Comoros,-11.6455,43.3333,8026,0,160,7866
2/25/22,Comoros,-11.6455,43.3333,8026,0,160,7866
2/26/22,Comoros,-11.6455,43.3333,8032,0,160,7872
2/27/22,Comoros,-11.6455,43.3333,8033,0,160,7873
2/28/22,Comoros,-11.6455,43.3333,8033,0,160,7873
3/1/22,Comoros,-11.6455,43.3333,8033,0,160,7873
3/2/22,Comoros,-11.6455,43.3333,8033,0,160,7873
3/3/22,Comoros,-11.6455,43.3333,8033,0,160,7873
3/4/22,Comoros,-11.6455,43.3333,8047,0,160,7887
3/5/22,Comoros,-11.6455,43.3333,8047,0,160,7887
3/6/22,Comoros,-11.6455,43.3333,8047,0,160,7887
3/7/22,Comoros,-11.6455,43.3333,8048,0,160,7888
3/8/22,Comoros,-11.6455,43.3333,8051,0,160,7891
3/9/22,Comoros,-11.6455,43.3333,8051,0,160,7891
3/10/22,Comoros,-11.6455,43.3333,8057,0,160,7897
3/11/22,Comoros,-11.6455,43.3333,8060,0,160,7900
3/12/22,Comoros,-11.6455,43.3333,8060,0,160,7900
3/13/22,Comoros,-11.6455,43.3333,8063,0,160,7903
3/14/22,Comoros,-11.6455,43.3333,8069,0,160,7909
3/15/22,Comoros,-11.6455,43.3333,8069,0,160,7909
3/16/22,Comoros,-11.6455,43.3333,8074,0,160,7914
3/17/22,Comoros,-11.6455,43.3333,8074,0,160,7914
3/18/22,Comoros,-11.6455,43.3333,8076,0,160,7916
3/19/22,Comoros,-11.6455,43.3333,8076,0,160,7916
3/20/22,Comoros,-11.6455,43.3333,8076,0,160,7916
3/21/22,Comoros,-11.6455,43.3333,8077,0,160,7917
3/22/22,Comoros,-11.6455,43.3333,8078,0,160,7918
3/23/22,Comoros,-11.6455,43.3333,8078,0,160,7918
3/24/22,Comoros,-11.6455,43.3333,8081,0,160,7921
3/25/22,Comoros,-11.6455,43.3333,8081,0,160,7921
3/26/22,Comoros,-11.6455,43.3333,8081,0,160,7921
3/27/22,Comoros,-11.6455,43.3333,8081,0,160,7921
3/28/22,Comoros,-11.6455,43.3333,8083,0,160,7923
3/29/22,Comoros,-11.6455,43.3333,8085,0,160,7925
3/30/22,Comoros,-11.6455,43.3333,8086,0,160,7926
3/31/22,Comoros,-11.6455,43.3333,8086,0,160,7926
4/1/22,Comoros,-11.6455,43.3333,8088,0,160,7928
4/2/22,Comoros,-11.6455,43.3333,8088,0,160,7928
4/3/22,Comoros,-11.6455,43.3333,8093,0,160,7933
4/4/22,Comoros,-11.6455,43.3333,8093,0,160,7933
4/5/22,Comoros,-11.6455,43.3333,8093,0,160,7933
4/6/22,Comoros,-11.6455,43.3333,8095,0,160,7935
4/7/22,Comoros,-11.6455,43.3333,8095,0,160,7935
4/8/22,Comoros,-11.6455,43.3333,8097,0,160,7937
4/9/22,Comoros,-11.6455,43.3333,8097,0,160,7937
4/10/22,Comoros,-11.6455,43.3333,8099,0,160,7939
4/11/22,Comoros,-11.6455,43.3333,8100,0,160,7940
4/12/22,Comoros,-11.6455,43.3333,8100,0,160,7940
4/13/22,Comoros,-11.6455,43.3333,8100,0,160,7940
4/14/22,Comoros,-11.6455,43.3333,8100,0,160,7940
4/15/22,Comoros,-11.6455,43.3333,8100,0,160,7940
4/16/22,Comoros,-11.6455,43.3333,8100,0,160,7940
4/17/22,Comoros,-11.6455,43.3333,8100,0,160,7940
4/18/22,Comoros,-11.6455,43.3333,8100,0,160,7940
4/19/22,Comoros,-11.6455,43.3333,8103,0,160,7943
4/20/22,Comoros,-11.6455,43.3333,8103,0,160,7943
4/21/22,Comoros,-11.6455,43.3333,8104,0,160,7944
4/22/22,Comoros,-11.6455,43.3333,8104,0,160,7944
4/23/22,Comoros,-11.6455,43.3333,8104,0,160,7944
4/24/22,Comoros,-11.6455,43.3333,8104,0,160,7944
4/25/22,Comoros,-11.6455,43.3333,8105,0,160,7945
4/26/22,Comoros,-11.6455,43.3333,8105,0,160,7945
4/27/22,Comoros,-11.6455,43.3333,8105,0,160,7945
4/28/22,Comoros,-11.6455,43.3333,8105,0,160,7945
4/29/22,Comoros,-11.6455,43.3333,8105,0,160,7945
4/30/22,Comoros,-11.6455,43.3333,8105,0,160,7945
5/1/22,Comoros,-11.6455,43.3333,8105,0,160,7945
5/2/22,Comoros,-11.6455,43.3333,8106,0,160,7946
5/3/22,Comoros,-11.6455,43.3333,8107,0,160,7947
5/4/22,Comoros,-11.6455,43.3333,8107,0,160,7947
5/5/22,Comoros,-11.6455,43.3333,8107,0,160,7947
5/6/22,Comoros,-11.6455,43.3333,8107,0,160,7947
5/7/22,Comoros,-11.6455,43.3333,8107,0,160,7947
5/8/22,Comoros,-11.6455,43.3333,8107,0,160,7947
5/9/22,Comoros,-11.6455,43.3333,8107,0,160,7947
5/10/22,Comoros,-11.6455,43.3333,8108,0,160,7948
5/11/22,Comoros,-11.6455,43.3333,8108,0,160,7948
5/12/22,Comoros,-11.6455,43.3333,8108,0,160,7948
5/13/22,Comoros,-11.6455,43.3333,8108,0,160,7948
5/14/22,Comoros,-11.6455,43.3333,8108,0,160,7948
5/15/22,Comoros,-11.6455,43.3333,8108,0,160,7948
5/16/22,Comoros,-11.6455,43.3333,8108,0,160,7948
5/17/22,Comoros,-11.6455,43.3333,8110,0,160,7950
5/18/22,Comoros,-11.6455,43.3333,8110,0,160,7950
5/19/22,Comoros,-11.6455,43.3333,8110,0,160,7950
5/20/22,Comoros,-11.6455,43.3333,8110,0,160,7950
5/21/22,Comoros,-11.6455,43.3333,8110,0,160,7950
5/22/22,Comoros,-11.6455,43.3333,8110,0,160,7950
5/23/22,Comoros,-11.6455,43.3333,8114,0,160,7954
5/24/22,Comoros,-11.6455,43.3333,8114,0,160,7954
5/25/22,Comoros,-11.6455,43.3333,8120,0,161,7959
5/26/22,Comoros,-11.6455,43.3333,8120,0,161,7959
5/27/22,Comoros,-11.6455,43.3333,8120,0,160,7960
5/28/22,Comoros,-11.6455,43.3333,8120,0,160,7960
5/29/22,Comoros,-11.6455,43.3333,8120,0,160,7960
5/30/22,Comoros,-11.6455,43.3333,8120,0,160,7960
5/31/22,Comoros,-11.6455,43.3333,8120,0,160,7960
6/1/22,Comoros,-11.6455,43.3333,8120,0,160,7960
6/2/22,Comoros,-11.6455,43.3333,8126,0,160,7966
6/3/22,Comoros,-11.6455,43.3333,8126,0,160,7966
6/4/22,Comoros,-11.6455,43.3333,8126,0,160,7966
6/5/22,Comoros,-11.6455,43.3333,8126,0,160,7966
6/6/22,Comoros,-11.6455,43.3333,8126,0,160,7966
6/7/22,Comoros,-11.6455,43.3333,8126,0,160,7966
6/8/22,Comoros,-11.6455,43.3333,8126,0,160,7966
6/9/22,Comoros,-11.6455,43.3333,8126,0,160,7966
6/10/22,Comoros,-11.6455,43.3333,8131,0,160,7971
6/11/22,Comoros,-11.6455,43.3333,8131,0,160,7971
6/12/22,Comoros,-11.6455,43.3333,8131,0,160,7971
6/13/22,Comoros,-11.6455,43.3333,8131,0,160,7971
6/14/22,Comoros,-11.6455,43.3333,8131,0,160,7971
6/15/22,Comoros,-11.6455,43.3333,8131,0,160,7971
6/16/22,Comoros,-11.6455,43.3333,8131,0,160,7971
6/17/22,Comoros,-11.6455,43.3333,8131,0,160,7971
6/18/22,Comoros,-11.6455,43.3333,8131,0,160,7971
6/19/22,Comoros,-11.6455,43.3333,8131,0,160,7971
6/20/22,Comoros,-11.6455,43.3333,8131,0,160,7971
6/21/22,Comoros,-11.6455,43.3333,8131,0,160,7971
6/22/22,Comoros,-11.6455,43.3333,8131,0,160,7971
6/23/22,Comoros,-11.6455,43.3333,8136,0,160,7976
6/24/22,Comoros,-11.6455,43.3333,8136,0,160,7976
6/25/22,Comoros,-11.6455,43.3333,8136,0,160,7976
6/26/22,Comoros,-11.6455,43.3333,8136,0,160,7976
6/27/22,Comoros,-11.6455,43.3333,8136,0,160,7976
6/28/22,Comoros,-11.6455,43.3333,8139,0,160,7979
6/29/22,Comoros,-11.6455,43.3333,8139,0,160,7979
6/30/22,Comoros,-11.6455,43.3333,8139,0,160,7979
7/1/22,Comoros,-11.6455,43.3333,8139,0,160,7979
7/2/22,Comoros,-11.6455,43.3333,8139,0,160,7979
7/3/22,Comoros,-11.6455,43.3333,8139,0,160,7979
7/4/22,Comoros,-11.6455,43.3333,8161,0,160,8001
7/5/22,Comoros,-11.6455,43.3333,8161,0,160,8001
7/6/22,Comoros,-11.6455,43.3333,8161,0,160,8001
7/7/22,Comoros,-11.6455,43.3333,8161,0,160,8001
7/8/22,Comoros,-11.6455,43.3333,8161,0,160,8001
7/9/22,Comoros,-11.6455,43.3333,8161,0,160,8001
7/10/22,Comoros,-11.6455,43.3333,8161,0,160,8001
7/11/22,Comoros,-11.6455,43.3333,8161,0,160,8001
7/12/22,Comoros,-11.6455,43.3333,8209,0,160,8049
7/13/22,Comoros,-11.6455,43.3333,8209,0,160,8049
7/14/22,Comoros,-11.6455,43.3333,8209,0,160,8049
7/15/22,Comoros,-11.6455,43.3333,8209,0,160,8049
7/16/22,Comoros,-11.6455,43.3333,8209,0,160,8049
7/17/22,Comoros,-11.6455,43.3333,8209,0,160,8049
7/18/22,Comoros,-11.6455,43.3333,8209,0,160,8049
7/19/22,Comoros,-11.6455,43.3333,8270,0,160,8110
7/20/22,Comoros,-11.6455,43.3333,8270,0,160,8110
7/21/22,Comoros,-11.6455,43.3333,8270,0,160,8110
7/22/22,Comoros,-11.6455,43.3333,8270,0,160,8110
7/23/22,Comoros,-11.6455,43.3333,8270,0,160,8110
7/24/22,Comoros,-11.6455,43.3333,8270,0,160,8110
7/25/22,Comoros,-11.6455,43.3333,8270,0,160,8110
7/26/22,Comoros,-11.6455,43.3333,8301,0,160,8141
7/27/22,Comoros,-11.6455,43.3333,8301,0,160,8141
7/28/22,Comoros,-11.6455,43.3333,8306,0,160,8146
7/29/22,Comoros,-11.6455,43.3333,8315,0,160,8155
7/30/22,Comoros,-11.6455,43.3333,8315,0,160,8155
7/31/22,Comoros,-11.6455,43.3333,8315,0,160,8155
8/1/22,Comoros,-11.6455,43.3333,8315,0,160,8155
8/2/22,Comoros,-11.6455,43.3333,8329,0,160,8169
8/3/22,Comoros,-11.6455,43.3333,8329,0,160,8169
8/4/22,Comoros,-11.6455,43.3333,8329,0,160,8169
8/5/22,Comoros,-11.6455,43.3333,8340,0,160,8180
8/6/22,Comoros,-11.6455,43.3333,8340,0,160,8180
8/7/22,Comoros,-11.6455,43.3333,8340,0,160,8180
8/8/22,Comoros,-11.6455,43.3333,8351,0,160,8191
8/9/22,Comoros,-11.6455,43.3333,8351,0,160,8191
8/10/22,Comoros,-11.6455,43.3333,8351,0,160,8191
8/11/22,Comoros,-11.6455,43.3333,8351,0,160,8191
8/12/22,Comoros,-11.6455,43.3333,8351,0,161,8190
8/13/22,Comoros,-11.6455,43.3333,8351,0,161,8190
8/14/22,Comoros,-11.6455,43.3333,8351,0,161,8190
8/15/22,Comoros,-11.6455,43.3333,8374,0,161,8213
8/16/22,Comoros,-11.6455,43.3333,8374,0,161,8213
8/17/22,Comoros,-11.6455,43.3333,8374,0,161,8213
8/18/22,Comoros,-11.6455,43.3333,8374,0,161,8213
8/19/22,Comoros,-11.6455,43.3333,8409,0,161,8248
8/20/22,Comoros,-11.6455,43.3333,8409,0,161,8248
8/21/22,Comoros,-11.6455,43.3333,8409,0,161,8248
8/22/22,Comoros,-11.6455,43.3333,8425,0,161,8264
8/23/22,Comoros,-11.6455,43.3333,8425,0,161,8264
8/24/22,Comoros,-11.6455,43.3333,8425,0,161,8264
8/25/22,Comoros,-11.6455,43.3333,8425,0,161,8264
8/26/22,Comoros,-11.6455,43.3333,8445,0,161,8284
8/27/22,Comoros,-11.6455,43.3333,8445,0,161,8284
8/28/22,Comoros,-11.6455,43.3333,8445,0,161,8284
8/29/22,Comoros,-11.6455,43.3333,8445,0,161,8284
8/30/22,Comoros,-11.6455,43.3333,8450,0,161,8289
8/31/22,Comoros,-11.6455,43.3333,8455,0,161,8294
9/1/22,Comoros,-11.6455,43.3333,8455,0,161,8294
9/2/22,Comoros,-11.6455,43.3333,8455,0,161,8294
9/3/22,Comoros,-11.6455,43.3333,8455,0,161,8294
9/4/22,Comoros,-11.6455,43.3333,8455,0,161,8294
9/5/22,Comoros,-11.6455,43.3333,8455,0,161,8294
9/6/22,Comoros,-11.6455,43.3333,8455,0,161,8294
9/7/22,Comoros,-11.6455,43.3333,8455,0,161,8294
9/8/22,Comoros,-11.6455,43.3333,8455,0,161,8294
9/9/22,Comoros,-11.6455,43.3333,8455,0,161,8294
9/10/22,Comoros,-11.6455,43.3333,8455,0,161,8294
9/11/22,Comoros,-11.6455,43.3333,8455,0,161,8294
9/12/22,Comoros,-11.6455,43.3333,8455,0,161,8294
9/13/22,Comoros,-11.6455,43.3333,8455,0,161,8294
9/14/22,Comoros,-11.6455,43.3333,8467,0,161,8306
9/15/22,Comoros,-11.6455,43.3333,8467,0,161,8306
9/16/22,Comoros,-11.6455,43.3333,8467,0,161,8306
9/17/22,Comoros,-11.6455,43.3333,8467,0,161,8306
9/18/22,Comoros,-11.6455,43.3333,8467,0,161,8306
9/19/22,Comoros,-11.6455,43.3333,8471,0,161,8310
9/20/22,Comoros,-11.6455,43.3333,8471,0,161,8310
9/21/22,Comoros,-11.6455,43.3333,8471,0,161,8310
9/22/22,Comoros,-11.6455,43.3333,8471,0,161,8310
9/23/22,Comoros,-11.6455,43.3333,8471,0,161,8310
9/24/22,Comoros,-11.6455,43.3333,8471,0,161,8310
9/25/22,Comoros,-11.6455,43.3333,8471,0,161,8310
9/26/22,Comoros,-11.6455,43.3333,8471,0,161,8310
9/27/22,Comoros,-11.6455,43.3333,8471,0,161,8310
9/28/22,Comoros,-11.6455,43.3333,8471,0,161,8310
9/29/22,Comoros,-11.6455,43.3333,8471,0,161,8310
9/30/22,Comoros,-11.6455,43.3333,8471,0,161,8310
10/1/22,Comoros,-11.6455,43.3333,8471,0,161,8310
10/2/22,Comoros,-11.6455,43.3333,8471,0,161,8310
10/3/22,Comoros,-11.6455,43.3333,8471,0,161,8310
10/4/22,Comoros,-11.6455,43.3333,8471,0,161,8310
10/5/22,Comoros,-11.6455,43.3333,8471,0,161,8310
10/6/22,Comoros,-11.6455,43.3333,8471,0,161,8310
10/7/22,Comoros,-11.6455,43.3333,8471,0,161,8310
10/8/22,Comoros,-11.6455,43.3333,8471,0,161,8310
10/9/22,Comoros,-11.6455,43.3333,8471,0,161,8310
10/10/22,Comoros,-11.6455,43.3333,8473,0,161,8312
10/11/22,Comoros,-11.6455,43.3333,8473,0,161,8312
10/12/22,Comoros,-11.6455,43.3333,8473,0,161,8312
10/13/22,Comoros,-11.6455,43.3333,8481,0,161,8320
10/14/22,Comoros,-11.6455,43.3333,8481,0,161,8320
10/15/22,Comoros,-11.6455,43.3333,8481,0,161,8320
10/16/22,Comoros,-11.6455,43.3333,8481,0,161,8320
10/17/22,Comoros,-11.6455,43.3333,8481,0,161,8320
10/18/22,Comoros,-11.6455,43.3333,8481,0,161,8320
10/19/22,Comoros,-11.6455,43.3333,8481,0,161,8320
10/20/22,Comoros,-11.6455,43.3333,8481,0,161,8320
10/21/22,Comoros,-11.6455,43.3333,8481,0,161,8320
10/22/22,Comoros,-11.6455,43.3333,8481,0,161,8320
10/23/22,Comoros,-11.6455,43.3333,8481,0,161,8320
10/24/22,Comoros,-11.6455,43.3333,8672,0,161,8511
10/25/22,Comoros,-11.6455,43.3333,8672,0,161,8511
10/26/22,Comoros,-11.6455,43.3333,8672,0,161,8511
10/27/22,Comoros,-11.6455,43.3333,8762,0,161,8601
10/28/22,Comoros,-11.6455,43.3333,8762,0,161,8601
10/29/22,Comoros,-11.6455,43.3333,8762,0,161,8601
10/30/22,Comoros,-11.6455,43.3333,8762,0,161,8601
10/31/22,Comoros,-11.6455,43.3333,8762,0,161,8601
11/1/22,Comoros,-11.6455,43.3333,8762,0,161,8601
11/2/22,Comoros,-11.6455,43.3333,8762,0,161,8601
11/3/22,Comoros,-11.6455,43.3333,8762,0,161,8601
11/4/22,Comoros,-11.6455,43.3333,8762,0,161,8601
11/5/22,Comoros,-11.6455,43.3333,8762,0,161,8601
11/6/22,Comoros,-11.6455,43.3333,8762,0,161,8601
11/7/22,Comoros,-11.6455,43.3333,8879,0,161,8718
11/8/22,Comoros,-11.6455,43.3333,8879,0,161,8718
11/9/22,Comoros,-11.6455,43.3333,8879,0,161,8718
11/10/22,Comoros,-11.6455,43.3333,8879,0,161,8718
11/11/22,Comoros,-11.6455,43.3333,8879,0,161,8718
11/12/22,Comoros,-11.6455,43.3333,8879,0,161,8718
11/13/22,Comoros,-11.6455,43.3333,8879,0,161,8718
11/14/22,Comoros,-11.6455,43.3333,8925,0,161,8764
11/15/22,Comoros,-11.6455,43.3333,8925,0,161,8764
11/16/22,Comoros,-11.6455,43.3333,8925,0,161,8764
11/17/22,Comoros,-11.6455,43.3333,8925,0,161,8764
11/18/22,Comoros,-11.6455,43.3333,8941,0,161,8780
11/19/22,Comoros,-11.6455,43.3333,8941,0,161,8780
11/20/22,Comoros,-11.6455,43.3333,8941,0,161,8780
11/21/22,Comoros,-11.6455,43.3333,8941,0,161,8780
11/22/22,Comoros,-11.6455,43.3333,8941,0,161,8780
11/23/22,Comoros,-11.6455,43.3333,8941,0,161,8780
11/24/22,Comoros,-11.6455,43.3333,8941,0,161,8780
11/25/22,Comoros,-11.6455,43.3333,8941,0,161,8780
11/26/22,Comoros,-11.6455,43.3333,8941,0,161,8780
11/27/22,Comoros,-11.6455,43.3333,8941,0,161,8780
11/28/22,Comoros,-11.6455,43.3333,8941,0,161,8780
11/29/22,Comoros,-11.6455,43.3333,8965,0,161,8804
11/30/22,Comoros,-11.6455,43.3333,8965,0,161,8804
12/1/22,Comoros,-11.6455,43.3333,8965,0,161,8804
12/2/22,Comoros,-11.6455,43.3333,8965,0,161,8804
12/3/22,Comoros,-11.6455,43.3333,8965,0,161,8804
12/4/22,Comoros,-11.6455,43.3333,8965,0,161,8804
12/5/22,Comoros,-11.6455,43.3333,8968,0,161,8807
12/6/22,Comoros,-11.6455,43.3333,8977,0,161,8816
12/7/22,Comoros,-11.6455,43.3333,8977,0,161,8816
12/8/22,Comoros,-11.6455,43.3333,8977,0,161,8816
12/9/22,Comoros,-11.6455,43.3333,8977,0,161,8816
12/10/22,Comoros,-11.6455,43.3333,8977,0,161,8816
12/11/22,Comoros,-11.6455,43.3333,8977,0,161,8816
12/12/22,Comoros,-11.6455,43.3333,8977,0,161,8816
12/13/22,Comoros,-11.6455,43.3333,8977,0,161,8816
12/14/22,Comoros,-11.6455,43.3333,8979,0,161,8818
12/15/22,Comoros,-11.6455,43.3333,8979,0,161,8818
12/16/22,Comoros,-11.6455,43.3333,8979,0,161,8818
12/17/22,Comoros,-11.6455,43.3333,8979,0,161,8818
1/1/22,Congo (Brazzaville),-0.228,15.8277,20089,0,367,19722
1/2/22,Congo (Brazzaville),-0.228,15.8277,20089,0,367,19722
1/3/22,Congo (Brazzaville),-0.228,15.8277,21277,0,369,20908
1/4/22,Congo (Brazzaville),-0.228,15.8277,21277,0,369,20908
1/5/22,Congo (Brazzaville),-0.228,15.8277,21277,0,369,20908
1/6/22,Congo (Brazzaville),-0.228,15.8277,21277,0,369,20908
1/7/22,Congo (Brazzaville),-0.228,15.8277,21844,0,370,21474
1/8/22,Congo (Brazzaville),-0.228,15.8277,21844,0,370,21474
1/9/22,Congo (Brazzaville),-0.228,15.8277,22418,0,370,22048
1/10/22,Congo (Brazzaville),-0.228,15.8277,22418,0,370,22048
1/11/22,Congo (Brazzaville),-0.228,15.8277,22418,0,370,22048
1/12/22,Congo (Brazzaville),-0.228,15.8277,22418,0,370,22048
1/13/22,Congo (Brazzaville),-0.228,15.8277,22418,0,370,22048
1/14/22,Congo (Brazzaville),-0.228,15.8277,22969,0,371,22598
1/15/22,Congo (Brazzaville),-0.228,15.8277,22969,0,371,22598
1/16/22,Congo (Brazzaville),-0.228,15.8277,22969,0,371,22598
1/17/22,Congo (Brazzaville),-0.228,15.8277,23244,0,371,22873
1/18/22,Congo (Brazzaville),-0.228,15.8277,23244,0,371,22873
1/19/22,Congo (Brazzaville),-0.228,15.8277,23244,0,371,22873
1/20/22,Congo (Brazzaville),-0.228,15.8277,23244,0,371,22873
1/21/22,Congo (Brazzaville),-0.228,15.8277,23380,0,371,23009
1/22/22,Congo (Brazzaville),-0.228,15.8277,23380,0,371,23009
1/23/22,Congo (Brazzaville),-0.228,15.8277,23485,0,371,23114
1/24/22,Congo (Brazzaville),-0.228,15.8277,23485,0,371,23114
1/25/22,Congo (Brazzaville),-0.228,15.8277,23485,0,371,23114
1/26/22,Congo (Brazzaville),-0.228,15.8277,23485,0,371,23114
1/27/22,Congo (Brazzaville),-0.228,15.8277,23653,0,371,23282
1/28/22,Congo (Brazzaville),-0.228,15.8277,23653,0,371,23282
1/29/22,Congo (Brazzaville),-0.228,15.8277,23653,0,371,23282
1/30/22,Congo (Brazzaville),-0.228,15.8277,23653,0,371,23282
1/31/22,Congo (Brazzaville),-0.228,15.8277,23705,0,371,23334
2/1/22,Congo (Brazzaville),-0.228,15.8277,23705,0,371,23334
2/2/22,Congo (Brazzaville),-0.228,15.8277,23705,0,371,23334
2/3/22,Congo (Brazzaville),-0.228,15.8277,23705,0,371,23334
2/4/22,Congo (Brazzaville),-0.228,15.8277,23705,0,371,23334
2/5/22,Congo (Brazzaville),-0.228,15.8277,23705,0,371,23334
2/6/22,Congo (Brazzaville),-0.228,15.8277,23705,0,371,23334
2/7/22,Congo (Brazzaville),-0.228,15.8277,23792,0,375,23417
2/8/22,Congo (Brazzaville),-0.228,15.8277,23792,0,375,23417
2/9/22,Congo (Brazzaville),-0.228,15.8277,23854,0,375,23479
2/10/22,Congo (Brazzaville),-0.228,15.8277,23860,0,375,23485
2/11/22,Congo (Brazzaville),-0.228,15.8277,23860,0,375,23485
2/12/22,Congo (Brazzaville),-0.228,15.8277,23860,0,375,23485
2/13/22,Congo (Brazzaville),-0.228,15.8277,23860,0,375,23485
2/14/22,Congo (Brazzaville),-0.228,15.8277,23874,0,375,23499
2/15/22,Congo (Brazzaville),-0.228,15.8277,23874,0,375,23499
2/16/22,Congo (Brazzaville),-0.228,15.8277,23874,0,375,23499
2/17/22,Congo (Brazzaville),-0.228,15.8277,23874,0,375,23499
2/18/22,Congo (Brazzaville),-0.228,15.8277,23874,0,375,23499
2/19/22,Congo (Brazzaville),-0.228,15.8277,23874,0,375,23499
2/20/22,Congo (Brazzaville),-0.228,15.8277,23874,0,375,23499
2/21/22,Congo (Brazzaville),-0.228,15.8277,23925,0,377,23548
2/22/22,Congo (Brazzaville),-0.228,15.8277,23925,0,377,23548
2/23/22,Congo (Brazzaville),-0.228,15.8277,23925,0,377,23548
2/24/22,Congo (Brazzaville),-0.228,15.8277,23967,0,378,23589
2/25/22,Congo (Brazzaville),-0.228,15.8277,23967,0,378,23589
2/26/22,Congo (Brazzaville),-0.228,15.8277,23967,0,378,23589
2/27/22,Congo (Brazzaville),-0.228,15.8277,23967,0,378,23589
2/28/22,Congo (Brazzaville),-0.228,15.8277,24020,0,378,23642
3/1/22,Congo (Brazzaville),-0.228,15.8277,24020,0,378,23642
3/2/22,Congo (Brazzaville),-0.228,15.8277,24020,0,378,23642
3/3/22,Congo (Brazzaville),-0.228,15.8277,24020,0,378,23642
3/4/22,Congo (Brazzaville),-0.228,15.8277,24020,0,378,23642
3/5/22,Congo (Brazzaville),-0.228,15.8277,24020,0,378,23642
3/6/22,Congo (Brazzaville),-0.228,15.8277,24020,0,378,23642
3/7/22,Congo (Brazzaville),-0.228,15.8277,24020,0,378,23642
3/8/22,Congo (Brazzaville),-0.228,15.8277,24020,0,378,23642
3/9/22,Congo (Brazzaville),-0.228,15.8277,24041,0,378,23663
3/10/22,Congo (Brazzaville),-0.228,15.8277,24041,0,378,23663
3/11/22,Congo (Brazzaville),-0.228,15.8277,24049,0,378,23671
3/12/22,Congo (Brazzaville),-0.228,15.8277,24049,0,378,23671
3/13/22,Congo (Brazzaville),-0.228,15.8277,24049,0,378,23671
3/14/22,Congo (Brazzaville),-0.228,15.8277,24049,0,378,23671
3/15/22,Congo (Brazzaville),-0.228,15.8277,24049,0,378,23671
3/16/22,Congo (Brazzaville),-0.228,15.8277,24049,0,378,23671
3/17/22,Congo (Brazzaville),-0.228,15.8277,24049,0,378,23671
3/18/22,Congo (Brazzaville),-0.228,15.8277,24059,0,383,23676
3/19/22,Congo (Brazzaville),-0.228,15.8277,24059,0,383,23676
3/20/22,Congo (Brazzaville),-0.228,15.8277,24059,0,383,23676
3/21/22,Congo (Brazzaville),-0.228,15.8277,24062,0,384,23678
3/22/22,Congo (Brazzaville),-0.228,15.8277,24062,0,384,23678
3/23/22,Congo (Brazzaville),-0.228,15.8277,24062,0,384,23678
3/24/22,Congo (Brazzaville),-0.228,15.8277,24062,0,384,23678
3/25/22,Congo (Brazzaville),-0.228,15.8277,24062,0,384,23678
3/26/22,Congo (Brazzaville),-0.228,15.8277,24062,0,384,23678
3/27/22,Congo (Brazzaville),-0.228,15.8277,24062,0,384,23678
3/28/22,Congo (Brazzaville),-0.228,15.8277,24069,0,384,23685
3/29/22,Congo (Brazzaville),-0.228,15.8277,24069,0,384,23685
3/30/22,Congo (Brazzaville),-0.228,15.8277,24069,0,384,23685
3/31/22,Congo (Brazzaville),-0.228,15.8277,24071,0,385,23686
4/1/22,Congo (Brazzaville),-0.228,15.8277,24071,0,385,23686
4/2/22,Congo (Brazzaville),-0.228,15.8277,24071,0,385,23686
4/3/22,Congo (Brazzaville),-0.228,15.8277,24071,0,385,23686
4/4/22,Congo (Brazzaville),-0.228,15.8277,24071,0,385,23686
4/5/22,Congo (Brazzaville),-0.228,15.8277,24079,0,385,23694
4/6/22,Congo (Brazzaville),-0.228,15.8277,24079,0,385,23694
4/7/22,Congo (Brazzaville),-0.228,15.8277,24079,0,385,23694
4/8/22,Congo (Brazzaville),-0.228,15.8277,24079,0,385,23694
4/9/22,Congo (Brazzaville),-0.228,15.8277,24079,0,385,23694
4/10/22,Congo (Brazzaville),-0.228,15.8277,24079,0,385,23694
4/11/22,Congo (Brazzaville),-0.228,15.8277,24079,0,385,23694
4/12/22,Congo (Brazzaville),-0.228,15.8277,24079,0,385,23694
4/13/22,Congo (Brazzaville),-0.228,15.8277,24079,0,385,23694
4/14/22,Congo (Brazzaville),-0.228,15.8277,24079,0,385,23694
4/15/22,Congo (Brazzaville),-0.228,15.8277,24079,0,385,23694
4/16/22,Congo (Brazzaville),-0.228,15.8277,24079,0,385,23694
4/17/22,Congo (Brazzaville),-0.228,15.8277,24079,0,385,23694
4/18/22,Congo (Brazzaville),-0.228,15.8277,24079,0,385,23694
4/19/22,Congo (Brazzaville),-0.228,15.8277,24079,0,385,23694
4/20/22,Congo (Brazzaville),-0.228,15.8277,24079,0,385,23694
4/21/22,Congo (Brazzaville),-0.228,15.8277,24079,0,385,23694
4/22/22,Congo (Brazzaville),-0.228,15.8277,24079,0,385,23694
4/23/22,Congo (Brazzaville),-0.228,15.8277,24079,0,385,23694
4/24/22,Congo (Brazzaville),-0.228,15.8277,24079,0,385,23694
4/25/22,Congo (Brazzaville),-0.228,15.8277,24079,0,385,23694
4/26/22,Congo (Brazzaville),-0.228,15.8277,24079,0,385,23694
4/27/22,Congo (Brazzaville),-0.228,15.8277,24079,0,385,23694
4/28/22,Congo (Brazzaville),-0.228,15.8277,24079,0,385,23694
4/29/22,Congo (Brazzaville),-0.228,15.8277,24079,0,385,23694
4/30/22,Congo (Brazzaville),-0.228,15.8277,24079,0,385,23694
5/1/22,Congo (Brazzaville),-0.228,15.8277,24079,0,385,23694
5/2/22,Congo (Brazzaville),-0.228,15.8277,24079,0,385,23694
5/3/22,Congo (Brazzaville),-0.228,15.8277,24079,0,385,23694
5/4/22,Congo (Brazzaville),-0.228,15.8277,24079,0,385,23694
5/5/22,Congo (Brazzaville),-0.228,15.8277,24079,0,385,23694
5/6/22,Congo (Brazzaville),-0.228,15.8277,24079,0,385,23694
5/7/22,Congo (Brazzaville),-0.228,15.8277,24079,0,385,23694
5/8/22,Congo (Brazzaville),-0.228,15.8277,24079,0,385,23694
5/9/22,Congo (Brazzaville),-0.228,15.8277,24079,0,385,23694
5/10/22,Congo (Brazzaville),-0.228,15.8277,24079,0,385,23694
5/11/22,Congo (Brazzaville),-0.228,15.8277,24079,0,385,23694
5/12/22,Congo (Brazzaville),-0.228,15.8277,24079,0,385,23694
5/13/22,Congo (Brazzaville),-0.228,15.8277,24079,0,385,23694
5/14/22,Congo (Brazzaville),-0.228,15.8277,24079,0,385,23694
5/15/22,Congo (Brazzaville),-0.228,15.8277,24079,0,385,23694
5/16/22,Congo (Brazzaville),-0.228,15.8277,24079,0,385,23694
5/17/22,Congo (Brazzaville),-0.228,15.8277,24079,0,385,23694
5/18/22,Congo (Brazzaville),-0.228,15.8277,24079,0,385,23694
5/19/22,Congo (Brazzaville),-0.228,15.8277,24079,0,385,23694
5/20/22,Congo (Brazzaville),-0.228,15.8277,24079,0,385,23694
5/21/22,Congo (Brazzaville),-0.228,15.8277,24079,0,385,23694
5/22/22,Congo (Brazzaville),-0.228,15.8277,24079,0,385,23694
5/23/22,Congo (Brazzaville),-0.228,15.8277,24079,0,385,23694
5/24/22,Congo (Brazzaville),-0.228,15.8277,24079,0,385,23694
5/25/22,Congo (Brazzaville),-0.228,15.8277,24079,0,385,23694
5/26/22,Congo (Brazzaville),-0.228,15.8277,24079,0,385,23694
5/27/22,Congo (Brazzaville),-0.228,15.8277,24079,0,385,23694
5/28/22,Congo (Brazzaville),-0.228,15.8277,24079,0,385,23694
5/29/22,Congo (Brazzaville),-0.228,15.8277,24079,0,385,23694
5/30/22,Congo (Brazzaville),-0.228,15.8277,24079,0,385,23694
5/31/22,Congo (Brazzaville),-0.228,15.8277,24079,0,385,23694
6/1/22,Congo (Brazzaville),-0.228,15.8277,24079,0,385,23694
6/2/22,Congo (Brazzaville),-0.228,15.8277,24128,0,385,23743
6/3/22,Congo (Brazzaville),-0.228,15.8277,24128,0,385,23743
6/4/22,Congo (Brazzaville),-0.228,15.8277,24128,0,385,23743
6/5/22,Congo (Brazzaville),-0.228,15.8277,24128,0,385,23743
6/6/22,Congo (Brazzaville),-0.228,15.8277,24128,0,385,23743
6/7/22,Congo (Brazzaville),-0.228,15.8277,24128,0,385,23743
6/8/22,Congo (Brazzaville),-0.228,15.8277,24128,0,385,23743
6/9/22,Congo (Brazzaville),-0.228,15.8277,24128,0,385,23743
6/10/22,Congo (Brazzaville),-0.228,15.8277,24128,0,385,23743
6/11/22,Congo (Brazzaville),-0.228,15.8277,24128,0,385,23743
6/12/22,Congo (Brazzaville),-0.228,15.8277,24128,0,385,23743
6/13/22,Congo (Brazzaville),-0.228,15.8277,24128,0,385,23743
6/14/22,Congo (Brazzaville),-0.228,15.8277,24128,0,385,23743
6/15/22,Congo (Brazzaville),-0.228,15.8277,24128,0,385,23743
6/16/22,Congo (Brazzaville),-0.228,15.8277,24128,0,385,23743
6/17/22,Congo (Brazzaville),-0.228,15.8277,24128,0,385,23743
6/18/22,Congo (Brazzaville),-0.228,15.8277,24128,0,385,23743
6/19/22,Congo (Brazzaville),-0.228,15.8277,24128,0,385,23743
6/20/22,Congo (Brazzaville),-0.228,15.8277,24128,0,385,23743
6/21/22,Congo (Brazzaville),-0.228,15.8277,24128,0,385,23743
6/22/22,Congo (Brazzaville),-0.228,15.8277,24128,0,385,23743
6/23/22,Congo (Brazzaville),-0.228,15.8277,24128,0,385,23743
6/24/22,Congo (Brazzaville),-0.228,15.8277,24128,0,385,23743
6/25/22,Congo (Brazzaville),-0.228,15.8277,24128,0,385,23743
6/26/22,Congo (Brazzaville),-0.228,15.8277,24128,0,385,23743
6/27/22,Congo (Brazzaville),-0.228,15.8277,24128,0,385,23743
6/28/22,Congo (Brazzaville),-0.228,15.8277,24128,0,385,23743
6/29/22,Congo (Brazzaville),-0.228,15.8277,24128,0,385,23743
6/30/22,Congo (Brazzaville),-0.228,15.8277,24128,0,385,23743
7/1/22,Congo (Brazzaville),-0.228,15.8277,24128,0,385,23743
7/2/22,Congo (Brazzaville),-0.228,15.8277,24128,0,385,23743
7/3/22,Congo (Brazzaville),-0.228,15.8277,24128,0,385,23743
7/4/22,Congo (Brazzaville),-0.228,15.8277,24128,0,385,23743
7/5/22,Congo (Brazzaville),-0.228,15.8277,24128,0,385,23743
7/6/22,Congo (Brazzaville),-0.228,15.8277,24128,0,385,23743
7/7/22,Congo (Brazzaville),-0.228,15.8277,24421,0,386,24035
7/8/22,Congo (Brazzaville),-0.228,15.8277,24421,0,386,24035
7/9/22,Congo (Brazzaville),-0.228,15.8277,24421,0,386,24035
7/10/22,Congo (Brazzaville),-0.228,15.8277,24421,0,386,24035
7/11/22,Congo (Brazzaville),-0.228,15.8277,24421,0,386,24035
7/12/22,Congo (Brazzaville),-0.228,15.8277,24421,0,386,24035
7/13/22,Congo (Brazzaville),-0.228,15.8277,24421,0,386,24035
7/14/22,Congo (Brazzaville),-0.228,15.8277,24421,0,386,24035
7/15/22,Congo (Brazzaville),-0.228,15.8277,24604,0,386,24218
7/16/22,Congo (Brazzaville),-0.228,15.8277,24604,0,386,24218
7/17/22,Congo (Brazzaville),-0.228,15.8277,24604,0,386,24218
7/18/22,Congo (Brazzaville),-0.228,15.8277,24604,0,386,24218
7/19/22,Congo (Brazzaville),-0.228,15.8277,24604,0,386,24218
7/20/22,Congo (Brazzaville),-0.228,15.8277,24604,0,386,24218
7/21/22,Congo (Brazzaville),-0.228,15.8277,24604,0,386,24218
7/22/22,Congo (Brazzaville),-0.228,15.8277,24604,0,386,24218
7/23/22,Congo (Brazzaville),-0.228,15.8277,24604,0,386,24218
7/24/22,Congo (Brazzaville),-0.228,15.8277,24604,0,386,24218
7/25/22,Congo (Brazzaville),-0.228,15.8277,24604,0,386,24218
7/26/22,Congo (Brazzaville),-0.228,15.8277,24604,0,386,24218
7/27/22,Congo (Brazzaville),-0.228,15.8277,24604,0,386,24218
7/28/22,Congo (Brazzaville),-0.228,15.8277,24604,0,386,24218
7/29/22,Congo (Brazzaville),-0.228,15.8277,24775,0,386,24389
7/30/22,Congo (Brazzaville),-0.228,15.8277,24775,0,386,24389
7/31/22,Congo (Brazzaville),-0.228,15.8277,24775,0,386,24389
8/1/22,Congo (Brazzaville),-0.228,15.8277,24775,0,386,24389
8/2/22,Congo (Brazzaville),-0.228,15.8277,24775,0,386,24389
8/3/22,Congo (Brazzaville),-0.228,15.8277,24775,0,386,24389
8/4/22,Congo (Brazzaville),-0.228,15.8277,24775,0,386,24389
8/5/22,Congo (Brazzaville),-0.228,15.8277,24775,0,386,24389
8/6/22,Congo (Brazzaville),-0.228,15.8277,24775,0,386,24389
8/7/22,Congo (Brazzaville),-0.228,15.8277,24775,0,386,24389
8/8/22,Congo (Brazzaville),-0.228,15.8277,24775,0,386,24389
8/9/22,Congo (Brazzaville),-0.228,15.8277,24775,0,386,24389
8/10/22,Congo (Brazzaville),-0.228,15.8277,24775,0,386,24389
8/11/22,Congo (Brazzaville),-0.228,15.8277,24837,0,386,24451
8/12/22,Congo (Brazzaville),-0.228,15.8277,24837,0,386,24451
8/13/22,Congo (Brazzaville),-0.228,15.8277,24837,0,386,24451
8/14/22,Congo (Brazzaville),-0.228,15.8277,24837,0,386,24451
8/15/22,Congo (Brazzaville),-0.228,15.8277,24837,0,386,24451
8/16/22,Congo (Brazzaville),-0.228,15.8277,24837,0,386,24451
8/17/22,Congo (Brazzaville),-0.228,15.8277,24837,0,386,24451
8/18/22,Congo (Brazzaville),-0.228,15.8277,24837,0,386,24451
8/19/22,Congo (Brazzaville),-0.228,15.8277,24837,0,386,24451
8/20/22,Congo (Brazzaville),-0.228,15.8277,24837,0,386,24451
8/21/22,Congo (Brazzaville),-0.228,15.8277,24837,0,386,24451
8/22/22,Congo (Brazzaville),-0.228,15.8277,24837,0,386,24451
8/23/22,Congo (Brazzaville),-0.228,15.8277,24837,0,386,24451
8/24/22,Congo (Brazzaville),-0.228,15.8277,24837,0,386,24451
8/25/22,Congo (Brazzaville),-0.228,15.8277,24837,0,386,24451
8/26/22,Congo (Brazzaville),-0.228,15.8277,24837,0,386,24451
8/27/22,Congo (Brazzaville),-0.228,15.8277,24837,0,386,24451
8/28/22,Congo (Brazzaville),-0.228,15.8277,24837,0,386,24451
8/29/22,Congo (Brazzaville),-0.228,15.8277,24837,0,386,24451
8/30/22,Congo (Brazzaville),-0.228,15.8277,24837,0,386,24451
8/31/22,Congo (Brazzaville),-0.228,15.8277,24837,0,386,24451
9/1/22,Congo (Brazzaville),-0.228,15.8277,24837,0,386,24451
9/2/22,Congo (Brazzaville),-0.228,15.8277,24837,0,386,24451
9/3/22,Congo (Brazzaville),-0.228,15.8277,24837,0,386,24451
9/4/22,Congo (Brazzaville),-0.228,15.8277,24837,0,386,24451
9/5/22,Congo (Brazzaville),-0.228,15.8277,24837,0,386,24451
9/6/22,Congo (Brazzaville),-0.228,15.8277,24837,0,386,24451
9/7/22,Congo (Brazzaville),-0.228,15.8277,24837,0,386,24451
9/8/22,Congo (Brazzaville),-0.228,15.8277,24837,0,386,24451
9/9/22,Congo (Brazzaville),-0.228,15.8277,24837,0,386,24451
9/10/22,Congo (Brazzaville),-0.228,15.8277,24837,0,386,24451
9/11/22,Congo (Brazzaville),-0.228,15.8277,24837,0,386,24451
9/12/22,Congo (Brazzaville),-0.228,15.8277,24837,0,386,24451
9/13/22,Congo (Brazzaville),-0.228,15.8277,24837,0,386,24451
9/14/22,Congo (Brazzaville),-0.228,15.8277,24837,0,386,24451
9/15/22,Congo (Brazzaville),-0.228,15.8277,24837,0,386,24451
9/16/22,Congo (Brazzaville),-0.228,15.8277,24837,0,386,24451
9/17/22,Congo (Brazzaville),-0.228,15.8277,24837,0,386,24451
9/18/22,Congo (Brazzaville),-0.228,15.8277,24837,0,386,24451
9/19/22,Congo (Brazzaville),-0.228,15.8277,24837,0,386,24451
9/20/22,Congo (Brazzaville),-0.228,15.8277,24837,0,386,24451
9/21/22,Congo (Brazzaville),-0.228,15.8277,24837,0,386,24451
9/22/22,Congo (Brazzaville),-0.228,15.8277,24837,0,386,24451
9/23/22,Congo (Brazzaville),-0.228,15.8277,24837,0,386,24451
9/24/22,Congo (Brazzaville),-0.228,15.8277,24837,0,386,24451
9/25/22,Congo (Brazzaville),-0.228,15.8277,24837,0,386,24451
9/26/22,Congo (Brazzaville),-0.228,15.8277,24837,0,386,24451
9/27/22,Congo (Brazzaville),-0.228,15.8277,24837,0,386,24451
9/28/22,Congo (Brazzaville),-0.228,15.8277,24837,0,386,24451
9/29/22,Congo (Brazzaville),-0.228,15.8277,24837,0,386,24451
9/30/22,Congo (Brazzaville),-0.228,15.8277,24837,0,386,24451
10/1/22,Congo (Brazzaville),-0.228,15.8277,24837,0,386,24451
10/2/22,Congo (Brazzaville),-0.228,15.8277,24837,0,386,24451
10/3/22,Congo (Brazzaville),-0.228,15.8277,24837,0,386,24451
10/4/22,Congo (Brazzaville),-0.228,15.8277,24837,0,386,24451
10/5/22,Congo (Brazzaville),-0.228,15.8277,24837,0,386,24451
10/6/22,Congo (Brazzaville),-0.228,15.8277,24837,0,386,24451
10/7/22,Congo (Brazzaville),-0.228,15.8277,24837,0,386,24451
10/8/22,Congo (Brazzaville),-0.228,15.8277,24837,0,386,24451
10/9/22,Congo (Brazzaville),-0.228,15.8277,24837,0,386,24451
10/10/22,Congo (Brazzaville),-0.228,15.8277,24837,0,386,24451
10/11/22,Congo (Brazzaville),-0.228,15.8277,24837,0,386,24451
10/12/22,Congo (Brazzaville),-0.228,15.8277,24837,0,386,24451
10/13/22,Congo (Brazzaville),-0.228,15.8277,24837,0,386,24451
10/14/22,Congo (Brazzaville),-0.228,15.8277,24837,0,386,24451
10/15/22,Congo (Brazzaville),-0.228,15.8277,24837,0,386,24451
10/16/22,Congo (Brazzaville),-0.228,15.8277,24837,0,386,24451
10/17/22,Congo (Brazzaville),-0.228,15.8277,24837,0,386,24451
10/18/22,Congo (Brazzaville),-0.228,15.8277,24837,0,386,24451
10/19/22,Congo (Brazzaville),-0.228,15.8277,24837,0,386,24451
10/20/22,Congo (Brazzaville),-0.228,15.8277,24837,0,386,24451
10/21/22,Congo (Brazzaville),-0.228,15.8277,24837,0,386,24451
10/22/22,Congo (Brazzaville),-0.228,15.8277,24837,0,386,24451
10/23/22,Congo (Brazzaville),-0.228,15.8277,24837,0,386,24451
10/24/22,Congo (Brazzaville),-0.228,15.8277,24837,0,386,24451
10/25/22,Congo (Brazzaville),-0.228,15.8277,24837,0,386,24451
10/26/22,Congo (Brazzaville),-0.228,15.8277,24837,0,386,24451
10/27/22,Congo (Brazzaville),-0.228,15.8277,24837,0,386,24451
10/28/22,Congo (Brazzaville),-0.228,15.8277,24837,0,386,24451
10/29/22,Congo (Brazzaville),-0.228,15.8277,24837,0,386,24451
10/30/22,Congo (Brazzaville),-0.228,15.8277,24837,0,386,24451
10/31/22,Congo (Brazzaville),-0.228,15.8277,24837,0,386,24451
11/1/22,Congo (Brazzaville),-0.228,15.8277,24837,0,386,24451
11/2/22,Congo (Brazzaville),-0.228,15.8277,24837,0,386,24451
11/3/22,Congo (Brazzaville),-0.228,15.8277,24837,0,386,24451
11/4/22,Congo (Brazzaville),-0.228,15.8277,24837,0,386,24451
11/5/22,Congo (Brazzaville),-0.228,15.8277,24837,0,386,24451
11/6/22,Congo (Brazzaville),-0.228,15.8277,24837,0,386,24451
11/7/22,Congo (Brazzaville),-0.228,15.8277,24837,0,386,24451
11/8/22,Congo (Brazzaville),-0.228,15.8277,24837,0,386,24451
11/9/22,Congo (Brazzaville),-0.228,15.8277,24837,0,386,24451
11/10/22,Congo (Brazzaville),-0.228,15.8277,24837,0,386,24451
11/11/22,Congo (Brazzaville),-0.228,15.8277,24837,0,386,24451
11/12/22,Congo (Brazzaville),-0.228,15.8277,24837,0,386,24451
11/13/22,Congo (Brazzaville),-0.228,15.8277,24837,0,386,24451
11/14/22,Congo (Brazzaville),-0.228,15.8277,24837,0,386,24451
11/15/22,Congo (Brazzaville),-0.228,15.8277,24837,0,386,24451
11/16/22,Congo (Brazzaville),-0.228,15.8277,25074,0,386,24688
11/17/22,Congo (Brazzaville),-0.228,15.8277,25375,0,386,24989
11/18/22,Congo (Brazzaville),-0.228,15.8277,25375,0,386,24989
11/19/22,Congo (Brazzaville),-0.228,15.8277,25375,0,386,24989
11/20/22,Congo (Brazzaville),-0.228,15.8277,25375,0,386,24989
11/21/22,Congo (Brazzaville),-0.228,15.8277,25375,0,386,24989
11/22/22,Congo (Brazzaville),-0.228,15.8277,25375,0,386,24989
11/23/22,Congo (Brazzaville),-0.228,15.8277,25375,0,386,24989
11/24/22,Congo (Brazzaville),-0.228,15.8277,25375,0,386,24989
11/25/22,Congo (Brazzaville),-0.228,15.8277,25375,0,386,24989
11/26/22,Congo (Brazzaville),-0.228,15.8277,25375,0,386,24989
11/27/22,Congo (Brazzaville),-0.228,15.8277,25375,0,386,24989
11/28/22,Congo (Brazzaville),-0.228,15.8277,25375,0,386,24989
11/29/22,Congo (Brazzaville),-0.228,15.8277,25375,0,386,24989
11/30/22,Congo (Brazzaville),-0.228,15.8277,25375,0,386,24989
12/1/22,Congo (Brazzaville),-0.228,15.8277,25375,0,386,24989
12/2/22,Congo (Brazzaville),-0.228,15.8277,25375,0,386,24989
12/3/22,Congo (Brazzaville),-0.228,15.8277,25375,0,386,24989
12/4/22,Congo (Brazzaville),-0.228,15.8277,25375,0,386,24989
12/5/22,Congo (Brazzaville),-0.228,15.8277,25375,0,386,24989
12/6/22,Congo (Brazzaville),-0.228,15.8277,25375,0,386,24989
12/7/22,Congo (Brazzaville),-0.228,15.8277,25375,0,386,24989
12/8/22,Congo (Brazzaville),-0.228,15.8277,25375,0,386,24989
12/9/22,Congo (Brazzaville),-0.228,15.8277,25375,0,386,24989
12/10/22,Congo (Brazzaville),-0.228,15.8277,25375,0,386,24989
12/11/22,Congo (Brazzaville),-0.228,15.8277,25375,0,386,24989
12/12/22,Congo (Brazzaville),-0.228,15.8277,25375,0,386,24989
12/13/22,Congo (Brazzaville),-0.228,15.8277,25375,0,386,24989
12/14/22,Congo (Brazzaville),-0.228,15.8277,25375,0,386,24989
12/15/22,Congo (Brazzaville),-0.228,15.8277,25375,0,386,24989
12/16/22,Congo (Brazzaville),-0.228,15.8277,25375,0,386,24989
12/17/22,Congo (Brazzaville),-0.228,15.8277,25375,0,386,24989
1/1/22,Congo (Kinshasa),-4.0383,21.7587,74793,0,1205,73588
1/2/22,Congo (Kinshasa),-4.0383,21.7587,74793,0,1205,73588
1/3/22,Congo (Kinshasa),-4.0383,21.7587,74793,0,1205,73588
1/4/22,Congo (Kinshasa),-4.0383,21.7587,79274,0,1225,78049
1/5/22,Congo (Kinshasa),-4.0383,21.7587,79942,0,1225,78717
1/6/22,Congo (Kinshasa),-4.0383,21.7587,80175,0,1225,78950
1/7/22,Congo (Kinshasa),-4.0383,21.7587,80175,0,1225,78950
1/8/22,Congo (Kinshasa),-4.0383,21.7587,80175,0,1225,78950
1/9/22,Congo (Kinshasa),-4.0383,21.7587,80175,0,1225,78950
1/10/22,Congo (Kinshasa),-4.0383,21.7587,80998,0,1225,79773
1/11/22,Congo (Kinshasa),-4.0383,21.7587,81719,0,1225,80494
1/12/22,Congo (Kinshasa),-4.0383,21.7587,81719,0,1225,80494
1/13/22,Congo (Kinshasa),-4.0383,21.7587,81719,0,1225,80494
1/14/22,Congo (Kinshasa),-4.0383,21.7587,82306,0,1225,81081
1/15/22,Congo (Kinshasa),-4.0383,21.7587,82306,0,1225,81081
1/16/22,Congo (Kinshasa),-4.0383,21.7587,82306,0,1225,81081
1/17/22,Congo (Kinshasa),-4.0383,21.7587,82984,0,1278,81706
1/18/22,Congo (Kinshasa),-4.0383,21.7587,82984,0,1278,81706
1/19/22,Congo (Kinshasa),-4.0383,21.7587,82984,0,1278,81706
1/20/22,Congo (Kinshasa),-4.0383,21.7587,84198,0,1278,82920
1/21/22,Congo (Kinshasa),-4.0383,21.7587,84283,0,1278,83005
1/22/22,Congo (Kinshasa),-4.0383,21.7587,84283,0,1278,83005
1/23/22,Congo (Kinshasa),-4.0383,21.7587,84283,0,1278,83005
1/24/22,Congo (Kinshasa),-4.0383,21.7587,84519,0,1278,83241
1/25/22,Congo (Kinshasa),-4.0383,21.7587,84760,0,1278,83482
1/26/22,Congo (Kinshasa),-4.0383,21.7587,84877,0,1278,83599
1/27/22,Congo (Kinshasa),-4.0383,21.7587,84926,0,1278,83648
1/28/22,Congo (Kinshasa),-4.0383,21.7587,84998,0,1278,83720
1/29/22,Congo (Kinshasa),-4.0383,21.7587,84998,0,1278,83720
1/30/22,Congo (Kinshasa),-4.0383,21.7587,84998,0,1278,83720
1/31/22,Congo (Kinshasa),-4.0383,21.7587,85379,0,1278,84101
2/1/22,Congo (Kinshasa),-4.0383,21.7587,85379,0,1278,84101
2/2/22,Congo (Kinshasa),-4.0383,21.7587,85510,0,1278,84232
2/3/22,Congo (Kinshasa),-4.0383,21.7587,85510,0,1278,84232
2/4/22,Congo (Kinshasa),-4.0383,21.7587,85510,0,1278,84232
2/5/22,Congo (Kinshasa),-4.0383,21.7587,85510,0,1278,84232
2/6/22,Congo (Kinshasa),-4.0383,21.7587,85510,0,1278,84232
2/7/22,Congo (Kinshasa),-4.0383,21.7587,85686,0,1316,84370
2/8/22,Congo (Kinshasa),-4.0383,21.7587,85686,0,1316,84370
2/9/22,Congo (Kinshasa),-4.0383,21.7587,85708,0,1316,84392
2/10/22,Congo (Kinshasa),-4.0383,21.7587,85743,0,1316,84427
2/11/22,Congo (Kinshasa),-4.0383,21.7587,85776,0,1316,84460
2/12/22,Congo (Kinshasa),-4.0383,21.7587,85776,0,1316,84460
2/13/22,Congo (Kinshasa),-4.0383,21.7587,85776,0,1316,84460
2/14/22,Congo (Kinshasa),-4.0383,21.7587,85793,0,1316,84477
2/15/22,Congo (Kinshasa),-4.0383,21.7587,85793,0,1316,84477
2/16/22,Congo (Kinshasa),-4.0383,21.7587,85822,0,1316,84506
2/17/22,Congo (Kinshasa),-4.0383,21.7587,85834,0,1316,84518
2/18/22,Congo (Kinshasa),-4.0383,21.7587,85834,0,1316,84518
2/19/22,Congo (Kinshasa),-4.0383,21.7587,85834,0,1316,84518
2/20/22,Congo (Kinshasa),-4.0383,21.7587,85834,0,1316,84518
2/21/22,Congo (Kinshasa),-4.0383,21.7587,85876,0,1335,84541
2/22/22,Congo (Kinshasa),-4.0383,21.7587,85876,0,1335,84541
2/23/22,Congo (Kinshasa),-4.0383,21.7587,85876,0,1335,84541
2/24/22,Congo (Kinshasa),-4.0383,21.7587,85938,0,1335,84603
2/25/22,Congo (Kinshasa),-4.0383,21.7587,85999,0,1335,84664
2/26/22,Congo (Kinshasa),-4.0383,21.7587,85999,0,1335,84664
2/27/22,Congo (Kinshasa),-4.0383,21.7587,85999,0,1335,84664
2/28/22,Congo (Kinshasa),-4.0383,21.7587,86018,0,1335,84683
3/1/22,Congo (Kinshasa),-4.0383,21.7587,86039,0,1335,84704
3/2/22,Congo (Kinshasa),-4.0383,21.7587,86039,0,1335,84704
3/3/22,Congo (Kinshasa),-4.0383,21.7587,86138,0,1335,84803
3/4/22,Congo (Kinshasa),-4.0383,21.7587,86154,0,1335,84819
3/5/22,Congo (Kinshasa),-4.0383,21.7587,86154,0,1335,84819
3/6/22,Congo (Kinshasa),-4.0383,21.7587,86154,0,1335,84819
3/7/22,Congo (Kinshasa),-4.0383,21.7587,86154,0,1335,84819
3/8/22,Congo (Kinshasa),-4.0383,21.7587,86154,0,1335,84819
3/9/22,Congo (Kinshasa),-4.0383,21.7587,86271,0,1335,84936
3/10/22,Congo (Kinshasa),-4.0383,21.7587,86290,0,1335,84955
3/11/22,Congo (Kinshasa),-4.0383,21.7587,86315,0,1335,84980
3/12/22,Congo (Kinshasa),-4.0383,21.7587,86315,0,1335,84980
3/13/22,Congo (Kinshasa),-4.0383,21.7587,86315,0,1335,84980
3/14/22,Congo (Kinshasa),-4.0383,21.7587,86344,0,1335,85009
3/15/22,Congo (Kinshasa),-4.0383,21.7587,86375,0,1335,85040
3/16/22,Congo (Kinshasa),-4.0383,21.7587,86426,0,1335,85091
3/17/22,Congo (Kinshasa),-4.0383,21.7587,86461,0,1335,85126
3/18/22,Congo (Kinshasa),-4.0383,21.7587,86461,0,1335,85126
3/19/22,Congo (Kinshasa),-4.0383,21.7587,86461,0,1335,85126
3/20/22,Congo (Kinshasa),-4.0383,21.7587,86461,0,1335,85126
3/21/22,Congo (Kinshasa),-4.0383,21.7587,86461,0,1335,85126
3/22/22,Congo (Kinshasa),-4.0383,21.7587,86509,0,1335,85174
3/23/22,Congo (Kinshasa),-4.0383,21.7587,86585,0,1335,85250
3/24/22,Congo (Kinshasa),-4.0383,21.7587,86598,0,1335,85263
3/25/22,Congo (Kinshasa),-4.0383,21.7587,86611,0,1335,85276
3/26/22,Congo (Kinshasa),-4.0383,21.7587,86611,0,1335,85276
3/27/22,Congo (Kinshasa),-4.0383,21.7587,86611,0,1335,85276
3/28/22,Congo (Kinshasa),-4.0383,21.7587,86628,0,1335,85293
3/29/22,Congo (Kinshasa),-4.0383,21.7587,86715,0,1337,85378
3/30/22,Congo (Kinshasa),-4.0383,21.7587,86748,0,1337,85411
3/31/22,Congo (Kinshasa),-4.0383,21.7587,86748,0,1337,85411
4/1/22,Congo (Kinshasa),-4.0383,21.7587,86748,0,1337,85411
4/2/22,Congo (Kinshasa),-4.0383,21.7587,86748,0,1337,85411
4/3/22,Congo (Kinshasa),-4.0383,21.7587,86748,0,1337,85411
4/4/22,Congo (Kinshasa),-4.0383,21.7587,86748,0,1337,85411
4/5/22,Congo (Kinshasa),-4.0383,21.7587,86748,0,1337,85411
4/6/22,Congo (Kinshasa),-4.0383,21.7587,86748,0,1337,85411
4/7/22,Congo (Kinshasa),-4.0383,21.7587,86748,0,1337,85411
4/8/22,Congo (Kinshasa),-4.0383,21.7587,86748,0,1337,85411
4/9/22,Congo (Kinshasa),-4.0383,21.7587,86748,0,1337,85411
4/10/22,Congo (Kinshasa),-4.0383,21.7587,86748,0,1337,85411
4/11/22,Congo (Kinshasa),-4.0383,21.7587,86748,0,1337,85411
4/12/22,Congo (Kinshasa),-4.0383,21.7587,86748,0,1337,85411
4/13/22,Congo (Kinshasa),-4.0383,21.7587,86748,0,1337,85411
4/14/22,Congo (Kinshasa),-4.0383,21.7587,87023,0,1337,85686
4/15/22,Congo (Kinshasa),-4.0383,21.7587,87023,0,1337,85686
4/16/22,Congo (Kinshasa),-4.0383,21.7587,87023,0,1337,85686
4/17/22,Congo (Kinshasa),-4.0383,21.7587,87023,0,1337,85686
4/18/22,Congo (Kinshasa),-4.0383,21.7587,87023,0,1337,85686
4/19/22,Congo (Kinshasa),-4.0383,21.7587,87023,0,1337,85686
4/20/22,Congo (Kinshasa),-4.0383,21.7587,87023,0,1337,85686
4/21/22,Congo (Kinshasa),-4.0383,21.7587,87023,0,1337,85686
4/22/22,Congo (Kinshasa),-4.0383,21.7587,87023,0,1337,85686
4/23/22,Congo (Kinshasa),-4.0383,21.7587,87023,0,1337,85686
4/24/22,Congo (Kinshasa),-4.0383,21.7587,87023,0,1337,85686
4/25/22,Congo (Kinshasa),-4.0383,21.7587,87023,0,1337,85686
4/26/22,Congo (Kinshasa),-4.0383,21.7587,87023,0,1337,85686
4/27/22,Congo (Kinshasa),-4.0383,21.7587,87023,0,1337,85686
4/28/22,Congo (Kinshasa),-4.0383,21.7587,87023,0,1337,85686
4/29/22,Congo (Kinshasa),-4.0383,21.7587,87023,0,1337,85686
4/30/22,Congo (Kinshasa),-4.0383,21.7587,87023,0,1337,85686
5/1/22,Congo (Kinshasa),-4.0383,21.7587,87023,0,1337,85686
5/2/22,Congo (Kinshasa),-4.0383,21.7587,87023,0,1337,85686
5/3/22,Congo (Kinshasa),-4.0383,21.7587,87023,0,1337,85686
5/4/22,Congo (Kinshasa),-4.0383,21.7587,87023,0,1337,85686
5/5/22,Congo (Kinshasa),-4.0383,21.7587,87023,0,1337,85686
5/6/22,Congo (Kinshasa),-4.0383,21.7587,87023,0,1337,85686
5/7/22,Congo (Kinshasa),-4.0383,21.7587,87023,0,1337,85686
5/8/22,Congo (Kinshasa),-4.0383,21.7587,87023,0,1337,85686
5/9/22,Congo (Kinshasa),-4.0383,21.7587,87023,0,1337,85686
5/10/22,Congo (Kinshasa),-4.0383,21.7587,87023,0,1337,85686
5/11/22,Congo (Kinshasa),-4.0383,21.7587,87023,0,1337,85686
5/12/22,Congo (Kinshasa),-4.0383,21.7587,87023,0,1337,85686
5/13/22,Congo (Kinshasa),-4.0383,21.7587,87023,0,1337,85686
5/14/22,Congo (Kinshasa),-4.0383,21.7587,87023,0,1337,85686
5/15/22,Congo (Kinshasa),-4.0383,21.7587,87023,0,1337,85686
5/16/22,Congo (Kinshasa),-4.0383,21.7587,87633,0,1338,86295
5/17/22,Congo (Kinshasa),-4.0383,21.7587,87633,0,1338,86295
5/18/22,Congo (Kinshasa),-4.0383,21.7587,87633,0,1338,86295
5/19/22,Congo (Kinshasa),-4.0383,21.7587,87633,0,1338,86295
5/20/22,Congo (Kinshasa),-4.0383,21.7587,87633,0,1338,86295
5/21/22,Congo (Kinshasa),-4.0383,21.7587,87633,0,1338,86295
5/22/22,Congo (Kinshasa),-4.0383,21.7587,87633,0,1338,86295
5/23/22,Congo (Kinshasa),-4.0383,21.7587,87633,0,1338,86295
5/24/22,Congo (Kinshasa),-4.0383,21.7587,87633,0,1338,86295
5/25/22,Congo (Kinshasa),-4.0383,21.7587,88036,0,1338,86698
5/26/22,Congo (Kinshasa),-4.0383,21.7587,88036,0,1338,86698
5/27/22,Congo (Kinshasa),-4.0383,21.7587,88036,0,1338,86698
5/28/22,Congo (Kinshasa),-4.0383,21.7587,88036,0,1338,86698
5/29/22,Congo (Kinshasa),-4.0383,21.7587,88036,0,1338,86698
5/30/22,Congo (Kinshasa),-4.0383,21.7587,88374,0,1338,87036
5/31/22,Congo (Kinshasa),-4.0383,21.7587,88374,0,1338,87036
6/1/22,Congo (Kinshasa),-4.0383,21.7587,88374,0,1338,87036
6/2/22,Congo (Kinshasa),-4.0383,21.7587,89189,0,1338,87851
6/3/22,Congo (Kinshasa),-4.0383,21.7587,89189,0,1338,87851
6/4/22,Congo (Kinshasa),-4.0383,21.7587,89189,0,1338,87851
6/5/22,Congo (Kinshasa),-4.0383,21.7587,89189,0,1338,87851
6/6/22,Congo (Kinshasa),-4.0383,21.7587,89189,0,1338,87851
6/7/22,Congo (Kinshasa),-4.0383,21.7587,89189,0,1338,87851
6/8/22,Congo (Kinshasa),-4.0383,21.7587,89189,0,1338,87851
6/9/22,Congo (Kinshasa),-4.0383,21.7587,89189,0,1338,87851
6/10/22,Congo (Kinshasa),-4.0383,21.7587,89932,0,1345,88587
6/11/22,Congo (Kinshasa),-4.0383,21.7587,89932,0,1345,88587
6/12/22,Congo (Kinshasa),-4.0383,21.7587,89932,0,1345,88587
6/13/22,Congo (Kinshasa),-4.0383,21.7587,89932,0,1345,88587
6/14/22,Congo (Kinshasa),-4.0383,21.7587,89932,0,1345,88587
6/15/22,Congo (Kinshasa),-4.0383,21.7587,89932,0,1345,88587
6/16/22,Congo (Kinshasa),-4.0383,21.7587,89932,0,1345,88587
6/17/22,Congo (Kinshasa),-4.0383,21.7587,89932,0,1345,88587
6/18/22,Congo (Kinshasa),-4.0383,21.7587,89932,0,1345,88587
6/19/22,Congo (Kinshasa),-4.0383,21.7587,89932,0,1345,88587
6/20/22,Congo (Kinshasa),-4.0383,21.7587,90561,0,1353,89208
6/21/22,Congo (Kinshasa),-4.0383,21.7587,90561,0,1353,89208
6/22/22,Congo (Kinshasa),-4.0383,21.7587,90561,0,1353,89208
6/23/22,Congo (Kinshasa),-4.0383,21.7587,91082,0,1371,89711
6/24/22,Congo (Kinshasa),-4.0383,21.7587,91082,0,1371,89711
6/25/22,Congo (Kinshasa),-4.0383,21.7587,91082,0,1371,89711
6/26/22,Congo (Kinshasa),-4.0383,21.7587,91082,0,1371,89711
6/27/22,Congo (Kinshasa),-4.0383,21.7587,91082,0,1371,89711
6/28/22,Congo (Kinshasa),-4.0383,21.7587,91082,0,1371,89711
6/29/22,Congo (Kinshasa),-4.0383,21.7587,91082,0,1371,89711
6/30/22,Congo (Kinshasa),-4.0383,21.7587,91082,0,1371,89711
7/1/22,Congo (Kinshasa),-4.0383,21.7587,91393,0,1375,90018
7/2/22,Congo (Kinshasa),-4.0383,21.7587,91393,0,1375,90018
7/3/22,Congo (Kinshasa),-4.0383,21.7587,91393,0,1375,90018
7/4/22,Congo (Kinshasa),-4.0383,21.7587,91393,0,1375,90018
7/5/22,Congo (Kinshasa),-4.0383,21.7587,91393,0,1375,90018
7/6/22,Congo (Kinshasa),-4.0383,21.7587,91393,0,1375,90018
7/7/22,Congo (Kinshasa),-4.0383,21.7587,91393,0,1375,90018
7/8/22,Congo (Kinshasa),-4.0383,21.7587,91393,0,1375,90018
7/9/22,Congo (Kinshasa),-4.0383,21.7587,91393,0,1375,90018
7/10/22,Congo (Kinshasa),-4.0383,21.7587,91393,0,1375,90018
7/11/22,Congo (Kinshasa),-4.0383,21.7587,91737,0,1376,90361
7/12/22,Congo (Kinshasa),-4.0383,21.7587,91737,0,1376,90361
7/13/22,Congo (Kinshasa),-4.0383,21.7587,91737,0,1376,90361
7/14/22,Congo (Kinshasa),-4.0383,21.7587,91737,0,1376,90361
7/15/22,Congo (Kinshasa),-4.0383,21.7587,91737,0,1376,90361
7/16/22,Congo (Kinshasa),-4.0383,21.7587,91737,0,1376,90361
7/17/22,Congo (Kinshasa),-4.0383,21.7587,91737,0,1376,90361
7/18/22,Congo (Kinshasa),-4.0383,21.7587,91737,0,1376,90361
7/19/22,Congo (Kinshasa),-4.0383,21.7587,91928,0,1390,90538
7/20/22,Congo (Kinshasa),-4.0383,21.7587,91928,0,1390,90538
7/21/22,Congo (Kinshasa),-4.0383,21.7587,91928,0,1390,90538
7/22/22,Congo (Kinshasa),-4.0383,21.7587,91928,0,1390,90538
7/23/22,Congo (Kinshasa),-4.0383,21.7587,91928,0,1390,90538
7/24/22,Congo (Kinshasa),-4.0383,21.7587,91928,0,1390,90538
7/25/22,Congo (Kinshasa),-4.0383,21.7587,91928,0,1390,90538
7/26/22,Congo (Kinshasa),-4.0383,21.7587,92173,0,1390,90783
7/27/22,Congo (Kinshasa),-4.0383,21.7587,92173,0,1390,90783
7/28/22,Congo (Kinshasa),-4.0383,21.7587,92173,0,1390,90783
7/29/22,Congo (Kinshasa),-4.0383,21.7587,92173,0,1390,90783
7/30/22,Congo (Kinshasa),-4.0383,21.7587,92173,0,1390,90783
7/31/22,Congo (Kinshasa),-4.0383,21.7587,92173,0,1390,90783
8/1/22,Congo (Kinshasa),-4.0383,21.7587,92173,0,1390,90783
8/2/22,Congo (Kinshasa),-4.0383,21.7587,92173,0,1390,90783
8/3/22,Congo (Kinshasa),-4.0383,21.7587,92173,0,1390,90783
8/4/22,Congo (Kinshasa),-4.0383,21.7587,92173,0,1390,90783
8/5/22,Congo (Kinshasa),-4.0383,21.7587,92173,0,1390,90783
8/6/22,Congo (Kinshasa),-4.0383,21.7587,92173,0,1390,90783
8/7/22,Congo (Kinshasa),-4.0383,21.7587,92173,0,1390,90783
8/8/22,Congo (Kinshasa),-4.0383,21.7587,92456,0,1391,91065
8/9/22,Congo (Kinshasa),-4.0383,21.7587,92456,0,1391,91065
8/10/22,Congo (Kinshasa),-4.0383,21.7587,92456,0,1391,91065
8/11/22,Congo (Kinshasa),-4.0383,21.7587,92456,0,1391,91065
8/12/22,Congo (Kinshasa),-4.0383,21.7587,92456,0,1391,91065
8/13/22,Congo (Kinshasa),-4.0383,21.7587,92456,0,1391,91065
8/14/22,Congo (Kinshasa),-4.0383,21.7587,92456,0,1391,91065
8/15/22,Congo (Kinshasa),-4.0383,21.7587,92457,0,1391,91066
8/16/22,Congo (Kinshasa),-4.0383,21.7587,92543,0,1393,91150
8/17/22,Congo (Kinshasa),-4.0383,21.7587,92543,0,1393,91150
8/18/22,Congo (Kinshasa),-4.0383,21.7587,92543,0,1393,91150
8/19/22,Congo (Kinshasa),-4.0383,21.7587,92543,0,1393,91150
8/20/22,Congo (Kinshasa),-4.0383,21.7587,92543,0,1393,91150
8/21/22,Congo (Kinshasa),-4.0383,21.7587,92543,0,1393,91150
8/22/22,Congo (Kinshasa),-4.0383,21.7587,92588,0,1396,91192
8/23/22,Congo (Kinshasa),-4.0383,21.7587,92588,0,1396,91192
8/24/22,Congo (Kinshasa),-4.0383,21.7587,92588,0,1396,91192
8/25/22,Congo (Kinshasa),-4.0383,21.7587,92588,0,1396,91192
8/26/22,Congo (Kinshasa),-4.0383,21.7587,92634,0,1400,91234
8/27/22,Congo (Kinshasa),-4.0383,21.7587,92634,0,1400,91234
8/28/22,Congo (Kinshasa),-4.0383,21.7587,92634,0,1400,91234
8/29/22,Congo (Kinshasa),-4.0383,21.7587,92634,0,1400,91234
8/30/22,Congo (Kinshasa),-4.0383,21.7587,92634,0,1400,91234
8/31/22,Congo (Kinshasa),-4.0383,21.7587,92634,0,1400,91234
9/1/22,Congo (Kinshasa),-4.0383,21.7587,92711,0,1405,91306
9/2/22,Congo (Kinshasa),-4.0383,21.7587,92711,0,1405,91306
9/3/22,Congo (Kinshasa),-4.0383,21.7587,92711,0,1405,91306
9/4/22,Congo (Kinshasa),-4.0383,21.7587,92711,0,1405,91306
9/5/22,Congo (Kinshasa),-4.0383,21.7587,92711,0,1405,91306
9/6/22,Congo (Kinshasa),-4.0383,21.7587,92711,0,1405,91306
9/7/22,Congo (Kinshasa),-4.0383,21.7587,92711,0,1405,91306
9/8/22,Congo (Kinshasa),-4.0383,21.7587,92711,0,1405,91306
9/9/22,Congo (Kinshasa),-4.0383,21.7587,92751,0,1422,91329
9/10/22,Congo (Kinshasa),-4.0383,21.7587,92751,0,1422,91329
9/11/22,Congo (Kinshasa),-4.0383,21.7587,92751,0,1422,91329
9/12/22,Congo (Kinshasa),-4.0383,21.7587,92751,0,1422,91329
9/13/22,Congo (Kinshasa),-4.0383,21.7587,92751,0,1422,91329
9/14/22,Congo (Kinshasa),-4.0383,21.7587,92751,0,1422,91329
9/15/22,Congo (Kinshasa),-4.0383,21.7587,92751,0,1422,91329
9/16/22,Congo (Kinshasa),-4.0383,21.7587,92751,0,1422,91329
9/17/22,Congo (Kinshasa),-4.0383,21.7587,92751,0,1422,91329
9/18/22,Congo (Kinshasa),-4.0383,21.7587,92751,0,1422,91329
9/19/22,Congo (Kinshasa),-4.0383,21.7587,92809,0,1441,91368
9/20/22,Congo (Kinshasa),-4.0383,21.7587,92809,0,1442,91367
9/21/22,Congo (Kinshasa),-4.0383,21.7587,92809,0,1442,91367
9/22/22,Congo (Kinshasa),-4.0383,21.7587,92852,0,1442,91410
9/23/22,Congo (Kinshasa),-4.0383,21.7587,92852,0,1442,91410
9/24/22,Congo (Kinshasa),-4.0383,21.7587,92852,0,1442,91410
9/25/22,Congo (Kinshasa),-4.0383,21.7587,92852,0,1442,91410
9/26/22,Congo (Kinshasa),-4.0383,21.7587,92852,0,1442,91410
9/27/22,Congo (Kinshasa),-4.0383,21.7587,92852,0,1442,91410
9/28/22,Congo (Kinshasa),-4.0383,21.7587,92852,0,1442,91410
9/29/22,Congo (Kinshasa),-4.0383,21.7587,92852,0,1442,91410
9/30/22,Congo (Kinshasa),-4.0383,21.7587,92893,0,1443,91450
10/1/22,Congo (Kinshasa),-4.0383,21.7587,92893,0,1443,91450
10/2/22,Congo (Kinshasa),-4.0383,21.7587,92893,0,1443,91450
10/3/22,Congo (Kinshasa),-4.0383,21.7587,92893,0,1443,91450
10/4/22,Congo (Kinshasa),-4.0383,21.7587,92893,0,1443,91450
10/5/22,Congo (Kinshasa),-4.0383,21.7587,92893,0,1443,91450
10/6/22,Congo (Kinshasa),-4.0383,21.7587,92893,0,1443,91450
10/7/22,Congo (Kinshasa),-4.0383,21.7587,92934,0,1443,91491
10/8/22,Congo (Kinshasa),-4.0383,21.7587,92934,0,1443,91491
10/9/22,Congo (Kinshasa),-4.0383,21.7587,92934,0,1443,91491
10/10/22,Congo (Kinshasa),-4.0383,21.7587,92934,0,1443,91491
10/11/22,Congo (Kinshasa),-4.0383,21.7587,92934,0,1443,91491
10/12/22,Congo (Kinshasa),-4.0383,21.7587,92934,0,1443,91491
10/13/22,Congo (Kinshasa),-4.0383,21.7587,92934,0,1443,91491
10/14/22,Congo (Kinshasa),-4.0383,21.7587,92972,0,1444,91528
10/15/22,Congo (Kinshasa),-4.0383,21.7587,92972,0,1444,91528
10/16/22,Congo (Kinshasa),-4.0383,21.7587,92972,0,1444,91528
10/17/22,Congo (Kinshasa),-4.0383,21.7587,92972,0,1444,91528
10/18/22,Congo (Kinshasa),-4.0383,21.7587,92972,0,1444,91528
10/19/22,Congo (Kinshasa),-4.0383,21.7587,92972,0,1444,91528
10/20/22,Congo (Kinshasa),-4.0383,21.7587,93027,0,1445,91582
10/21/22,Congo (Kinshasa),-4.0383,21.7587,93027,0,1445,91582
10/22/22,Congo (Kinshasa),-4.0383,21.7587,93027,0,1445,91582
10/23/22,Congo (Kinshasa),-4.0383,21.7587,93027,0,1445,91582
10/24/22,Congo (Kinshasa),-4.0383,21.7587,93027,0,1445,91582
10/25/22,Congo (Kinshasa),-4.0383,21.7587,93027,0,1445,91582
10/26/22,Congo (Kinshasa),-4.0383,21.7587,93027,0,1445,91582
10/27/22,Congo (Kinshasa),-4.0383,21.7587,93027,0,1445,91582
10/28/22,Congo (Kinshasa),-4.0383,21.7587,93086,0,1445,91641
10/29/22,Congo (Kinshasa),-4.0383,21.7587,93086,0,1445,91641
10/30/22,Congo (Kinshasa),-4.0383,21.7587,93086,0,1445,91641
10/31/22,Congo (Kinshasa),-4.0383,21.7587,93086,0,1445,91641
11/1/22,Congo (Kinshasa),-4.0383,21.7587,93086,0,1445,91641
11/2/22,Congo (Kinshasa),-4.0383,21.7587,93086,0,1445,91641
11/3/22,Congo (Kinshasa),-4.0383,21.7587,93086,0,1445,91641
11/4/22,Congo (Kinshasa),-4.0383,21.7587,93219,0,1445,91774
11/5/22,Congo (Kinshasa),-4.0383,21.7587,93219,0,1445,91774
11/6/22,Congo (Kinshasa),-4.0383,21.7587,93219,0,1445,91774
11/7/22,Congo (Kinshasa),-4.0383,21.7587,93219,0,1445,91774
11/8/22,Congo (Kinshasa),-4.0383,21.7587,93219,0,1445,91774
11/9/22,Congo (Kinshasa),-4.0383,21.7587,93219,0,1445,91774
11/10/22,Congo (Kinshasa),-4.0383,21.7587,93467,0,1447,92020
11/11/22,Congo (Kinshasa),-4.0383,21.7587,93467,0,1447,92020
11/12/22,Congo (Kinshasa),-4.0383,21.7587,93467,0,1447,92020
11/13/22,Congo (Kinshasa),-4.0383,21.7587,93467,0,1447,92020
11/14/22,Congo (Kinshasa),-4.0383,21.7587,93467,0,1447,92020
11/15/22,Congo (Kinshasa),-4.0383,21.7587,93467,0,1447,92020
11/16/22,Congo (Kinshasa),-4.0383,21.7587,93467,0,1447,92020
11/17/22,Congo (Kinshasa),-4.0383,21.7587,93467,0,1447,92020
11/18/22,Congo (Kinshasa),-4.0383,21.7587,93837,0,1452,92385
11/19/22,Congo (Kinshasa),-4.0383,21.7587,93837,0,1452,92385
11/20/22,Congo (Kinshasa),-4.0383,21.7587,93837,0,1452,92385
11/21/22,Congo (Kinshasa),-4.0383,21.7587,93837,0,1452,92385
11/22/22,Congo (Kinshasa),-4.0383,21.7587,93837,0,1452,92385
11/23/22,Congo (Kinshasa),-4.0383,21.7587,93837,0,1452,92385
11/24/22,Congo (Kinshasa),-4.0383,21.7587,93837,0,1452,92385
11/25/22,Congo (Kinshasa),-4.0383,21.7587,93837,0,1452,92385
11/26/22,Congo (Kinshasa),-4.0383,21.7587,93837,0,1452,92385
11/27/22,Congo (Kinshasa),-4.0383,21.7587,93837,0,1452,92385
11/28/22,Congo (Kinshasa),-4.0383,21.7587,94204,0,1455,92749
11/29/22,Congo (Kinshasa),-4.0383,21.7587,94204,0,1455,92749
11/30/22,Congo (Kinshasa),-4.0383,21.7587,94204,0,1455,92749
12/1/22,Congo (Kinshasa),-4.0383,21.7587,94204,0,1455,92749
12/2/22,Congo (Kinshasa),-4.0383,21.7587,94204,0,1455,92749
12/3/22,Congo (Kinshasa),-4.0383,21.7587,94204,0,1455,92749
12/4/22,Congo (Kinshasa),-4.0383,21.7587,94204,0,1455,92749
12/5/22,Congo (Kinshasa),-4.0383,21.7587,94452,0,1456,92996
12/6/22,Congo (Kinshasa),-4.0383,21.7587,94452,0,1456,92996
12/7/22,Congo (Kinshasa),-4.0383,21.7587,94452,0,1456,92996
12/8/22,Congo (Kinshasa),-4.0383,21.7587,94452,0,1456,92996
12/9/22,Congo (Kinshasa),-4.0383,21.7587,94452,0,1456,92996
12/10/22,Congo (Kinshasa),-4.0383,21.7587,94452,0,1456,92996
12/11/22,Congo (Kinshasa),-4.0383,21.7587,94452,0,1456,92996
12/12/22,Congo (Kinshasa),-4.0383,21.7587,94714,0,1457,93257
12/13/22,Congo (Kinshasa),-4.0383,21.7587,94714,0,1457,93257
12/14/22,Congo (Kinshasa),-4.0383,21.7587,94714,0,1457,93257
12/15/22,Congo (Kinshasa),-4.0383,21.7587,94714,0,1457,93257
12/16/22,Congo (Kinshasa),-4.0383,21.7587,94970,0,1461,93509
12/17/22,Congo (Kinshasa),-4.0383,21.7587,94970,0,1461,93509
1/1/22,Costa Rica,9.7489,-83.7534,570556,0,7353,563203
1/2/22,Costa Rica,9.7489,-83.7534,570556,0,7353,563203
1/3/22,Costa Rica,9.7489,-83.7534,570556,0,7353,563203
1/4/22,Costa Rica,9.7489,-83.7534,575871,0,7366,568505
1/5/22,Costa Rica,9.7489,-83.7534,578413,0,7369,571044
1/6/22,Costa Rica,9.7489,-83.7534,581394,0,7370,574024
1/7/22,Costa Rica,9.7489,-83.7534,584547,0,7372,577175
1/8/22,Costa Rica,9.7489,-83.7534,584547,0,7372,577175
1/9/22,Costa Rica,9.7489,-83.7534,584547,0,7372,577175
1/10/22,Costa Rica,9.7489,-83.7534,591745,0,7382,584363
1/11/22,Costa Rica,9.7489,-83.7534,595795,0,7386,588409
1/12/22,Costa Rica,9.7489,-83.7534,599965,0,7394,592571
1/13/22,Costa Rica,9.7489,-83.7534,604658,0,7401,597257
1/14/22,Costa Rica,9.7489,-83.7534,609882,0,7406,602476
1/15/22,Costa Rica,9.7489,-83.7534,609882,0,7406,602476
1/16/22,Costa Rica,9.7489,-83.7534,609882,0,7406,602476
1/17/22,Costa Rica,9.7489,-83.7534,620587,0,7421,613166
1/18/22,Costa Rica,9.7489,-83.7534,625952,0,7425,618527
1/19/22,Costa Rica,9.7489,-83.7534,631311,0,7434,623877
1/20/22,Costa Rica,9.7489,-83.7534,637327,0,7441,629886
1/21/22,Costa Rica,9.7489,-83.7534,643496,0,7451,636045
1/22/22,Costa Rica,9.7489,-83.7534,643496,0,7451,636045
1/23/22,Costa Rica,9.7489,-83.7534,643496,0,7451,636045
1/24/22,Costa Rica,9.7489,-83.7534,643496,0,7451,636045
1/25/22,Costa Rica,9.7489,-83.7534,661684,0,7492,654192
1/26/22,Costa Rica,9.7489,-83.7534,668209,0,7505,660704
1/27/22,Costa Rica,9.7489,-83.7534,675178,0,7521,667657
1/28/22,Costa Rica,9.7489,-83.7534,682480,0,7533,674947
1/29/22,Costa Rica,9.7489,-83.7534,682480,0,7533,674947
1/30/22,Costa Rica,9.7489,-83.7534,682480,0,7533,674947
1/31/22,Costa Rica,9.7489,-83.7534,694865,0,7575,687290
2/1/22,Costa Rica,9.7489,-83.7534,701471,0,7593,693878
2/2/22,Costa Rica,9.7489,-83.7534,708560,0,7605,700955
2/3/22,Costa Rica,9.7489,-83.7534,715749,0,7621,708128
2/4/22,Costa Rica,9.7489,-83.7534,721971,0,7641,714330
2/5/22,Costa Rica,9.7489,-83.7534,721971,0,7641,714330
2/6/22,Costa Rica,9.7489,-83.7534,721971,0,7641,714330
2/7/22,Costa Rica,9.7489,-83.7534,733708,0,7694,726014
2/8/22,Costa Rica,9.7489,-83.7534,739844,0,7712,732132
2/9/22,Costa Rica,9.7489,-83.7534,745949,0,7730,738219
2/10/22,Costa Rica,9.7489,-83.7534,751605,0,7752,743853
2/11/22,Costa Rica,9.7489,-83.7534,757093,0,7772,749321
2/12/22,Costa Rica,9.7489,-83.7534,757093,0,7772,749321
2/13/22,Costa Rica,9.7489,-83.7534,757093,0,7772,749321
2/14/22,Costa Rica,9.7489,-83.7534,766520,0,7806,758714
2/15/22,Costa Rica,9.7489,-83.7534,771027,0,7829,763198
2/16/22,Costa Rica,9.7489,-83.7534,775318,0,7847,767471
2/17/22,Costa Rica,9.7489,-83.7534,779323,0,7874,771449
2/18/22,Costa Rica,9.7489,-83.7534,783437,0,7894,775543
2/19/22,Costa Rica,9.7489,-83.7534,783437,0,7894,775543
2/20/22,Costa Rica,9.7489,-83.7534,783437,0,7894,775543
2/21/22,Costa Rica,9.7489,-83.7534,790444,0,7936,782508
2/22/22,Costa Rica,9.7489,-83.7534,793835,0,7954,785881
2/23/22,Costa Rica,9.7489,-83.7534,797030,0,7969,789061
2/24/22,Costa Rica,9.7489,-83.7534,799826,0,7984,791842
2/25/22,Costa Rica,9.7489,-83.7534,802472,0,7999,794473
2/26/22,Costa Rica,9.7489,-83.7534,802472,0,7999,794473
2/27/22,Costa Rica,9.7489,-83.7534,802472,0,7999,794473
2/28/22,Costa Rica,9.7489,-83.7534,806928,0,8037,798891
3/1/22,Costa Rica,9.7489,-83.7534,809131,0,8047,801084
3/2/22,Costa Rica,9.7489,-83.7534,811040,0,8057,802983
3/3/22,Costa Rica,9.7489,-83.7534,812812,0,8073,804739
3/4/22,Costa Rica,9.7489,-83.7534,814583,0,8082,806501
3/5/22,Costa Rica,9.7489,-83.7534,814583,0,8082,806501
3/6/22,Costa Rica,9.7489,-83.7534,814583,0,8082,806501
3/7/22,Costa Rica,9.7489,-83.7534,817538,0,8121,809417
3/8/22,Costa Rica,9.7489,-83.7534,818996,0,8136,810860
3/9/22,Costa Rica,9.7489,-83.7534,820445,0,8142,812303
3/10/22,Costa Rica,9.7489,-83.7534,821813,0,8149,813664
3/11/22,Costa Rica,9.7489,-83.7534,822935,0,8160,814775
3/12/22,Costa Rica,9.7489,-83.7534,822935,0,8160,814775
3/13/22,Costa Rica,9.7489,-83.7534,822935,0,8160,814775
3/14/22,Costa Rica,9.7489,-83.7534,825158,0,8186,816972
3/15/22,Costa Rica,9.7489,-83.7534,826251,0,8192,818059
3/16/22,Costa Rica,9.7489,-83.7534,827346,0,8202,819144
3/17/22,Costa Rica,9.7489,-83.7534,828442,0,8215,820227
3/18/22,Costa Rica,9.7489,-83.7534,829400,0,8226,821174
3/19/22,Costa Rica,9.7489,-83.7534,829400,0,8226,821174
3/20/22,Costa Rica,9.7489,-83.7534,829400,0,8226,821174
3/21/22,Costa Rica,9.7489,-83.7534,831152,0,8244,822908
3/22/22,Costa Rica,9.7489,-83.7534,832054,0,8256,823798
3/23/22,Costa Rica,9.7489,-83.7534,832966,0,8261,824705
3/24/22,Costa Rica,9.7489,-83.7534,833909,0,8263,825646
3/25/22,Costa Rica,9.7489,-83.7534,834726,0,8266,826460
3/26/22,Costa Rica,9.7489,-83.7534,834726,0,8266,826460
3/27/22,Costa Rica,9.7489,-83.7534,834726,0,8266,826460
3/28/22,Costa Rica,9.7489,-83.7534,834726,0,8266,826460
3/29/22,Costa Rica,9.7489,-83.7534,834726,0,8266,826460
3/30/22,Costa Rica,9.7489,-83.7534,837828,0,8298,829530
3/31/22,Costa Rica,9.7489,-83.7534,838537,0,8300,830237
4/1/22,Costa Rica,9.7489,-83.7534,839368,0,8308,831060
4/2/22,Costa Rica,9.7489,-83.7534,839368,0,8308,831060
4/3/22,Costa Rica,9.7489,-83.7534,839368,0,8308,831060
4/4/22,Costa Rica,9.7489,-83.7534,839368,0,8308,831060
4/5/22,Costa Rica,9.7489,-83.7534,841343,0,8327,833016
4/6/22,Costa Rica,9.7489,-83.7534,841343,0,8327,833016
4/7/22,Costa Rica,9.7489,-83.7534,841343,0,8327,833016
4/8/22,Costa Rica,9.7489,-83.7534,841343,0,8327,833016
4/9/22,Costa Rica,9.7489,-83.7534,841343,0,8327,833016
4/10/22,Costa Rica,9.7489,-83.7534,841343,0,8327,833016
4/11/22,Costa Rica,9.7489,-83.7534,841343,0,8327,833016
4/12/22,Costa Rica,9.7489,-83.7534,844892,0,8357,836535
4/13/22,Costa Rica,9.7489,-83.7534,844892,0,8357,836535
4/14/22,Costa Rica,9.7489,-83.7534,844892,0,8357,836535
4/15/22,Costa Rica,9.7489,-83.7534,844892,0,8357,836535
4/16/22,Costa Rica,9.7489,-83.7534,844892,0,8357,836535
4/17/22,Costa Rica,9.7489,-83.7534,844892,0,8357,836535
4/18/22,Costa Rica,9.7489,-83.7534,844892,0,8357,836535
4/19/22,Costa Rica,9.7489,-83.7534,844892,0,8357,836535
4/20/22,Costa Rica,9.7489,-83.7534,847784,0,8383,839401
4/21/22,Costa Rica,9.7489,-83.7534,847784,0,8383,839401
4/22/22,Costa Rica,9.7489,-83.7534,847784,0,8383,839401
4/23/22,Costa Rica,9.7489,-83.7534,847784,0,8383,839401
4/24/22,Costa Rica,9.7489,-83.7534,847784,0,8383,839401
4/25/22,Costa Rica,9.7489,-83.7534,847784,0,8383,839401
4/26/22,Costa Rica,9.7489,-83.7534,847784,0,8383,839401
4/27/22,Costa Rica,9.7489,-83.7534,852074,0,8405,843669
4/28/22,Costa Rica,9.7489,-83.7534,852074,0,8405,843669
4/29/22,Costa Rica,9.7489,-83.7534,852074,0,8405,843669
4/30/22,Costa Rica,9.7489,-83.7534,852074,0,8405,843669
5/1/22,Costa Rica,9.7489,-83.7534,852074,0,8405,843669
5/2/22,Costa Rica,9.7489,-83.7534,852074,0,8405,843669
5/3/22,Costa Rica,9.7489,-83.7534,852074,0,8405,843669
5/4/22,Costa Rica,9.7489,-83.7534,857290,0,8421,848869
5/5/22,Costa Rica,9.7489,-83.7534,857290,0,8421,848869
5/6/22,Costa Rica,9.7489,-83.7534,857290,0,8421,848869
5/7/22,Costa Rica,9.7489,-83.7534,857290,0,8421,848869
5/8/22,Costa Rica,9.7489,-83.7534,857290,0,8421,848869
5/9/22,Costa Rica,9.7489,-83.7534,857290,0,8421,848869
5/10/22,Costa Rica,9.7489,-83.7534,866164,0,8444,857720
5/11/22,Costa Rica,9.7489,-83.7534,866164,0,8444,857720
5/12/22,Costa Rica,9.7489,-83.7534,866164,0,8444,857720
5/13/22,Costa Rica,9.7489,-83.7534,866164,0,8444,857720
5/14/22,Costa Rica,9.7489,-83.7534,866164,0,8444,857720
5/15/22,Costa Rica,9.7489,-83.7534,866164,0,8444,857720
5/16/22,Costa Rica,9.7489,-83.7534,866164,0,8444,857720
5/17/22,Costa Rica,9.7489,-83.7534,866164,0,8444,857720
5/18/22,Costa Rica,9.7489,-83.7534,877533,0,8472,869061
5/19/22,Costa Rica,9.7489,-83.7534,877533,0,8472,869061
5/20/22,Costa Rica,9.7489,-83.7534,877533,0,8472,869061
5/21/22,Costa Rica,9.7489,-83.7534,877533,0,8472,869061
5/22/22,Costa Rica,9.7489,-83.7534,877533,0,8472,869061
5/23/22,Costa Rica,9.7489,-83.7534,877533,0,8472,869061
5/24/22,Costa Rica,9.7489,-83.7534,891038,0,8495,882543
5/25/22,Costa Rica,9.7489,-83.7534,891038,0,8495,882543
5/26/22,Costa Rica,9.7489,-83.7534,891038,0,8495,882543
5/27/22,Costa Rica,9.7489,-83.7534,891038,0,8495,882543
5/28/22,Costa Rica,9.7489,-83.7534,891038,0,8495,882543
5/29/22,Costa Rica,9.7489,-83.7534,891038,0,8495,882543
5/30/22,Costa Rica,9.7489,-83.7534,891038,0,8495,882543
5/31/22,Costa Rica,9.7489,-83.7534,891038,0,8495,882543
6/1/22,Costa Rica,9.7489,-83.7534,904934,0,8525,896409
6/2/22,Costa Rica,9.7489,-83.7534,904934,0,8525,896409
6/3/22,Costa Rica,9.7489,-83.7534,904934,0,8525,896409
6/4/22,Costa Rica,9.7489,-83.7534,904934,0,8525,896409
6/5/22,Costa Rica,9.7489,-83.7534,904934,0,8525,896409
6/6/22,Costa Rica,9.7489,-83.7534,904934,0,8525,896409
6/7/22,Costa Rica,9.7489,-83.7534,904934,0,8525,896409
6/8/22,Costa Rica,9.7489,-83.7534,904934,0,8525,896409
6/9/22,Costa Rica,9.7489,-83.7534,904934,0,8525,896409
6/10/22,Costa Rica,9.7489,-83.7534,904934,0,8525,896409
6/11/22,Costa Rica,9.7489,-83.7534,904934,0,8525,896409
6/12/22,Costa Rica,9.7489,-83.7534,904934,0,8525,896409
6/13/22,Costa Rica,9.7489,-83.7534,904934,0,8525,896409
6/14/22,Costa Rica,9.7489,-83.7534,904934,0,8525,896409
6/15/22,Costa Rica,9.7489,-83.7534,904934,0,8525,896409
6/16/22,Costa Rica,9.7489,-83.7534,904934,0,8525,896409
6/17/22,Costa Rica,9.7489,-83.7534,904934,0,8525,896409
6/18/22,Costa Rica,9.7489,-83.7534,904934,0,8525,896409
6/19/22,Costa Rica,9.7489,-83.7534,904934,0,8525,896409
6/20/22,Costa Rica,9.7489,-83.7534,904934,0,8525,896409
6/21/22,Costa Rica,9.7489,-83.7534,904934,0,8525,896409
6/22/22,Costa Rica,9.7489,-83.7534,904934,0,8525,896409
6/23/22,Costa Rica,9.7489,-83.7534,904934,0,8525,896409
6/24/22,Costa Rica,9.7489,-83.7534,904934,0,8525,896409
6/25/22,Costa Rica,9.7489,-83.7534,904934,0,8525,896409
6/26/22,Costa Rica,9.7489,-83.7534,904934,0,8525,896409
6/27/22,Costa Rica,9.7489,-83.7534,904934,0,8525,896409
6/28/22,Costa Rica,9.7489,-83.7534,904934,0,8525,896409
6/29/22,Costa Rica,9.7489,-83.7534,904934,0,8525,896409
6/30/22,Costa Rica,9.7489,-83.7534,904934,0,8525,896409
7/1/22,Costa Rica,9.7489,-83.7534,904934,0,8525,896409
7/2/22,Costa Rica,9.7489,-83.7534,904934,0,8525,896409
7/3/22,Costa Rica,9.7489,-83.7534,904934,0,8525,896409
7/4/22,Costa Rica,9.7489,-83.7534,904934,0,8525,896409
7/5/22,Costa Rica,9.7489,-83.7534,904934,0,8525,896409
7/6/22,Costa Rica,9.7489,-83.7534,904934,0,8525,896409
7/7/22,Costa Rica,9.7489,-83.7534,904934,0,8525,896409
7/8/22,Costa Rica,9.7489,-83.7534,904934,0,8525,896409
7/9/22,Costa Rica,9.7489,-83.7534,904934,0,8525,896409
7/10/22,Costa Rica,9.7489,-83.7534,904934,0,8525,896409
7/11/22,Costa Rica,9.7489,-83.7534,904934,0,8525,896409
7/12/22,Costa Rica,9.7489,-83.7534,904934,0,8525,896409
7/13/22,Costa Rica,9.7489,-83.7534,904934,0,8525,896409
7/14/22,Costa Rica,9.7489,-83.7534,904934,0,8525,896409
7/15/22,Costa Rica,9.7489,-83.7534,904934,0,8525,896409
7/16/22,Costa Rica,9.7489,-83.7534,904934,0,8525,896409
7/17/22,Costa Rica,9.7489,-83.7534,904934,0,8525,896409
7/18/22,Costa Rica,9.7489,-83.7534,904934,0,8525,896409
7/19/22,Costa Rica,9.7489,-83.7534,904934,0,8525,896409
7/20/22,Costa Rica,9.7489,-83.7534,960340,0,8525,951815
7/21/22,Costa Rica,9.7489,-83.7534,960340,0,8525,951815
7/22/22,Costa Rica,9.7489,-83.7534,960340,0,8525,951815
7/23/22,Costa Rica,9.7489,-83.7534,989213,0,8670,980543
7/24/22,Costa Rica,9.7489,-83.7534,989213,0,8670,980543
7/25/22,Costa Rica,9.7489,-83.7534,989213,0,8670,980543
7/26/22,Costa Rica,9.7489,-83.7534,1028375,0,8690,1019685
7/27/22,Costa Rica,9.7489,-83.7534,1028375,0,8690,1019685
7/28/22,Costa Rica,9.7489,-83.7534,1028375,0,8690,1019685
7/29/22,Costa Rica,9.7489,-83.7534,1028375,0,8690,1019685
7/30/22,Costa Rica,9.7489,-83.7534,1028375,0,8720,1019655
7/31/22,Costa Rica,9.7489,-83.7534,1028375,0,8720,1019655
8/1/22,Costa Rica,9.7489,-83.7534,1028375,0,8720,1019655
8/2/22,Costa Rica,9.7489,-83.7534,1044385,0,8740,1035645
8/3/22,Costa Rica,9.7489,-83.7534,1044385,0,8740,1035645
8/4/22,Costa Rica,9.7489,-83.7534,1044385,0,8740,1035645
8/5/22,Costa Rica,9.7489,-83.7534,1044385,0,8754,1035631
8/6/22,Costa Rica,9.7489,-83.7534,1044385,0,8754,1035631
8/7/22,Costa Rica,9.7489,-83.7534,1044385,0,8754,1035631
8/8/22,Costa Rica,9.7489,-83.7534,1044385,0,8754,1035631
8/9/22,Costa Rica,9.7489,-83.7534,1057695,0,8774,1048921
8/10/22,Costa Rica,9.7489,-83.7534,1057695,0,8774,1048921
8/11/22,Costa Rica,9.7489,-83.7534,1057695,0,8774,1048921
8/12/22,Costa Rica,9.7489,-83.7534,1057695,0,8780,1048915
8/13/22,Costa Rica,9.7489,-83.7534,1057695,0,8780,1048915
8/14/22,Costa Rica,9.7489,-83.7534,1057695,0,8780,1048915
8/15/22,Costa Rica,9.7489,-83.7534,1057695,0,8780,1048915
8/16/22,Costa Rica,9.7489,-83.7534,1069162,0,8800,1060362
8/17/22,Costa Rica,9.7489,-83.7534,1069162,0,8800,1060362
8/18/22,Costa Rica,9.7489,-83.7534,1069162,0,8800,1060362
8/19/22,Costa Rica,9.7489,-83.7534,1069162,0,8808,1060354
8/20/22,Costa Rica,9.7489,-83.7534,1069162,0,8808,1060354
8/21/22,Costa Rica,9.7489,-83.7534,1069162,0,8808,1060354
8/22/22,Costa Rica,9.7489,-83.7534,1069162,0,8808,1060354
8/23/22,Costa Rica,9.7489,-83.7534,1079825,0,8828,1070997
8/24/22,Costa Rica,9.7489,-83.7534,1079825,0,8828,1070997
8/25/22,Costa Rica,9.7489,-83.7534,1079825,0,8836,1070989
8/26/22,Costa Rica,9.7489,-83.7534,1079825,0,8836,1070989
8/27/22,Costa Rica,9.7489,-83.7534,1079825,0,8836,1070989
8/28/22,Costa Rica,9.7489,-83.7534,1079825,0,8836,1070989
8/29/22,Costa Rica,9.7489,-83.7534,1079825,0,8836,1070989
8/30/22,Costa Rica,9.7489,-83.7534,1088716,0,8856,1079860
8/31/22,Costa Rica,9.7489,-83.7534,1088716,0,8856,1079860
9/1/22,Costa Rica,9.7489,-83.7534,1088716,0,8856,1079860
9/2/22,Costa Rica,9.7489,-83.7534,1088716,0,8867,1079849
9/3/22,Costa Rica,9.7489,-83.7534,1088716,0,8867,1079849
9/4/22,Costa Rica,9.7489,-83.7534,1088716,0,8867,1079849
9/5/22,Costa Rica,9.7489,-83.7534,1088716,0,8867,1079849
9/6/22,Costa Rica,9.7489,-83.7534,1097629,0,8887,1088742
9/7/22,Costa Rica,9.7489,-83.7534,1097629,0,8887,1088742
9/8/22,Costa Rica,9.7489,-83.7534,1097629,0,8887,1088742
9/9/22,Costa Rica,9.7489,-83.7534,1097629,0,8887,1088742
9/10/22,Costa Rica,9.7489,-83.7534,1097629,0,8893,1088736
9/11/22,Costa Rica,9.7489,-83.7534,1097629,0,8893,1088736
9/12/22,Costa Rica,9.7489,-83.7534,1098379,0,8893,1089486
9/13/22,Costa Rica,9.7489,-83.7534,1105792,0,8913,1096879
9/14/22,Costa Rica,9.7489,-83.7534,1105792,0,8913,1096879
9/15/22,Costa Rica,9.7489,-83.7534,1105792,0,8913,1096879
9/16/22,Costa Rica,9.7489,-83.7534,1105792,0,8913,1096879
9/17/22,Costa Rica,9.7489,-83.7534,1105792,0,8913,1096879
9/18/22,Costa Rica,9.7489,-83.7534,1105792,0,8913,1096879
9/19/22,Costa Rica,9.7489,-83.7534,1105792,0,8913,1096879
9/20/22,Costa Rica,9.7489,-83.7534,1111969,0,8933,1103036
9/21/22,Costa Rica,9.7489,-83.7534,1111969,0,8933,1103036
9/22/22,Costa Rica,9.7489,-83.7534,1111969,0,8933,1103036
9/23/22,Costa Rica,9.7489,-83.7534,1111969,0,8933,1103036
9/24/22,Costa Rica,9.7489,-83.7534,1111969,0,8933,1103036
9/25/22,Costa Rica,9.7489,-83.7534,1111969,0,8933,1103036
9/26/22,Costa Rica,9.7489,-83.7534,1111969,0,8933,1103036
9/27/22,Costa Rica,9.7489,-83.7534,1117989,0,8970,1109019
9/28/22,Costa Rica,9.7489,-83.7534,1117989,0,8970,1109019
9/29/22,Costa Rica,9.7489,-83.7534,1117989,0,8970,1109019
9/30/22,Costa Rica,9.7489,-83.7534,1117989,0,8970,1109019
10/1/22,Costa Rica,9.7489,-83.7534,1117989,0,8970,1109019
10/2/22,Costa Rica,9.7489,-83.7534,1117989,0,8970,1109019
10/3/22,Costa Rica,9.7489,-83.7534,1117989,0,8970,1109019
10/4/22,Costa Rica,9.7489,-83.7534,1117989,0,8970,1109019
10/5/22,Costa Rica,9.7489,-83.7534,1123001,0,8966,1114035
10/6/22,Costa Rica,9.7489,-83.7534,1123001,0,8966,1114035
10/7/22,Costa Rica,9.7489,-83.7534,1123001,0,8966,1114035
10/8/22,Costa Rica,9.7489,-83.7534,1123001,0,8966,1114035
10/9/22,Costa Rica,9.7489,-83.7534,1123001,0,8966,1114035
10/10/22,Costa Rica,9.7489,-83.7534,1123001,0,8966,1114035
10/11/22,Costa Rica,9.7489,-83.7534,1127500,0,8974,1118526
10/12/22,Costa Rica,9.7489,-83.7534,1127602,0,8974,1118628
10/13/22,Costa Rica,9.7489,-83.7534,1127602,0,8974,1118628
10/14/22,Costa Rica,9.7489,-83.7534,1127602,0,8974,1118628
10/15/22,Costa Rica,9.7489,-83.7534,1127602,0,8974,1118628
10/16/22,Costa Rica,9.7489,-83.7534,1127602,0,8974,1118628
10/17/22,Costa Rica,9.7489,-83.7534,1127602,0,8974,1118628
10/18/22,Costa Rica,9.7489,-83.7534,1130568,0,8982,1121586
10/19/22,Costa Rica,9.7489,-83.7534,1130568,0,8982,1121586
10/20/22,Costa Rica,9.7489,-83.7534,1130568,0,8982,1121586
10/21/22,Costa Rica,9.7489,-83.7534,1130568,0,8982,1121586
10/22/22,Costa Rica,9.7489,-83.7534,1130568,0,8982,1121586
10/23/22,Costa Rica,9.7489,-83.7534,1130568,0,8982,1121586
10/24/22,Costa Rica,9.7489,-83.7534,1130568,0,8982,1121586
10/25/22,Costa Rica,9.7489,-83.7534,1133096,0,8990,1124106
10/26/22,Costa Rica,9.7489,-83.7534,1133096,0,8990,1124106
10/27/22,Costa Rica,9.7489,-83.7534,1133096,0,8990,1124106
10/28/22,Costa Rica,9.7489,-83.7534,1133096,0,8990,1124106
10/29/22,Costa Rica,9.7489,-83.7534,1133096,0,8990,1124106
10/30/22,Costa Rica,9.7489,-83.7534,1133096,0,8990,1124106
10/31/22,Costa Rica,9.7489,-83.7534,1133096,0,8990,1124106
11/1/22,Costa Rica,9.7489,-83.7534,1135713,0,8999,1126714
11/2/22,Costa Rica,9.7489,-83.7534,1135713,0,8999,1126714
11/3/22,Costa Rica,9.7489,-83.7534,1135713,0,8999,1126714
11/4/22,Costa Rica,9.7489,-83.7534,1138416,0,9009,1129407
11/5/22,Costa Rica,9.7489,-83.7534,1138416,0,9009,1129407
11/6/22,Costa Rica,9.7489,-83.7534,1138416,0,9009,1129407
11/7/22,Costa Rica,9.7489,-83.7534,1138416,0,9009,1129407
11/8/22,Costa Rica,9.7489,-83.7534,1138416,0,9009,1129407
11/9/22,Costa Rica,9.7489,-83.7534,1138416,0,9009,1129407
11/10/22,Costa Rica,9.7489,-83.7534,1138416,0,9009,1129407
11/11/22,Costa Rica,9.7489,-83.7534,1140864,0,9019,1131845
11/12/22,Costa Rica,9.7489,-83.7534,1140864,0,9019,1131845
11/13/22,Costa Rica,9.7489,-83.7534,1140864,0,9019,1131845
11/14/22,Costa Rica,9.7489,-83.7534,1140864,0,9019,1131845
11/15/22,Costa Rica,9.7489,-83.7534,1140864,0,9019,1131845
11/16/22,Costa Rica,9.7489,-83.7534,1140864,0,9019,1131845
11/17/22,Costa Rica,9.7489,-83.7534,1140864,0,9019,1131845
11/18/22,Costa Rica,9.7489,-83.7534,1143597,0,9031,1134566
11/19/22,Costa Rica,9.7489,-83.7534,1143597,0,9031,1134566
11/20/22,Costa Rica,9.7489,-83.7534,1143597,0,9031,1134566
11/21/22,Costa Rica,9.7489,-83.7534,1143597,0,9031,1134566
11/22/22,Costa Rica,9.7489,-83.7534,1143597,0,9031,1134566
11/23/22,Costa Rica,9.7489,-83.7534,1143597,0,9031,1134566
11/24/22,Costa Rica,9.7489,-83.7534,1143597,0,9031,1134566
11/25/22,Costa Rica,9.7489,-83.7534,1143597,0,9031,1134566
11/26/22,Costa Rica,9.7489,-83.7534,1143597,0,9031,1134566
11/27/22,Costa Rica,9.7489,-83.7534,1143597,0,9031,1134566
11/28/22,Costa Rica,9.7489,-83.7534,1143597,0,9031,1134566
11/29/22,Costa Rica,9.7489,-83.7534,1146135,0,9038,1137097
11/30/22,Costa Rica,9.7489,-83.7534,1146135,0,9038,1137097
12/1/22,Costa Rica,9.7489,-83.7534,1146135,0,9038,1137097
12/2/22,Costa Rica,9.7489,-83.7534,1148914,0,9046,1139868
12/3/22,Costa Rica,9.7489,-83.7534,1148914,0,9046,1139868
12/4/22,Costa Rica,9.7489,-83.7534,1148914,0,9046,1139868
12/5/22,Costa Rica,9.7489,-83.7534,1148914,0,9046,1139868
12/6/22,Costa Rica,9.7489,-83.7534,1148914,0,9046,1139868
12/7/22,Costa Rica,9.7489,-83.7534,1148914,0,9046,1139868
12/8/22,Costa Rica,9.7489,-83.7534,1148914,0,9046,1139868
12/9/22,Costa Rica,9.7489,-83.7534,1148914,0,9046,1139868
12/10/22,Costa Rica,9.7489,-83.7534,1148914,0,9046,1139868
12/11/22,Costa Rica,9.7489,-83.7534,1148914,0,9046,1139868
12/12/22,Costa Rica,9.7489,-83.7534,1148914,0,9046,1139868
12/13/22,Costa Rica,9.7489,-83.7534,1152466,0,9051,1143415
12/14/22,Costa Rica,9.7489,-83.7534,1152466,0,9051,1143415
12/15/22,Costa Rica,9.7489,-83.7534,1152466,0,9051,1143415
12/16/22,Costa Rica,9.7489,-83.7534,1152466,0,9051,1143415
12/17/22,Costa Rica,9.7489,-83.7534,1152466,0,9051,1143415
1/1/22,Cote d'Ivoire,7.54,-5.5471,71815,0,718,71097
1/2/22,Cote d'Ivoire,7.54,-5.5471,72352,0,720,71632
1/3/22,Cote d'Ivoire,7.54,-5.5471,72352,0,720,71632
1/4/22,Cote d'Ivoire,7.54,-5.5471,73786,0,723,73063
1/5/22,Cote d'Ivoire,7.54,-5.5471,75064,0,727,74337
1/6/22,Cote d'Ivoire,7.54,-5.5471,75715,0,730,74985
1/7/22,Cote d'Ivoire,7.54,-5.5471,76321,0,732,75589
1/8/22,Cote d'Ivoire,7.54,-5.5471,76732,0,733,75999
1/9/22,Cote d'Ivoire,7.54,-5.5471,77449,0,735,76714
1/10/22,Cote d'Ivoire,7.54,-5.5471,77677,0,738,76939
1/11/22,Cote d'Ivoire,7.54,-5.5471,77857,0,742,77115
1/12/22,Cote d'Ivoire,7.54,-5.5471,78258,0,745,77513
1/13/22,Cote d'Ivoire,7.54,-5.5471,78495,0,747,77748
1/14/22,Cote d'Ivoire,7.54,-5.5471,78699,0,748,77951
1/15/22,Cote d'Ivoire,7.54,-5.5471,79088,0,753,78335
1/16/22,Cote d'Ivoire,7.54,-5.5471,79088,0,753,78335
1/17/22,Cote d'Ivoire,7.54,-5.5471,79273,0,761,78512
1/18/22,Cote d'Ivoire,7.54,-5.5471,79435,0,763,78672
1/19/22,Cote d'Ivoire,7.54,-5.5471,79558,0,764,78794
1/20/22,Cote d'Ivoire,7.54,-5.5471,79558,0,764,78794
1/21/22,Cote d'Ivoire,7.54,-5.5471,79814,0,771,79043
1/22/22,Cote d'Ivoire,7.54,-5.5471,80114,0,778,79336
1/23/22,Cote d'Ivoire,7.54,-5.5471,80176,0,779,79397
1/24/22,Cote d'Ivoire,7.54,-5.5471,80249,0,779,79470
1/25/22,Cote d'Ivoire,7.54,-5.5471,80363,0,782,79581
1/26/22,Cote d'Ivoire,7.54,-5.5471,80396,0,782,79614
1/27/22,Cote d'Ivoire,7.54,-5.5471,80487,0,782,79705
1/28/22,Cote d'Ivoire,7.54,-5.5471,80566,0,782,79784
1/29/22,Cote d'Ivoire,7.54,-5.5471,80623,0,784,79839
1/30/22,Cote d'Ivoire,7.54,-5.5471,80695,0,785,79910
1/31/22,Cote d'Ivoire,7.54,-5.5471,80718,0,785,79933
2/1/22,Cote d'Ivoire,7.54,-5.5471,80783,0,785,79998
2/2/22,Cote d'Ivoire,7.54,-5.5471,80783,0,785,79998
2/3/22,Cote d'Ivoire,7.54,-5.5471,80783,0,785,79998
2/4/22,Cote d'Ivoire,7.54,-5.5471,80821,0,786,80035
2/5/22,Cote d'Ivoire,7.54,-5.5471,80901,0,786,80115
2/6/22,Cote d'Ivoire,7.54,-5.5471,80920,0,786,80134
2/7/22,Cote d'Ivoire,7.54,-5.5471,80938,0,787,80151
2/8/22,Cote d'Ivoire,7.54,-5.5471,80976,0,787,80189
2/9/22,Cote d'Ivoire,7.54,-5.5471,81005,0,787,80218
2/10/22,Cote d'Ivoire,7.54,-5.5471,81040,0,789,80251
2/11/22,Cote d'Ivoire,7.54,-5.5471,81109,0,789,80320
2/12/22,Cote d'Ivoire,7.54,-5.5471,81118,0,789,80329
2/13/22,Cote d'Ivoire,7.54,-5.5471,81118,0,789,80329
2/14/22,Cote d'Ivoire,7.54,-5.5471,81213,0,791,80422
2/15/22,Cote d'Ivoire,7.54,-5.5471,81237,0,791,80446
2/16/22,Cote d'Ivoire,7.54,-5.5471,81253,0,791,80462
2/17/22,Cote d'Ivoire,7.54,-5.5471,81282,0,791,80491
2/18/22,Cote d'Ivoire,7.54,-5.5471,81322,0,791,80531
2/19/22,Cote d'Ivoire,7.54,-5.5471,81346,0,791,80555
2/20/22,Cote d'Ivoire,7.54,-5.5471,81367,0,791,80576
2/21/22,Cote d'Ivoire,7.54,-5.5471,81374,0,791,80583
2/22/22,Cote d'Ivoire,7.54,-5.5471,81397,0,791,80606
2/23/22,Cote d'Ivoire,7.54,-5.5471,81410,0,791,80619
2/24/22,Cote d'Ivoire,7.54,-5.5471,81410,0,791,80619
2/25/22,Cote d'Ivoire,7.54,-5.5471,81449,0,792,80657
2/26/22,Cote d'Ivoire,7.54,-5.5471,81467,0,792,80675
2/27/22,Cote d'Ivoire,7.54,-5.5471,81467,0,792,80675
2/28/22,Cote d'Ivoire,7.54,-5.5471,81483,0,793,80690
3/1/22,Cote d'Ivoire,7.54,-5.5471,81483,0,793,80690
3/2/22,Cote d'Ivoire,7.54,-5.5471,81518,0,794,80724
3/3/22,Cote d'Ivoire,7.54,-5.5471,81523,0,794,80729
3/4/22,Cote d'Ivoire,7.54,-5.5471,81534,0,795,80739
3/5/22,Cote d'Ivoire,7.54,-5.5471,81546,0,795,80751
3/6/22,Cote d'Ivoire,7.54,-5.5471,81556,0,795,80761
3/7/22,Cote d'Ivoire,7.54,-5.5471,81556,0,795,80761
3/8/22,Cote d'Ivoire,7.54,-5.5471,81559,0,795,80764
3/9/22,Cote d'Ivoire,7.54,-5.5471,81571,0,795,80776
3/10/22,Cote d'Ivoire,7.54,-5.5471,81571,0,795,80776
3/11/22,Cote d'Ivoire,7.54,-5.5471,81577,0,795,80782
3/12/22,Cote d'Ivoire,7.54,-5.5471,81594,0,796,80798
3/13/22,Cote d'Ivoire,7.54,-5.5471,81597,0,796,80801
3/14/22,Cote d'Ivoire,7.54,-5.5471,81598,0,796,80802
3/15/22,Cote d'Ivoire,7.54,-5.5471,81616,0,796,80820
3/16/22,Cote d'Ivoire,7.54,-5.5471,81626,0,796,80830
3/17/22,Cote d'Ivoire,7.54,-5.5471,81637,0,796,80841
3/18/22,Cote d'Ivoire,7.54,-5.5471,81643,0,796,80847
3/19/22,Cote d'Ivoire,7.54,-5.5471,81655,0,796,80859
3/20/22,Cote d'Ivoire,7.54,-5.5471,81655,0,796,80859
3/21/22,Cote d'Ivoire,7.54,-5.5471,81667,0,796,80871
3/22/22,Cote d'Ivoire,7.54,-5.5471,81671,0,796,80875
3/23/22,Cote d'Ivoire,7.54,-5.5471,81675,0,796,80879
3/24/22,Cote d'Ivoire,7.54,-5.5471,81680,0,796,80884
3/25/22,Cote d'Ivoire,7.54,-5.5471,81690,0,796,80894
3/26/22,Cote d'Ivoire,7.54,-5.5471,81697,0,796,80901
3/27/22,Cote d'Ivoire,7.54,-5.5471,81697,0,796,80901
3/28/22,Cote d'Ivoire,7.54,-5.5471,81714,0,796,80918
3/29/22,Cote d'Ivoire,7.54,-5.5471,81719,0,796,80923
3/30/22,Cote d'Ivoire,7.54,-5.5471,81722,0,796,80926
3/31/22,Cote d'Ivoire,7.54,-5.5471,81741,0,796,80945
4/1/22,Cote d'Ivoire,7.54,-5.5471,81741,0,796,80945
4/2/22,Cote d'Ivoire,7.54,-5.5471,81761,0,796,80965
4/3/22,Cote d'Ivoire,7.54,-5.5471,81761,0,796,80965
4/4/22,Cote d'Ivoire,7.54,-5.5471,81771,0,796,80975
4/5/22,Cote d'Ivoire,7.54,-5.5471,81780,0,796,80984
4/6/22,Cote d'Ivoire,7.54,-5.5471,81780,0,796,80984
4/7/22,Cote d'Ivoire,7.54,-5.5471,81800,0,796,81004
4/8/22,Cote d'Ivoire,7.54,-5.5471,81803,0,796,81007
4/9/22,Cote d'Ivoire,7.54,-5.5471,81814,0,796,81018
4/10/22,Cote d'Ivoire,7.54,-5.5471,81828,0,796,81032
4/11/22,Cote d'Ivoire,7.54,-5.5471,81829,0,797,81032
4/12/22,Cote d'Ivoire,7.54,-5.5471,81834,0,797,81037
4/13/22,Cote d'Ivoire,7.54,-5.5471,81838,0,797,81041
4/14/22,Cote d'Ivoire,7.54,-5.5471,81842,0,797,81045
4/15/22,Cote d'Ivoire,7.54,-5.5471,81849,0,797,81052
4/16/22,Cote d'Ivoire,7.54,-5.5471,81857,0,797,81060
4/17/22,Cote d'Ivoire,7.54,-5.5471,81857,0,797,81060
4/18/22,Cote d'Ivoire,7.54,-5.5471,81861,0,797,81064
4/19/22,Cote d'Ivoire,7.54,-5.5471,81861,0,797,81064
4/20/22,Cote d'Ivoire,7.54,-5.5471,81870,0,799,81071
4/21/22,Cote d'Ivoire,7.54,-5.5471,81875,0,799,81076
4/22/22,Cote d'Ivoire,7.54,-5.5471,81881,0,799,81082
4/23/22,Cote d'Ivoire,7.54,-5.5471,81887,0,799,81088
4/24/22,Cote d'Ivoire,7.54,-5.5471,81887,0,799,81088
4/25/22,Cote d'Ivoire,7.54,-5.5471,81898,0,799,81099
4/26/22,Cote d'Ivoire,7.54,-5.5471,81909,0,799,81110
4/27/22,Cote d'Ivoire,7.54,-5.5471,81913,0,799,81114
4/28/22,Cote d'Ivoire,7.54,-5.5471,81920,0,799,81121
4/29/22,Cote d'Ivoire,7.54,-5.5471,81930,0,799,81131
4/30/22,Cote d'Ivoire,7.54,-5.5471,81930,0,799,81131
5/1/22,Cote d'Ivoire,7.54,-5.5471,81957,0,799,81158
5/2/22,Cote d'Ivoire,7.54,-5.5471,81957,0,799,81158
5/3/22,Cote d'Ivoire,7.54,-5.5471,81959,0,799,81160
5/4/22,Cote d'Ivoire,7.54,-5.5471,81967,0,799,81168
5/5/22,Cote d'Ivoire,7.54,-5.5471,81968,0,799,81169
5/6/22,Cote d'Ivoire,7.54,-5.5471,81970,0,799,81171
5/7/22,Cote d'Ivoire,7.54,-5.5471,81970,0,799,81171
5/8/22,Cote d'Ivoire,7.54,-5.5471,81974,0,799,81175
5/9/22,Cote d'Ivoire,7.54,-5.5471,81974,0,799,81175
5/10/22,Cote d'Ivoire,7.54,-5.5471,81977,0,799,81178
5/11/22,Cote d'Ivoire,7.54,-5.5471,81977,0,799,81178
5/12/22,Cote d'Ivoire,7.54,-5.5471,81985,0,799,81186
5/13/22,Cote d'Ivoire,7.54,-5.5471,81989,0,799,81190
5/14/22,Cote d'Ivoire,7.54,-5.5471,81989,0,799,81190
5/15/22,Cote d'Ivoire,7.54,-5.5471,82001,0,799,81202
5/16/22,Cote d'Ivoire,7.54,-5.5471,82008,0,799,81209
5/17/22,Cote d'Ivoire,7.54,-5.5471,82008,0,799,81209
5/18/22,Cote d'Ivoire,7.54,-5.5471,82020,0,799,81221
5/19/22,Cote d'Ivoire,7.54,-5.5471,82034,0,799,81235
5/20/22,Cote d'Ivoire,7.54,-5.5471,82044,0,799,81245
5/21/22,Cote d'Ivoire,7.54,-5.5471,82044,0,799,81245
5/22/22,Cote d'Ivoire,7.54,-5.5471,82044,0,799,81245
5/23/22,Cote d'Ivoire,7.54,-5.5471,82070,0,799,81271
5/24/22,Cote d'Ivoire,7.54,-5.5471,82088,0,799,81289
5/25/22,Cote d'Ivoire,7.54,-5.5471,82116,0,799,81317
5/26/22,Cote d'Ivoire,7.54,-5.5471,82141,0,799,81342
5/27/22,Cote d'Ivoire,7.54,-5.5471,82155,0,799,81356
5/28/22,Cote d'Ivoire,7.54,-5.5471,82183,0,799,81384
5/29/22,Cote d'Ivoire,7.54,-5.5471,82193,0,799,81394
5/30/22,Cote d'Ivoire,7.54,-5.5471,82194,0,799,81395
5/31/22,Cote d'Ivoire,7.54,-5.5471,82215,0,799,81416
6/1/22,Cote d'Ivoire,7.54,-5.5471,82226,0,799,81427
6/2/22,Cote d'Ivoire,7.54,-5.5471,82226,0,799,81427
6/3/22,Cote d'Ivoire,7.54,-5.5471,82242,0,799,81443
6/4/22,Cote d'Ivoire,7.54,-5.5471,82280,0,799,81481
6/5/22,Cote d'Ivoire,7.54,-5.5471,82305,0,799,81506
6/6/22,Cote d'Ivoire,7.54,-5.5471,82309,0,799,81510
6/7/22,Cote d'Ivoire,7.54,-5.5471,82309,0,799,81510
6/8/22,Cote d'Ivoire,7.54,-5.5471,82347,0,799,81548
6/9/22,Cote d'Ivoire,7.54,-5.5471,82364,0,799,81565
6/10/22,Cote d'Ivoire,7.54,-5.5471,82393,0,799,81594
6/11/22,Cote d'Ivoire,7.54,-5.5471,82467,0,799,81668
6/12/22,Cote d'Ivoire,7.54,-5.5471,82487,0,799,81688
6/13/22,Cote d'Ivoire,7.54,-5.5471,82492,0,799,81693
6/14/22,Cote d'Ivoire,7.54,-5.5471,82492,0,799,81693
6/15/22,Cote d'Ivoire,7.54,-5.5471,82580,0,800,81780
6/16/22,Cote d'Ivoire,7.54,-5.5471,82614,0,800,81814
6/17/22,Cote d'Ivoire,7.54,-5.5471,82659,0,801,81858
6/18/22,Cote d'Ivoire,7.54,-5.5471,82659,0,801,81858
6/19/22,Cote d'Ivoire,7.54,-5.5471,82724,0,802,81922
6/20/22,Cote d'Ivoire,7.54,-5.5471,82743,0,802,81941
6/21/22,Cote d'Ivoire,7.54,-5.5471,82805,0,802,82003
6/22/22,Cote d'Ivoire,7.54,-5.5471,82842,0,804,82038
6/23/22,Cote d'Ivoire,7.54,-5.5471,82905,0,804,82101
6/24/22,Cote d'Ivoire,7.54,-5.5471,82953,0,804,82149
6/25/22,Cote d'Ivoire,7.54,-5.5471,82999,0,805,82194
6/26/22,Cote d'Ivoire,7.54,-5.5471,83049,0,805,82244
6/27/22,Cote d'Ivoire,7.54,-5.5471,83049,0,805,82244
6/28/22,Cote d'Ivoire,7.54,-5.5471,83049,0,805,82244
6/29/22,Cote d'Ivoire,7.54,-5.5471,83309,0,805,82504
6/30/22,Cote d'Ivoire,7.54,-5.5471,83463,0,805,82658
7/1/22,Cote d'Ivoire,7.54,-5.5471,83571,0,805,82766
7/2/22,Cote d'Ivoire,7.54,-5.5471,83637,0,805,82832
7/3/22,Cote d'Ivoire,7.54,-5.5471,83659,0,805,82854
7/4/22,Cote d'Ivoire,7.54,-5.5471,83679,0,805,82874
7/5/22,Cote d'Ivoire,7.54,-5.5471,83729,0,805,82924
7/6/22,Cote d'Ivoire,7.54,-5.5471,83823,0,805,83018
7/7/22,Cote d'Ivoire,7.54,-5.5471,83896,0,805,83091
7/8/22,Cote d'Ivoire,7.54,-5.5471,83979,0,805,83174
7/9/22,Cote d'Ivoire,7.54,-5.5471,84042,0,805,83237
7/10/22,Cote d'Ivoire,7.54,-5.5471,84079,0,805,83274
7/11/22,Cote d'Ivoire,7.54,-5.5471,84084,0,805,83279
7/12/22,Cote d'Ivoire,7.54,-5.5471,84165,0,806,83359
7/13/22,Cote d'Ivoire,7.54,-5.5471,84248,0,806,83442
7/14/22,Cote d'Ivoire,7.54,-5.5471,84347,0,806,83541
7/15/22,Cote d'Ivoire,7.54,-5.5471,84451,0,806,83645
7/16/22,Cote d'Ivoire,7.54,-5.5471,84501,0,806,83695
7/17/22,Cote d'Ivoire,7.54,-5.5471,84583,0,806,83777
7/18/22,Cote d'Ivoire,7.54,-5.5471,84616,0,808,83808
7/19/22,Cote d'Ivoire,7.54,-5.5471,84658,0,808,83850
7/20/22,Cote d'Ivoire,7.54,-5.5471,84742,0,808,83934
7/21/22,Cote d'Ivoire,7.54,-5.5471,84845,0,808,84037
7/22/22,Cote d'Ivoire,7.54,-5.5471,84889,0,809,84080
7/23/22,Cote d'Ivoire,7.54,-5.5471,84950,0,809,84141
7/24/22,Cote d'Ivoire,7.54,-5.5471,84982,0,810,84172
7/25/22,Cote d'Ivoire,7.54,-5.5471,84998,0,810,84188
7/26/22,Cote d'Ivoire,7.54,-5.5471,85055,0,810,84245
7/27/22,Cote d'Ivoire,7.54,-5.5471,85055,0,810,84245
7/28/22,Cote d'Ivoire,7.54,-5.5471,85055,0,810,84245
7/29/22,Cote d'Ivoire,7.54,-5.5471,85253,0,811,84442
7/30/22,Cote d'Ivoire,7.54,-5.5471,85306,0,811,84495
7/31/22,Cote d'Ivoire,7.54,-5.5471,85306,0,811,84495
8/1/22,Cote d'Ivoire,7.54,-5.5471,85368,0,811,84557
8/2/22,Cote d'Ivoire,7.54,-5.5471,85444,0,811,84633
8/3/22,Cote d'Ivoire,7.54,-5.5471,85520,0,811,84709
8/4/22,Cote d'Ivoire,7.54,-5.5471,85601,0,811,84790
8/5/22,Cote d'Ivoire,7.54,-5.5471,85676,0,811,84865
8/6/22,Cote d'Ivoire,7.54,-5.5471,85712,0,811,84901
8/7/22,Cote d'Ivoire,7.54,-5.5471,85712,0,811,84901
8/8/22,Cote d'Ivoire,7.54,-5.5471,85780,0,811,84969
8/9/22,Cote d'Ivoire,7.54,-5.5471,85794,0,811,84983
8/10/22,Cote d'Ivoire,7.54,-5.5471,85879,0,813,85066
8/11/22,Cote d'Ivoire,7.54,-5.5471,85966,0,815,85151
8/12/22,Cote d'Ivoire,7.54,-5.5471,86029,0,815,85214
8/13/22,Cote d'Ivoire,7.54,-5.5471,86092,0,815,85277
8/14/22,Cote d'Ivoire,7.54,-5.5471,86151,0,815,85336
8/15/22,Cote d'Ivoire,7.54,-5.5471,86183,0,817,85366
8/16/22,Cote d'Ivoire,7.54,-5.5471,86209,0,817,85392
8/17/22,Cote d'Ivoire,7.54,-5.5471,86256,0,817,85439
8/18/22,Cote d'Ivoire,7.54,-5.5471,86301,0,817,85484
8/19/22,Cote d'Ivoire,7.54,-5.5471,86372,0,817,85555
8/20/22,Cote d'Ivoire,7.54,-5.5471,86440,0,817,85623
8/21/22,Cote d'Ivoire,7.54,-5.5471,86440,0,817,85623
8/22/22,Cote d'Ivoire,7.54,-5.5471,86454,0,817,85637
8/23/22,Cote d'Ivoire,7.54,-5.5471,86511,0,817,85694
8/24/22,Cote d'Ivoire,7.54,-5.5471,86542,0,817,85725
8/25/22,Cote d'Ivoire,7.54,-5.5471,86542,0,817,85725
8/26/22,Cote d'Ivoire,7.54,-5.5471,86577,0,817,85760
8/27/22,Cote d'Ivoire,7.54,-5.5471,86606,0,817,85789
8/28/22,Cote d'Ivoire,7.54,-5.5471,86640,0,817,85823
8/29/22,Cote d'Ivoire,7.54,-5.5471,86650,0,817,85833
8/30/22,Cote d'Ivoire,7.54,-5.5471,86695,0,819,85876
8/31/22,Cote d'Ivoire,7.54,-5.5471,86738,0,819,85919
9/1/22,Cote d'Ivoire,7.54,-5.5471,86760,0,819,85941
9/2/22,Cote d'Ivoire,7.54,-5.5471,86779,0,819,85960
9/3/22,Cote d'Ivoire,7.54,-5.5471,86808,0,819,85989
9/4/22,Cote d'Ivoire,7.54,-5.5471,86821,0,819,86002
9/5/22,Cote d'Ivoire,7.54,-5.5471,86824,0,819,86005
9/6/22,Cote d'Ivoire,7.54,-5.5471,86840,0,820,86020
9/7/22,Cote d'Ivoire,7.54,-5.5471,86870,0,820,86050
9/8/22,Cote d'Ivoire,7.54,-5.5471,86885,0,821,86064
9/9/22,Cote d'Ivoire,7.54,-5.5471,86885,0,821,86064
9/10/22,Cote d'Ivoire,7.54,-5.5471,86919,0,822,86097
9/11/22,Cote d'Ivoire,7.54,-5.5471,86919,0,822,86097
9/12/22,Cote d'Ivoire,7.54,-5.5471,86941,0,822,86119
9/13/22,Cote d'Ivoire,7.54,-5.5471,86941,0,822,86119
9/14/22,Cote d'Ivoire,7.54,-5.5471,86941,0,822,86119
9/15/22,Cote d'Ivoire,7.54,-5.5471,86990,0,822,86168
9/16/22,Cote d'Ivoire,7.54,-5.5471,87009,0,822,86187
9/17/22,Cote d'Ivoire,7.54,-5.5471,87009,0,822,86187
9/18/22,Cote d'Ivoire,7.54,-5.5471,87031,0,822,86209
9/19/22,Cote d'Ivoire,7.54,-5.5471,87036,0,822,86214
9/20/22,Cote d'Ivoire,7.54,-5.5471,87073,0,823,86250
9/21/22,Cote d'Ivoire,7.54,-5.5471,87081,0,823,86258
9/22/22,Cote d'Ivoire,7.54,-5.5471,87094,0,823,86271
9/23/22,Cote d'Ivoire,7.54,-5.5471,87123,0,823,86300
9/24/22,Cote d'Ivoire,7.54,-5.5471,87129,0,823,86306
9/25/22,Cote d'Ivoire,7.54,-5.5471,87135,0,823,86312
9/26/22,Cote d'Ivoire,7.54,-5.5471,87135,0,823,86312
9/27/22,Cote d'Ivoire,7.54,-5.5471,87159,0,824,86335
9/28/22,Cote d'Ivoire,7.54,-5.5471,87159,0,824,86335
9/29/22,Cote d'Ivoire,7.54,-5.5471,87208,0,826,86382
9/30/22,Cote d'Ivoire,7.54,-5.5471,87208,0,826,86382
10/1/22,Cote d'Ivoire,7.54,-5.5471,87258,0,826,86432
10/2/22,Cote d'Ivoire,7.54,-5.5471,87282,0,826,86456
10/3/22,Cote d'Ivoire,7.54,-5.5471,87293,0,826,86467
10/4/22,Cote d'Ivoire,7.54,-5.5471,87316,0,826,86490
10/5/22,Cote d'Ivoire,7.54,-5.5471,87316,0,826,86490
10/6/22,Cote d'Ivoire,7.54,-5.5471,87374,0,826,86548
10/7/22,Cote d'Ivoire,7.54,-5.5471,87388,0,826,86562
10/8/22,Cote d'Ivoire,7.54,-5.5471,87422,0,826,86596
10/9/22,Cote d'Ivoire,7.54,-5.5471,87428,0,826,86602
10/10/22,Cote d'Ivoire,7.54,-5.5471,87438,0,826,86612
10/11/22,Cote d'Ivoire,7.54,-5.5471,87455,0,826,86629
10/12/22,Cote d'Ivoire,7.54,-5.5471,87490,0,826,86664
10/13/22,Cote d'Ivoire,7.54,-5.5471,87509,0,826,86683
10/14/22,Cote d'Ivoire,7.54,-5.5471,87509,0,826,86683
10/15/22,Cote d'Ivoire,7.54,-5.5471,87535,0,827,86708
10/16/22,Cote d'Ivoire,7.54,-5.5471,87598,0,827,86771
10/17/22,Cote d'Ivoire,7.54,-5.5471,87602,0,827,86775
10/18/22,Cote d'Ivoire,7.54,-5.5471,87602,0,827,86775
10/19/22,Cote d'Ivoire,7.54,-5.5471,87657,0,827,86830
10/20/22,Cote d'Ivoire,7.54,-5.5471,87676,0,827,86849
10/21/22,Cote d'Ivoire,7.54,-5.5471,87691,0,827,86864
10/22/22,Cote d'Ivoire,7.54,-5.5471,87693,0,827,86866
10/23/22,Cote d'Ivoire,7.54,-5.5471,87700,0,827,86873
10/24/22,Cote d'Ivoire,7.54,-5.5471,87700,0,827,86873
10/25/22,Cote d'Ivoire,7.54,-5.5471,87720,0,827,86893
10/26/22,Cote d'Ivoire,7.54,-5.5471,87720,0,827,86893
10/27/22,Cote d'Ivoire,7.54,-5.5471,87731,0,827,86904
10/28/22,Cote d'Ivoire,7.54,-5.5471,87753,0,827,86926
10/29/22,Cote d'Ivoire,7.54,-5.5471,87753,0,827,86926
10/30/22,Cote d'Ivoire,7.54,-5.5471,87773,0,827,86946
10/31/22,Cote d'Ivoire,7.54,-5.5471,87774,0,827,86947
11/1/22,Cote d'Ivoire,7.54,-5.5471,87781,0,827,86954
11/2/22,Cote d'Ivoire,7.54,-5.5471,87781,0,827,86954
11/3/22,Cote d'Ivoire,7.54,-5.5471,87822,0,828,86994
11/4/22,Cote d'Ivoire,7.54,-5.5471,87824,0,829,86995
11/5/22,Cote d'Ivoire,7.54,-5.5471,87830,0,829,87001
11/6/22,Cote d'Ivoire,7.54,-5.5471,87830,0,829,87001
11/7/22,Cote d'Ivoire,7.54,-5.5471,87830,0,829,87001
11/8/22,Cote d'Ivoire,7.54,-5.5471,87839,0,829,87010
11/9/22,Cote d'Ivoire,7.54,-5.5471,87839,0,829,87010
11/10/22,Cote d'Ivoire,7.54,-5.5471,87847,0,829,87018
11/11/22,Cote d'Ivoire,7.54,-5.5471,87851,0,829,87022
11/12/22,Cote d'Ivoire,7.54,-5.5471,87851,0,829,87022
11/13/22,Cote d'Ivoire,7.54,-5.5471,87851,0,829,87022
11/14/22,Cote d'Ivoire,7.54,-5.5471,87860,0,829,87031
11/15/22,Cote d'Ivoire,7.54,-5.5471,87860,0,829,87031
11/16/22,Cote d'Ivoire,7.54,-5.5471,87864,0,829,87035
11/17/22,Cote d'Ivoire,7.54,-5.5471,87864,0,829,87035
11/18/22,Cote d'Ivoire,7.54,-5.5471,87864,0,829,87035
11/19/22,Cote d'Ivoire,7.54,-5.5471,87870,0,830,87040
11/20/22,Cote d'Ivoire,7.54,-5.5471,87870,0,830,87040
11/21/22,Cote d'Ivoire,7.54,-5.5471,87870,0,830,87040
11/22/22,Cote d'Ivoire,7.54,-5.5471,87881,0,830,87051
11/23/22,Cote d'Ivoire,7.54,-5.5471,87882,0,830,87052
11/24/22,Cote d'Ivoire,7.54,-5.5471,87883,0,830,87053
11/25/22,Cote d'Ivoire,7.54,-5.5471,87883,0,830,87053
11/26/22,Cote d'Ivoire,7.54,-5.5471,87885,0,830,87055
11/27/22,Cote d'Ivoire,7.54,-5.5471,87885,0,830,87055
11/28/22,Cote d'Ivoire,7.54,-5.5471,87885,0,830,87055
11/29/22,Cote d'Ivoire,7.54,-5.5471,87885,0,830,87055
11/30/22,Cote d'Ivoire,7.54,-5.5471,87885,0,830,87055
12/1/22,Cote d'Ivoire,7.54,-5.5471,87887,0,830,87057
12/2/22,Cote d'Ivoire,7.54,-5.5471,87887,0,830,87057
12/3/22,Cote d'Ivoire,7.54,-5.5471,87887,0,830,87057
12/4/22,Cote d'Ivoire,7.54,-5.5471,87888,0,830,87058
12/5/22,Cote d'Ivoire,7.54,-5.5471,87889,0,830,87059
12/6/22,Cote d'Ivoire,7.54,-5.5471,87890,0,830,87060
12/7/22,Cote d'Ivoire,7.54,-5.5471,87891,0,830,87061
12/8/22,Cote d'Ivoire,7.54,-5.5471,87891,0,830,87061
12/9/22,Cote d'Ivoire,7.54,-5.5471,87892,0,830,87062
12/10/22,Cote d'Ivoire,7.54,-5.5471,87894,0,830,87064
12/11/22,Cote d'Ivoire,7.54,-5.5471,87894,0,830,87064
12/12/22,Cote d'Ivoire,7.54,-5.5471,87894,0,830,87064
12/13/22,Cote d'Ivoire,7.54,-5.5471,87902,0,830,87072
12/14/22,Cote d'Ivoire,7.54,-5.5471,87902,0,830,87072
12/15/22,Cote d'Ivoire,7.54,-5.5471,87909,0,830,87079
12/16/22,Cote d'Ivoire,7.54,-5.5471,87909,0,830,87079
12/17/22,Cote d'Ivoire,7.54,-5.5471,87911,0,830,87081
1/1/22,Croatia,45.1,15.2,720538,0,12571,707967
1/2/22,Croatia,45.1,15.2,720951,0,12609,708342
1/3/22,Croatia,45.1,15.2,722054,0,12653,709401
1/4/22,Croatia,45.1,15.2,727899,0,12699,715200
1/5/22,Croatia,45.1,15.2,736486,0,12731,723755
1/6/22,Croatia,45.1,15.2,745544,0,12764,732780
1/7/22,Croatia,45.1,15.2,749455,0,12805,736650
1/8/22,Croatia,45.1,15.2,758272,0,12841,745431
1/9/22,Croatia,45.1,15.2,765605,0,12878,752727
1/10/22,Croatia,45.1,15.2,767183,0,12918,754265
1/11/22,Croatia,45.1,15.2,775139,0,12956,762183
1/12/22,Croatia,45.1,15.2,785033,0,12983,772050
1/13/22,Croatia,45.1,15.2,794190,0,13006,781184
1/14/22,Croatia,45.1,15.2,802745,0,13038,789707
1/15/22,Croatia,45.1,15.2,811703,0,13073,798630
1/16/22,Croatia,45.1,15.2,817435,0,13118,804317
1/17/22,Croatia,45.1,15.2,818832,0,13157,805675
1/18/22,Croatia,45.1,15.2,826380,0,13212,813168
1/19/22,Croatia,45.1,15.2,836807,0,13257,823550
1/20/22,Croatia,45.1,15.2,848150,0,13300,834850
1/21/22,Croatia,45.1,15.2,859264,0,13335,845929
1/22/22,Croatia,45.1,15.2,869965,0,13371,856594
1/23/22,Croatia,45.1,15.2,877060,0,13407,863653
1/24/22,Croatia,45.1,15.2,878891,0,13451,865440
1/25/22,Croatia,45.1,15.2,887362,0,13502,873860
1/26/22,Croatia,45.1,15.2,899174,0,13566,885608
1/27/22,Croatia,45.1,15.2,909674,0,13625,896049
1/28/22,Croatia,45.1,15.2,919598,0,13690,905908
1/29/22,Croatia,45.1,15.2,929502,0,13731,915771
1/30/22,Croatia,45.1,15.2,935722,0,13777,921945
1/31/22,Croatia,45.1,15.2,937167,0,13827,923340
2/1/22,Croatia,45.1,15.2,944552,0,13893,930659
2/2/22,Croatia,45.1,15.2,954555,0,13947,940608
2/3/22,Croatia,45.1,15.2,963370,0,13989,949381
2/4/22,Croatia,45.1,15.2,971464,0,14035,957429
2/5/22,Croatia,45.1,15.2,979000,0,14078,964922
2/6/22,Croatia,45.1,15.2,983780,0,14137,969643
2/7/22,Croatia,45.1,15.2,985050,0,14194,970856
2/8/22,Croatia,45.1,15.2,990595,0,14244,976351
2/9/22,Croatia,45.1,15.2,998463,0,14281,984182
2/10/22,Croatia,45.1,15.2,1004804,0,14329,990475
2/11/22,Croatia,45.1,15.2,1009973,0,14373,995600
2/12/22,Croatia,45.1,15.2,1015185,0,14424,1000761
2/13/22,Croatia,45.1,15.2,1017915,0,14473,1003442
2/14/22,Croatia,45.1,15.2,1018367,0,14537,1003830
2/15/22,Croatia,45.1,15.2,1021777,0,14584,1007193
2/16/22,Croatia,45.1,15.2,1027572,0,14632,1012940
2/17/22,Croatia,45.1,15.2,1032033,0,14679,1017354
2/18/22,Croatia,45.1,15.2,1035632,0,14729,1020903
2/19/22,Croatia,45.1,15.2,1039157,0,14773,1024384
2/20/22,Croatia,45.1,15.2,1041212,0,14815,1026397
2/21/22,Croatia,45.1,15.2,1041524,0,14869,1026655
2/22/22,Croatia,45.1,15.2,1043334,0,14905,1028429
2/23/22,Croatia,45.1,15.2,1047108,0,14942,1032166
2/24/22,Croatia,45.1,15.2,1049667,0,14964,1034703
2/25/22,Croatia,45.1,15.2,1051697,0,14990,1036707
2/26/22,Croatia,45.1,15.2,1053568,0,15012,1038556
2/27/22,Croatia,45.1,15.2,1054596,0,15030,1039566
2/28/22,Croatia,45.1,15.2,1054794,0,15069,1039725
3/1/22,Croatia,45.1,15.2,1055943,0,15101,1040842
3/2/22,Croatia,45.1,15.2,1058453,0,15122,1043331
3/3/22,Croatia,45.1,15.2,1060078,0,15145,1044933
3/4/22,Croatia,45.1,15.2,1061429,0,15172,1046257
3/5/22,Croatia,45.1,15.2,1062953,0,15194,1047759
3/6/22,Croatia,45.1,15.2,1063828,0,15214,1048614
3/7/22,Croatia,45.1,15.2,1063985,0,15234,1048751
3/8/22,Croatia,45.1,15.2,1065001,0,15250,1049751
3/9/22,Croatia,45.1,15.2,1067589,0,15276,1052313
3/10/22,Croatia,45.1,15.2,1069317,0,15294,1054023
3/11/22,Croatia,45.1,15.2,1070855,0,15308,1055547
3/12/22,Croatia,45.1,15.2,1072430,0,15321,1057109
3/13/22,Croatia,45.1,15.2,1073386,0,15336,1058050
3/14/22,Croatia,45.1,15.2,1073527,0,15354,1058173
3/15/22,Croatia,45.1,15.2,1074706,0,15373,1059333
3/16/22,Croatia,45.1,15.2,1077365,0,15383,1061982
3/17/22,Croatia,45.1,15.2,1079397,0,15392,1064005
3/18/22,Croatia,45.1,15.2,1081336,0,15410,1065926
3/19/22,Croatia,45.1,15.2,1083111,0,15425,1067686
3/20/22,Croatia,45.1,15.2,1084012,0,15435,1068577
3/21/22,Croatia,45.1,15.2,1084304,0,15451,1068853
3/22/22,Croatia,45.1,15.2,1085558,0,15463,1070095
3/23/22,Croatia,45.1,15.2,1087635,0,15476,1072159
3/24/22,Croatia,45.1,15.2,1089696,0,15485,1074211
3/25/22,Croatia,45.1,15.2,1091511,0,15495,1076016
3/26/22,Croatia,45.1,15.2,1093098,0,15509,1077589
3/27/22,Croatia,45.1,15.2,1094059,0,15520,1078539
3/28/22,Croatia,45.1,15.2,1094202,0,15534,1078668
3/29/22,Croatia,45.1,15.2,1095115,0,15548,1079567
3/30/22,Croatia,45.1,15.2,1097409,0,15563,1081846
3/31/22,Croatia,45.1,15.2,1099176,0,15563,1083613
4/1/22,Croatia,45.1,15.2,1100618,0,15584,1085034
4/2/22,Croatia,45.1,15.2,1101921,0,15592,1086329
4/3/22,Croatia,45.1,15.2,1102730,0,15601,1087129
4/4/22,Croatia,45.1,15.2,1102827,0,15619,1087208
4/5/22,Croatia,45.1,15.2,1103662,0,15634,1088028
4/6/22,Croatia,45.1,15.2,1105315,0,15646,1089669
4/7/22,Croatia,45.1,15.2,1106557,0,15652,1090905
4/8/22,Croatia,45.1,15.2,1107648,0,15660,1091988
4/9/22,Croatia,45.1,15.2,1108551,0,15675,1092876
4/10/22,Croatia,45.1,15.2,1109066,0,15685,1093381
4/11/22,Croatia,45.1,15.2,1109148,0,15694,1093454
4/12/22,Croatia,45.1,15.2,1109847,0,15702,1094145
4/13/22,Croatia,45.1,15.2,1110989,0,15707,1095282
4/14/22,Croatia,45.1,15.2,1111823,0,15715,1096108
4/15/22,Croatia,45.1,15.2,1112491,0,15720,1096771
4/16/22,Croatia,45.1,15.2,1113135,0,15725,1097410
4/17/22,Croatia,45.1,15.2,1113517,0,15735,1097782
4/18/22,Croatia,45.1,15.2,1113547,0,15742,1097805
4/19/22,Croatia,45.1,15.2,1113663,0,15752,1097911
4/20/22,Croatia,45.1,15.2,1114141,0,15757,1098384
4/21/22,Croatia,45.1,15.2,1115442,0,15765,1099677
4/22/22,Croatia,45.1,15.2,1116281,0,15772,1100509
4/23/22,Croatia,45.1,15.2,1117175,0,15778,1101397
4/24/22,Croatia,45.1,15.2,1117735,0,15782,1101953
4/25/22,Croatia,45.1,15.2,1117822,0,15790,1102032
4/26/22,Croatia,45.1,15.2,1118526,0,15801,1102725
4/27/22,Croatia,45.1,15.2,1119916,0,15808,1104108
4/28/22,Croatia,45.1,15.2,1120766,0,15817,1104949
4/29/22,Croatia,45.1,15.2,1121662,0,15822,1105840
4/30/22,Croatia,45.1,15.2,1122459,0,15828,1106631
5/1/22,Croatia,45.1,15.2,1122982,0,15835,1107147
5/2/22,Croatia,45.1,15.2,1123029,0,15843,1107186
5/3/22,Croatia,45.1,15.2,1123578,0,15848,1107730
5/4/22,Croatia,45.1,15.2,1124762,0,15856,1108906
5/5/22,Croatia,45.1,15.2,1125723,0,15865,1109858
5/6/22,Croatia,45.1,15.2,1126501,0,15874,1110627
5/7/22,Croatia,45.1,15.2,1127336,0,15881,1111455
5/8/22,Croatia,45.1,15.2,1127742,0,15888,1111854
5/9/22,Croatia,45.1,15.2,1127799,0,15896,1111903
5/10/22,Croatia,45.1,15.2,1128239,0,15899,1112340
5/11/22,Croatia,45.1,15.2,1129199,0,15905,1113294
5/12/22,Croatia,45.1,15.2,1129836,0,15912,1113924
5/13/22,Croatia,45.1,15.2,1130562,0,15920,1114642
5/14/22,Croatia,45.1,15.2,1131105,0,15925,1115180
5/15/22,Croatia,45.1,15.2,1131450,0,15930,1115520
5/16/22,Croatia,45.1,15.2,1131492,0,15942,1115550
5/17/22,Croatia,45.1,15.2,1131898,0,15944,1115954
5/18/22,Croatia,45.1,15.2,1132671,0,15945,1116726
5/19/22,Croatia,45.1,15.2,1133139,0,15950,1117189
5/20/22,Croatia,45.1,15.2,1133565,0,15954,1117611
5/21/22,Croatia,45.1,15.2,1134027,0,15961,1118066
5/22/22,Croatia,45.1,15.2,1134232,0,15966,1118266
5/23/22,Croatia,45.1,15.2,1134269,0,15968,1118301
5/24/22,Croatia,45.1,15.2,1134541,0,15970,1118571
5/25/22,Croatia,45.1,15.2,1135128,0,15973,1119155
5/26/22,Croatia,45.1,15.2,1135549,0,15978,1119571
5/27/22,Croatia,45.1,15.2,1135874,0,15978,1119896
5/28/22,Croatia,45.1,15.2,1136229,0,15979,1120250
5/29/22,Croatia,45.1,15.2,1136417,0,15983,1120434
5/30/22,Croatia,45.1,15.2,1136453,0,15984,1120469
5/31/22,Croatia,45.1,15.2,1136500,0,15987,1120513
6/1/22,Croatia,45.1,15.2,1136706,0,15991,1120715
6/2/22,Croatia,45.1,15.2,1137192,0,15995,1121197
6/3/22,Croatia,45.1,15.2,1137597,0,15998,1121599
6/4/22,Croatia,45.1,15.2,1137864,0,15998,1121866
6/5/22,Croatia,45.1,15.2,1138046,0,15998,1122048
6/6/22,Croatia,45.1,15.2,1138076,0,16003,1122073
6/7/22,Croatia,45.1,15.2,1138278,0,16004,1122274
6/8/22,Croatia,45.1,15.2,1138702,0,16007,1122695
6/9/22,Croatia,45.1,15.2,1139034,0,16012,1123022
6/10/22,Croatia,45.1,15.2,1139319,0,16014,1123305
6/11/22,Croatia,45.1,15.2,1139612,0,16016,1123596
6/12/22,Croatia,45.1,15.2,1139816,0,16019,1123797
6/13/22,Croatia,45.1,15.2,1139835,0,16019,1123816
6/14/22,Croatia,45.1,15.2,1140078,0,16020,1124058
6/15/22,Croatia,45.1,15.2,1140625,0,16022,1124603
6/16/22,Croatia,45.1,15.2,1141047,0,16022,1125025
6/17/22,Croatia,45.1,15.2,1141115,0,16024,1125091
6/18/22,Croatia,45.1,15.2,1141546,0,16027,1125519
6/19/22,Croatia,45.1,15.2,1141919,0,16030,1125889
6/20/22,Croatia,45.1,15.2,1141948,0,16031,1125917
6/21/22,Croatia,45.1,15.2,1142345,0,16035,1126310
6/22/22,Croatia,45.1,15.2,1143179,0,16039,1127140
6/23/22,Croatia,45.1,15.2,1143354,0,16043,1127311
6/24/22,Croatia,45.1,15.2,1143966,0,16047,1127919
6/25/22,Croatia,45.1,15.2,1145053,0,16048,1129005
6/26/22,Croatia,45.1,15.2,1145490,0,16050,1129440
6/27/22,Croatia,45.1,15.2,1145521,0,16052,1129469
6/28/22,Croatia,45.1,15.2,1146183,0,16059,1130124
6/29/22,Croatia,45.1,15.2,1147380,0,16060,1131320
6/30/22,Croatia,45.1,15.2,1148528,0,16065,1132463
7/1/22,Croatia,45.1,15.2,1149575,0,16070,1133505
7/2/22,Croatia,45.1,15.2,1150653,0,16073,1134580
7/3/22,Croatia,45.1,15.2,1151466,0,16079,1135387
7/4/22,Croatia,45.1,15.2,1151523,0,16082,1135441
7/5/22,Croatia,45.1,15.2,1152335,0,16089,1136246
7/6/22,Croatia,45.1,15.2,1154129,0,16093,1138036
7/7/22,Croatia,45.1,15.2,1155583,0,16096,1139487
7/8/22,Croatia,45.1,15.2,1156932,0,16101,1140831
7/9/22,Croatia,45.1,15.2,1158420,0,16103,1142317
7/10/22,Croatia,45.1,15.2,1159177,0,16107,1143070
7/11/22,Croatia,45.1,15.2,1159241,0,16118,1143123
7/12/22,Croatia,45.1,15.2,1160253,0,16124,1144129
7/13/22,Croatia,45.1,15.2,1162061,0,16130,1145931
7/14/22,Croatia,45.1,15.2,1163824,0,16135,1147689
7/15/22,Croatia,45.1,15.2,1165478,0,16143,1149335
7/16/22,Croatia,45.1,15.2,1167132,0,16147,1150985
7/17/22,Croatia,45.1,15.2,1168111,0,16156,1151955
7/18/22,Croatia,45.1,15.2,1168191,0,16158,1152033
7/19/22,Croatia,45.1,15.2,1169342,0,16169,1153173
7/20/22,Croatia,45.1,15.2,1171581,0,16181,1155400
7/21/22,Croatia,45.1,15.2,1173374,0,16188,1157186
7/22/22,Croatia,45.1,15.2,1174865,0,16198,1158667
7/23/22,Croatia,45.1,15.2,1176519,0,16206,1160313
7/24/22,Croatia,45.1,15.2,1177595,0,16217,1161378
7/25/22,Croatia,45.1,15.2,1177692,0,16235,1161457
7/26/22,Croatia,45.1,15.2,1178958,0,16249,1162709
7/27/22,Croatia,45.1,15.2,1180857,0,16265,1164592
7/28/22,Croatia,45.1,15.2,1182836,0,16277,1166559
7/29/22,Croatia,45.1,15.2,1184303,0,16288,1168015
7/30/22,Croatia,45.1,15.2,1185799,0,16300,1169499
7/31/22,Croatia,45.1,15.2,1186739,0,16313,1170426
8/1/22,Croatia,45.1,15.2,1186787,0,16326,1170461
8/2/22,Croatia,45.1,15.2,1187825,0,16336,1171489
8/3/22,Croatia,45.1,15.2,1189593,0,16350,1173243
8/4/22,Croatia,45.1,15.2,1191079,0,16365,1174714
8/5/22,Croatia,45.1,15.2,1192305,0,16379,1175926
8/6/22,Croatia,45.1,15.2,1192555,0,16389,1176166
8/7/22,Croatia,45.1,15.2,1193298,0,16401,1176897
8/8/22,Croatia,45.1,15.2,1193362,0,16420,1176942
8/9/22,Croatia,45.1,15.2,1194349,0,16434,1177915
8/10/22,Croatia,45.1,15.2,1196221,0,16446,1179775
8/11/22,Croatia,45.1,15.2,1197804,0,16461,1181343
8/12/22,Croatia,45.1,15.2,1198898,0,16472,1182426
8/13/22,Croatia,45.1,15.2,1200113,0,16484,1183629
8/14/22,Croatia,45.1,15.2,1200742,0,16496,1184246
8/15/22,Croatia,45.1,15.2,1200807,0,16508,1184299
8/16/22,Croatia,45.1,15.2,1200972,0,16520,1184452
8/17/22,Croatia,45.1,15.2,1201743,0,16528,1185215
8/18/22,Croatia,45.1,15.2,1203617,0,16545,1187072
8/19/22,Croatia,45.1,15.2,1204642,0,16552,1188090
8/20/22,Croatia,45.1,15.2,1205948,0,16559,1189389
8/21/22,Croatia,45.1,15.2,1206587,0,16571,1190016
8/22/22,Croatia,45.1,15.2,1206633,0,16579,1190054
8/23/22,Croatia,45.1,15.2,1207353,0,16595,1190758
8/24/22,Croatia,45.1,15.2,1208529,0,16612,1191917
8/25/22,Croatia,45.1,15.2,1209580,0,16622,1192958
8/26/22,Croatia,45.1,15.2,1210431,0,16639,1193792
8/27/22,Croatia,45.1,15.2,1211419,0,16646,1194773
8/28/22,Croatia,45.1,15.2,1211920,0,16658,1195262
8/29/22,Croatia,45.1,15.2,1211979,0,16673,1195306
8/30/22,Croatia,45.1,15.2,1212547,0,16690,1195857
8/31/22,Croatia,45.1,15.2,1213658,0,16702,1196956
9/1/22,Croatia,45.1,15.2,1214579,0,16712,1197867
9/2/22,Croatia,45.1,15.2,1215271,0,16724,1198547
9/3/22,Croatia,45.1,15.2,1215999,0,16735,1199264
9/4/22,Croatia,45.1,15.2,1216429,0,16739,1199690
9/5/22,Croatia,45.1,15.2,1216456,0,16746,1199710
9/6/22,Croatia,45.1,15.2,1216935,0,16756,1200179
9/7/22,Croatia,45.1,15.2,1217869,0,16761,1201108
9/8/22,Croatia,45.1,15.2,1218663,0,16772,1201891
9/9/22,Croatia,45.1,15.2,1218663,0,16772,1201891
9/10/22,Croatia,45.1,15.2,1220015,0,16792,1203223
9/11/22,Croatia,45.1,15.2,1220456,0,16797,1203659
9/12/22,Croatia,45.1,15.2,1220490,0,16806,1203684
9/13/22,Croatia,45.1,15.2,1220986,0,16813,1204173
9/14/22,Croatia,45.1,15.2,1222007,0,16817,1205190
9/15/22,Croatia,45.1,15.2,1222914,0,16827,1206087
9/16/22,Croatia,45.1,15.2,1223641,0,16834,1206807
9/17/22,Croatia,45.1,15.2,1224366,0,16837,1207529
9/18/22,Croatia,45.1,15.2,1224837,0,16840,1207997
9/19/22,Croatia,45.1,15.2,1224885,0,16849,1208036
9/20/22,Croatia,45.1,15.2,1225365,0,16854,1208511
9/21/22,Croatia,45.1,15.2,1226323,0,16854,1209469
9/22/22,Croatia,45.1,15.2,1227197,0,16861,1210336
9/23/22,Croatia,45.1,15.2,1227852,0,16867,1210985
9/24/22,Croatia,45.1,15.2,1228574,0,16875,1211699
9/25/22,Croatia,45.1,15.2,1229014,0,16877,1212137
9/26/22,Croatia,45.1,15.2,1229044,0,16881,1212163
9/27/22,Croatia,45.1,15.2,1229570,0,16887,1212683
9/28/22,Croatia,45.1,15.2,1230666,0,16892,1213774
9/29/22,Croatia,45.1,15.2,1231575,0,16902,1214673
9/30/22,Croatia,45.1,15.2,1232379,0,16908,1215471
10/1/22,Croatia,45.1,15.2,1233260,0,16912,1216348
10/2/22,Croatia,45.1,15.2,1233728,0,16914,1216814
10/3/22,Croatia,45.1,15.2,1233787,0,16922,1216865
10/4/22,Croatia,45.1,15.2,1234358,0,16930,1217428
10/5/22,Croatia,45.1,15.2,1235379,0,16937,1218442
10/6/22,Croatia,45.1,15.2,1236319,0,16942,1219377
10/7/22,Croatia,45.1,15.2,1236915,0,16953,1219962
10/8/22,Croatia,45.1,15.2,1237687,0,16959,1220728
10/9/22,Croatia,45.1,15.2,1238117,0,16965,1221152
10/10/22,Croatia,45.1,15.2,1238160,0,16980,1221180
10/11/22,Croatia,45.1,15.2,1238556,0,16986,1221570
10/12/22,Croatia,45.1,15.2,1239496,0,16994,1222502
10/13/22,Croatia,45.1,15.2,1240232,0,16999,1223233
10/14/22,Croatia,45.1,15.2,1240813,0,17006,1223807
10/15/22,Croatia,45.1,15.2,1241383,0,17012,1224371
10/16/22,Croatia,45.1,15.2,1241764,0,17023,1224741
10/17/22,Croatia,45.1,15.2,1241791,0,17032,1224759
10/18/22,Croatia,45.1,15.2,1242154,0,17039,1225115
10/19/22,Croatia,45.1,15.2,1242909,0,17046,1225863
10/20/22,Croatia,45.1,15.2,1243500,0,17053,1226447
10/21/22,Croatia,45.1,15.2,1243928,0,17060,1226868
10/22/22,Croatia,45.1,15.2,1244365,0,17070,1227295
10/23/22,Croatia,45.1,15.2,1244642,0,17076,1227566
10/24/22,Croatia,45.1,15.2,1244692,0,17085,1227607
10/25/22,Croatia,45.1,15.2,1244975,0,17096,1227879
10/26/22,Croatia,45.1,15.2,1245552,0,17109,1228443
10/27/22,Croatia,45.1,15.2,1246045,0,17117,1228928
10/28/22,Croatia,45.1,15.2,1246375,0,17121,1229254
10/29/22,Croatia,45.1,15.2,1246731,0,17128,1229603
10/30/22,Croatia,45.1,15.2,1246920,0,17136,1229784
10/31/22,Croatia,45.1,15.2,1246947,0,17142,1229805
11/1/22,Croatia,45.1,15.2,1247199,0,17147,1230052
11/2/22,Croatia,45.1,15.2,1247242,0,17156,1230086
11/3/22,Croatia,45.1,15.2,1247678,0,17165,1230513
11/4/22,Croatia,45.1,15.2,1248133,0,17176,1230957
11/5/22,Croatia,45.1,15.2,1248450,0,17185,1231265
11/6/22,Croatia,45.1,15.2,1248609,0,17191,1231418
11/7/22,Croatia,45.1,15.2,1248635,0,17194,1231441
11/8/22,Croatia,45.1,15.2,1248864,0,17200,1231664
11/9/22,Croatia,45.1,15.2,1249239,0,17205,1232034
11/10/22,Croatia,45.1,15.2,1249502,0,17212,1232290
11/11/22,Croatia,45.1,15.2,1249699,0,17215,1232484
11/12/22,Croatia,45.1,15.2,1249943,0,17218,1232725
11/13/22,Croatia,45.1,15.2,1250099,0,17223,1232876
11/14/22,Croatia,45.1,15.2,1250131,0,17233,1232898
11/15/22,Croatia,45.1,15.2,1250299,0,17238,1233061
11/16/22,Croatia,45.1,15.2,1250699,0,17244,1233455
11/17/22,Croatia,45.1,15.2,1250968,0,17249,1233719
11/18/22,Croatia,45.1,15.2,1251199,0,17254,1233945
11/19/22,Croatia,45.1,15.2,1251225,0,17260,1233965
11/20/22,Croatia,45.1,15.2,1251415,0,17263,1234152
11/21/22,Croatia,45.1,15.2,1251441,0,17268,1234173
11/22/22,Croatia,45.1,15.2,1251655,0,17268,1234387
11/23/22,Croatia,45.1,15.2,1252036,0,17278,1234758
11/24/22,Croatia,45.1,15.2,1252367,0,17282,1235085
11/25/22,Croatia,45.1,15.2,1252608,0,17288,1235320
11/26/22,Croatia,45.1,15.2,1252886,0,17292,1235594
11/27/22,Croatia,45.1,15.2,1253067,0,17298,1235769
11/28/22,Croatia,45.1,15.2,1253087,0,17306,1235781
11/29/22,Croatia,45.1,15.2,1253306,0,17312,1235994
11/30/22,Croatia,45.1,15.2,1253761,0,17316,1236445
12/1/22,Croatia,45.1,15.2,1254083,0,17330,1236753
12/2/22,Croatia,45.1,15.2,1254355,0,17334,1237021
12/3/22,Croatia,45.1,15.2,1254644,0,17339,1237305
12/4/22,Croatia,45.1,15.2,1254814,0,17348,1237466
12/5/22,Croatia,45.1,15.2,1254857,0,17348,1237509
12/6/22,Croatia,45.1,15.2,1255155,0,17364,1237791
12/7/22,Croatia,45.1,15.2,1255643,0,17371,1238272
12/8/22,Croatia,45.1,15.2,1256073,0,17379,1238694
12/9/22,Croatia,45.1,15.2,1256445,0,17389,1239056
12/10/22,Croatia,45.1,15.2,1256818,0,17396,1239422
12/11/22,Croatia,45.1,15.2,1257061,0,17400,1239661
12/12/22,Croatia,45.1,15.2,1257099,0,17415,1239684
12/13/22,Croatia,45.1,15.2,1257412,0,17427,1239985
12/14/22,Croatia,45.1,15.2,1257989,0,17429,1240560
12/15/22,Croatia,45.1,15.2,1258420,0,17435,1240985
12/16/22,Croatia,45.1,15.2,1258740,0,17445,1241295
12/17/22,Croatia,45.1,15.2,1259113,0,17447,1241666
1/1/22,Cuba,21.521757,-77.781167,966473,0,8323,958150
1/2/22,Cuba,21.521757,-77.781167,966942,0,8324,958618
1/3/22,Cuba,21.521757,-77.781167,967498,0,8324,959174
1/4/22,Cuba,21.521757,-77.781167,968171,0,8324,959847
1/5/22,Cuba,21.521757,-77.781167,969138,0,8324,960814
1/6/22,Cuba,21.521757,-77.781167,970567,0,8325,962242
1/7/22,Cuba,21.521757,-77.781167,972513,0,8325,964188
1/8/22,Cuba,21.521757,-77.781167,974687,0,8326,966361
1/9/22,Cuba,21.521757,-77.781167,977410,0,8328,969082
1/10/22,Cuba,21.521757,-77.781167,979929,0,8329,971600
1/11/22,Cuba,21.521757,-77.781167,982614,0,8330,974284
1/12/22,Cuba,21.521757,-77.781167,985402,0,8330,977072
1/13/22,Cuba,21.521757,-77.781167,988789,0,8331,980458
1/14/22,Cuba,21.521757,-77.781167,992125,0,8332,983793
1/15/22,Cuba,21.521757,-77.781167,995631,0,8335,987296
1/16/22,Cuba,21.521757,-77.781167,999193,0,8340,990853
1/17/22,Cuba,21.521757,-77.781167,1002499,0,8341,994158
1/18/22,Cuba,21.521757,-77.781167,1005649,0,8345,997304
1/19/22,Cuba,21.521757,-77.781167,1008616,0,8348,1000268
1/20/22,Cuba,21.521757,-77.781167,1011811,0,8352,1003459
1/21/22,Cuba,21.521757,-77.781167,1015203,0,8353,1006850
1/22/22,Cuba,21.521757,-77.781167,1018604,0,8358,1010246
1/23/22,Cuba,21.521757,-77.781167,1022112,0,8363,1013749
1/24/22,Cuba,21.521757,-77.781167,1025419,0,8367,1017052
1/25/22,Cuba,21.521757,-77.781167,1028183,0,8373,1019810
1/26/22,Cuba,21.521757,-77.781167,1031170,0,8376,1022794
1/27/22,Cuba,21.521757,-77.781167,1033984,0,8383,1025601
1/28/22,Cuba,21.521757,-77.781167,1036783,0,8388,1028395
1/29/22,Cuba,21.521757,-77.781167,1039842,0,8390,1031452
1/30/22,Cuba,21.521757,-77.781167,1042671,0,8397,1034274
1/31/22,Cuba,21.521757,-77.781167,1044790,0,8399,1036391
2/1/22,Cuba,21.521757,-77.781167,1046400,0,8407,1037993
2/2/22,Cuba,21.521757,-77.781167,1047860,0,8415,1039445
2/3/22,Cuba,21.521757,-77.781167,1049406,0,8420,1040986
2/4/22,Cuba,21.521757,-77.781167,1050840,0,8427,1042413
2/5/22,Cuba,21.521757,-77.781167,1052220,0,8431,1043789
2/6/22,Cuba,21.521757,-77.781167,1053560,0,8439,1045121
2/7/22,Cuba,21.521757,-77.781167,1054909,0,8443,1046466
2/8/22,Cuba,21.521757,-77.781167,1055927,0,8447,1047480
2/9/22,Cuba,21.521757,-77.781167,1056846,0,8450,1048396
2/10/22,Cuba,21.521757,-77.781167,1057797,0,8454,1049343
2/11/22,Cuba,21.521757,-77.781167,1058946,0,8460,1050486
2/12/22,Cuba,21.521757,-77.781167,1059834,0,8467,1051367
2/13/22,Cuba,21.521757,-77.781167,1060732,0,8472,1052260
2/14/22,Cuba,21.521757,-77.781167,1061524,0,8476,1053048
2/15/22,Cuba,21.521757,-77.781167,1062154,0,8476,1053678
2/16/22,Cuba,21.521757,-77.781167,1062748,0,8477,1054271
2/17/22,Cuba,21.521757,-77.781167,1063481,0,8482,1054999
2/18/22,Cuba,21.521757,-77.781167,1064128,0,8484,1055644
2/19/22,Cuba,21.521757,-77.781167,1064757,0,8486,1056271
2/20/22,Cuba,21.521757,-77.781167,1065385,0,8487,1056898
2/21/22,Cuba,21.521757,-77.781167,1065947,0,8491,1057456
2/22/22,Cuba,21.521757,-77.781167,1066414,0,8491,1057923
2/23/22,Cuba,21.521757,-77.781167,1066927,0,8494,1058433
2/24/22,Cuba,21.521757,-77.781167,1067522,0,8494,1059028
2/25/22,Cuba,21.521757,-77.781167,1068148,0,8494,1059654
2/26/22,Cuba,21.521757,-77.781167,1068757,0,8494,1060263
2/27/22,Cuba,21.521757,-77.781167,1069387,0,8494,1060893
2/28/22,Cuba,21.521757,-77.781167,1069862,0,8494,1061368
3/1/22,Cuba,21.521757,-77.781167,1070258,0,8495,1061763
3/2/22,Cuba,21.521757,-77.781167,1070730,0,8496,1062234
3/3/22,Cuba,21.521757,-77.781167,1071326,0,8498,1062828
3/4/22,Cuba,21.521757,-77.781167,1071964,0,8498,1063466
3/5/22,Cuba,21.521757,-77.781167,1072474,0,8499,1063975
3/6/22,Cuba,21.521757,-77.781167,1072956,0,8500,1064456
3/7/22,Cuba,21.521757,-77.781167,1073504,0,8501,1065003
3/8/22,Cuba,21.521757,-77.781167,1073951,0,8501,1065450
3/9/22,Cuba,21.521757,-77.781167,1074469,0,8502,1065967
3/10/22,Cuba,21.521757,-77.781167,1075030,0,8502,1066528
3/11/22,Cuba,21.521757,-77.781167,1075616,0,8503,1067113
3/12/22,Cuba,21.521757,-77.781167,1076229,0,8503,1067726
3/13/22,Cuba,21.521757,-77.781167,1076785,0,8503,1068282
3/14/22,Cuba,21.521757,-77.781167,1077405,0,8503,1068902
3/15/22,Cuba,21.521757,-77.781167,1077966,0,8503,1069463
3/16/22,Cuba,21.521757,-77.781167,1078525,0,8503,1070022
3/17/22,Cuba,21.521757,-77.781167,1079111,0,8503,1070608
3/18/22,Cuba,21.521757,-77.781167,1079853,0,8504,1071349
3/19/22,Cuba,21.521757,-77.781167,1080686,0,8506,1072180
3/20/22,Cuba,21.521757,-77.781167,1081472,0,8506,1072966
3/21/22,Cuba,21.521757,-77.781167,1082201,0,8507,1073694
3/22/22,Cuba,21.521757,-77.781167,1082880,0,8508,1074372
3/23/22,Cuba,21.521757,-77.781167,1083691,0,8508,1075183
3/24/22,Cuba,21.521757,-77.781167,1084568,0,8508,1076060
3/25/22,Cuba,21.521757,-77.781167,1085404,0,8508,1076896
3/26/22,Cuba,21.521757,-77.781167,1086361,0,8509,1077852
3/27/22,Cuba,21.521757,-77.781167,1087183,0,8509,1078674
3/28/22,Cuba,21.521757,-77.781167,1088017,0,8510,1079507
3/29/22,Cuba,21.521757,-77.781167,1088638,0,8510,1080128
3/30/22,Cuba,21.521757,-77.781167,1089452,0,8510,1080942
3/31/22,Cuba,21.521757,-77.781167,1090285,0,8510,1081775
4/1/22,Cuba,21.521757,-77.781167,1091063,0,8510,1082553
4/2/22,Cuba,21.521757,-77.781167,1091852,0,8512,1083340
4/3/22,Cuba,21.521757,-77.781167,1092547,0,8514,1084033
4/4/22,Cuba,21.521757,-77.781167,1093166,0,8515,1084651
4/5/22,Cuba,21.521757,-77.781167,1093676,0,8516,1085160
4/6/22,Cuba,21.521757,-77.781167,1094352,0,8517,1085835
4/7/22,Cuba,21.521757,-77.781167,1095006,0,8517,1086489
4/8/22,Cuba,21.521757,-77.781167,1095625,0,8517,1087108
4/9/22,Cuba,21.521757,-77.781167,1096234,0,8517,1087717
4/10/22,Cuba,21.521757,-77.781167,1096837,0,8518,1088319
4/11/22,Cuba,21.521757,-77.781167,1097333,0,8519,1088814
4/12/22,Cuba,21.521757,-77.781167,1097675,0,8519,1089156
4/13/22,Cuba,21.521757,-77.781167,1098114,0,8519,1089595
4/14/22,Cuba,21.521757,-77.781167,1098563,0,8519,1090044
4/15/22,Cuba,21.521757,-77.781167,1099042,0,8519,1090523
4/16/22,Cuba,21.521757,-77.781167,1099444,0,8520,1090924
4/17/22,Cuba,21.521757,-77.781167,1099736,0,8520,1091216
4/18/22,Cuba,21.521757,-77.781167,1100073,0,8521,1091552
4/19/22,Cuba,21.521757,-77.781167,1100312,0,8522,1091790
4/20/22,Cuba,21.521757,-77.781167,1100609,0,8522,1092087
4/21/22,Cuba,21.521757,-77.781167,1100938,0,8522,1092416
4/22/22,Cuba,21.521757,-77.781167,1101220,0,8523,1092697
4/23/22,Cuba,21.521757,-77.781167,1101486,0,8523,1092963
4/24/22,Cuba,21.521757,-77.781167,1101731,0,8525,1093206
4/25/22,Cuba,21.521757,-77.781167,1101968,0,8525,1093443
4/26/22,Cuba,21.521757,-77.781167,1102164,0,8525,1093639
4/27/22,Cuba,21.521757,-77.781167,1102355,0,8525,1093830
4/28/22,Cuba,21.521757,-77.781167,1102559,0,8525,1094034
4/29/22,Cuba,21.521757,-77.781167,1102750,0,8526,1094224
4/30/22,Cuba,21.521757,-77.781167,1102941,0,8526,1094415
5/1/22,Cuba,21.521757,-77.781167,1103131,0,8527,1094604
5/2/22,Cuba,21.521757,-77.781167,1103286,0,8527,1094759
5/3/22,Cuba,21.521757,-77.781167,1103395,0,8527,1094868
5/4/22,Cuba,21.521757,-77.781167,1103488,0,8527,1094961
5/5/22,Cuba,21.521757,-77.781167,1103606,0,8527,1095079
5/6/22,Cuba,21.521757,-77.781167,1103753,0,8527,1095226
5/7/22,Cuba,21.521757,-77.781167,1103876,0,8527,1095349
5/8/22,Cuba,21.521757,-77.781167,1103980,0,8527,1095453
5/9/22,Cuba,21.521757,-77.781167,1104057,0,8527,1095530
5/10/22,Cuba,21.521757,-77.781167,1104110,0,8528,1095582
5/11/22,Cuba,21.521757,-77.781167,1104206,0,8529,1095677
5/12/22,Cuba,21.521757,-77.781167,1104316,0,8529,1095787
5/13/22,Cuba,21.521757,-77.781167,1104393,0,8529,1095864
5/14/22,Cuba,21.521757,-77.781167,1104496,0,8529,1095967
5/15/22,Cuba,21.521757,-77.781167,1104589,0,8529,1096060
5/16/22,Cuba,21.521757,-77.781167,1104661,0,8529,1096132
5/17/22,Cuba,21.521757,-77.781167,1104707,0,8529,1096178
5/18/22,Cuba,21.521757,-77.781167,1104769,0,8529,1096240
5/19/22,Cuba,21.521757,-77.781167,1104830,0,8529,1096301
5/20/22,Cuba,21.521757,-77.781167,1104891,0,8529,1096362
5/21/22,Cuba,21.521757,-77.781167,1104935,0,8529,1096406
5/22/22,Cuba,21.521757,-77.781167,1104979,0,8529,1096450
5/23/22,Cuba,21.521757,-77.781167,1105016,0,8529,1096487
5/24/22,Cuba,21.521757,-77.781167,1105047,0,8529,1096518
5/25/22,Cuba,21.521757,-77.781167,1105091,0,8529,1096562
5/26/22,Cuba,21.521757,-77.781167,1105136,0,8529,1096607
5/27/22,Cuba,21.521757,-77.781167,1105181,0,8529,1096652
5/28/22,Cuba,21.521757,-77.781167,1105227,0,8529,1096698
5/29/22,Cuba,21.521757,-77.781167,1105258,0,8529,1096729
5/30/22,Cuba,21.521757,-77.781167,1105290,0,8529,1096761
5/31/22,Cuba,21.521757,-77.781167,1105319,0,8529,1096790
6/1/22,Cuba,21.521757,-77.781167,1105360,0,8529,1096831
6/2/22,Cuba,21.521757,-77.781167,1105389,0,8529,1096860
6/3/22,Cuba,21.521757,-77.781167,1105419,0,8529,1096890
6/4/22,Cuba,21.521757,-77.781167,1105443,0,8529,1096914
6/5/22,Cuba,21.521757,-77.781167,1105461,0,8529,1096932
6/6/22,Cuba,21.521757,-77.781167,1105477,0,8529,1096948
6/7/22,Cuba,21.521757,-77.781167,1105490,0,8529,1096961
6/8/22,Cuba,21.521757,-77.781167,1105517,0,8529,1096988
6/9/22,Cuba,21.521757,-77.781167,1105546,0,8529,1097017
6/10/22,Cuba,21.521757,-77.781167,1105577,0,8529,1097048
6/11/22,Cuba,21.521757,-77.781167,1105592,0,8529,1097063
6/12/22,Cuba,21.521757,-77.781167,1105612,0,8529,1097083
6/13/22,Cuba,21.521757,-77.781167,1105631,0,8529,1097102
6/14/22,Cuba,21.521757,-77.781167,1105643,0,8529,1097114
6/15/22,Cuba,21.521757,-77.781167,1105664,0,8529,1097135
6/16/22,Cuba,21.521757,-77.781167,1105681,0,8529,1097152
6/17/22,Cuba,21.521757,-77.781167,1105707,0,8529,1097178
6/18/22,Cuba,21.521757,-77.781167,1105729,0,8529,1097200
6/19/22,Cuba,21.521757,-77.781167,1105753,0,8529,1097224
6/20/22,Cuba,21.521757,-77.781167,1105778,0,8529,1097249
6/21/22,Cuba,21.521757,-77.781167,1105795,0,8529,1097266
6/22/22,Cuba,21.521757,-77.781167,1105817,0,8529,1097288
6/23/22,Cuba,21.521757,-77.781167,1105846,0,8529,1097317
6/24/22,Cuba,21.521757,-77.781167,1105875,0,8529,1097346
6/25/22,Cuba,21.521757,-77.781167,1105896,0,8529,1097367
6/26/22,Cuba,21.521757,-77.781167,1105924,0,8529,1097395
6/27/22,Cuba,21.521757,-77.781167,1105950,0,8529,1097421
6/28/22,Cuba,21.521757,-77.781167,1105978,0,8529,1097449
6/29/22,Cuba,21.521757,-77.781167,1105989,0,8529,1097460
6/30/22,Cuba,21.521757,-77.781167,1106023,0,8529,1097494
7/1/22,Cuba,21.521757,-77.781167,1106045,0,8529,1097516
7/2/22,Cuba,21.521757,-77.781167,1106087,0,8529,1097558
7/3/22,Cuba,21.521757,-77.781167,1106124,0,8529,1097595
7/4/22,Cuba,21.521757,-77.781167,1106167,0,8529,1097638
7/5/22,Cuba,21.521757,-77.781167,1106203,0,8529,1097674
7/6/22,Cuba,21.521757,-77.781167,1106240,0,8529,1097711
7/7/22,Cuba,21.521757,-77.781167,1106283,0,8529,1097754
7/8/22,Cuba,21.521757,-77.781167,1106327,0,8529,1097798
7/9/22,Cuba,21.521757,-77.781167,1106365,0,8529,1097836
7/10/22,Cuba,21.521757,-77.781167,1106422,0,8529,1097893
7/11/22,Cuba,21.521757,-77.781167,1106459,0,8529,1097930
7/12/22,Cuba,21.521757,-77.781167,1106490,0,8529,1097961
7/13/22,Cuba,21.521757,-77.781167,1106553,0,8529,1098024
7/14/22,Cuba,21.521757,-77.781167,1106602,0,8529,1098073
7/15/22,Cuba,21.521757,-77.781167,1106666,0,8529,1098137
7/16/22,Cuba,21.521757,-77.781167,1106730,0,8529,1098201
7/17/22,Cuba,21.521757,-77.781167,1106798,0,8529,1098269
7/18/22,Cuba,21.521757,-77.781167,1106879,0,8529,1098350
7/19/22,Cuba,21.521757,-77.781167,1106930,0,8529,1098401
7/20/22,Cuba,21.521757,-77.781167,1107005,0,8529,1098476
7/21/22,Cuba,21.521757,-77.781167,1107100,0,8529,1098571
7/22/22,Cuba,21.521757,-77.781167,1107197,0,8529,1098668
7/23/22,Cuba,21.521757,-77.781167,1107311,0,8529,1098782
7/24/22,Cuba,21.521757,-77.781167,1107407,0,8529,1098878
7/25/22,Cuba,21.521757,-77.781167,1107510,0,8529,1098981
7/26/22,Cuba,21.521757,-77.781167,1107610,0,8529,1099081
7/27/22,Cuba,21.521757,-77.781167,1107708,0,8529,1099179
7/28/22,Cuba,21.521757,-77.781167,1107800,0,8529,1099271
7/29/22,Cuba,21.521757,-77.781167,1107888,0,8529,1099359
7/30/22,Cuba,21.521757,-77.781167,1107985,0,8529,1099456
7/31/22,Cuba,21.521757,-77.781167,1108094,0,8529,1099565
8/1/22,Cuba,21.521757,-77.781167,1108201,0,8529,1099672
8/2/22,Cuba,21.521757,-77.781167,1108261,0,8529,1099732
8/3/22,Cuba,21.521757,-77.781167,1108361,0,8529,1099832
8/4/22,Cuba,21.521757,-77.781167,1108492,0,8529,1099963
8/5/22,Cuba,21.521757,-77.781167,1108621,0,8529,1100092
8/6/22,Cuba,21.521757,-77.781167,1108706,0,8529,1100177
8/7/22,Cuba,21.521757,-77.781167,1108827,0,8529,1100298
8/8/22,Cuba,21.521757,-77.781167,1108895,0,8529,1100366
8/9/22,Cuba,21.521757,-77.781167,1108982,0,8529,1100453
8/10/22,Cuba,21.521757,-77.781167,1109077,0,8529,1100548
8/11/22,Cuba,21.521757,-77.781167,1109193,0,8529,1100664
8/12/22,Cuba,21.521757,-77.781167,1109259,0,8529,1100730
8/13/22,Cuba,21.521757,-77.781167,1109360,0,8529,1100831
8/14/22,Cuba,21.521757,-77.781167,1109433,0,8529,1100904
8/15/22,Cuba,21.521757,-77.781167,1109520,0,8529,1100991
8/16/22,Cuba,21.521757,-77.781167,1109577,0,8529,1101048
8/17/22,Cuba,21.521757,-77.781167,1109649,0,8529,1101120
8/18/22,Cuba,21.521757,-77.781167,1109752,0,8529,1101223
8/19/22,Cuba,21.521757,-77.781167,1109837,0,8529,1101308
8/20/22,Cuba,21.521757,-77.781167,1109911,0,8529,1101382
8/21/22,Cuba,21.521757,-77.781167,1109992,0,8530,1101462
8/22/22,Cuba,21.521757,-77.781167,1110054,0,8530,1101524
8/23/22,Cuba,21.521757,-77.781167,1110102,0,8530,1101572
8/24/22,Cuba,21.521757,-77.781167,1110159,0,8530,1101629
8/25/22,Cuba,21.521757,-77.781167,1110218,0,8530,1101688
8/26/22,Cuba,21.521757,-77.781167,1110277,0,8530,1101747
8/27/22,Cuba,21.521757,-77.781167,1110337,0,8530,1101807
8/28/22,Cuba,21.521757,-77.781167,1110407,0,8530,1101877
8/29/22,Cuba,21.521757,-77.781167,1110464,0,8530,1101934
8/30/22,Cuba,21.521757,-77.781167,1110497,0,8530,1101967
8/31/22,Cuba,21.521757,-77.781167,1110539,0,8530,1102009
9/1/22,Cuba,21.521757,-77.781167,1110586,0,8530,1102056
9/2/22,Cuba,21.521757,-77.781167,1110631,0,8530,1102101
9/3/22,Cuba,21.521757,-77.781167,1110668,0,8530,1102138
9/4/22,Cuba,21.521757,-77.781167,1110713,0,8530,1102183
9/5/22,Cuba,21.521757,-77.781167,1110742,0,8530,1102212
9/6/22,Cuba,21.521757,-77.781167,1110759,0,8530,1102229
9/7/22,Cuba,21.521757,-77.781167,1110790,0,8530,1102260
9/8/22,Cuba,21.521757,-77.781167,1110808,0,8530,1102278
9/9/22,Cuba,21.521757,-77.781167,1110840,0,8530,1102310
9/10/22,Cuba,21.521757,-77.781167,1110858,0,8530,1102328
9/11/22,Cuba,21.521757,-77.781167,1110894,0,8530,1102364
9/12/22,Cuba,21.521757,-77.781167,1110918,0,8530,1102388
9/13/22,Cuba,21.521757,-77.781167,1110927,0,8530,1102397
9/14/22,Cuba,21.521757,-77.781167,1110948,0,8530,1102418
9/15/22,Cuba,21.521757,-77.781167,1110971,0,8530,1102441
9/16/22,Cuba,21.521757,-77.781167,1110990,0,8530,1102460
9/17/22,Cuba,21.521757,-77.781167,1111011,0,8530,1102481
9/18/22,Cuba,21.521757,-77.781167,1111031,0,8530,1102501
9/19/22,Cuba,21.521757,-77.781167,1111045,0,8530,1102515
9/20/22,Cuba,21.521757,-77.781167,1111067,0,8530,1102537
9/21/22,Cuba,21.521757,-77.781167,1111080,0,8530,1102550
9/22/22,Cuba,21.521757,-77.781167,1111096,0,8530,1102566
9/23/22,Cuba,21.521757,-77.781167,1111109,0,8530,1102579
9/24/22,Cuba,21.521757,-77.781167,1111128,0,8530,1102598
9/25/22,Cuba,21.521757,-77.781167,1111146,0,8530,1102616
9/26/22,Cuba,21.521757,-77.781167,1111161,0,8530,1102631
9/27/22,Cuba,21.521757,-77.781167,1111164,0,8530,1102634
9/28/22,Cuba,21.521757,-77.781167,1111170,0,8530,1102640
9/29/22,Cuba,21.521757,-77.781167,1111179,0,8530,1102649
9/30/22,Cuba,21.521757,-77.781167,1111186,0,8530,1102656
10/1/22,Cuba,21.521757,-77.781167,1111194,0,8530,1102664
10/2/22,Cuba,21.521757,-77.781167,1111200,0,8530,1102670
10/3/22,Cuba,21.521757,-77.781167,1111206,0,8530,1102676
10/4/22,Cuba,21.521757,-77.781167,1111207,0,8530,1102677
10/5/22,Cuba,21.521757,-77.781167,1111218,0,8530,1102688
10/6/22,Cuba,21.521757,-77.781167,1111224,0,8530,1102694
10/7/22,Cuba,21.521757,-77.781167,1111229,0,8530,1102699
10/8/22,Cuba,21.521757,-77.781167,1111233,0,8530,1102703
10/9/22,Cuba,21.521757,-77.781167,1111237,0,8530,1102707
10/10/22,Cuba,21.521757,-77.781167,1111238,0,8530,1102708
10/11/22,Cuba,21.521757,-77.781167,1111238,0,8530,1102708
10/12/22,Cuba,21.521757,-77.781167,1111242,0,8530,1102712
10/13/22,Cuba,21.521757,-77.781167,1111242,0,8530,1102712
10/14/22,Cuba,21.521757,-77.781167,1111248,0,8530,1102718
10/15/22,Cuba,21.521757,-77.781167,1111251,0,8530,1102721
10/16/22,Cuba,21.521757,-77.781167,1111258,0,8530,1102728
10/17/22,Cuba,21.521757,-77.781167,1111260,0,8530,1102730
10/18/22,Cuba,21.521757,-77.781167,1111260,0,8530,1102730
10/19/22,Cuba,21.521757,-77.781167,1111263,0,8530,1102733
10/20/22,Cuba,21.521757,-77.781167,1111265,0,8530,1102735
10/21/22,Cuba,21.521757,-77.781167,1111266,0,8530,1102736
10/22/22,Cuba,21.521757,-77.781167,1111267,0,8530,1102737
10/23/22,Cuba,21.521757,-77.781167,1111267,0,8530,1102737
10/24/22,Cuba,21.521757,-77.781167,1111273,0,8530,1102743
10/25/22,Cuba,21.521757,-77.781167,1111274,0,8530,1102744
10/26/22,Cuba,21.521757,-77.781167,1111277,0,8530,1102747
10/27/22,Cuba,21.521757,-77.781167,1111278,0,8530,1102748
10/28/22,Cuba,21.521757,-77.781167,1111279,0,8530,1102749
10/29/22,Cuba,21.521757,-77.781167,1111281,0,8530,1102751
10/30/22,Cuba,21.521757,-77.781167,1111284,0,8530,1102754
10/31/22,Cuba,21.521757,-77.781167,1111285,0,8530,1102755
11/1/22,Cuba,21.521757,-77.781167,1111286,0,8530,1102756
11/2/22,Cuba,21.521757,-77.781167,1111287,0,8530,1102757
11/3/22,Cuba,21.521757,-77.781167,1111290,0,8530,1102760
11/4/22,Cuba,21.521757,-77.781167,1111291,0,8530,1102761
11/5/22,Cuba,21.521757,-77.781167,1111292,0,8530,1102762
11/6/22,Cuba,21.521757,-77.781167,1111296,0,8530,1102766
11/7/22,Cuba,21.521757,-77.781167,1111298,0,8530,1102768
11/8/22,Cuba,21.521757,-77.781167,1111300,0,8530,1102770
11/9/22,Cuba,21.521757,-77.781167,1111303,0,8530,1102773
11/10/22,Cuba,21.521757,-77.781167,1111311,0,8530,1102781
11/11/22,Cuba,21.521757,-77.781167,1111311,0,8530,1102781
11/12/22,Cuba,21.521757,-77.781167,1111317,0,8530,1102787
11/13/22,Cuba,21.521757,-77.781167,1111321,0,8530,1102791
11/14/22,Cuba,21.521757,-77.781167,1111328,0,8530,1102798
11/15/22,Cuba,21.521757,-77.781167,1111330,0,8530,1102800
11/16/22,Cuba,21.521757,-77.781167,1111332,0,8530,1102802
11/17/22,Cuba,21.521757,-77.781167,1111333,0,8530,1102803
11/18/22,Cuba,21.521757,-77.781167,1111335,0,8530,1102805
11/19/22,Cuba,21.521757,-77.781167,1111337,0,8530,1102807
11/20/22,Cuba,21.521757,-77.781167,1111338,0,8530,1102808
11/21/22,Cuba,21.521757,-77.781167,1111345,0,8530,1102815
11/22/22,Cuba,21.521757,-77.781167,1111345,0,8530,1102815
11/23/22,Cuba,21.521757,-77.781167,1111354,0,8530,1102824
11/24/22,Cuba,21.521757,-77.781167,1111360,0,8530,1102830
11/25/22,Cuba,21.521757,-77.781167,1111363,0,8530,1102833
11/26/22,Cuba,21.521757,-77.781167,1111368,0,8530,1102838
11/27/22,Cuba,21.521757,-77.781167,1111375,0,8530,1102845
11/28/22,Cuba,21.521757,-77.781167,1111379,0,8530,1102849
11/29/22,Cuba,21.521757,-77.781167,1111384,0,8530,1102854
11/30/22,Cuba,21.521757,-77.781167,1111392,0,8530,1102862
12/1/22,Cuba,21.521757,-77.781167,1111398,0,8530,1102868
12/2/22,Cuba,21.521757,-77.781167,1111412,0,8530,1102882
12/3/22,Cuba,21.521757,-77.781167,1111421,0,8530,1102891
12/4/22,Cuba,21.521757,-77.781167,1111434,0,8530,1102904
12/5/22,Cuba,21.521757,-77.781167,1111447,0,8530,1102917
12/6/22,Cuba,21.521757,-77.781167,1111452,0,8530,1102922
12/7/22,Cuba,21.521757,-77.781167,1111466,0,8530,1102936
12/8/22,Cuba,21.521757,-77.781167,1111484,0,8530,1102954
12/9/22,Cuba,21.521757,-77.781167,1111518,0,8530,1102988
12/10/22,Cuba,21.521757,-77.781167,1111530,0,8530,1103000
12/11/22,Cuba,21.521757,-77.781167,1111549,0,8530,1103019
12/12/22,Cuba,21.521757,-77.781167,1111564,0,8530,1103034
12/13/22,Cuba,21.521757,-77.781167,1111569,0,8530,1103039
12/14/22,Cuba,21.521757,-77.781167,1111582,0,8530,1103052
12/15/22,Cuba,21.521757,-77.781167,1111594,0,8530,1103064
12/16/22,Cuba,21.521757,-77.781167,1111625,0,8530,1103095
12/17/22,Cuba,21.521757,-77.781167,1111647,0,8530,1103117
1/1/22,Cyprus,35.1264,33.4299,169159,0,638,168521
1/2/22,Cyprus,35.1264,33.4299,172697,0,639,172058
1/3/22,Cyprus,35.1264,33.4299,177721,0,641,177080
1/4/22,Cyprus,35.1264,33.4299,183178,0,646,182532
1/5/22,Cyprus,35.1264,33.4299,188380,0,650,187730
1/6/22,Cyprus,35.1264,33.4299,192157,0,650,191507
1/7/22,Cyprus,35.1264,33.4299,197401,0,650,196751
1/8/22,Cyprus,35.1264,33.4299,201360,0,654,200706
1/9/22,Cyprus,35.1264,33.4299,204372,0,657,203715
1/10/22,Cyprus,35.1264,33.4299,208559,0,661,207898
1/11/22,Cyprus,35.1264,33.4299,212074,0,665,211409
1/12/22,Cyprus,35.1264,33.4299,215271,0,669,214602
1/13/22,Cyprus,35.1264,33.4299,218374,0,672,217702
1/14/22,Cyprus,35.1264,33.4299,221416,0,672,220744
1/15/22,Cyprus,35.1264,33.4299,223767,0,673,223094
1/16/22,Cyprus,35.1264,33.4299,225738,0,681,225057
1/17/22,Cyprus,35.1264,33.4299,228881,0,684,228197
1/18/22,Cyprus,35.1264,33.4299,230856,0,689,230167
1/19/22,Cyprus,35.1264,33.4299,233082,0,689,232393
1/20/22,Cyprus,35.1264,33.4299,235364,0,700,234664
1/21/22,Cyprus,35.1264,33.4299,235364,0,700,234664
1/22/22,Cyprus,35.1264,33.4299,237260,0,709,236551
1/23/22,Cyprus,35.1264,33.4299,239073,0,712,238361
1/24/22,Cyprus,35.1264,33.4299,241888,0,713,241175
1/25/22,Cyprus,35.1264,33.4299,241888,0,713,241175
1/26/22,Cyprus,35.1264,33.4299,243818,0,724,243094
1/27/22,Cyprus,35.1264,33.4299,246354,0,724,245630
1/28/22,Cyprus,35.1264,33.4299,248941,0,726,248215
1/29/22,Cyprus,35.1264,33.4299,251125,0,730,250395
1/30/22,Cyprus,35.1264,33.4299,253350,0,731,252619
1/31/22,Cyprus,35.1264,33.4299,256746,0,733,256013
2/1/22,Cyprus,35.1264,33.4299,259784,0,734,259050
2/2/22,Cyprus,35.1264,33.4299,262867,0,736,262131
2/3/22,Cyprus,35.1264,33.4299,265945,0,736,265209
2/4/22,Cyprus,35.1264,33.4299,268852,0,740,268112
2/5/22,Cyprus,35.1264,33.4299,271420,0,741,270679
2/6/22,Cyprus,35.1264,33.4299,273634,0,745,272889
2/7/22,Cyprus,35.1264,33.4299,273634,0,745,272889
2/8/22,Cyprus,35.1264,33.4299,277864,0,756,277108
2/9/22,Cyprus,35.1264,33.4299,280643,0,761,279882
2/10/22,Cyprus,35.1264,33.4299,283458,0,762,282696
2/11/22,Cyprus,35.1264,33.4299,285943,0,780,285163
2/12/22,Cyprus,35.1264,33.4299,288063,0,785,287278
2/13/22,Cyprus,35.1264,33.4299,290110,0,785,289325
2/14/22,Cyprus,35.1264,33.4299,293040,0,788,292252
2/15/22,Cyprus,35.1264,33.4299,295686,0,791,294895
2/16/22,Cyprus,35.1264,33.4299,298235,0,798,297437
2/17/22,Cyprus,35.1264,33.4299,300435,0,802,299633
2/18/22,Cyprus,35.1264,33.4299,302739,0,807,301932
2/19/22,Cyprus,35.1264,33.4299,304503,0,811,303692
2/20/22,Cyprus,35.1264,33.4299,306219,0,823,305396
2/21/22,Cyprus,35.1264,33.4299,308917,0,825,308092
2/22/22,Cyprus,35.1264,33.4299,311239,0,830,310409
2/23/22,Cyprus,35.1264,33.4299,313406,0,833,312573
2/24/22,Cyprus,35.1264,33.4299,313406,0,833,312573
2/25/22,Cyprus,35.1264,33.4299,315341,0,848,314493
2/26/22,Cyprus,35.1264,33.4299,318773,0,852,317921
2/27/22,Cyprus,35.1264,33.4299,320160,0,854,319306
2/28/22,Cyprus,35.1264,33.4299,322516,0,856,321660
3/1/22,Cyprus,35.1264,33.4299,324502,0,857,323645
3/2/22,Cyprus,35.1264,33.4299,326611,0,859,325752
3/3/22,Cyprus,35.1264,33.4299,328657,0,861,327796
3/4/22,Cyprus,35.1264,33.4299,329674,0,873,328801
3/5/22,Cyprus,35.1264,33.4299,331508,0,875,330633
3/6/22,Cyprus,35.1264,33.4299,333238,0,877,332361
3/7/22,Cyprus,35.1264,33.4299,334822,0,878,333944
3/8/22,Cyprus,35.1264,33.4299,338517,0,883,337634
3/9/22,Cyprus,35.1264,33.4299,341383,0,886,340497
3/10/22,Cyprus,35.1264,33.4299,344856,0,889,343967
3/11/22,Cyprus,35.1264,33.4299,347876,0,895,346981
3/12/22,Cyprus,35.1264,33.4299,350688,0,899,349789
3/13/22,Cyprus,35.1264,33.4299,353002,0,902,352100
3/14/22,Cyprus,35.1264,33.4299,356784,0,902,355882
3/15/22,Cyprus,35.1264,33.4299,360078,0,904,359174
3/16/22,Cyprus,35.1264,33.4299,363792,0,904,362888
3/17/22,Cyprus,35.1264,33.4299,367743,0,905,366838
3/18/22,Cyprus,35.1264,33.4299,370311,0,915,369396
3/19/22,Cyprus,35.1264,33.4299,373658,0,916,372742
3/20/22,Cyprus,35.1264,33.4299,377356,0,919,376437
3/21/22,Cyprus,35.1264,33.4299,382642,0,920,381722
3/22/22,Cyprus,35.1264,33.4299,387315,0,923,386392
3/23/22,Cyprus,35.1264,33.4299,392019,0,927,391092
3/24/22,Cyprus,35.1264,33.4299,397205,0,927,396278
3/25/22,Cyprus,35.1264,33.4299,400534,0,930,399604
3/26/22,Cyprus,35.1264,33.4299,405706,0,932,404774
3/27/22,Cyprus,35.1264,33.4299,410020,0,932,409088
3/28/22,Cyprus,35.1264,33.4299,416514,0,935,415579
3/29/22,Cyprus,35.1264,33.4299,421603,0,937,420666
3/30/22,Cyprus,35.1264,33.4299,426377,0,938,425439
3/31/22,Cyprus,35.1264,33.4299,430726,0,940,429786
4/1/22,Cyprus,35.1264,33.4299,433217,0,942,432275
4/2/22,Cyprus,35.1264,33.4299,437111,0,945,436166
4/3/22,Cyprus,35.1264,33.4299,439964,0,947,439017
4/4/22,Cyprus,35.1264,33.4299,444174,0,951,443223
4/5/22,Cyprus,35.1264,33.4299,447161,0,954,446207
4/6/22,Cyprus,35.1264,33.4299,449877,0,955,448922
4/7/22,Cyprus,35.1264,33.4299,452334,0,957,451377
4/8/22,Cyprus,35.1264,33.4299,454362,0,979,453383
4/9/22,Cyprus,35.1264,33.4299,456126,0,980,455146
4/10/22,Cyprus,35.1264,33.4299,457585,0,982,456603
4/11/22,Cyprus,35.1264,33.4299,459839,0,985,458854
4/12/22,Cyprus,35.1264,33.4299,461531,0,987,460544
4/13/22,Cyprus,35.1264,33.4299,462945,0,989,461956
4/14/22,Cyprus,35.1264,33.4299,464366,0,993,463373
4/15/22,Cyprus,35.1264,33.4299,464366,0,993,463373
4/16/22,Cyprus,35.1264,33.4299,464366,0,993,463373
4/17/22,Cyprus,35.1264,33.4299,464366,0,993,463373
4/18/22,Cyprus,35.1264,33.4299,464366,0,993,463373
4/19/22,Cyprus,35.1264,33.4299,465787,0,993,464794
4/20/22,Cyprus,35.1264,33.4299,465787,0,993,464794
4/21/22,Cyprus,35.1264,33.4299,465787,0,993,464794
4/22/22,Cyprus,35.1264,33.4299,470319,0,1006,469313
4/23/22,Cyprus,35.1264,33.4299,470481,0,1011,469470
4/24/22,Cyprus,35.1264,33.4299,470481,0,1011,469470
4/25/22,Cyprus,35.1264,33.4299,470481,0,1011,469470
4/26/22,Cyprus,35.1264,33.4299,470481,0,1011,469470
4/27/22,Cyprus,35.1264,33.4299,470481,0,1011,469470
4/28/22,Cyprus,35.1264,33.4299,470481,0,1011,469470
4/29/22,Cyprus,35.1264,33.4299,480220,0,1015,479205
4/30/22,Cyprus,35.1264,33.4299,480220,0,1020,479200
5/1/22,Cyprus,35.1264,33.4299,480220,0,1020,479200
5/2/22,Cyprus,35.1264,33.4299,480220,0,1020,479200
5/3/22,Cyprus,35.1264,33.4299,480220,0,1020,479200
5/4/22,Cyprus,35.1264,33.4299,480220,0,1020,479200
5/5/22,Cyprus,35.1264,33.4299,480220,0,1020,479200
5/6/22,Cyprus,35.1264,33.4299,483664,0,1027,482637
5/7/22,Cyprus,35.1264,33.4299,483664,0,1032,482632
5/8/22,Cyprus,35.1264,33.4299,483664,0,1032,482632
5/9/22,Cyprus,35.1264,33.4299,483664,0,1032,482632
5/10/22,Cyprus,35.1264,33.4299,483664,0,1032,482632
5/11/22,Cyprus,35.1264,33.4299,483664,0,1032,482632
5/12/22,Cyprus,35.1264,33.4299,483664,0,1032,482632
5/13/22,Cyprus,35.1264,33.4299,486086,0,1051,485035
5/14/22,Cyprus,35.1264,33.4299,486086,0,1051,485035
5/15/22,Cyprus,35.1264,33.4299,486086,0,1051,485035
5/16/22,Cyprus,35.1264,33.4299,486086,0,1051,485035
5/17/22,Cyprus,35.1264,33.4299,486086,0,1051,485035
5/18/22,Cyprus,35.1264,33.4299,486086,0,1051,485035
5/19/22,Cyprus,35.1264,33.4299,486086,0,1051,485035
5/20/22,Cyprus,35.1264,33.4299,488189,0,1057,487132
5/21/22,Cyprus,35.1264,33.4299,488189,0,1057,487132
5/22/22,Cyprus,35.1264,33.4299,488189,0,1057,487132
5/23/22,Cyprus,35.1264,33.4299,488189,0,1057,487132
5/24/22,Cyprus,35.1264,33.4299,488189,0,1057,487132
5/25/22,Cyprus,35.1264,33.4299,488189,0,1057,487132
5/26/22,Cyprus,35.1264,33.4299,488189,0,1057,487132
5/27/22,Cyprus,35.1264,33.4299,489963,0,1059,488904
5/28/22,Cyprus,35.1264,33.4299,489963,0,1059,488904
5/29/22,Cyprus,35.1264,33.4299,489963,0,1059,488904
5/30/22,Cyprus,35.1264,33.4299,489963,0,1059,488904
5/31/22,Cyprus,35.1264,33.4299,489963,0,1059,488904
6/1/22,Cyprus,35.1264,33.4299,489963,0,1059,488904
6/2/22,Cyprus,35.1264,33.4299,489963,0,1059,488904
6/3/22,Cyprus,35.1264,33.4299,491777,0,1067,490710
6/4/22,Cyprus,35.1264,33.4299,491777,0,1067,490710
6/5/22,Cyprus,35.1264,33.4299,491777,0,1067,490710
6/6/22,Cyprus,35.1264,33.4299,491777,0,1067,490710
6/7/22,Cyprus,35.1264,33.4299,491777,0,1067,490710
6/8/22,Cyprus,35.1264,33.4299,491777,0,1067,490710
6/9/22,Cyprus,35.1264,33.4299,491777,0,1067,490710
6/10/22,Cyprus,35.1264,33.4299,493984,0,1068,492916
6/11/22,Cyprus,35.1264,33.4299,493984,0,1068,492916
6/12/22,Cyprus,35.1264,33.4299,493984,0,1068,492916
6/13/22,Cyprus,35.1264,33.4299,493984,0,1068,492916
6/14/22,Cyprus,35.1264,33.4299,493984,0,1068,492916
6/15/22,Cyprus,35.1264,33.4299,493984,0,1068,492916
6/16/22,Cyprus,35.1264,33.4299,493984,0,1068,492916
6/17/22,Cyprus,35.1264,33.4299,497454,0,1070,496384
6/18/22,Cyprus,35.1264,33.4299,497454,0,1070,496384
6/19/22,Cyprus,35.1264,33.4299,497454,0,1070,496384
6/20/22,Cyprus,35.1264,33.4299,497454,0,1070,496384
6/21/22,Cyprus,35.1264,33.4299,497454,0,1070,496384
6/22/22,Cyprus,35.1264,33.4299,497454,0,1070,496384
6/23/22,Cyprus,35.1264,33.4299,497454,0,1070,496384
6/24/22,Cyprus,35.1264,33.4299,504717,0,1072,503645
6/25/22,Cyprus,35.1264,33.4299,504717,0,1072,503645
6/26/22,Cyprus,35.1264,33.4299,504717,0,1072,503645
6/27/22,Cyprus,35.1264,33.4299,504717,0,1072,503645
6/28/22,Cyprus,35.1264,33.4299,504717,0,1072,503645
6/29/22,Cyprus,35.1264,33.4299,504717,0,1072,503645
6/30/22,Cyprus,35.1264,33.4299,504717,0,1072,503645
7/1/22,Cyprus,35.1264,33.4299,515596,0,1075,514521
7/2/22,Cyprus,35.1264,33.4299,515596,0,1075,514521
7/3/22,Cyprus,35.1264,33.4299,515596,0,1075,514521
7/4/22,Cyprus,35.1264,33.4299,515596,0,1075,514521
7/5/22,Cyprus,35.1264,33.4299,515596,0,1075,514521
7/6/22,Cyprus,35.1264,33.4299,515596,0,1075,514521
7/7/22,Cyprus,35.1264,33.4299,515596,0,1075,514521
7/8/22,Cyprus,35.1264,33.4299,530510,0,1079,529431
7/9/22,Cyprus,35.1264,33.4299,530510,0,1079,529431
7/10/22,Cyprus,35.1264,33.4299,530510,0,1079,529431
7/11/22,Cyprus,35.1264,33.4299,530510,0,1079,529431
7/12/22,Cyprus,35.1264,33.4299,530510,0,1079,529431
7/13/22,Cyprus,35.1264,33.4299,530510,0,1079,529431
7/14/22,Cyprus,35.1264,33.4299,530510,0,1079,529431
7/15/22,Cyprus,35.1264,33.4299,545896,0,1086,544810
7/16/22,Cyprus,35.1264,33.4299,545896,0,1086,544810
7/17/22,Cyprus,35.1264,33.4299,545896,0,1086,544810
7/18/22,Cyprus,35.1264,33.4299,545896,0,1086,544810
7/19/22,Cyprus,35.1264,33.4299,545896,0,1086,544810
7/20/22,Cyprus,35.1264,33.4299,545896,0,1086,544810
7/21/22,Cyprus,35.1264,33.4299,545896,0,1086,544810
7/22/22,Cyprus,35.1264,33.4299,556048,0,1099,554949
7/23/22,Cyprus,35.1264,33.4299,556048,0,1099,554949
7/24/22,Cyprus,35.1264,33.4299,556048,0,1099,554949
7/25/22,Cyprus,35.1264,33.4299,556048,0,1099,554949
7/26/22,Cyprus,35.1264,33.4299,556048,0,1099,554949
7/27/22,Cyprus,35.1264,33.4299,556048,0,1099,554949
7/28/22,Cyprus,35.1264,33.4299,556048,0,1099,554949
7/29/22,Cyprus,35.1264,33.4299,562911,0,1115,561796
7/30/22,Cyprus,35.1264,33.4299,562911,0,1115,561796
7/31/22,Cyprus,35.1264,33.4299,562911,0,1115,561796
8/1/22,Cyprus,35.1264,33.4299,562911,0,1115,561796
8/2/22,Cyprus,35.1264,33.4299,562911,0,1115,561796
8/3/22,Cyprus,35.1264,33.4299,562911,0,1115,561796
8/4/22,Cyprus,35.1264,33.4299,562911,0,1115,561796
8/5/22,Cyprus,35.1264,33.4299,562911,0,1115,561796
8/6/22,Cyprus,35.1264,33.4299,568383,0,1143,567240
8/7/22,Cyprus,35.1264,33.4299,568383,0,1143,567240
8/8/22,Cyprus,35.1264,33.4299,568383,0,1143,567240
8/9/22,Cyprus,35.1264,33.4299,568383,0,1143,567240
8/10/22,Cyprus,35.1264,33.4299,568383,0,1143,567240
8/11/22,Cyprus,35.1264,33.4299,568383,0,1143,567240
8/12/22,Cyprus,35.1264,33.4299,571994,0,1149,570845
8/13/22,Cyprus,35.1264,33.4299,571994,0,1149,570845
8/14/22,Cyprus,35.1264,33.4299,571994,0,1149,570845
8/15/22,Cyprus,35.1264,33.4299,571994,0,1149,570845
8/16/22,Cyprus,35.1264,33.4299,571994,0,1149,570845
8/17/22,Cyprus,35.1264,33.4299,571994,0,1149,570845
8/18/22,Cyprus,35.1264,33.4299,571994,0,1149,570845
8/19/22,Cyprus,35.1264,33.4299,574124,0,1152,572972
8/20/22,Cyprus,35.1264,33.4299,574124,0,1152,572972
8/21/22,Cyprus,35.1264,33.4299,574124,0,1152,572972
8/22/22,Cyprus,35.1264,33.4299,574124,0,1152,572972
8/23/22,Cyprus,35.1264,33.4299,574124,0,1152,572972
8/24/22,Cyprus,35.1264,33.4299,574124,0,1152,572972
8/25/22,Cyprus,35.1264,33.4299,574124,0,1152,572972
8/26/22,Cyprus,35.1264,33.4299,576278,0,1168,575110
8/27/22,Cyprus,35.1264,33.4299,576278,0,1168,575110
8/28/22,Cyprus,35.1264,33.4299,576278,0,1168,575110
8/29/22,Cyprus,35.1264,33.4299,576278,0,1168,575110
8/30/22,Cyprus,35.1264,33.4299,576278,0,1168,575110
8/31/22,Cyprus,35.1264,33.4299,576278,0,1168,575110
9/1/22,Cyprus,35.1264,33.4299,576278,0,1168,575110
9/2/22,Cyprus,35.1264,33.4299,578030,0,1172,576858
9/3/22,Cyprus,35.1264,33.4299,578030,0,1172,576858
9/4/22,Cyprus,35.1264,33.4299,578030,0,1172,576858
9/5/22,Cyprus,35.1264,33.4299,578030,0,1172,576858
9/6/22,Cyprus,35.1264,33.4299,578030,0,1172,576858
9/7/22,Cyprus,35.1264,33.4299,578030,0,1172,576858
9/8/22,Cyprus,35.1264,33.4299,578030,0,1172,576858
9/9/22,Cyprus,35.1264,33.4299,578030,0,1172,576858
9/10/22,Cyprus,35.1264,33.4299,579899,0,1173,578726
9/11/22,Cyprus,35.1264,33.4299,579899,0,1173,578726
9/12/22,Cyprus,35.1264,33.4299,579899,0,1173,578726
9/13/22,Cyprus,35.1264,33.4299,579899,0,1173,578726
9/14/22,Cyprus,35.1264,33.4299,579899,0,1173,578726
9/15/22,Cyprus,35.1264,33.4299,579899,0,1173,578726
9/16/22,Cyprus,35.1264,33.4299,582381,0,1178,581203
9/17/22,Cyprus,35.1264,33.4299,582381,0,1178,581203
9/18/22,Cyprus,35.1264,33.4299,582381,0,1178,581203
9/19/22,Cyprus,35.1264,33.4299,582381,0,1178,581203
9/20/22,Cyprus,35.1264,33.4299,582381,0,1178,581203
9/21/22,Cyprus,35.1264,33.4299,582381,0,1178,581203
9/22/22,Cyprus,35.1264,33.4299,582381,0,1178,581203
9/23/22,Cyprus,35.1264,33.4299,585313,0,1180,584133
9/24/22,Cyprus,35.1264,33.4299,585313,0,1180,584133
9/25/22,Cyprus,35.1264,33.4299,585313,0,1180,584133
9/26/22,Cyprus,35.1264,33.4299,585313,0,1180,584133
9/27/22,Cyprus,35.1264,33.4299,585313,0,1180,584133
9/28/22,Cyprus,35.1264,33.4299,585313,0,1180,584133
9/29/22,Cyprus,35.1264,33.4299,585313,0,1180,584133
9/30/22,Cyprus,35.1264,33.4299,587994,0,1182,586812
10/1/22,Cyprus,35.1264,33.4299,587994,0,1182,586812
10/2/22,Cyprus,35.1264,33.4299,587994,0,1182,586812
10/3/22,Cyprus,35.1264,33.4299,587994,0,1182,586812
10/4/22,Cyprus,35.1264,33.4299,587994,0,1182,586812
10/5/22,Cyprus,35.1264,33.4299,587994,0,1182,586812
10/6/22,Cyprus,35.1264,33.4299,587994,0,1182,586812
10/7/22,Cyprus,35.1264,33.4299,590783,0,1187,589596
10/8/22,Cyprus,35.1264,33.4299,590783,0,1187,589596
10/9/22,Cyprus,35.1264,33.4299,590783,0,1187,589596
10/10/22,Cyprus,35.1264,33.4299,590783,0,1187,589596
10/11/22,Cyprus,35.1264,33.4299,590783,0,1187,589596
10/12/22,Cyprus,35.1264,33.4299,590783,0,1187,589596
10/13/22,Cyprus,35.1264,33.4299,590783,0,1187,589596
10/14/22,Cyprus,35.1264,33.4299,593542,0,1189,592353
10/15/22,Cyprus,35.1264,33.4299,593542,0,1189,592353
10/16/22,Cyprus,35.1264,33.4299,593542,0,1189,592353
10/17/22,Cyprus,35.1264,33.4299,593542,0,1189,592353
10/18/22,Cyprus,35.1264,33.4299,593542,0,1189,592353
10/19/22,Cyprus,35.1264,33.4299,593542,0,1189,592353
10/20/22,Cyprus,35.1264,33.4299,593542,0,1189,592353
10/21/22,Cyprus,35.1264,33.4299,596297,0,1191,595106
10/22/22,Cyprus,35.1264,33.4299,596297,0,1191,595106
10/23/22,Cyprus,35.1264,33.4299,596297,0,1191,595106
10/24/22,Cyprus,35.1264,33.4299,596297,0,1191,595106
10/25/22,Cyprus,35.1264,33.4299,596297,0,1191,595106
10/26/22,Cyprus,35.1264,33.4299,596297,0,1191,595106
10/27/22,Cyprus,35.1264,33.4299,596297,0,1191,595106
10/28/22,Cyprus,35.1264,33.4299,599118,0,1194,597924
10/29/22,Cyprus,35.1264,33.4299,599118,0,1194,597924
10/30/22,Cyprus,35.1264,33.4299,599118,0,1194,597924
10/31/22,Cyprus,35.1264,33.4299,599118,0,1194,597924
11/1/22,Cyprus,35.1264,33.4299,599118,0,1194,597924
11/2/22,Cyprus,35.1264,33.4299,599118,0,1194,597924
11/3/22,Cyprus,35.1264,33.4299,599118,0,1194,597924
11/4/22,Cyprus,35.1264,33.4299,602662,0,1200,601462
11/5/22,Cyprus,35.1264,33.4299,602662,0,1200,601462
11/6/22,Cyprus,35.1264,33.4299,602662,0,1200,601462
11/7/22,Cyprus,35.1264,33.4299,602662,0,1200,601462
11/8/22,Cyprus,35.1264,33.4299,602662,0,1200,601462
11/9/22,Cyprus,35.1264,33.4299,602662,0,1200,601462
11/10/22,Cyprus,35.1264,33.4299,602662,0,1200,601462
11/11/22,Cyprus,35.1264,33.4299,602662,0,1200,601462
11/12/22,Cyprus,35.1264,33.4299,606287,0,1210,605077
11/13/22,Cyprus,35.1264,33.4299,606287,0,1210,605077
11/14/22,Cyprus,35.1264,33.4299,606287,0,1210,605077
11/15/22,Cyprus,35.1264,33.4299,606287,0,1210,605077
11/16/22,Cyprus,35.1264,33.4299,606287,0,1210,605077
11/17/22,Cyprus,35.1264,33.4299,606287,0,1210,605077
11/18/22,Cyprus,35.1264,33.4299,610023,0,1218,608805
11/19/22,Cyprus,35.1264,33.4299,610023,0,1218,608805
11/20/22,Cyprus,35.1264,33.4299,610023,0,1218,608805
11/21/22,Cyprus,35.1264,33.4299,610023,0,1218,608805
11/22/22,Cyprus,35.1264,33.4299,610023,0,1218,608805
11/23/22,Cyprus,35.1264,33.4299,610023,0,1218,608805
11/24/22,Cyprus,35.1264,33.4299,610023,0,1218,608805
11/25/22,Cyprus,35.1264,33.4299,614237,0,1226,613011
11/26/22,Cyprus,35.1264,33.4299,614237,0,1226,613011
11/27/22,Cyprus,35.1264,33.4299,614237,0,1226,613011
11/28/22,Cyprus,35.1264,33.4299,614237,0,1226,613011
11/29/22,Cyprus,35.1264,33.4299,614237,0,1226,613011
11/30/22,Cyprus,35.1264,33.4299,614237,0,1226,613011
12/1/22,Cyprus,35.1264,33.4299,614237,0,1226,613011
12/2/22,Cyprus,35.1264,33.4299,618248,0,1237,617011
12/3/22,Cyprus,35.1264,33.4299,618248,0,1237,617011
12/4/22,Cyprus,35.1264,33.4299,618248,0,1237,617011
12/5/22,Cyprus,35.1264,33.4299,618248,0,1237,617011
12/6/22,Cyprus,35.1264,33.4299,618248,0,1237,617011
12/7/22,Cyprus,35.1264,33.4299,618248,0,1237,617011
12/8/22,Cyprus,35.1264,33.4299,618248,0,1237,617011
12/9/22,Cyprus,35.1264,33.4299,622102,0,1242,620860
12/10/22,Cyprus,35.1264,33.4299,622102,0,1242,620860
12/11/22,Cyprus,35.1264,33.4299,622102,0,1242,620860
12/12/22,Cyprus,35.1264,33.4299,622102,0,1242,620860
12/13/22,Cyprus,35.1264,33.4299,622102,0,1242,620860
12/14/22,Cyprus,35.1264,33.4299,622102,0,1242,620860
12/15/22,Cyprus,35.1264,33.4299,622102,0,1242,620860
12/16/22,Cyprus,35.1264,33.4299,625562,0,1250,624312
12/17/22,Cyprus,35.1264,33.4299,625562,0,1250,624312
1/1/22,Czechia,49.8175,15.473,2480736,0,36182,2444554
1/2/22,Czechia,49.8175,15.473,2481832,0,36219,2445613
1/3/22,Czechia,49.8175,15.473,2483762,0,36255,2447507
1/4/22,Czechia,49.8175,15.473,2493145,0,36326,2456819
1/5/22,Czechia,49.8175,15.473,2503374,0,36397,2466977
1/6/22,Czechia,49.8175,15.473,2510796,0,36449,2474347
1/7/22,Czechia,49.8175,15.473,2517475,0,36507,2480968
1/8/22,Czechia,49.8175,15.473,2524171,0,36558,2487613
1/9/22,Czechia,49.8175,15.473,2528146,0,36590,2491556
1/10/22,Czechia,49.8175,15.473,2530917,0,36624,2494293
1/11/22,Czechia,49.8175,15.473,2538298,0,36683,2501615
1/12/22,Czechia,49.8175,15.473,2562235,0,36765,2525470
1/13/22,Czechia,49.8175,15.473,2562235,0,36765,2525470
1/14/22,Czechia,49.8175,15.473,2573945,0,36799,2537146
1/15/22,Czechia,49.8175,15.473,2587147,0,36828,2550319
1/16/22,Czechia,49.8175,15.473,2632719,0,36853,2595866
1/17/22,Czechia,49.8175,15.473,2641228,0,36874,2604354
1/18/22,Czechia,49.8175,15.473,2662424,0,36910,2625514
1/19/22,Czechia,49.8175,15.473,2692967,0,36937,2656030
1/20/22,Czechia,49.8175,15.473,2722736,0,36972,2685764
1/21/22,Czechia,49.8175,15.473,2757901,0,36997,2720904
1/22/22,Czechia,49.8175,15.473,2787628,0,37021,2750607
1/23/22,Czechia,49.8175,15.473,2808253,0,37034,2771219
1/24/22,Czechia,49.8175,15.473,2824706,0,37050,2787656
1/25/22,Czechia,49.8175,15.473,2858293,0,37080,2821213
1/26/22,Czechia,49.8175,15.473,2900420,0,37092,2863328
1/27/22,Czechia,49.8175,15.473,2955286,0,37114,2918172
1/28/22,Czechia,49.8175,15.473,3011231,0,37145,2974086
1/29/22,Czechia,49.8175,15.473,3066602,0,37168,3029434
1/30/22,Czechia,49.8175,15.473,3088053,0,37184,3050869
1/31/22,Czechia,49.8175,15.473,3115889,0,37209,3078680
2/1/22,Czechia,49.8175,15.473,3150554,0,37243,3113311
2/2/22,Czechia,49.8175,15.473,3217661,0,37281,3180380
2/3/22,Czechia,49.8175,15.473,3268443,0,37325,3231118
2/4/22,Czechia,49.8175,15.473,3312744,0,37363,3275381
2/5/22,Czechia,49.8175,15.473,3346615,0,37410,3309205
2/6/22,Czechia,49.8175,15.473,3374680,0,37449,3337231
2/7/22,Czechia,49.8175,15.473,3385286,0,37478,3347808
2/8/22,Czechia,49.8175,15.473,3414963,0,37549,3377414
2/9/22,Czechia,49.8175,15.473,3458101,0,37612,3420489
2/10/22,Czechia,49.8175,15.473,3493940,0,37660,3456280
2/11/22,Czechia,49.8175,15.473,3525477,0,37712,3487765
2/12/22,Czechia,49.8175,15.473,3551711,0,37765,3513946
2/13/22,Czechia,49.8175,15.473,3564497,0,37820,3526677
2/14/22,Czechia,49.8175,15.473,3572795,0,37873,3534922
2/15/22,Czechia,49.8175,15.473,3624361,0,37991,3586370
2/16/22,Czechia,49.8175,15.473,3629389,0,37991,3591398
2/17/22,Czechia,49.8175,15.473,3649295,0,38050,3611245
2/18/22,Czechia,49.8175,15.473,3667743,0,38106,3629637
2/19/22,Czechia,49.8175,15.473,3684163,0,38188,3645975
2/20/22,Czechia,49.8175,15.473,3693738,0,38226,3655512
2/21/22,Czechia,49.8175,15.473,3711531,0,38335,3673196
2/22/22,Czechia,49.8175,15.473,3714705,0,38335,3676370
2/23/22,Czechia,49.8175,15.473,3731633,0,38403,3693230
2/24/22,Czechia,49.8175,15.473,3744898,0,38433,3706465
2/25/22,Czechia,49.8175,15.473,3756826,0,38491,3718335
2/26/22,Czechia,49.8175,15.473,3767707,0,38558,3729149
2/27/22,Czechia,49.8175,15.473,3774273,0,38592,3735681
2/28/22,Czechia,49.8175,15.473,3774273,0,38592,3735681
3/1/22,Czechia,49.8175,15.473,3787816,0,38685,3749131
3/2/22,Czechia,49.8175,15.473,3801822,0,38741,3763081
3/3/22,Czechia,49.8175,15.473,3814708,0,38787,3775921
3/4/22,Czechia,49.8175,15.473,3824372,0,38837,3785535
3/5/22,Czechia,49.8175,15.473,3834261,0,38892,3795369
3/6/22,Czechia,49.8175,15.473,3839664,0,38915,3800749
3/7/22,Czechia,49.8175,15.473,3842705,0,38940,3803765
3/8/22,Czechia,49.8175,15.473,3855105,0,38986,3816119
3/9/22,Czechia,49.8175,15.473,3867607,0,39032,3828575
3/10/22,Czechia,49.8175,15.473,3878361,0,39068,3839293
3/11/22,Czechia,49.8175,15.473,3888172,0,39100,3849072
3/12/22,Czechia,49.8175,15.473,3896563,0,39126,3857437
3/13/22,Czechia,49.8175,15.473,3905420,0,39155,3866265
3/14/22,Czechia,49.8175,15.473,3906606,0,39155,3867451
3/15/22,Czechia,49.8175,15.473,3919536,0,39216,3880320
3/16/22,Czechia,49.8175,15.473,3932228,0,39248,3892980
3/17/22,Czechia,49.8175,15.473,3942465,0,39271,3903194
3/18/22,Czechia,49.8175,15.473,3952137,0,39318,3912819
3/19/22,Czechia,49.8175,15.473,3962517,0,39352,3923165
3/20/22,Czechia,49.8175,15.473,3968087,0,39359,3928728
3/21/22,Czechia,49.8175,15.473,3970741,0,39374,3931367
3/22/22,Czechia,49.8175,15.473,3983263,0,39418,3943845
3/23/22,Czechia,49.8175,15.473,3995765,0,39441,3956324
3/24/22,Czechia,49.8175,15.473,4013020,0,39495,3973525
3/25/22,Czechia,49.8175,15.473,4022019,0,39527,3982492
3/26/22,Czechia,49.8175,15.473,4022019,0,39527,3982492
3/27/22,Czechia,49.8175,15.473,4029203,0,39563,3989640
3/28/22,Czechia,49.8175,15.473,4039032,0,39610,3999422
3/29/22,Czechia,49.8175,15.473,4049647,0,39640,4010007
3/30/22,Czechia,49.8175,15.473,4058723,0,39673,4019050
3/31/22,Czechia,49.8175,15.473,4066564,0,39692,4026872
4/1/22,Czechia,49.8175,15.473,4073829,0,39706,4034123
4/2/22,Czechia,49.8175,15.473,4077544,0,39715,4037829
4/3/22,Czechia,49.8175,15.473,4079679,0,39723,4039956
4/4/22,Czechia,49.8175,15.473,4086258,0,39755,4046503
4/5/22,Czechia,49.8175,15.473,4093300,0,39784,4053516
4/6/22,Czechia,49.8175,15.473,4101132,0,39816,4061316
4/7/22,Czechia,49.8175,15.473,4107208,0,39844,4067364
4/8/22,Czechia,49.8175,15.473,4112287,0,39872,4072415
4/9/22,Czechia,49.8175,15.473,4115341,0,39880,4075461
4/10/22,Czechia,49.8175,15.473,4115738,0,39880,4075858
4/11/22,Czechia,49.8175,15.473,4122103,0,39917,4082186
4/12/22,Czechia,49.8175,15.473,4127104,0,39933,4087171
4/13/22,Czechia,49.8175,15.473,4134831,0,39945,4094886
4/14/22,Czechia,49.8175,15.473,4131963,0,39945,4092018
4/15/22,Czechia,49.8175,15.473,4136525,0,39971,4096554
4/16/22,Czechia,49.8175,15.473,4138441,0,39980,4098461
4/17/22,Czechia,49.8175,15.473,4139418,0,39990,4099428
4/18/22,Czechia,49.8175,15.473,4140424,0,39997,4100427
4/19/22,Czechia,49.8175,15.473,4144163,0,40022,4104141
4/20/22,Czechia,49.8175,15.473,4148309,0,40038,4108271
4/21/22,Czechia,49.8175,15.473,4151107,0,40058,4111049
4/22/22,Czechia,49.8175,15.473,4153635,0,40071,4113564
4/23/22,Czechia,49.8175,15.473,4154960,0,40081,4114879
4/24/22,Czechia,49.8175,15.473,4155729,0,40083,4115646
4/25/22,Czechia,49.8175,15.473,4157991,0,40102,4117889
4/26/22,Czechia,49.8175,15.473,4160143,0,40114,4120029
4/27/22,Czechia,49.8175,15.473,4162613,0,40123,4122490
4/28/22,Czechia,49.8175,15.473,4164485,0,40143,4124342
4/29/22,Czechia,49.8175,15.473,4166233,0,40155,4126078
4/30/22,Czechia,49.8175,15.473,4166475,0,40155,4126320
5/1/22,Czechia,49.8175,15.473,4167608,0,40164,4127444
5/2/22,Czechia,49.8175,15.473,4169382,0,40175,4129207
5/3/22,Czechia,49.8175,15.473,4170756,0,40184,4130572
5/4/22,Czechia,49.8175,15.473,4172302,0,40194,4132108
5/5/22,Czechia,49.8175,15.473,4173715,0,40203,4133512
5/6/22,Czechia,49.8175,15.473,4174709,0,40212,4134497
5/7/22,Czechia,49.8175,15.473,4175131,0,40215,4134916
5/8/22,Czechia,49.8175,15.473,4175310,0,40220,4135090
5/9/22,Czechia,49.8175,15.473,4175322,0,40220,4135102
5/10/22,Czechia,49.8175,15.473,4177129,0,40233,4136896
5/11/22,Czechia,49.8175,15.473,4177276,0,40233,4137043
5/12/22,Czechia,49.8175,15.473,4178519,0,40240,4138279
5/13/22,Czechia,49.8175,15.473,4179110,0,40245,4138865
5/14/22,Czechia,49.8175,15.473,4179254,0,40245,4139009
5/15/22,Czechia,49.8175,15.473,4179449,0,40246,4139203
5/16/22,Czechia,49.8175,15.473,4179981,0,40256,4139725
5/17/22,Czechia,49.8175,15.473,4180583,0,40258,4140325
5/18/22,Czechia,49.8175,15.473,4181046,0,40260,4140786
5/19/22,Czechia,49.8175,15.473,4181475,0,40262,4141213
5/20/22,Czechia,49.8175,15.473,4181872,0,40265,4141607
5/21/22,Czechia,49.8175,15.473,4181957,0,40266,4141691
5/22/22,Czechia,49.8175,15.473,4181140,0,40266,4140874
5/23/22,Czechia,49.8175,15.473,4182529,0,40270,4142259
5/24/22,Czechia,49.8175,15.473,4182798,0,40277,4142521
5/25/22,Czechia,49.8175,15.473,4183201,0,40280,4142921
5/26/22,Czechia,49.8175,15.473,4183511,0,40280,4143231
5/27/22,Czechia,49.8175,15.473,4183817,0,40281,4143536
5/28/22,Czechia,49.8175,15.473,4183868,0,40281,4143587
5/29/22,Czechia,49.8175,15.473,4183966,0,40281,4143685
5/30/22,Czechia,49.8175,15.473,4184289,0,40283,4144006
5/31/22,Czechia,49.8175,15.473,4184645,0,40288,4144357
6/1/22,Czechia,49.8175,15.473,4184945,0,40289,4144656
6/2/22,Czechia,49.8175,15.473,4185178,0,40290,4144888
6/3/22,Czechia,49.8175,15.473,4185467,0,40290,4145177
6/4/22,Czechia,49.8175,15.473,4185575,0,40291,4145284
6/5/22,Czechia,49.8175,15.473,4185677,0,40293,4145384
6/6/22,Czechia,49.8175,15.473,4186087,0,40294,4145793
6/7/22,Czechia,49.8175,15.473,4186492,0,40295,4146197
6/8/22,Czechia,49.8175,15.473,4186492,0,40295,4146197
6/9/22,Czechia,49.8175,15.473,4186921,0,40297,4146624
6/10/22,Czechia,49.8175,15.473,4187672,0,40301,4147371
6/11/22,Czechia,49.8175,15.473,4187899,0,40301,4147598
6/12/22,Czechia,49.8175,15.473,4187986,0,40302,4147684
6/13/22,Czechia,49.8175,15.473,4188457,0,40303,4148154
6/14/22,Czechia,49.8175,15.473,4189007,0,40303,4148704
6/15/22,Czechia,49.8175,15.473,4189550,0,40303,4149247
6/16/22,Czechia,49.8175,15.473,4190033,0,40307,4149726
6/17/22,Czechia,49.8175,15.473,4190558,0,40307,4150251
6/18/22,Czechia,49.8175,15.473,4190681,0,40307,4150374
6/19/22,Czechia,49.8175,15.473,4190900,0,40308,4150592
6/20/22,Czechia,49.8175,15.473,4191530,0,40309,4151221
6/21/22,Czechia,49.8175,15.473,4192274,0,40309,4151965
6/22/22,Czechia,49.8175,15.473,4193111,0,40310,4152801
6/23/22,Czechia,49.8175,15.473,4194033,0,40312,4153721
6/24/22,Czechia,49.8175,15.473,4194992,0,40313,4154679
6/25/22,Czechia,49.8175,15.473,4195231,0,40313,4154918
6/26/22,Czechia,49.8175,15.473,4195536,0,40313,4155223
6/27/22,Czechia,49.8175,15.473,4196831,0,40314,4156517
6/28/22,Czechia,49.8175,15.473,4198371,0,40316,4158055
6/29/22,Czechia,49.8175,15.473,4199867,0,40316,4159551
6/30/22,Czechia,49.8175,15.473,4201201,0,40318,4160883
7/1/22,Czechia,49.8175,15.473,4202797,0,40321,4162476
7/2/22,Czechia,49.8175,15.473,4203510,0,40321,4163189
7/3/22,Czechia,49.8175,15.473,4203782,0,40322,4163460
7/4/22,Czechia,49.8175,15.473,4205113,0,40324,4164789
7/5/22,Czechia,49.8175,15.473,4206028,0,40324,4165704
7/6/22,Czechia,49.8175,15.473,4206375,0,40325,4166050
7/7/22,Czechia,49.8175,15.473,4207929,0,40330,4167599
7/8/22,Czechia,49.8175,15.473,4210311,0,40332,4169979
7/9/22,Czechia,49.8175,15.473,4210887,0,40332,4170555
7/10/22,Czechia,49.8175,15.473,4211611,0,40332,4171279
7/11/22,Czechia,49.8175,15.473,4213838,0,40334,4173504
7/12/22,Czechia,49.8175,15.473,4214511,0,40334,4174177
7/13/22,Czechia,49.8175,15.473,4219131,0,40343,4178788
7/14/22,Czechia,49.8175,15.473,4221495,0,40346,4181149
7/15/22,Czechia,49.8175,15.473,4224439,0,40350,4184089
7/16/22,Czechia,49.8175,15.473,4225794,0,40352,4185442
7/17/22,Czechia,49.8175,15.473,4226056,0,40355,4185701
7/18/22,Czechia,49.8175,15.473,4229211,0,40360,4188851
7/19/22,Czechia,49.8175,15.473,4233426,0,40365,4193061
7/20/22,Czechia,49.8175,15.473,4237282,0,40370,4196912
7/21/22,Czechia,49.8175,15.473,4241008,0,40380,4200628
7/22/22,Czechia,49.8175,15.473,4244833,0,40383,4204450
7/23/22,Czechia,49.8175,15.473,4244833,0,40383,4204450
7/24/22,Czechia,49.8175,15.473,4246770,0,40387,4206383
7/25/22,Czechia,49.8175,15.473,4247533,0,40390,4207143
7/26/22,Czechia,49.8175,15.473,4256055,0,40420,4215635
7/27/22,Czechia,49.8175,15.473,4260225,0,40434,4219791
7/28/22,Czechia,49.8175,15.473,4263854,0,40448,4223406
7/29/22,Czechia,49.8175,15.473,4264743,0,40448,4224295
7/30/22,Czechia,49.8175,15.473,4269212,0,40469,4228743
7/31/22,Czechia,49.8175,15.473,4269766,0,40477,4229289
8/1/22,Czechia,49.8175,15.473,4273304,0,40500,4232804
8/2/22,Czechia,49.8175,15.473,4276396,0,40518,4235878
8/3/22,Czechia,49.8175,15.473,4280357,0,40531,4239826
8/4/22,Czechia,49.8175,15.473,4283662,0,40544,4243118
8/5/22,Czechia,49.8175,15.473,4287884,0,40555,4247329
8/6/22,Czechia,49.8175,15.473,4288852,0,40555,4248297
8/7/22,Czechia,49.8175,15.473,4289883,0,40566,4249317
8/8/22,Czechia,49.8175,15.473,4292932,0,40587,4252345
8/9/22,Czechia,49.8175,15.473,4292932,0,40587,4252345
8/10/22,Czechia,49.8175,15.473,4297469,0,40601,4256868
8/11/22,Czechia,49.8175,15.473,4302477,0,40619,4261858
8/12/22,Czechia,49.8175,15.473,4305402,0,40634,4264768
8/13/22,Czechia,49.8175,15.473,4306853,0,40641,4266212
8/14/22,Czechia,49.8175,15.473,4307135,0,40647,4266488
8/15/22,Czechia,49.8175,15.473,4310239,0,40660,4269579
8/16/22,Czechia,49.8175,15.473,4314213,0,40674,4273539
8/17/22,Czechia,49.8175,15.473,4317780,0,40687,4277093
8/18/22,Czechia,49.8175,15.473,4320609,0,40700,4279909
8/19/22,Czechia,49.8175,15.473,4323488,0,40714,4282774
8/20/22,Czechia,49.8175,15.473,4324812,0,40719,4284093
8/21/22,Czechia,49.8175,15.473,4325194,0,40726,4284468
8/22/22,Czechia,49.8175,15.473,4327819,0,40747,4287072
8/23/22,Czechia,49.8175,15.473,4330039,0,40756,4289283
8/24/22,Czechia,49.8175,15.473,4332971,0,40758,4292213
8/25/22,Czechia,49.8175,15.473,4334684,0,40758,4293926
8/26/22,Czechia,49.8175,15.473,4338808,0,40781,4298027
8/27/22,Czechia,49.8175,15.473,4339998,0,40787,4299211
8/28/22,Czechia,49.8175,15.473,4340382,0,40791,4299591
8/29/22,Czechia,49.8175,15.473,4343107,0,40805,4302302
8/30/22,Czechia,49.8175,15.473,4345369,0,40814,4304555
8/31/22,Czechia,49.8175,15.473,4348510,0,40829,4307681
9/1/22,Czechia,49.8175,15.473,4352022,0,40839,4311183
9/2/22,Czechia,49.8175,15.473,4354525,0,40846,4313679
9/3/22,Czechia,49.8175,15.473,4355725,0,40848,4314877
9/4/22,Czechia,49.8175,15.473,4356062,0,40851,4315211
9/5/22,Czechia,49.8175,15.473,4358878,0,40857,4318021
9/6/22,Czechia,49.8175,15.473,4361336,0,40869,4320467
9/7/22,Czechia,49.8175,15.473,4365965,0,40883,4325082
9/8/22,Czechia,49.8175,15.473,4369120,0,40898,4328222
9/9/22,Czechia,49.8175,15.473,4372298,0,40905,4331393
9/10/22,Czechia,49.8175,15.473,4373873,0,40906,4332967
9/11/22,Czechia,49.8175,15.473,4374085,0,40906,4333179
9/12/22,Czechia,49.8175,15.473,4377652,0,40918,4336734
9/13/22,Czechia,49.8175,15.473,4377738,0,40918,4336820
9/14/22,Czechia,49.8175,15.473,4386429,0,40932,4345497
9/15/22,Czechia,49.8175,15.473,4390188,0,40943,4349245
9/16/22,Czechia,49.8175,15.473,4393940,0,40951,4352989
9/17/22,Czechia,49.8175,15.473,4395603,0,40953,4354650
9/18/22,Czechia,49.8175,15.473,4396134,0,40956,4355178
9/19/22,Czechia,49.8175,15.473,4400015,0,40967,4359048
9/20/22,Czechia,49.8175,15.473,4401773,0,40967,4360806
9/21/22,Czechia,49.8175,15.473,4409510,0,40990,4368520
9/22/22,Czechia,49.8175,15.473,4413519,0,40999,4372520
9/23/22,Czechia,49.8175,15.473,4417617,0,41009,4376608
9/24/22,Czechia,49.8175,15.473,4419509,0,41012,4378497
9/25/22,Czechia,49.8175,15.473,4419726,0,41012,4378714
9/26/22,Czechia,49.8175,15.473,4424760,0,41039,4383721
9/27/22,Czechia,49.8175,15.473,4431015,0,41049,4389966
9/28/22,Czechia,49.8175,15.473,4433510,0,41059,4392451
9/29/22,Czechia,49.8175,15.473,4437198,0,41090,4396108
9/30/22,Czechia,49.8175,15.473,4442820,0,41104,4401716
10/1/22,Czechia,49.8175,15.473,4445052,0,41107,4403945
10/2/22,Czechia,49.8175,15.473,4445673,0,41118,4404555
10/3/22,Czechia,49.8175,15.473,4450607,0,41142,4409465
10/4/22,Czechia,49.8175,15.473,4452643,0,41142,4411501
10/5/22,Czechia,49.8175,15.473,4460831,0,41185,4419646
10/6/22,Czechia,49.8175,15.473,4465014,0,41200,4423814
10/7/22,Czechia,49.8175,15.473,4469059,0,41225,4427834
10/8/22,Czechia,49.8175,15.473,4470713,0,41234,4429479
10/9/22,Czechia,49.8175,15.473,4471217,0,41240,4429977
10/10/22,Czechia,49.8175,15.473,4475164,0,41281,4433883
10/11/22,Czechia,49.8175,15.473,4479715,0,41311,4438404
10/12/22,Czechia,49.8175,15.473,4481937,0,41332,4440605
10/13/22,Czechia,49.8175,15.473,4485388,0,41354,4444034
10/14/22,Czechia,49.8175,15.473,4488281,0,41376,4446905
10/15/22,Czechia,49.8175,15.473,4490294,0,41380,4448914
10/16/22,Czechia,49.8175,15.473,4490643,0,41388,4449255
10/17/22,Czechia,49.8175,15.473,4493130,0,41420,4451710
10/18/22,Czechia,49.8175,15.473,4496553,0,41427,4455126
10/19/22,Czechia,49.8175,15.473,4499362,0,41454,4457908
10/20/22,Czechia,49.8175,15.473,4500308,0,41454,4458854
10/21/22,Czechia,49.8175,15.473,4504003,0,41491,4462512
10/22/22,Czechia,49.8175,15.473,4504786,0,41492,4463294
10/23/22,Czechia,49.8175,15.473,4504885,0,41492,4463393
10/24/22,Czechia,49.8175,15.473,4506846,0,41524,4465322
10/25/22,Czechia,49.8175,15.473,4506896,0,41524,4465372
10/26/22,Czechia,49.8175,15.473,4519021,0,41549,4477472
10/27/22,Czechia,49.8175,15.473,4512136,0,41567,4470569
10/28/22,Czechia,49.8175,15.473,4512718,0,41570,4471148
10/29/22,Czechia,49.8175,15.473,4512776,0,41570,4471206
10/30/22,Czechia,49.8175,15.473,4512963,0,41573,4471390
10/31/22,Czechia,49.8175,15.473,4513087,0,41580,4471507
11/1/22,Czechia,49.8175,15.473,4515117,0,41602,4473515
11/2/22,Czechia,49.8175,15.473,4516710,0,41613,4475097
11/3/22,Czechia,49.8175,15.473,4517514,0,41624,4475890
11/4/22,Czechia,49.8175,15.473,4518555,0,41635,4476920
11/5/22,Czechia,49.8175,15.473,4519751,0,41648,4478103
11/6/22,Czechia,49.8175,15.473,4519947,0,41654,4478293
11/7/22,Czechia,49.8175,15.473,4520054,0,41660,4478394
11/8/22,Czechia,49.8175,15.473,4521430,0,41674,4479756
11/9/22,Czechia,49.8175,15.473,4522444,0,41682,4480762
11/10/22,Czechia,49.8175,15.473,4523069,0,41698,4481371
11/11/22,Czechia,49.8175,15.473,4523895,0,41703,4482192
11/12/22,Czechia,49.8175,15.473,4524863,0,41710,4483153
11/13/22,Czechia,49.8175,15.473,4525021,0,41713,4483308
11/14/22,Czechia,49.8175,15.473,4525110,0,41717,4483393
11/15/22,Czechia,49.8175,15.473,4526328,0,41732,4484596
11/16/22,Czechia,49.8175,15.473,4527218,0,41738,4485480
11/17/22,Czechia,49.8175,15.473,4527776,0,41743,4486033
11/18/22,Czechia,49.8175,15.473,4528130,0,41746,4486384
11/19/22,Czechia,49.8175,15.473,4528833,0,41751,4487082
11/20/22,Czechia,49.8175,15.473,4529002,0,41755,4487247
11/21/22,Czechia,49.8175,15.473,4529105,0,41759,4487346
11/22/22,Czechia,49.8175,15.473,4530396,0,41772,4488624
11/23/22,Czechia,49.8175,15.473,4531025,0,41774,4489251
11/24/22,Czechia,49.8175,15.473,4531859,0,41783,4490076
11/25/22,Czechia,49.8175,15.473,4532640,0,41791,4490849
11/26/22,Czechia,49.8175,15.473,4533602,0,41797,4491805
11/27/22,Czechia,49.8175,15.473,4533753,0,41799,4491954
11/28/22,Czechia,49.8175,15.473,4533848,0,41800,4492048
11/29/22,Czechia,49.8175,15.473,4557086,0,41814,4515272
11/30/22,Czechia,49.8175,15.473,4558202,0,41882,4516320
12/1/22,Czechia,49.8175,15.473,4559200,0,41888,4517312
12/2/22,Czechia,49.8175,15.473,4560109,0,41897,4518212
12/3/22,Czechia,49.8175,15.473,4561031,0,41901,4519130
12/4/22,Czechia,49.8175,15.473,4561223,0,41904,4519319
12/5/22,Czechia,49.8175,15.473,4561350,0,41904,4519446
12/6/22,Czechia,49.8175,15.473,4562887,0,41923,4520964
12/7/22,Czechia,49.8175,15.473,4564148,0,41931,4522217
12/8/22,Czechia,49.8175,15.473,4565229,0,41937,4523292
12/9/22,Czechia,49.8175,15.473,4566217,0,41949,4524268
12/10/22,Czechia,49.8175,15.473,4567205,0,41952,4525253
12/11/22,Czechia,49.8175,15.473,4567383,0,41953,4525430
12/12/22,Czechia,49.8175,15.473,4567493,0,41957,4525536
12/13/22,Czechia,49.8175,15.473,4568993,0,41971,4527022
12/14/22,Czechia,49.8175,15.473,4570189,0,41979,4528210
12/15/22,Czechia,49.8175,15.473,4571137,0,41991,4529146
12/16/22,Czechia,49.8175,15.473,4571924,0,42001,4529923
12/17/22,Czechia,49.8175,15.473,4572726,0,42005,4530721
1/1/22,Denmark,56.2639,9.5018,831974,0,3287,828687
1/2/22,Denmark,56.2639,9.5018,839952,0,3302,836650
1/3/22,Denmark,56.2639,9.5018,849334,0,3308,846026
1/4/22,Denmark,56.2639,9.5018,874890,0,3323,871567
1/5/22,Denmark,56.2639,9.5018,903652,0,3338,900314
1/6/22,Denmark,56.2639,9.5018,929647,0,3349,926298
1/7/22,Denmark,56.2639,9.5018,948499,0,3359,945140
1/8/22,Denmark,56.2639,9.5018,961591,0,3387,958204
1/9/22,Denmark,56.2639,9.5018,982189,0,3401,978788
1/10/22,Denmark,56.2639,9.5018,997079,0,3411,993668
1/11/22,Denmark,56.2639,9.5018,1020221,0,3425,1016796
1/12/22,Denmark,56.2639,9.5018,1045670,0,3450,1042220
1/13/22,Denmark,56.2639,9.5018,1072431,0,3470,1068961
1/14/22,Denmark,56.2639,9.5018,1096434,0,3485,1092949
1/15/22,Denmark,56.2639,9.5018,1121881,0,3501,1118380
1/16/22,Denmark,56.2639,9.5018,1149246,0,3512,1145734
1/17/22,Denmark,56.2639,9.5018,1178595,0,3523,1175072
1/18/22,Denmark,56.2639,9.5018,1213582,0,3537,1210045
1/19/22,Denmark,56.2639,9.5018,1253200,0,3553,1249647
1/20/22,Denmark,56.2639,9.5018,1294068,0,3569,1290499
1/21/22,Denmark,56.2639,9.5018,1342309,0,3590,1338719
1/22/22,Denmark,56.2639,9.5018,1379122,0,3617,1375505
1/23/22,Denmark,56.2639,9.5018,1421658,0,3629,1418029
1/24/22,Denmark,56.2639,9.5018,1462869,0,3642,1459227
1/25/22,Denmark,56.2639,9.5018,1510577,0,3656,1506921
1/26/22,Denmark,56.2639,9.5018,1558312,0,3677,1554635
1/27/22,Denmark,56.2639,9.5018,1610313,0,3697,1606616
1/28/22,Denmark,56.2639,9.5018,1664142,0,3723,1660419
1/29/22,Denmark,56.2639,9.5018,1706529,0,3740,1702789
1/30/22,Denmark,56.2639,9.5018,1743246,0,3761,1739485
1/31/22,Denmark,56.2639,9.5018,1772901,0,3778,1769123
2/1/22,Denmark,56.2639,9.5018,1819505,0,3795,1815710
2/2/22,Denmark,56.2639,9.5018,1875214,0,3815,1871399
2/3/22,Denmark,56.2639,9.5018,1919543,0,3836,1915707
2/4/22,Denmark,56.2639,9.5018,1961273,0,3854,1957419
2/5/22,Denmark,56.2639,9.5018,2000463,0,3889,1996574
2/6/22,Denmark,56.2639,9.5018,2038073,0,3907,2034166
2/7/22,Denmark,56.2639,9.5018,2073328,0,3935,2069393
2/8/22,Denmark,56.2639,9.5018,2124590,0,3954,2120636
2/9/22,Denmark,56.2639,9.5018,2179734,0,3975,2175759
2/10/22,Denmark,56.2639,9.5018,2234177,0,4006,2230171
2/11/22,Denmark,56.2639,9.5018,2283836,0,4030,2279806
2/12/22,Denmark,56.2639,9.5018,2328905,0,4067,2324838
2/13/22,Denmark,56.2639,9.5018,2367533,0,4098,2363435
2/14/22,Denmark,56.2639,9.5018,2397366,0,4140,2393226
2/15/22,Denmark,56.2639,9.5018,2441321,0,4172,2437149
2/16/22,Denmark,56.2639,9.5018,2484869,0,4197,2480672
2/17/22,Denmark,56.2639,9.5018,2525517,0,4241,2521276
2/18/22,Denmark,56.2639,9.5018,2561714,0,4286,2557428
2/19/22,Denmark,56.2639,9.5018,2595018,0,4314,2590704
2/20/22,Denmark,56.2639,9.5018,2621660,0,4348,2617312
2/21/22,Denmark,56.2639,9.5018,2650559,0,4377,2646182
2/22/22,Denmark,56.2639,9.5018,2681103,0,4412,2676691
2/23/22,Denmark,56.2639,9.5018,2710998,0,4463,2706535
2/24/22,Denmark,56.2639,9.5018,2736535,0,4502,2732033
2/25/22,Denmark,56.2639,9.5018,2759752,0,4543,2755209
2/26/22,Denmark,56.2639,9.5018,2777111,0,4580,2772531
2/27/22,Denmark,56.2639,9.5018,2794212,0,4628,2789584
2/28/22,Denmark,56.2639,9.5018,2810800,0,4658,2806142
3/1/22,Denmark,56.2639,9.5018,2829529,0,4696,2824833
3/2/22,Denmark,56.2639,9.5018,2850274,0,4734,2845540
3/3/22,Denmark,56.2639,9.5018,2850293,0,4733,2845560
3/4/22,Denmark,56.2639,9.5018,2883965,0,4820,2879145
3/5/22,Denmark,56.2639,9.5018,2899700,0,4878,2894822
3/6/22,Denmark,56.2639,9.5018,2910527,0,4916,2905611
3/7/22,Denmark,56.2639,9.5018,2922756,0,4953,2917803
3/8/22,Denmark,56.2639,9.5018,2938246,0,4996,2933250
3/9/22,Denmark,56.2639,9.5018,2955211,0,5056,2950155
3/10/22,Denmark,56.2639,9.5018,2969537,0,5097,2964440
3/11/22,Denmark,56.2639,9.5018,2983370,0,5124,2978246
3/12/22,Denmark,56.2639,9.5018,2990461,0,5176,2985285
3/13/22,Denmark,56.2639,9.5018,2997119,0,5223,2991896
3/14/22,Denmark,56.2639,9.5018,3005034,0,5244,2999790
3/15/22,Denmark,56.2639,9.5018,3014997,0,5280,3009717
3/16/22,Denmark,56.2639,9.5018,3024588,0,5305,3019283
3/17/22,Denmark,56.2639,9.5018,3032928,0,5348,3027580
3/18/22,Denmark,56.2639,9.5018,3040155,0,5386,3034769
3/19/22,Denmark,56.2639,9.5018,3046507,0,5423,3041084
3/20/22,Denmark,56.2639,9.5018,3051491,0,5450,3046041
3/21/22,Denmark,56.2639,9.5018,3056722,0,5478,3051244
3/22/22,Denmark,56.2639,9.5018,3064138,0,5509,3058629
3/23/22,Denmark,56.2639,9.5018,3070430,0,5535,3064895
3/24/22,Denmark,56.2639,9.5018,3075839,0,5567,3070272
3/25/22,Denmark,56.2639,9.5018,3081511,0,5591,3075920
3/26/22,Denmark,56.2639,9.5018,3085833,0,5632,3080201
3/27/22,Denmark,56.2639,9.5018,3089192,0,5634,3083558
3/28/22,Denmark,56.2639,9.5018,3092564,0,5634,3086930
3/29/22,Denmark,56.2639,9.5018,3097060,0,5634,3091426
3/30/22,Denmark,56.2639,9.5018,3101471,0,5717,3095754
3/31/22,Denmark,56.2639,9.5018,3105402,0,5747,3099655
4/1/22,Denmark,56.2639,9.5018,3108402,0,5772,3102630
4/2/22,Denmark,56.2639,9.5018,3111254,0,5794,3105460
4/3/22,Denmark,56.2639,9.5018,3113334,0,5811,3107523
4/4/22,Denmark,56.2639,9.5018,3115600,0,5826,3109774
4/5/22,Denmark,56.2639,9.5018,3118963,0,5847,3113116
4/6/22,Denmark,56.2639,9.5018,3122177,0,5862,3116315
4/7/22,Denmark,56.2639,9.5018,3124924,0,5886,3119038
4/8/22,Denmark,56.2639,9.5018,3127604,0,5910,3121694
4/9/22,Denmark,56.2639,9.5018,3130061,0,5934,3124127
4/10/22,Denmark,56.2639,9.5018,3131783,0,5957,3125826
4/11/22,Denmark,56.2639,9.5018,3133588,0,5970,3127618
4/12/22,Denmark,56.2639,9.5018,3136271,0,5981,3130290
4/13/22,Denmark,56.2639,9.5018,3138528,0,5994,3132534
4/14/22,Denmark,56.2639,9.5018,3140787,0,6010,3134777
4/15/22,Denmark,56.2639,9.5018,3142234,0,6023,3136211
4/16/22,Denmark,56.2639,9.5018,3143644,0,6034,3137610
4/17/22,Denmark,56.2639,9.5018,3145251,0,6046,3139205
4/18/22,Denmark,56.2639,9.5018,3145251,0,6046,3139205
4/19/22,Denmark,56.2639,9.5018,3148266,0,6068,3142198
4/20/22,Denmark,56.2639,9.5018,3150617,0,6079,3144538
4/21/22,Denmark,56.2639,9.5018,3152659,0,6096,3146563
4/22/22,Denmark,56.2639,9.5018,3154293,0,6109,3148184
4/23/22,Denmark,56.2639,9.5018,3155643,0,6121,3149522
4/24/22,Denmark,56.2639,9.5018,3156648,0,6133,3150515
4/25/22,Denmark,56.2639,9.5018,3157631,0,6154,3151477
4/26/22,Denmark,56.2639,9.5018,3159115,0,6165,3152950
4/27/22,Denmark,56.2639,9.5018,3160322,0,6174,3154148
4/28/22,Denmark,56.2639,9.5018,3161410,0,6184,3155226
4/29/22,Denmark,56.2639,9.5018,3162350,0,6198,3156152
4/30/22,Denmark,56.2639,9.5018,3163284,0,6207,3157077
5/1/22,Denmark,56.2639,9.5018,3163955,0,6219,3157736
5/2/22,Denmark,56.2639,9.5018,3164735,0,6232,3158503
5/3/22,Denmark,56.2639,9.5018,3165728,0,6240,3159488
5/4/22,Denmark,56.2639,9.5018,3166690,0,6256,3160434
5/5/22,Denmark,56.2639,9.5018,3167562,0,6267,3161295
5/6/22,Denmark,56.2639,9.5018,3168449,0,6275,3162174
5/7/22,Denmark,56.2639,9.5018,3169368,0,6283,3163085
5/8/22,Denmark,56.2639,9.5018,3169943,0,6287,3163656
5/9/22,Denmark,56.2639,9.5018,3170525,0,6293,3164232
5/10/22,Denmark,56.2639,9.5018,3171528,0,6301,3165227
5/11/22,Denmark,56.2639,9.5018,3172378,0,6309,3166069
5/12/22,Denmark,56.2639,9.5018,3173120,0,6320,3166800
5/13/22,Denmark,56.2639,9.5018,3173885,0,6327,3167558
5/14/22,Denmark,56.2639,9.5018,3174312,0,6334,3167978
5/15/22,Denmark,56.2639,9.5018,3174800,0,6336,3168464
5/16/22,Denmark,56.2639,9.5018,3175370,0,6342,3169028
5/17/22,Denmark,56.2639,9.5018,3176173,0,6345,3169828
5/18/22,Denmark,56.2639,9.5018,3176917,0,6353,3170564
5/19/22,Denmark,56.2639,9.5018,3177581,0,6361,3171220
5/20/22,Denmark,56.2639,9.5018,3177581,0,6361,3171220
5/21/22,Denmark,56.2639,9.5018,3177581,0,6361,3171220
5/22/22,Denmark,56.2639,9.5018,3177581,0,6361,3171220
5/23/22,Denmark,56.2639,9.5018,3177581,0,6361,3171220
5/24/22,Denmark,56.2639,9.5018,3180136,0,6384,3173752
5/25/22,Denmark,56.2639,9.5018,3180709,0,6388,3174321
5/26/22,Denmark,56.2639,9.5018,3181233,0,6392,3174841
5/27/22,Denmark,56.2639,9.5018,3181539,0,6393,3175146
5/28/22,Denmark,56.2639,9.5018,3182007,0,6399,3175608
5/29/22,Denmark,56.2639,9.5018,3182007,0,6399,3175608
5/30/22,Denmark,56.2639,9.5018,3182813,0,6407,3176406
5/31/22,Denmark,56.2639,9.5018,3183525,0,6412,3177113
6/1/22,Denmark,56.2639,9.5018,3184171,0,6417,3177754
6/2/22,Denmark,56.2639,9.5018,3184762,0,6421,3178341
6/3/22,Denmark,56.2639,9.5018,3185307,0,6425,3178882
6/4/22,Denmark,56.2639,9.5018,3185307,0,6425,3178882
6/5/22,Denmark,56.2639,9.5018,3185307,0,6425,3178882
6/6/22,Denmark,56.2639,9.5018,3185307,0,6425,3178882
6/7/22,Denmark,56.2639,9.5018,3187294,0,6437,3180857
6/8/22,Denmark,56.2639,9.5018,3188200,0,6441,3181759
6/9/22,Denmark,56.2639,9.5018,3189112,0,6444,3182668
6/10/22,Denmark,56.2639,9.5018,3190021,0,6453,3183568
6/11/22,Denmark,56.2639,9.5018,3190021,0,6453,3183568
6/12/22,Denmark,56.2639,9.5018,3190021,0,6453,3183568
6/13/22,Denmark,56.2639,9.5018,3192448,0,6463,3185985
6/14/22,Denmark,56.2639,9.5018,3193607,0,6466,3187141
6/15/22,Denmark,56.2639,9.5018,3194812,0,6468,3188344
6/16/22,Denmark,56.2639,9.5018,3196034,0,6470,3189564
6/17/22,Denmark,56.2639,9.5018,3197228,0,6470,3190758
6/18/22,Denmark,56.2639,9.5018,3197228,0,6470,3190758
6/19/22,Denmark,56.2639,9.5018,3197228,0,6470,3190758
6/20/22,Denmark,56.2639,9.5018,3200460,0,6478,3193982
6/21/22,Denmark,56.2639,9.5018,3202601,0,6481,3196120
6/22/22,Denmark,56.2639,9.5018,3204559,0,6483,3198076
6/23/22,Denmark,56.2639,9.5018,3206325,0,6485,3199840
6/24/22,Denmark,56.2639,9.5018,3207777,0,6487,3201290
6/25/22,Denmark,56.2639,9.5018,3207777,0,6487,3201290
6/26/22,Denmark,56.2639,9.5018,3207777,0,6487,3201290
6/27/22,Denmark,56.2639,9.5018,3211064,0,6497,3204567
6/28/22,Denmark,56.2639,9.5018,3213896,0,6503,3207393
6/29/22,Denmark,56.2639,9.5018,3216229,0,6512,3209717
6/30/22,Denmark,56.2639,9.5018,3218395,0,6518,3211877
7/1/22,Denmark,56.2639,9.5018,3220185,0,6520,3213665
7/2/22,Denmark,56.2639,9.5018,3220185,0,6520,3213665
7/3/22,Denmark,56.2639,9.5018,3220185,0,6520,3213665
7/4/22,Denmark,56.2639,9.5018,3224120,0,6536,3217584
7/5/22,Denmark,56.2639,9.5018,3227021,0,6543,3220478
7/6/22,Denmark,56.2639,9.5018,3229795,0,6548,3223247
7/7/22,Denmark,56.2639,9.5018,3232467,0,6554,3225913
7/8/22,Denmark,56.2639,9.5018,3234881,0,6559,3228322
7/9/22,Denmark,56.2639,9.5018,3234881,0,6559,3228322
7/10/22,Denmark,56.2639,9.5018,3234881,0,6559,3228322
7/11/22,Denmark,56.2639,9.5018,3240466,0,6578,3233888
7/12/22,Denmark,56.2639,9.5018,3243423,0,6579,3236844
7/13/22,Denmark,56.2639,9.5018,3245928,0,6579,3239349
7/14/22,Denmark,56.2639,9.5018,3248426,0,6592,3241834
7/15/22,Denmark,56.2639,9.5018,3250368,0,6600,3243768
7/16/22,Denmark,56.2639,9.5018,3250368,0,6600,3243768
7/17/22,Denmark,56.2639,9.5018,3250368,0,6600,3243768
7/18/22,Denmark,56.2639,9.5018,3255936,0,6612,3249324
7/19/22,Denmark,56.2639,9.5018,3258821,0,6616,3252205
7/20/22,Denmark,56.2639,9.5018,3261046,0,6620,3254426
7/21/22,Denmark,56.2639,9.5018,3263162,0,6630,3256532
7/22/22,Denmark,56.2639,9.5018,3265047,0,6640,3258407
7/23/22,Denmark,56.2639,9.5018,3265047,0,6640,3258407
7/24/22,Denmark,56.2639,9.5018,3265047,0,6640,3258407
7/25/22,Denmark,56.2639,9.5018,3265047,0,6640,3258407
7/26/22,Denmark,56.2639,9.5018,3271537,0,6667,3264870
7/27/22,Denmark,56.2639,9.5018,3273346,0,6672,3266674
7/28/22,Denmark,56.2639,9.5018,3274920,0,6677,3268243
7/29/22,Denmark,56.2639,9.5018,3276295,0,6688,3269607
7/30/22,Denmark,56.2639,9.5018,3276295,0,6688,3269607
7/31/22,Denmark,56.2639,9.5018,3276295,0,6688,3269607
8/1/22,Denmark,56.2639,9.5018,3280252,0,6720,3273532
8/2/22,Denmark,56.2639,9.5018,3282205,0,6731,3275474
8/3/22,Denmark,56.2639,9.5018,3284035,0,6736,3277299
8/4/22,Denmark,56.2639,9.5018,3285721,0,6749,3278972
8/5/22,Denmark,56.2639,9.5018,3287083,0,6750,3280333
8/6/22,Denmark,56.2639,9.5018,3287083,0,6750,3280333
8/7/22,Denmark,56.2639,9.5018,3287083,0,6750,3280333
8/8/22,Denmark,56.2639,9.5018,3290594,0,6800,3283794
8/9/22,Denmark,56.2639,9.5018,3292527,0,6807,3285720
8/10/22,Denmark,56.2639,9.5018,3294667,0,6823,3287844
8/11/22,Denmark,56.2639,9.5018,3296838,0,6829,3290009
8/12/22,Denmark,56.2639,9.5018,3298716,0,6841,3291875
8/13/22,Denmark,56.2639,9.5018,3298716,0,6841,3291875
8/14/22,Denmark,56.2639,9.5018,3298716,0,6841,3291875
8/15/22,Denmark,56.2639,9.5018,3302757,0,6865,3295892
8/16/22,Denmark,56.2639,9.5018,3304657,0,6875,3297782
8/17/22,Denmark,56.2639,9.5018,3306313,0,6882,3299431
8/18/22,Denmark,56.2639,9.5018,3307771,0,6885,3300886
8/19/22,Denmark,56.2639,9.5018,3308848,0,6895,3301953
8/20/22,Denmark,56.2639,9.5018,3308848,0,6895,3301953
8/21/22,Denmark,56.2639,9.5018,3308848,0,6895,3301953
8/22/22,Denmark,56.2639,9.5018,3311631,0,6914,3304717
8/23/22,Denmark,56.2639,9.5018,3312798,0,6920,3305878
8/24/22,Denmark,56.2639,9.5018,3313907,0,6933,3306974
8/25/22,Denmark,56.2639,9.5018,3315016,0,6937,3308079
8/26/22,Denmark,56.2639,9.5018,3315957,0,6942,3309015
8/27/22,Denmark,56.2639,9.5018,3315957,0,6942,3309015
8/28/22,Denmark,56.2639,9.5018,3315957,0,6942,3309015
8/29/22,Denmark,56.2639,9.5018,3318087,0,6961,3311126
8/30/22,Denmark,56.2639,9.5018,3319074,0,6969,3312105
8/31/22,Denmark,56.2639,9.5018,3319834,0,6972,3312862
9/1/22,Denmark,56.2639,9.5018,3320626,0,6983,3313643
9/2/22,Denmark,56.2639,9.5018,3321212,0,6985,3314227
9/3/22,Denmark,56.2639,9.5018,3321212,0,6985,3314227
9/4/22,Denmark,56.2639,9.5018,3321212,0,6985,3314227
9/5/22,Denmark,56.2639,9.5018,3323028,0,7002,3316026
9/6/22,Denmark,56.2639,9.5018,3324092,0,7009,3317083
9/7/22,Denmark,56.2639,9.5018,3324969,0,7012,3317957
9/8/22,Denmark,56.2639,9.5018,3325851,0,7014,3318837
9/9/22,Denmark,56.2639,9.5018,3326681,0,7017,3319664
9/10/22,Denmark,56.2639,9.5018,3326681,0,7017,3319664
9/11/22,Denmark,56.2639,9.5018,3326681,0,7017,3319664
9/12/22,Denmark,56.2639,9.5018,3328476,0,7031,3321445
9/13/22,Denmark,56.2639,9.5018,3329466,0,7032,3322434
9/14/22,Denmark,56.2639,9.5018,3330335,0,7036,3323299
9/15/22,Denmark,56.2639,9.5018,3331175,0,7039,3324136
9/16/22,Denmark,56.2639,9.5018,3331919,0,7042,3324877
9/17/22,Denmark,56.2639,9.5018,3331919,0,7042,3324877
9/18/22,Denmark,56.2639,9.5018,3331919,0,7042,3324877
9/19/22,Denmark,56.2639,9.5018,3333717,0,7053,3326664
9/20/22,Denmark,56.2639,9.5018,3334679,0,7055,3327624
9/21/22,Denmark,56.2639,9.5018,3335748,0,7065,3328683
9/22/22,Denmark,56.2639,9.5018,3336607,0,7070,3329537
9/23/22,Denmark,56.2639,9.5018,3337913,0,7075,3330838
9/24/22,Denmark,56.2639,9.5018,3337913,0,7075,3330838
9/25/22,Denmark,56.2639,9.5018,3337913,0,7075,3330838
9/26/22,Denmark,56.2639,9.5018,3340485,0,7088,3333397
9/27/22,Denmark,56.2639,9.5018,3341961,0,7092,3334869
9/28/22,Denmark,56.2639,9.5018,3343574,0,7106,3336468
9/29/22,Denmark,56.2639,9.5018,3344922,0,7114,3337808
9/30/22,Denmark,56.2639,9.5018,3346163,0,7123,3339040
10/1/22,Denmark,56.2639,9.5018,3346163,0,7123,3339040
10/2/22,Denmark,56.2639,9.5018,3346163,0,7123,3339040
10/3/22,Denmark,56.2639,9.5018,3349047,0,7136,3341911
10/4/22,Denmark,56.2639,9.5018,3350564,0,7137,3343427
10/5/22,Denmark,56.2639,9.5018,3352273,0,7152,3345121
10/6/22,Denmark,56.2639,9.5018,3353815,0,7161,3346654
10/7/22,Denmark,56.2639,9.5018,3355007,0,7170,3347837
10/8/22,Denmark,56.2639,9.5018,3355007,0,7170,3347837
10/9/22,Denmark,56.2639,9.5018,3355007,0,7170,3347837
10/10/22,Denmark,56.2639,9.5018,3358503,0,7190,3351313
10/11/22,Denmark,56.2639,9.5018,3360173,0,7200,3352973
10/12/22,Denmark,56.2639,9.5018,3361575,0,7207,3354368
10/13/22,Denmark,56.2639,9.5018,3363094,0,7214,3355880
10/14/22,Denmark,56.2639,9.5018,3364246,0,7222,3357024
10/15/22,Denmark,56.2639,9.5018,3364246,0,7222,3357024
10/16/22,Denmark,56.2639,9.5018,3364246,0,7222,3357024
10/17/22,Denmark,56.2639,9.5018,3367633,0,7244,3360389
10/18/22,Denmark,56.2639,9.5018,3369020,0,7255,3361765
10/19/22,Denmark,56.2639,9.5018,3370464,0,7271,3363193
10/20/22,Denmark,56.2639,9.5018,3371605,0,7283,3364322
10/21/22,Denmark,56.2639,9.5018,3372576,0,7296,3365280
10/22/22,Denmark,56.2639,9.5018,3372576,0,7296,3365280
10/23/22,Denmark,56.2639,9.5018,3372576,0,7296,3365280
10/24/22,Denmark,56.2639,9.5018,3375154,0,7335,3367819
10/25/22,Denmark,56.2639,9.5018,3376538,0,7344,3369194
10/26/22,Denmark,56.2639,9.5018,3377554,0,7354,3370200
10/27/22,Denmark,56.2639,9.5018,3378494,0,7361,3371133
10/28/22,Denmark,56.2639,9.5018,3379393,0,7370,3372023
10/29/22,Denmark,56.2639,9.5018,3379393,0,7370,3372023
10/30/22,Denmark,56.2639,9.5018,3379393,0,7370,3372023
10/31/22,Denmark,56.2639,9.5018,3381223,0,7396,3373827
11/1/22,Denmark,56.2639,9.5018,3382145,0,7403,3374742
11/2/22,Denmark,56.2639,9.5018,3382887,0,7412,3375475
11/3/22,Denmark,56.2639,9.5018,3383519,0,7424,3376095
11/4/22,Denmark,56.2639,9.5018,3384093,0,7436,3376657
11/5/22,Denmark,56.2639,9.5018,3384093,0,7436,3376657
11/6/22,Denmark,56.2639,9.5018,3384093,0,7436,3376657
11/7/22,Denmark,56.2639,9.5018,3385515,0,7462,3378053
11/8/22,Denmark,56.2639,9.5018,3386248,0,7469,3378779
11/9/22,Denmark,56.2639,9.5018,3386898,0,7472,3379426
11/10/22,Denmark,56.2639,9.5018,3387782,0,7479,3380303
11/11/22,Denmark,56.2639,9.5018,3388326,0,7483,3380843
11/12/22,Denmark,56.2639,9.5018,3388326,0,7483,3380843
11/13/22,Denmark,56.2639,9.5018,3388326,0,7483,3380843
11/14/22,Denmark,56.2639,9.5018,3389802,0,7501,3382301
11/15/22,Denmark,56.2639,9.5018,3390488,0,7512,3382976
11/16/22,Denmark,56.2639,9.5018,3391150,0,7518,3383632
11/17/22,Denmark,56.2639,9.5018,3391724,0,7519,3384205
11/18/22,Denmark,56.2639,9.5018,3392212,0,7519,3384693
11/19/22,Denmark,56.2639,9.5018,3392212,0,7519,3384693
11/20/22,Denmark,56.2639,9.5018,3392212,0,7519,3384693
11/21/22,Denmark,56.2639,9.5018,3393598,0,7543,3386055
11/22/22,Denmark,56.2639,9.5018,3394211,0,7545,3386666
11/23/22,Denmark,56.2639,9.5018,3394887,0,7549,3387338
11/24/22,Denmark,56.2639,9.5018,3395601,0,7557,3388044
11/25/22,Denmark,56.2639,9.5018,3396301,0,7562,3388739
11/26/22,Denmark,56.2639,9.5018,3396301,0,7562,3388739
11/27/22,Denmark,56.2639,9.5018,3396301,0,7562,3388739
11/28/22,Denmark,56.2639,9.5018,3398127,0,7573,3390554
11/29/22,Denmark,56.2639,9.5018,3399235,0,7577,3391658
11/30/22,Denmark,56.2639,9.5018,3400329,0,7581,3392748
12/1/22,Denmark,56.2639,9.5018,3401535,0,7586,3393949
12/2/22,Denmark,56.2639,9.5018,3402567,0,7590,3394977
12/3/22,Denmark,56.2639,9.5018,3402567,0,7590,3394977
12/4/22,Denmark,56.2639,9.5018,3402567,0,7590,3394977
12/5/22,Denmark,56.2639,9.5018,3405355,0,7604,3397751
12/6/22,Denmark,56.2639,9.5018,3406785,0,7606,3399179
12/7/22,Denmark,56.2639,9.5018,3406785,0,7606,3399179
12/8/22,Denmark,56.2639,9.5018,3410244,0,7622,3402622
12/9/22,Denmark,56.2639,9.5018,3411881,0,7628,3404253
12/10/22,Denmark,56.2639,9.5018,3411881,0,7628,3404253
12/11/22,Denmark,56.2639,9.5018,3411881,0,7628,3404253
12/12/22,Denmark,56.2639,9.5018,3413970,0,7645,3406325
12/13/22,Denmark,56.2639,9.5018,3415044,0,7657,3407387
12/14/22,Denmark,56.2639,9.5018,3416016,0,7669,3408347
12/15/22,Denmark,56.2639,9.5018,3417357,0,7675,3409682
12/16/22,Denmark,56.2639,9.5018,3418420,0,7684,3410736
12/17/22,Denmark,56.2639,9.5018,3418420,0,7684,3410736
1/1/22,Diamond Princess,0.0,0.0,712,0,13,699
1/2/22,Diamond Princess,0.0,0.0,712,0,13,699
1/3/22,Diamond Princess,0.0,0.0,712,0,13,699
1/4/22,Diamond Princess,0.0,0.0,712,0,13,699
1/5/22,Diamond Princess,0.0,0.0,712,0,13,699
1/6/22,Diamond Princess,0.0,0.0,712,0,13,699
1/7/22,Diamond Princess,0.0,0.0,712,0,13,699
1/8/22,Diamond Princess,0.0,0.0,712,0,13,699
1/9/22,Diamond Princess,0.0,0.0,712,0,13,699
1/10/22,Diamond Princess,0.0,0.0,712,0,13,699
1/11/22,Diamond Princess,0.0,0.0,712,0,13,699
1/12/22,Diamond Princess,0.0,0.0,712,0,13,699
1/13/22,Diamond Princess,0.0,0.0,712,0,13,699
1/14/22,Diamond Princess,0.0,0.0,712,0,13,699
1/15/22,Diamond Princess,0.0,0.0,712,0,13,699
1/16/22,Diamond Princess,0.0,0.0,712,0,13,699
1/17/22,Diamond Princess,0.0,0.0,712,0,13,699
1/18/22,Diamond Princess,0.0,0.0,712,0,13,699
1/19/22,Diamond Princess,0.0,0.0,712,0,13,699
1/20/22,Diamond Princess,0.0,0.0,712,0,13,699
1/21/22,Diamond Princess,0.0,0.0,712,0,13,699
1/22/22,Diamond Princess,0.0,0.0,712,0,13,699
1/23/22,Diamond Princess,0.0,0.0,712,0,13,699
1/24/22,Diamond Princess,0.0,0.0,712,0,13,699
1/25/22,Diamond Princess,0.0,0.0,712,0,13,699
1/26/22,Diamond Princess,0.0,0.0,712,0,13,699
1/27/22,Diamond Princess,0.0,0.0,712,0,13,699
1/28/22,Diamond Princess,0.0,0.0,712,0,13,699
1/29/22,Diamond Princess,0.0,0.0,712,0,13,699
1/30/22,Diamond Princess,0.0,0.0,712,0,13,699
1/31/22,Diamond Princess,0.0,0.0,712,0,13,699
2/1/22,Diamond Princess,0.0,0.0,712,0,13,699
2/2/22,Diamond Princess,0.0,0.0,712,0,13,699
2/3/22,Diamond Princess,0.0,0.0,712,0,13,699
2/4/22,Diamond Princess,0.0,0.0,712,0,13,699
2/5/22,Diamond Princess,0.0,0.0,712,0,13,699
2/6/22,Diamond Princess,0.0,0.0,712,0,13,699
2/7/22,Diamond Princess,0.0,0.0,712,0,13,699
2/8/22,Diamond Princess,0.0,0.0,712,0,13,699
2/9/22,Diamond Princess,0.0,0.0,712,0,13,699
2/10/22,Diamond Princess,0.0,0.0,712,0,13,699
2/11/22,Diamond Princess,0.0,0.0,712,0,13,699
2/12/22,Diamond Princess,0.0,0.0,712,0,13,699
2/13/22,Diamond Princess,0.0,0.0,712,0,13,699
2/14/22,Diamond Princess,0.0,0.0,712,0,13,699
2/15/22,Diamond Princess,0.0,0.0,712,0,13,699
2/16/22,Diamond Princess,0.0,0.0,712,0,13,699
2/17/22,Diamond Princess,0.0,0.0,712,0,13,699
2/18/22,Diamond Princess,0.0,0.0,712,0,13,699
2/19/22,Diamond Princess,0.0,0.0,712,0,13,699
2/20/22,Diamond Princess,0.0,0.0,712,0,13,699
2/21/22,Diamond Princess,0.0,0.0,712,0,13,699
2/22/22,Diamond Princess,0.0,0.0,712,0,13,699
2/23/22,Diamond Princess,0.0,0.0,712,0,13,699
2/24/22,Diamond Princess,0.0,0.0,712,0,13,699
2/25/22,Diamond Princess,0.0,0.0,712,0,13,699
2/26/22,Diamond Princess,0.0,0.0,712,0,13,699
2/27/22,Diamond Princess,0.0,0.0,712,0,13,699
2/28/22,Diamond Princess,0.0,0.0,712,0,13,699
3/1/22,Diamond Princess,0.0,0.0,712,0,13,699
3/2/22,Diamond Princess,0.0,0.0,712,0,13,699
3/3/22,Diamond Princess,0.0,0.0,712,0,13,699
3/4/22,Diamond Princess,0.0,0.0,712,0,13,699
3/5/22,Diamond Princess,0.0,0.0,712,0,13,699
3/6/22,Diamond Princess,0.0,0.0,712,0,13,699
3/7/22,Diamond Princess,0.0,0.0,712,0,13,699
3/8/22,Diamond Princess,0.0,0.0,712,0,13,699
3/9/22,Diamond Princess,0.0,0.0,712,0,13,699
3/10/22,Diamond Princess,0.0,0.0,712,0,13,699
3/11/22,Diamond Princess,0.0,0.0,712,0,13,699
3/12/22,Diamond Princess,0.0,0.0,712,0,13,699
3/13/22,Diamond Princess,0.0,0.0,712,0,13,699
3/14/22,Diamond Princess,0.0,0.0,712,0,13,699
3/15/22,Diamond Princess,0.0,0.0,712,0,13,699
3/16/22,Diamond Princess,0.0,0.0,712,0,13,699
3/17/22,Diamond Princess,0.0,0.0,712,0,13,699
3/18/22,Diamond Princess,0.0,0.0,712,0,13,699
3/19/22,Diamond Princess,0.0,0.0,712,0,13,699
3/20/22,Diamond Princess,0.0,0.0,712,0,13,699
3/21/22,Diamond Princess,0.0,0.0,712,0,13,699
3/22/22,Diamond Princess,0.0,0.0,712,0,13,699
3/23/22,Diamond Princess,0.0,0.0,712,0,13,699
3/24/22,Diamond Princess,0.0,0.0,712,0,13,699
3/25/22,Diamond Princess,0.0,0.0,712,0,13,699
3/26/22,Diamond Princess,0.0,0.0,712,0,13,699
3/27/22,Diamond Princess,0.0,0.0,712,0,13,699
3/28/22,Diamond Princess,0.0,0.0,712,0,13,699
3/29/22,Diamond Princess,0.0,0.0,712,0,13,699
3/30/22,Diamond Princess,0.0,0.0,712,0,13,699
3/31/22,Diamond Princess,0.0,0.0,712,0,13,699
4/1/22,Diamond Princess,0.0,0.0,712,0,13,699
4/2/22,Diamond Princess,0.0,0.0,712,0,13,699
4/3/22,Diamond Princess,0.0,0.0,712,0,13,699
4/4/22,Diamond Princess,0.0,0.0,712,0,13,699
4/5/22,Diamond Princess,0.0,0.0,712,0,13,699
4/6/22,Diamond Princess,0.0,0.0,712,0,13,699
4/7/22,Diamond Princess,0.0,0.0,712,0,13,699
4/8/22,Diamond Princess,0.0,0.0,712,0,13,699
4/9/22,Diamond Princess,0.0,0.0,712,0,13,699
4/10/22,Diamond Princess,0.0,0.0,712,0,13,699
4/11/22,Diamond Princess,0.0,0.0,712,0,13,699
4/12/22,Diamond Princess,0.0,0.0,712,0,13,699
4/13/22,Diamond Princess,0.0,0.0,712,0,13,699
4/14/22,Diamond Princess,0.0,0.0,712,0,13,699
4/15/22,Diamond Princess,0.0,0.0,712,0,13,699
4/16/22,Diamond Princess,0.0,0.0,712,0,13,699
4/17/22,Diamond Princess,0.0,0.0,712,0,13,699
4/18/22,Diamond Princess,0.0,0.0,712,0,13,699
4/19/22,Diamond Princess,0.0,0.0,712,0,13,699
4/20/22,Diamond Princess,0.0,0.0,712,0,13,699
4/21/22,Diamond Princess,0.0,0.0,712,0,13,699
4/22/22,Diamond Princess,0.0,0.0,712,0,13,699
4/23/22,Diamond Princess,0.0,0.0,712,0,13,699
4/24/22,Diamond Princess,0.0,0.0,712,0,13,699
4/25/22,Diamond Princess,0.0,0.0,712,0,13,699
4/26/22,Diamond Princess,0.0,0.0,712,0,13,699
4/27/22,Diamond Princess,0.0,0.0,712,0,13,699
4/28/22,Diamond Princess,0.0,0.0,712,0,13,699
4/29/22,Diamond Princess,0.0,0.0,712,0,13,699
4/30/22,Diamond Princess,0.0,0.0,712,0,13,699
5/1/22,Diamond Princess,0.0,0.0,712,0,13,699
5/2/22,Diamond Princess,0.0,0.0,712,0,13,699
5/3/22,Diamond Princess,0.0,0.0,712,0,13,699
5/4/22,Diamond Princess,0.0,0.0,712,0,13,699
5/5/22,Diamond Princess,0.0,0.0,712,0,13,699
5/6/22,Diamond Princess,0.0,0.0,712,0,13,699
5/7/22,Diamond Princess,0.0,0.0,712,0,13,699
5/8/22,Diamond Princess,0.0,0.0,712,0,13,699
5/9/22,Diamond Princess,0.0,0.0,712,0,13,699
5/10/22,Diamond Princess,0.0,0.0,712,0,13,699
5/11/22,Diamond Princess,0.0,0.0,712,0,13,699
5/12/22,Diamond Princess,0.0,0.0,712,0,13,699
5/13/22,Diamond Princess,0.0,0.0,712,0,13,699
5/14/22,Diamond Princess,0.0,0.0,712,0,13,699
5/15/22,Diamond Princess,0.0,0.0,712,0,13,699
5/16/22,Diamond Princess,0.0,0.0,712,0,13,699
5/17/22,Diamond Princess,0.0,0.0,712,0,13,699
5/18/22,Diamond Princess,0.0,0.0,712,0,13,699
5/19/22,Diamond Princess,0.0,0.0,712,0,13,699
5/20/22,Diamond Princess,0.0,0.0,712,0,13,699
5/21/22,Diamond Princess,0.0,0.0,712,0,13,699
5/22/22,Diamond Princess,0.0,0.0,712,0,13,699
5/23/22,Diamond Princess,0.0,0.0,712,0,13,699
5/24/22,Diamond Princess,0.0,0.0,712,0,13,699
5/25/22,Diamond Princess,0.0,0.0,712,0,13,699
5/26/22,Diamond Princess,0.0,0.0,712,0,13,699
5/27/22,Diamond Princess,0.0,0.0,712,0,13,699
5/28/22,Diamond Princess,0.0,0.0,712,0,13,699
5/29/22,Diamond Princess,0.0,0.0,712,0,13,699
5/30/22,Diamond Princess,0.0,0.0,712,0,13,699
5/31/22,Diamond Princess,0.0,0.0,712,0,13,699
6/1/22,Diamond Princess,0.0,0.0,712,0,13,699
6/2/22,Diamond Princess,0.0,0.0,712,0,13,699
6/3/22,Diamond Princess,0.0,0.0,712,0,13,699
6/4/22,Diamond Princess,0.0,0.0,712,0,13,699
6/5/22,Diamond Princess,0.0,0.0,712,0,13,699
6/6/22,Diamond Princess,0.0,0.0,712,0,13,699
6/7/22,Diamond Princess,0.0,0.0,712,0,13,699
6/8/22,Diamond Princess,0.0,0.0,712,0,13,699
6/9/22,Diamond Princess,0.0,0.0,712,0,13,699
6/10/22,Diamond Princess,0.0,0.0,712,0,13,699
6/11/22,Diamond Princess,0.0,0.0,712,0,13,699
6/12/22,Diamond Princess,0.0,0.0,712,0,13,699
6/13/22,Diamond Princess,0.0,0.0,712,0,13,699
6/14/22,Diamond Princess,0.0,0.0,712,0,13,699
6/15/22,Diamond Princess,0.0,0.0,712,0,13,699
6/16/22,Diamond Princess,0.0,0.0,712,0,13,699
6/17/22,Diamond Princess,0.0,0.0,712,0,13,699
6/18/22,Diamond Princess,0.0,0.0,712,0,13,699
6/19/22,Diamond Princess,0.0,0.0,712,0,13,699
6/20/22,Diamond Princess,0.0,0.0,712,0,13,699
6/21/22,Diamond Princess,0.0,0.0,712,0,13,699
6/22/22,Diamond Princess,0.0,0.0,712,0,13,699
6/23/22,Diamond Princess,0.0,0.0,712,0,13,699
6/24/22,Diamond Princess,0.0,0.0,712,0,13,699
6/25/22,Diamond Princess,0.0,0.0,712,0,13,699
6/26/22,Diamond Princess,0.0,0.0,712,0,13,699
6/27/22,Diamond Princess,0.0,0.0,712,0,13,699
6/28/22,Diamond Princess,0.0,0.0,712,0,13,699
6/29/22,Diamond Princess,0.0,0.0,712,0,13,699
6/30/22,Diamond Princess,0.0,0.0,712,0,13,699
7/1/22,Diamond Princess,0.0,0.0,712,0,13,699
7/2/22,Diamond Princess,0.0,0.0,712,0,13,699
7/3/22,Diamond Princess,0.0,0.0,712,0,13,699
7/4/22,Diamond Princess,0.0,0.0,712,0,13,699
7/5/22,Diamond Princess,0.0,0.0,712,0,13,699
7/6/22,Diamond Princess,0.0,0.0,712,0,13,699
7/7/22,Diamond Princess,0.0,0.0,712,0,13,699
7/8/22,Diamond Princess,0.0,0.0,712,0,13,699
7/9/22,Diamond Princess,0.0,0.0,712,0,13,699
7/10/22,Diamond Princess,0.0,0.0,712,0,13,699
7/11/22,Diamond Princess,0.0,0.0,712,0,13,699
7/12/22,Diamond Princess,0.0,0.0,712,0,13,699
7/13/22,Diamond Princess,0.0,0.0,712,0,13,699
7/14/22,Diamond Princess,0.0,0.0,712,0,13,699
7/15/22,Diamond Princess,0.0,0.0,712,0,13,699
7/16/22,Diamond Princess,0.0,0.0,712,0,13,699
7/17/22,Diamond Princess,0.0,0.0,712,0,13,699
7/18/22,Diamond Princess,0.0,0.0,712,0,13,699
7/19/22,Diamond Princess,0.0,0.0,712,0,13,699
7/20/22,Diamond Princess,0.0,0.0,712,0,13,699
7/21/22,Diamond Princess,0.0,0.0,712,0,13,699
7/22/22,Diamond Princess,0.0,0.0,712,0,13,699
7/23/22,Diamond Princess,0.0,0.0,712,0,13,699
7/24/22,Diamond Princess,0.0,0.0,712,0,13,699
7/25/22,Diamond Princess,0.0,0.0,712,0,13,699
7/26/22,Diamond Princess,0.0,0.0,712,0,13,699
7/27/22,Diamond Princess,0.0,0.0,712,0,13,699
7/28/22,Diamond Princess,0.0,0.0,712,0,13,699
7/29/22,Diamond Princess,0.0,0.0,712,0,13,699
7/30/22,Diamond Princess,0.0,0.0,712,0,13,699
7/31/22,Diamond Princess,0.0,0.0,712,0,13,699
8/1/22,Diamond Princess,0.0,0.0,712,0,13,699
8/2/22,Diamond Princess,0.0,0.0,712,0,13,699
8/3/22,Diamond Princess,0.0,0.0,712,0,13,699
8/4/22,Diamond Princess,0.0,0.0,712,0,13,699
8/5/22,Diamond Princess,0.0,0.0,712,0,13,699
8/6/22,Diamond Princess,0.0,0.0,712,0,13,699
8/7/22,Diamond Princess,0.0,0.0,712,0,13,699
8/8/22,Diamond Princess,0.0,0.0,712,0,13,699
8/9/22,Diamond Princess,0.0,0.0,712,0,13,699
8/10/22,Diamond Princess,0.0,0.0,712,0,13,699
8/11/22,Diamond Princess,0.0,0.0,712,0,13,699
8/12/22,Diamond Princess,0.0,0.0,712,0,13,699
8/13/22,Diamond Princess,0.0,0.0,712,0,13,699
8/14/22,Diamond Princess,0.0,0.0,712,0,13,699
8/15/22,Diamond Princess,0.0,0.0,712,0,13,699
8/16/22,Diamond Princess,0.0,0.0,712,0,13,699
8/17/22,Diamond Princess,0.0,0.0,712,0,13,699
8/18/22,Diamond Princess,0.0,0.0,712,0,13,699
8/19/22,Diamond Princess,0.0,0.0,712,0,13,699
8/20/22,Diamond Princess,0.0,0.0,712,0,13,699
8/21/22,Diamond Princess,0.0,0.0,712,0,13,699
8/22/22,Diamond Princess,0.0,0.0,712,0,13,699
8/23/22,Diamond Princess,0.0,0.0,712,0,13,699
8/24/22,Diamond Princess,0.0,0.0,712,0,13,699
8/25/22,Diamond Princess,0.0,0.0,712,0,13,699
8/26/22,Diamond Princess,0.0,0.0,712,0,13,699
8/27/22,Diamond Princess,0.0,0.0,712,0,13,699
8/28/22,Diamond Princess,0.0,0.0,712,0,13,699
8/29/22,Diamond Princess,0.0,0.0,712,0,13,699
8/30/22,Diamond Princess,0.0,0.0,712,0,13,699
8/31/22,Diamond Princess,0.0,0.0,712,0,13,699
9/1/22,Diamond Princess,0.0,0.0,712,0,13,699
9/2/22,Diamond Princess,0.0,0.0,712,0,13,699
9/3/22,Diamond Princess,0.0,0.0,712,0,13,699
9/4/22,Diamond Princess,0.0,0.0,712,0,13,699
9/5/22,Diamond Princess,0.0,0.0,712,0,13,699
9/6/22,Diamond Princess,0.0,0.0,712,0,13,699
9/7/22,Diamond Princess,0.0,0.0,712,0,13,699
9/8/22,Diamond Princess,0.0,0.0,712,0,13,699
9/9/22,Diamond Princess,0.0,0.0,712,0,13,699
9/10/22,Diamond Princess,0.0,0.0,712,0,13,699
9/11/22,Diamond Princess,0.0,0.0,712,0,13,699
9/12/22,Diamond Princess,0.0,0.0,712,0,13,699
9/13/22,Diamond Princess,0.0,0.0,712,0,13,699
9/14/22,Diamond Princess,0.0,0.0,712,0,13,699
9/15/22,Diamond Princess,0.0,0.0,712,0,13,699
9/16/22,Diamond Princess,0.0,0.0,712,0,13,699
9/17/22,Diamond Princess,0.0,0.0,712,0,13,699
9/18/22,Diamond Princess,0.0,0.0,712,0,13,699
9/19/22,Diamond Princess,0.0,0.0,712,0,13,699
9/20/22,Diamond Princess,0.0,0.0,712,0,13,699
9/21/22,Diamond Princess,0.0,0.0,712,0,13,699
9/22/22,Diamond Princess,0.0,0.0,712,0,13,699
9/23/22,Diamond Princess,0.0,0.0,712,0,13,699
9/24/22,Diamond Princess,0.0,0.0,712,0,13,699
9/25/22,Diamond Princess,0.0,0.0,712,0,13,699
9/26/22,Diamond Princess,0.0,0.0,712,0,13,699
9/27/22,Diamond Princess,0.0,0.0,712,0,13,699
9/28/22,Diamond Princess,0.0,0.0,712,0,13,699
9/29/22,Diamond Princess,0.0,0.0,712,0,13,699
9/30/22,Diamond Princess,0.0,0.0,712,0,13,699
10/1/22,Diamond Princess,0.0,0.0,712,0,13,699
10/2/22,Diamond Princess,0.0,0.0,712,0,13,699
10/3/22,Diamond Princess,0.0,0.0,712,0,13,699
10/4/22,Diamond Princess,0.0,0.0,712,0,13,699
10/5/22,Diamond Princess,0.0,0.0,712,0,13,699
10/6/22,Diamond Princess,0.0,0.0,712,0,13,699
10/7/22,Diamond Princess,0.0,0.0,712,0,13,699
10/8/22,Diamond Princess,0.0,0.0,712,0,13,699
10/9/22,Diamond Princess,0.0,0.0,712,0,13,699
10/10/22,Diamond Princess,0.0,0.0,712,0,13,699
10/11/22,Diamond Princess,0.0,0.0,712,0,13,699
10/12/22,Diamond Princess,0.0,0.0,712,0,13,699
10/13/22,Diamond Princess,0.0,0.0,712,0,13,699
10/14/22,Diamond Princess,0.0,0.0,712,0,13,699
10/15/22,Diamond Princess,0.0,0.0,712,0,13,699
10/16/22,Diamond Princess,0.0,0.0,712,0,13,699
10/17/22,Diamond Princess,0.0,0.0,712,0,13,699
10/18/22,Diamond Princess,0.0,0.0,712,0,13,699
10/19/22,Diamond Princess,0.0,0.0,712,0,13,699
10/20/22,Diamond Princess,0.0,0.0,712,0,13,699
10/21/22,Diamond Princess,0.0,0.0,712,0,13,699
10/22/22,Diamond Princess,0.0,0.0,712,0,13,699
10/23/22,Diamond Princess,0.0,0.0,712,0,13,699
10/24/22,Diamond Princess,0.0,0.0,712,0,13,699
10/25/22,Diamond Princess,0.0,0.0,712,0,13,699
10/26/22,Diamond Princess,0.0,0.0,712,0,13,699
10/27/22,Diamond Princess,0.0,0.0,712,0,13,699
10/28/22,Diamond Princess,0.0,0.0,712,0,13,699
10/29/22,Diamond Princess,0.0,0.0,712,0,13,699
10/30/22,Diamond Princess,0.0,0.0,712,0,13,699
10/31/22,Diamond Princess,0.0,0.0,712,0,13,699
11/1/22,Diamond Princess,0.0,0.0,712,0,13,699
11/2/22,Diamond Princess,0.0,0.0,712,0,13,699
11/3/22,Diamond Princess,0.0,0.0,712,0,13,699
11/4/22,Diamond Princess,0.0,0.0,712,0,13,699
11/5/22,Diamond Princess,0.0,0.0,712,0,13,699
11/6/22,Diamond Princess,0.0,0.0,712,0,13,699
11/7/22,Diamond Princess,0.0,0.0,712,0,13,699
11/8/22,Diamond Princess,0.0,0.0,712,0,13,699
11/9/22,Diamond Princess,0.0,0.0,712,0,13,699
11/10/22,Diamond Princess,0.0,0.0,712,0,13,699
11/11/22,Diamond Princess,0.0,0.0,712,0,13,699
11/12/22,Diamond Princess,0.0,0.0,712,0,13,699
11/13/22,Diamond Princess,0.0,0.0,712,0,13,699
11/14/22,Diamond Princess,0.0,0.0,712,0,13,699
11/15/22,Diamond Princess,0.0,0.0,712,0,13,699
11/16/22,Diamond Princess,0.0,0.0,712,0,13,699
11/17/22,Diamond Princess,0.0,0.0,712,0,13,699
11/18/22,Diamond Princess,0.0,0.0,712,0,13,699
11/19/22,Diamond Princess,0.0,0.0,712,0,13,699
11/20/22,Diamond Princess,0.0,0.0,712,0,13,699
11/21/22,Diamond Princess,0.0,0.0,712,0,13,699
11/22/22,Diamond Princess,0.0,0.0,712,0,13,699
11/23/22,Diamond Princess,0.0,0.0,712,0,13,699
11/24/22,Diamond Princess,0.0,0.0,712,0,13,699
11/25/22,Diamond Princess,0.0,0.0,712,0,13,699
11/26/22,Diamond Princess,0.0,0.0,712,0,13,699
11/27/22,Diamond Princess,0.0,0.0,712,0,13,699
11/28/22,Diamond Princess,0.0,0.0,712,0,13,699
11/29/22,Diamond Princess,0.0,0.0,712,0,13,699
11/30/22,Diamond Princess,0.0,0.0,712,0,13,699
12/1/22,Diamond Princess,0.0,0.0,712,0,13,699
12/2/22,Diamond Princess,0.0,0.0,712,0,13,699
12/3/22,Diamond Princess,0.0,0.0,712,0,13,699
12/4/22,Diamond Princess,0.0,0.0,712,0,13,699
12/5/22,Diamond Princess,0.0,0.0,712,0,13,699
12/6/22,Diamond Princess,0.0,0.0,712,0,13,699
12/7/22,Diamond Princess,0.0,0.0,712,0,13,699
12/8/22,Diamond Princess,0.0,0.0,712,0,13,699
12/9/22,Diamond Princess,0.0,0.0,712,0,13,699
12/10/22,Diamond Princess,0.0,0.0,712,0,13,699
12/11/22,Diamond Princess,0.0,0.0,712,0,13,699
12/12/22,Diamond Princess,0.0,0.0,712,0,13,699
12/13/22,Diamond Princess,0.0,0.0,712,0,13,699
12/14/22,Diamond Princess,0.0,0.0,712,0,13,699
12/15/22,Diamond Princess,0.0,0.0,712,0,13,699
12/16/22,Diamond Princess,0.0,0.0,712,0,13,699
12/17/22,Diamond Princess,0.0,0.0,712,0,13,699
1/1/22,Djibouti,11.8251,42.5903,13668,0,189,13479
1/2/22,Djibouti,11.8251,42.5903,13685,0,189,13496
1/3/22,Djibouti,11.8251,42.5903,13723,0,189,13534
1/4/22,Djibouti,11.8251,42.5903,13769,0,189,13580
1/5/22,Djibouti,11.8251,42.5903,13839,0,189,13650
1/6/22,Djibouti,11.8251,42.5903,13948,0,189,13759
1/7/22,Djibouti,11.8251,42.5903,14035,0,189,13846
1/8/22,Djibouti,11.8251,42.5903,14084,0,189,13895
1/9/22,Djibouti,11.8251,42.5903,14177,0,189,13988
1/10/22,Djibouti,11.8251,42.5903,14317,0,189,14128
1/11/22,Djibouti,11.8251,42.5903,14415,0,189,14226
1/12/22,Djibouti,11.8251,42.5903,14541,0,189,14352
1/13/22,Djibouti,11.8251,42.5903,14680,0,189,14491
1/14/22,Djibouti,11.8251,42.5903,14801,0,189,14612
1/15/22,Djibouti,11.8251,42.5903,14841,0,189,14652
1/16/22,Djibouti,11.8251,42.5903,14900,0,189,14711
1/17/22,Djibouti,11.8251,42.5903,14984,0,189,14795
1/18/22,Djibouti,11.8251,42.5903,15089,0,189,14900
1/19/22,Djibouti,11.8251,42.5903,15134,0,189,14945
1/20/22,Djibouti,11.8251,42.5903,15200,0,189,15011
1/21/22,Djibouti,11.8251,42.5903,15250,0,189,15061
1/22/22,Djibouti,11.8251,42.5903,15271,0,189,15082
1/23/22,Djibouti,11.8251,42.5903,15311,0,189,15122
1/24/22,Djibouti,11.8251,42.5903,15349,0,189,15160
1/25/22,Djibouti,11.8251,42.5903,15372,0,189,15183
1/26/22,Djibouti,11.8251,42.5903,15396,0,189,15207
1/27/22,Djibouti,11.8251,42.5903,15411,0,189,15222
1/28/22,Djibouti,11.8251,42.5903,15429,0,189,15240
1/29/22,Djibouti,11.8251,42.5903,15440,0,189,15251
1/30/22,Djibouti,11.8251,42.5903,15451,0,189,15262
1/31/22,Djibouti,11.8251,42.5903,15464,0,189,15275
2/1/22,Djibouti,11.8251,42.5903,15472,0,189,15283
2/2/22,Djibouti,11.8251,42.5903,15475,0,189,15286
2/3/22,Djibouti,11.8251,42.5903,15492,0,189,15303
2/4/22,Djibouti,11.8251,42.5903,15507,0,189,15318
2/5/22,Djibouti,11.8251,42.5903,15510,0,189,15321
2/6/22,Djibouti,11.8251,42.5903,15510,0,189,15321
2/7/22,Djibouti,11.8251,42.5903,15524,0,189,15335
2/8/22,Djibouti,11.8251,42.5903,15525,0,189,15336
2/9/22,Djibouti,11.8251,42.5903,15527,0,189,15338
2/10/22,Djibouti,11.8251,42.5903,15529,0,189,15340
2/11/22,Djibouti,11.8251,42.5903,15530,0,189,15341
2/12/22,Djibouti,11.8251,42.5903,15531,0,189,15342
2/13/22,Djibouti,11.8251,42.5903,15534,0,189,15345
2/14/22,Djibouti,11.8251,42.5903,15534,0,189,15345
2/15/22,Djibouti,11.8251,42.5903,15535,0,189,15346
2/16/22,Djibouti,11.8251,42.5903,15535,0,189,15346
2/17/22,Djibouti,11.8251,42.5903,15535,0,189,15346
2/18/22,Djibouti,11.8251,42.5903,15537,0,189,15348
2/19/22,Djibouti,11.8251,42.5903,15541,0,189,15352
2/20/22,Djibouti,11.8251,42.5903,15542,0,189,15353
2/21/22,Djibouti,11.8251,42.5903,15542,0,189,15353
2/22/22,Djibouti,11.8251,42.5903,15542,0,189,15353
2/23/22,Djibouti,11.8251,42.5903,15543,0,189,15354
2/24/22,Djibouti,11.8251,42.5903,15545,0,189,15356
2/25/22,Djibouti,11.8251,42.5903,15546,0,189,15357
2/26/22,Djibouti,11.8251,42.5903,15547,0,189,15358
2/27/22,Djibouti,11.8251,42.5903,15547,0,189,15358
2/28/22,Djibouti,11.8251,42.5903,15547,0,189,15358
3/1/22,Djibouti,11.8251,42.5903,15547,0,189,15358
3/2/22,Djibouti,11.8251,42.5903,15547,0,189,15358
3/3/22,Djibouti,11.8251,42.5903,15549,0,189,15360
3/4/22,Djibouti,11.8251,42.5903,15550,0,189,15361
3/5/22,Djibouti,11.8251,42.5903,15550,0,189,15361
3/6/22,Djibouti,11.8251,42.5903,15550,0,189,15361
3/7/22,Djibouti,11.8251,42.5903,15550,0,189,15361
3/8/22,Djibouti,11.8251,42.5903,15550,0,189,15361
3/9/22,Djibouti,11.8251,42.5903,15564,0,189,15375
3/10/22,Djibouti,11.8251,42.5903,15564,0,189,15375
3/11/22,Djibouti,11.8251,42.5903,15564,0,189,15375
3/12/22,Djibouti,11.8251,42.5903,15564,0,189,15375
3/13/22,Djibouti,11.8251,42.5903,15565,0,189,15376
3/14/22,Djibouti,11.8251,42.5903,15568,0,189,15379
3/15/22,Djibouti,11.8251,42.5903,15568,0,189,15379
3/16/22,Djibouti,11.8251,42.5903,15572,0,189,15383
3/17/22,Djibouti,11.8251,42.5903,15572,0,189,15383
3/18/22,Djibouti,11.8251,42.5903,15573,0,189,15384
3/19/22,Djibouti,11.8251,42.5903,15573,0,189,15384
3/20/22,Djibouti,11.8251,42.5903,15573,0,189,15384
3/21/22,Djibouti,11.8251,42.5903,15573,0,189,15384
3/22/22,Djibouti,11.8251,42.5903,15574,0,189,15385
3/23/22,Djibouti,11.8251,42.5903,15578,0,189,15389
3/24/22,Djibouti,11.8251,42.5903,15580,0,189,15391
3/25/22,Djibouti,11.8251,42.5903,15580,0,189,15391
3/26/22,Djibouti,11.8251,42.5903,15580,0,189,15391
3/27/22,Djibouti,11.8251,42.5903,15580,0,189,15391
3/28/22,Djibouti,11.8251,42.5903,15585,0,189,15396
3/29/22,Djibouti,11.8251,42.5903,15585,0,189,15396
3/30/22,Djibouti,11.8251,42.5903,15585,0,189,15396
3/31/22,Djibouti,11.8251,42.5903,15587,0,189,15398
4/1/22,Djibouti,11.8251,42.5903,15587,0,189,15398
4/2/22,Djibouti,11.8251,42.5903,15588,0,189,15399
4/3/22,Djibouti,11.8251,42.5903,15590,0,189,15401
4/4/22,Djibouti,11.8251,42.5903,15590,0,189,15401
4/5/22,Djibouti,11.8251,42.5903,15591,0,189,15402
4/6/22,Djibouti,11.8251,42.5903,15591,0,189,15402
4/7/22,Djibouti,11.8251,42.5903,15593,0,189,15404
4/8/22,Djibouti,11.8251,42.5903,15593,0,189,15404
4/9/22,Djibouti,11.8251,42.5903,15594,0,189,15405
4/10/22,Djibouti,11.8251,42.5903,15594,0,189,15405
4/11/22,Djibouti,11.8251,42.5903,15595,0,189,15406
4/12/22,Djibouti,11.8251,42.5903,15595,0,189,15406
4/13/22,Djibouti,11.8251,42.5903,15598,0,189,15409
4/14/22,Djibouti,11.8251,42.5903,15598,0,189,15409
4/15/22,Djibouti,11.8251,42.5903,15598,0,189,15409
4/16/22,Djibouti,11.8251,42.5903,15598,0,189,15409
4/17/22,Djibouti,11.8251,42.5903,15598,0,189,15409
4/18/22,Djibouti,11.8251,42.5903,15598,0,189,15409
4/19/22,Djibouti,11.8251,42.5903,15598,0,189,15409
4/20/22,Djibouti,11.8251,42.5903,15598,0,189,15409
4/21/22,Djibouti,11.8251,42.5903,15611,0,189,15422
4/22/22,Djibouti,11.8251,42.5903,15611,0,189,15422
4/23/22,Djibouti,11.8251,42.5903,15611,0,189,15422
4/24/22,Djibouti,11.8251,42.5903,15611,0,189,15422
4/25/22,Djibouti,11.8251,42.5903,15611,0,189,15422
4/26/22,Djibouti,11.8251,42.5903,15611,0,189,15422
4/27/22,Djibouti,11.8251,42.5903,15611,0,189,15422
4/28/22,Djibouti,11.8251,42.5903,15611,0,189,15422
4/29/22,Djibouti,11.8251,42.5903,15611,0,189,15422
4/30/22,Djibouti,11.8251,42.5903,15611,0,189,15422
5/1/22,Djibouti,11.8251,42.5903,15631,0,189,15442
5/2/22,Djibouti,11.8251,42.5903,15631,0,189,15442
5/3/22,Djibouti,11.8251,42.5903,15631,0,189,15442
5/4/22,Djibouti,11.8251,42.5903,15631,0,189,15442
5/5/22,Djibouti,11.8251,42.5903,15631,0,189,15442
5/6/22,Djibouti,11.8251,42.5903,15631,0,189,15442
5/7/22,Djibouti,11.8251,42.5903,15631,0,189,15442
5/8/22,Djibouti,11.8251,42.5903,15631,0,189,15442
5/9/22,Djibouti,11.8251,42.5903,15631,0,189,15442
5/10/22,Djibouti,11.8251,42.5903,15631,0,189,15442
5/11/22,Djibouti,11.8251,42.5903,15631,0,189,15442
5/12/22,Djibouti,11.8251,42.5903,15631,0,189,15442
5/13/22,Djibouti,11.8251,42.5903,15631,0,189,15442
5/14/22,Djibouti,11.8251,42.5903,15631,0,189,15442
5/15/22,Djibouti,11.8251,42.5903,15631,0,189,15442
5/16/22,Djibouti,11.8251,42.5903,15631,0,189,15442
5/17/22,Djibouti,11.8251,42.5903,15631,0,189,15442
5/18/22,Djibouti,11.8251,42.5903,15631,0,189,15442
5/19/22,Djibouti,11.8251,42.5903,15631,0,189,15442
5/20/22,Djibouti,11.8251,42.5903,15675,0,189,15486
5/21/22,Djibouti,11.8251,42.5903,15675,0,189,15486
5/22/22,Djibouti,11.8251,42.5903,15675,0,189,15486
5/23/22,Djibouti,11.8251,42.5903,15675,0,189,15486
5/24/22,Djibouti,11.8251,42.5903,15675,0,189,15486
5/25/22,Djibouti,11.8251,42.5903,15675,0,189,15486
5/26/22,Djibouti,11.8251,42.5903,15675,0,189,15486
5/27/22,Djibouti,11.8251,42.5903,15675,0,189,15486
5/28/22,Djibouti,11.8251,42.5903,15675,0,189,15486
5/29/22,Djibouti,11.8251,42.5903,15675,0,189,15486
5/30/22,Djibouti,11.8251,42.5903,15675,0,189,15486
5/31/22,Djibouti,11.8251,42.5903,15675,0,189,15486
6/1/22,Djibouti,11.8251,42.5903,15675,0,189,15486
6/2/22,Djibouti,11.8251,42.5903,15675,0,189,15486
6/3/22,Djibouti,11.8251,42.5903,15675,0,189,15486
6/4/22,Djibouti,11.8251,42.5903,15675,0,189,15486
6/5/22,Djibouti,11.8251,42.5903,15675,0,189,15486
6/6/22,Djibouti,11.8251,42.5903,15675,0,189,15486
6/7/22,Djibouti,11.8251,42.5903,15675,0,189,15486
6/8/22,Djibouti,11.8251,42.5903,15686,0,189,15497
6/9/22,Djibouti,11.8251,42.5903,15686,0,189,15497
6/10/22,Djibouti,11.8251,42.5903,15686,0,189,15497
6/11/22,Djibouti,11.8251,42.5903,15686,0,189,15497
6/12/22,Djibouti,11.8251,42.5903,15686,0,189,15497
6/13/22,Djibouti,11.8251,42.5903,15690,0,189,15501
6/14/22,Djibouti,11.8251,42.5903,15690,0,189,15501
6/15/22,Djibouti,11.8251,42.5903,15690,0,189,15501
6/16/22,Djibouti,11.8251,42.5903,15690,0,189,15501
6/17/22,Djibouti,11.8251,42.5903,15690,0,189,15501
6/18/22,Djibouti,11.8251,42.5903,15690,0,189,15501
6/19/22,Djibouti,11.8251,42.5903,15690,0,189,15501
6/20/22,Djibouti,11.8251,42.5903,15690,0,189,15501
6/21/22,Djibouti,11.8251,42.5903,15690,0,189,15501
6/22/22,Djibouti,11.8251,42.5903,15690,0,189,15501
6/23/22,Djibouti,11.8251,42.5903,15690,0,189,15501
6/24/22,Djibouti,11.8251,42.5903,15690,0,189,15501
6/25/22,Djibouti,11.8251,42.5903,15690,0,189,15501
6/26/22,Djibouti,11.8251,42.5903,15690,0,189,15501
6/27/22,Djibouti,11.8251,42.5903,15690,0,189,15501
6/28/22,Djibouti,11.8251,42.5903,15690,0,189,15501
6/29/22,Djibouti,11.8251,42.5903,15690,0,189,15501
6/30/22,Djibouti,11.8251,42.5903,15690,0,189,15501
7/1/22,Djibouti,11.8251,42.5903,15690,0,189,15501
7/2/22,Djibouti,11.8251,42.5903,15690,0,189,15501
7/3/22,Djibouti,11.8251,42.5903,15690,0,189,15501
7/4/22,Djibouti,11.8251,42.5903,15690,0,189,15501
7/5/22,Djibouti,11.8251,42.5903,15690,0,189,15501
7/6/22,Djibouti,11.8251,42.5903,15690,0,189,15501
7/7/22,Djibouti,11.8251,42.5903,15690,0,189,15501
7/8/22,Djibouti,11.8251,42.5903,15690,0,189,15501
7/9/22,Djibouti,11.8251,42.5903,15690,0,189,15501
7/10/22,Djibouti,11.8251,42.5903,15690,0,189,15501
7/11/22,Djibouti,11.8251,42.5903,15690,0,189,15501
7/12/22,Djibouti,11.8251,42.5903,15690,0,189,15501
7/13/22,Djibouti,11.8251,42.5903,15690,0,189,15501
7/14/22,Djibouti,11.8251,42.5903,15690,0,189,15501
7/15/22,Djibouti,11.8251,42.5903,15690,0,189,15501
7/16/22,Djibouti,11.8251,42.5903,15690,0,189,15501
7/17/22,Djibouti,11.8251,42.5903,15690,0,189,15501
7/18/22,Djibouti,11.8251,42.5903,15690,0,189,15501
7/19/22,Djibouti,11.8251,42.5903,15690,0,189,15501
7/20/22,Djibouti,11.8251,42.5903,15690,0,189,15501
7/21/22,Djibouti,11.8251,42.5903,15690,0,189,15501
7/22/22,Djibouti,11.8251,42.5903,15690,0,189,15501
7/23/22,Djibouti,11.8251,42.5903,15690,0,189,15501
7/24/22,Djibouti,11.8251,42.5903,15690,0,189,15501
7/25/22,Djibouti,11.8251,42.5903,15690,0,189,15501
7/26/22,Djibouti,11.8251,42.5903,15690,0,189,15501
7/27/22,Djibouti,11.8251,42.5903,15690,0,189,15501
7/28/22,Djibouti,11.8251,42.5903,15690,0,189,15501
7/29/22,Djibouti,11.8251,42.5903,15690,0,189,15501
7/30/22,Djibouti,11.8251,42.5903,15690,0,189,15501
7/31/22,Djibouti,11.8251,42.5903,15690,0,189,15501
8/1/22,Djibouti,11.8251,42.5903,15690,0,189,15501
8/2/22,Djibouti,11.8251,42.5903,15690,0,189,15501
8/3/22,Djibouti,11.8251,42.5903,15690,0,189,15501
8/4/22,Djibouti,11.8251,42.5903,15690,0,189,15501
8/5/22,Djibouti,11.8251,42.5903,15690,0,189,15501
8/6/22,Djibouti,11.8251,42.5903,15690,0,189,15501
8/7/22,Djibouti,11.8251,42.5903,15690,0,189,15501
8/8/22,Djibouti,11.8251,42.5903,15690,0,189,15501
8/9/22,Djibouti,11.8251,42.5903,15690,0,189,15501
8/10/22,Djibouti,11.8251,42.5903,15690,0,189,15501
8/11/22,Djibouti,11.8251,42.5903,15690,0,189,15501
8/12/22,Djibouti,11.8251,42.5903,15690,0,189,15501
8/13/22,Djibouti,11.8251,42.5903,15690,0,189,15501
8/14/22,Djibouti,11.8251,42.5903,15690,0,189,15501
8/15/22,Djibouti,11.8251,42.5903,15690,0,189,15501
8/16/22,Djibouti,11.8251,42.5903,15690,0,189,15501
8/17/22,Djibouti,11.8251,42.5903,15690,0,189,15501
8/18/22,Djibouti,11.8251,42.5903,15690,0,189,15501
8/19/22,Djibouti,11.8251,42.5903,15690,0,189,15501
8/20/22,Djibouti,11.8251,42.5903,15690,0,189,15501
8/21/22,Djibouti,11.8251,42.5903,15690,0,189,15501
8/22/22,Djibouti,11.8251,42.5903,15690,0,189,15501
8/23/22,Djibouti,11.8251,42.5903,15690,0,189,15501
8/24/22,Djibouti,11.8251,42.5903,15690,0,189,15501
8/25/22,Djibouti,11.8251,42.5903,15690,0,189,15501
8/26/22,Djibouti,11.8251,42.5903,15690,0,189,15501
8/27/22,Djibouti,11.8251,42.5903,15690,0,189,15501
8/28/22,Djibouti,11.8251,42.5903,15690,0,189,15501
8/29/22,Djibouti,11.8251,42.5903,15690,0,189,15501
8/30/22,Djibouti,11.8251,42.5903,15690,0,189,15501
8/31/22,Djibouti,11.8251,42.5903,15690,0,189,15501
9/1/22,Djibouti,11.8251,42.5903,15690,0,189,15501
9/2/22,Djibouti,11.8251,42.5903,15690,0,189,15501
9/3/22,Djibouti,11.8251,42.5903,15690,0,189,15501
9/4/22,Djibouti,11.8251,42.5903,15690,0,189,15501
9/5/22,Djibouti,11.8251,42.5903,15690,0,189,15501
9/6/22,Djibouti,11.8251,42.5903,15690,0,189,15501
9/7/22,Djibouti,11.8251,42.5903,15690,0,189,15501
9/8/22,Djibouti,11.8251,42.5903,15690,0,189,15501
9/9/22,Djibouti,11.8251,42.5903,15690,0,189,15501
9/10/22,Djibouti,11.8251,42.5903,15690,0,189,15501
9/11/22,Djibouti,11.8251,42.5903,15690,0,189,15501
9/12/22,Djibouti,11.8251,42.5903,15690,0,189,15501
9/13/22,Djibouti,11.8251,42.5903,15690,0,189,15501
9/14/22,Djibouti,11.8251,42.5903,15690,0,189,15501
9/15/22,Djibouti,11.8251,42.5903,15690,0,189,15501
9/16/22,Djibouti,11.8251,42.5903,15690,0,189,15501
9/17/22,Djibouti,11.8251,42.5903,15690,0,189,15501
9/18/22,Djibouti,11.8251,42.5903,15690,0,189,15501
9/19/22,Djibouti,11.8251,42.5903,15690,0,189,15501
9/20/22,Djibouti,11.8251,42.5903,15690,0,189,15501
9/21/22,Djibouti,11.8251,42.5903,15690,0,189,15501
9/22/22,Djibouti,11.8251,42.5903,15690,0,189,15501
9/23/22,Djibouti,11.8251,42.5903,15690,0,189,15501
9/24/22,Djibouti,11.8251,42.5903,15690,0,189,15501
9/25/22,Djibouti,11.8251,42.5903,15690,0,189,15501
9/26/22,Djibouti,11.8251,42.5903,15690,0,189,15501
9/27/22,Djibouti,11.8251,42.5903,15690,0,189,15501
9/28/22,Djibouti,11.8251,42.5903,15690,0,189,15501
9/29/22,Djibouti,11.8251,42.5903,15690,0,189,15501
9/30/22,Djibouti,11.8251,42.5903,15690,0,189,15501
10/1/22,Djibouti,11.8251,42.5903,15690,0,189,15501
10/2/22,Djibouti,11.8251,42.5903,15690,0,189,15501
10/3/22,Djibouti,11.8251,42.5903,15690,0,189,15501
10/4/22,Djibouti,11.8251,42.5903,15690,0,189,15501
10/5/22,Djibouti,11.8251,42.5903,15690,0,189,15501
10/6/22,Djibouti,11.8251,42.5903,15690,0,189,15501
10/7/22,Djibouti,11.8251,42.5903,15690,0,189,15501
10/8/22,Djibouti,11.8251,42.5903,15690,0,189,15501
10/9/22,Djibouti,11.8251,42.5903,15690,0,189,15501
10/10/22,Djibouti,11.8251,42.5903,15690,0,189,15501
10/11/22,Djibouti,11.8251,42.5903,15690,0,189,15501
10/12/22,Djibouti,11.8251,42.5903,15690,0,189,15501
10/13/22,Djibouti,11.8251,42.5903,15690,0,189,15501
10/14/22,Djibouti,11.8251,42.5903,15690,0,189,15501
10/15/22,Djibouti,11.8251,42.5903,15690,0,189,15501
10/16/22,Djibouti,11.8251,42.5903,15690,0,189,15501
10/17/22,Djibouti,11.8251,42.5903,15690,0,189,15501
10/18/22,Djibouti,11.8251,42.5903,15690,0,189,15501
10/19/22,Djibouti,11.8251,42.5903,15690,0,189,15501
10/20/22,Djibouti,11.8251,42.5903,15690,0,189,15501
10/21/22,Djibouti,11.8251,42.5903,15690,0,189,15501
10/22/22,Djibouti,11.8251,42.5903,15690,0,189,15501
10/23/22,Djibouti,11.8251,42.5903,15690,0,189,15501
10/24/22,Djibouti,11.8251,42.5903,15690,0,189,15501
10/25/22,Djibouti,11.8251,42.5903,15690,0,189,15501
10/26/22,Djibouti,11.8251,42.5903,15690,0,189,15501
10/27/22,Djibouti,11.8251,42.5903,15690,0,189,15501
10/28/22,Djibouti,11.8251,42.5903,15690,0,189,15501
10/29/22,Djibouti,11.8251,42.5903,15690,0,189,15501
10/30/22,Djibouti,11.8251,42.5903,15690,0,189,15501
10/31/22,Djibouti,11.8251,42.5903,15690,0,189,15501
11/1/22,Djibouti,11.8251,42.5903,15690,0,189,15501
11/2/22,Djibouti,11.8251,42.5903,15690,0,189,15501
11/3/22,Djibouti,11.8251,42.5903,15690,0,189,15501
11/4/22,Djibouti,11.8251,42.5903,15690,0,189,15501
11/5/22,Djibouti,11.8251,42.5903,15690,0,189,15501
11/6/22,Djibouti,11.8251,42.5903,15690,0,189,15501
11/7/22,Djibouti,11.8251,42.5903,15690,0,189,15501
11/8/22,Djibouti,11.8251,42.5903,15690,0,189,15501
11/9/22,Djibouti,11.8251,42.5903,15690,0,189,15501
11/10/22,Djibouti,11.8251,42.5903,15690,0,189,15501
11/11/22,Djibouti,11.8251,42.5903,15690,0,189,15501
11/12/22,Djibouti,11.8251,42.5903,15690,0,189,15501
11/13/22,Djibouti,11.8251,42.5903,15690,0,189,15501
11/14/22,Djibouti,11.8251,42.5903,15690,0,189,15501
11/15/22,Djibouti,11.8251,42.5903,15690,0,189,15501
11/16/22,Djibouti,11.8251,42.5903,15690,0,189,15501
11/17/22,Djibouti,11.8251,42.5903,15690,0,189,15501
11/18/22,Djibouti,11.8251,42.5903,15690,0,189,15501
11/19/22,Djibouti,11.8251,42.5903,15690,0,189,15501
11/20/22,Djibouti,11.8251,42.5903,15690,0,189,15501
11/21/22,Djibouti,11.8251,42.5903,15690,0,189,15501
11/22/22,Djibouti,11.8251,42.5903,15690,0,189,15501
11/23/22,Djibouti,11.8251,42.5903,15690,0,189,15501
11/24/22,Djibouti,11.8251,42.5903,15690,0,189,15501
11/25/22,Djibouti,11.8251,42.5903,15690,0,189,15501
11/26/22,Djibouti,11.8251,42.5903,15690,0,189,15501
11/27/22,Djibouti,11.8251,42.5903,15690,0,189,15501
11/28/22,Djibouti,11.8251,42.5903,15690,0,189,15501
11/29/22,Djibouti,11.8251,42.5903,15690,0,189,15501
11/30/22,Djibouti,11.8251,42.5903,15690,0,189,15501
12/1/22,Djibouti,11.8251,42.5903,15690,0,189,15501
12/2/22,Djibouti,11.8251,42.5903,15690,0,189,15501
12/3/22,Djibouti,11.8251,42.5903,15690,0,189,15501
12/4/22,Djibouti,11.8251,42.5903,15690,0,189,15501
12/5/22,Djibouti,11.8251,42.5903,15690,0,189,15501
12/6/22,Djibouti,11.8251,42.5903,15690,0,189,15501
12/7/22,Djibouti,11.8251,42.5903,15690,0,189,15501
12/8/22,Djibouti,11.8251,42.5903,15690,0,189,15501
12/9/22,Djibouti,11.8251,42.5903,15690,0,189,15501
12/10/22,Djibouti,11.8251,42.5903,15690,0,189,15501
12/11/22,Djibouti,11.8251,42.5903,15690,0,189,15501
12/12/22,Djibouti,11.8251,42.5903,15690,0,189,15501
12/13/22,Djibouti,11.8251,42.5903,15690,0,189,15501
12/14/22,Djibouti,11.8251,42.5903,15690,0,189,15501
12/15/22,Djibouti,11.8251,42.5903,15690,0,189,15501
12/16/22,Djibouti,11.8251,42.5903,15690,0,189,15501
12/17/22,Djibouti,11.8251,42.5903,15690,0,189,15501
1/1/22,Dominica,15.415,-61.371,6862,0,47,6815
1/2/22,Dominica,15.415,-61.371,6862,0,47,6815
1/3/22,Dominica,15.415,-61.371,6862,0,47,6815
1/4/22,Dominica,15.415,-61.371,7073,0,47,7026
1/5/22,Dominica,15.415,-61.371,7073,0,47,7026
1/6/22,Dominica,15.415,-61.371,7137,0,47,7090
1/7/22,Dominica,15.415,-61.371,7241,0,47,7194
1/8/22,Dominica,15.415,-61.371,7299,0,47,7252
1/9/22,Dominica,15.415,-61.371,7299,0,47,7252
1/10/22,Dominica,15.415,-61.371,7394,0,47,7347
1/11/22,Dominica,15.415,-61.371,7562,0,47,7515
1/12/22,Dominica,15.415,-61.371,7667,0,47,7620
1/13/22,Dominica,15.415,-61.371,7667,0,47,7620
1/14/22,Dominica,15.415,-61.371,7822,0,48,7774
1/15/22,Dominica,15.415,-61.371,7822,0,48,7774
1/16/22,Dominica,15.415,-61.371,7957,0,48,7909
1/17/22,Dominica,15.415,-61.371,7957,0,48,7909
1/18/22,Dominica,15.415,-61.371,7957,0,48,7909
1/19/22,Dominica,15.415,-61.371,7957,0,48,7909
1/20/22,Dominica,15.415,-61.371,8349,0,48,8301
1/21/22,Dominica,15.415,-61.371,8421,0,49,8372
1/22/22,Dominica,15.415,-61.371,8421,0,49,8372
1/23/22,Dominica,15.415,-61.371,8517,0,49,8468
1/24/22,Dominica,15.415,-61.371,8517,0,49,8468
1/25/22,Dominica,15.415,-61.371,8517,0,49,8468
1/26/22,Dominica,15.415,-61.371,8838,0,51,8787
1/27/22,Dominica,15.415,-61.371,8838,0,51,8787
1/28/22,Dominica,15.415,-61.371,8838,0,51,8787
1/29/22,Dominica,15.415,-61.371,9032,0,51,8981
1/30/22,Dominica,15.415,-61.371,9032,0,51,8981
1/31/22,Dominica,15.415,-61.371,9032,0,51,8981
2/1/22,Dominica,15.415,-61.371,9387,0,51,9336
2/2/22,Dominica,15.415,-61.371,9387,0,51,9336
2/3/22,Dominica,15.415,-61.371,9502,0,51,9451
2/4/22,Dominica,15.415,-61.371,9621,0,51,9570
2/5/22,Dominica,15.415,-61.371,9722,0,51,9671
2/6/22,Dominica,15.415,-61.371,9722,0,51,9671
2/7/22,Dominica,15.415,-61.371,10000,0,51,9949
2/8/22,Dominica,15.415,-61.371,10073,0,53,10020
2/9/22,Dominica,15.415,-61.371,10073,0,53,10020
2/10/22,Dominica,15.415,-61.371,10190,0,53,10137
2/11/22,Dominica,15.415,-61.371,10311,0,53,10258
2/12/22,Dominica,15.415,-61.371,10414,0,53,10361
2/13/22,Dominica,15.415,-61.371,10414,0,53,10361
2/14/22,Dominica,15.415,-61.371,10527,0,53,10474
2/15/22,Dominica,15.415,-61.371,10669,0,54,10615
2/16/22,Dominica,15.415,-61.371,10728,0,55,10673
2/17/22,Dominica,15.415,-61.371,10752,0,57,10695
2/18/22,Dominica,15.415,-61.371,10801,0,57,10744
2/19/22,Dominica,15.415,-61.371,10801,0,57,10744
2/20/22,Dominica,15.415,-61.371,10801,0,57,10744
2/21/22,Dominica,15.415,-61.371,10801,0,57,10744
2/22/22,Dominica,15.415,-61.371,10953,0,57,10896
2/23/22,Dominica,15.415,-61.371,10991,0,57,10934
2/24/22,Dominica,15.415,-61.371,11016,0,57,10959
2/25/22,Dominica,15.415,-61.371,11016,0,57,10959
2/26/22,Dominica,15.415,-61.371,11016,0,57,10959
2/27/22,Dominica,15.415,-61.371,11016,0,57,10959
2/28/22,Dominica,15.415,-61.371,11108,0,57,11051
3/1/22,Dominica,15.415,-61.371,11108,0,57,11051
3/2/22,Dominica,15.415,-61.371,11108,0,57,11051
3/3/22,Dominica,15.415,-61.371,11148,0,61,11087
3/4/22,Dominica,15.415,-61.371,11248,0,61,11187
3/5/22,Dominica,15.415,-61.371,11248,0,61,11187
3/6/22,Dominica,15.415,-61.371,11248,0,61,11187
3/7/22,Dominica,15.415,-61.371,11248,0,61,11187
3/8/22,Dominica,15.415,-61.371,11248,0,61,11187
3/9/22,Dominica,15.415,-61.371,11462,0,62,11400
3/10/22,Dominica,15.415,-61.371,11502,0,62,11440
3/11/22,Dominica,15.415,-61.371,11502,0,62,11440
3/12/22,Dominica,15.415,-61.371,11502,0,62,11440
3/13/22,Dominica,15.415,-61.371,11502,0,62,11440
3/14/22,Dominica,15.415,-61.371,11529,0,62,11467
3/15/22,Dominica,15.415,-61.371,11529,0,62,11467
3/16/22,Dominica,15.415,-61.371,11643,0,62,11581
3/17/22,Dominica,15.415,-61.371,11643,0,62,11581
3/18/22,Dominica,15.415,-61.371,11674,0,62,11612
3/19/22,Dominica,15.415,-61.371,11724,0,62,11662
3/20/22,Dominica,15.415,-61.371,11724,0,62,11662
3/21/22,Dominica,15.415,-61.371,11745,0,62,11683
3/22/22,Dominica,15.415,-61.371,11777,0,63,11714
3/23/22,Dominica,15.415,-61.371,11777,0,63,11714
3/24/22,Dominica,15.415,-61.371,11787,0,63,11724
3/25/22,Dominica,15.415,-61.371,11787,0,63,11724
3/26/22,Dominica,15.415,-61.371,11787,0,63,11724
3/27/22,Dominica,15.415,-61.371,11787,0,63,11724
3/28/22,Dominica,15.415,-61.371,11805,0,63,11742
3/29/22,Dominica,15.415,-61.371,11816,0,63,11753
3/30/22,Dominica,15.415,-61.371,11839,0,63,11776
3/31/22,Dominica,15.415,-61.371,11859,0,63,11796
4/1/22,Dominica,15.415,-61.371,11891,0,63,11828
4/2/22,Dominica,15.415,-61.371,11891,0,63,11828
4/3/22,Dominica,15.415,-61.371,11891,0,63,11828
4/4/22,Dominica,15.415,-61.371,11891,0,63,11828
4/5/22,Dominica,15.415,-61.371,11897,0,63,11834
4/6/22,Dominica,15.415,-61.371,11897,0,63,11834
4/7/22,Dominica,15.415,-61.371,11953,0,63,11890
4/8/22,Dominica,15.415,-61.371,11953,0,63,11890
4/9/22,Dominica,15.415,-61.371,11953,0,63,11890
4/10/22,Dominica,15.415,-61.371,11953,0,63,11890
4/11/22,Dominica,15.415,-61.371,11953,0,63,11890
4/12/22,Dominica,15.415,-61.371,11981,0,63,11918
4/13/22,Dominica,15.415,-61.371,11986,0,63,11923
4/14/22,Dominica,15.415,-61.371,11988,0,63,11925
4/15/22,Dominica,15.415,-61.371,11988,0,63,11925
4/16/22,Dominica,15.415,-61.371,11988,0,63,11925
4/17/22,Dominica,15.415,-61.371,11988,0,63,11925
4/18/22,Dominica,15.415,-61.371,11988,0,63,11925
4/19/22,Dominica,15.415,-61.371,11988,0,63,11925
4/20/22,Dominica,15.415,-61.371,11988,0,63,11925
4/21/22,Dominica,15.415,-61.371,12011,0,63,11948
4/22/22,Dominica,15.415,-61.371,12011,0,63,11948
4/23/22,Dominica,15.415,-61.371,12011,0,63,11948
4/24/22,Dominica,15.415,-61.371,12011,0,63,11948
4/25/22,Dominica,15.415,-61.371,12011,0,63,11948
4/26/22,Dominica,15.415,-61.371,12011,0,63,11948
4/27/22,Dominica,15.415,-61.371,12033,0,63,11970
4/28/22,Dominica,15.415,-61.371,12033,0,63,11970
4/29/22,Dominica,15.415,-61.371,12033,0,63,11970
4/30/22,Dominica,15.415,-61.371,12033,0,63,11970
5/1/22,Dominica,15.415,-61.371,12161,0,63,12098
5/2/22,Dominica,15.415,-61.371,12161,0,63,12098
5/3/22,Dominica,15.415,-61.371,12161,0,63,12098
5/4/22,Dominica,15.415,-61.371,12161,0,63,12098
5/5/22,Dominica,15.415,-61.371,12161,0,63,12098
5/6/22,Dominica,15.415,-61.371,12386,0,63,12323
5/7/22,Dominica,15.415,-61.371,12386,0,63,12323
5/8/22,Dominica,15.415,-61.371,12493,0,63,12430
5/9/22,Dominica,15.415,-61.371,12493,0,63,12430
5/10/22,Dominica,15.415,-61.371,12493,0,63,12430
5/11/22,Dominica,15.415,-61.371,12685,0,63,12622
5/12/22,Dominica,15.415,-61.371,12685,0,63,12622
5/13/22,Dominica,15.415,-61.371,12685,0,63,12622
5/14/22,Dominica,15.415,-61.371,12685,0,63,12622
5/15/22,Dominica,15.415,-61.371,13116,0,63,13053
5/16/22,Dominica,15.415,-61.371,13116,0,63,13053
5/17/22,Dominica,15.415,-61.371,13116,0,63,13053
5/18/22,Dominica,15.415,-61.371,13116,0,63,13053
5/19/22,Dominica,15.415,-61.371,13116,0,63,13053
5/20/22,Dominica,15.415,-61.371,13116,0,63,13053
5/21/22,Dominica,15.415,-61.371,13116,0,63,13053
5/22/22,Dominica,15.415,-61.371,13116,0,63,13053
5/23/22,Dominica,15.415,-61.371,13752,0,63,13689
5/24/22,Dominica,15.415,-61.371,13752,0,63,13689
5/25/22,Dominica,15.415,-61.371,14184,0,65,14119
5/26/22,Dominica,15.415,-61.371,14184,0,65,14119
5/27/22,Dominica,15.415,-61.371,14184,0,65,14119
5/28/22,Dominica,15.415,-61.371,14184,0,65,14119
5/29/22,Dominica,15.415,-61.371,14184,0,65,14119
5/30/22,Dominica,15.415,-61.371,14184,0,65,14119
5/31/22,Dominica,15.415,-61.371,14184,0,65,14119
6/1/22,Dominica,15.415,-61.371,14184,0,65,14119
6/2/22,Dominica,15.415,-61.371,14295,0,67,14228
6/3/22,Dominica,15.415,-61.371,14295,0,67,14228
6/4/22,Dominica,15.415,-61.371,14295,0,67,14228
6/5/22,Dominica,15.415,-61.371,14295,0,67,14228
6/6/22,Dominica,15.415,-61.371,14295,0,67,14228
6/7/22,Dominica,15.415,-61.371,14295,0,67,14228
6/8/22,Dominica,15.415,-61.371,14295,0,67,14228
6/9/22,Dominica,15.415,-61.371,14638,0,67,14571
6/10/22,Dominica,15.415,-61.371,14638,0,67,14571
6/11/22,Dominica,15.415,-61.371,14638,0,67,14571
6/12/22,Dominica,15.415,-61.371,14638,0,67,14571
6/13/22,Dominica,15.415,-61.371,14638,0,67,14571
6/14/22,Dominica,15.415,-61.371,14717,0,67,14650
6/15/22,Dominica,15.415,-61.371,14717,0,67,14650
6/16/22,Dominica,15.415,-61.371,14717,0,67,14650
6/17/22,Dominica,15.415,-61.371,14781,0,67,14714
6/18/22,Dominica,15.415,-61.371,14781,0,67,14714
6/19/22,Dominica,15.415,-61.371,14781,0,67,14714
6/20/22,Dominica,15.415,-61.371,14781,0,67,14714
6/21/22,Dominica,15.415,-61.371,14781,0,67,14714
6/22/22,Dominica,15.415,-61.371,14781,0,67,14714
6/23/22,Dominica,15.415,-61.371,14781,0,67,14714
6/24/22,Dominica,15.415,-61.371,14821,0,67,14754
6/25/22,Dominica,15.415,-61.371,14821,0,67,14754
6/26/22,Dominica,15.415,-61.371,14821,0,67,14754
6/27/22,Dominica,15.415,-61.371,14821,0,67,14754
6/28/22,Dominica,15.415,-61.371,14852,0,68,14784
6/29/22,Dominica,15.415,-61.371,14852,0,68,14784
6/30/22,Dominica,15.415,-61.371,14852,0,68,14784
7/1/22,Dominica,15.415,-61.371,14852,0,68,14784
7/2/22,Dominica,15.415,-61.371,14852,0,68,14784
7/3/22,Dominica,15.415,-61.371,14852,0,68,14784
7/4/22,Dominica,15.415,-61.371,14852,0,68,14784
7/5/22,Dominica,15.415,-61.371,14852,0,68,14784
7/6/22,Dominica,15.415,-61.371,14852,0,68,14784
7/7/22,Dominica,15.415,-61.371,14852,0,68,14784
7/8/22,Dominica,15.415,-61.371,14852,0,68,14784
7/9/22,Dominica,15.415,-61.371,14852,0,68,14784
7/10/22,Dominica,15.415,-61.371,14852,0,68,14784
7/11/22,Dominica,15.415,-61.371,14852,0,68,14784
7/12/22,Dominica,15.415,-61.371,14852,0,68,14784
7/13/22,Dominica,15.415,-61.371,14852,0,68,14784
7/14/22,Dominica,15.415,-61.371,14852,0,68,14784
7/15/22,Dominica,15.415,-61.371,14852,0,68,14784
7/16/22,Dominica,15.415,-61.371,14852,0,68,14784
7/17/22,Dominica,15.415,-61.371,14852,0,68,14784
7/18/22,Dominica,15.415,-61.371,14852,0,68,14784
7/19/22,Dominica,15.415,-61.371,14852,0,68,14784
7/20/22,Dominica,15.415,-61.371,14852,0,68,14784
7/21/22,Dominica,15.415,-61.371,14852,0,68,14784
7/22/22,Dominica,15.415,-61.371,14852,0,68,14784
7/23/22,Dominica,15.415,-61.371,14852,0,68,14784
7/24/22,Dominica,15.415,-61.371,14852,0,68,14784
7/25/22,Dominica,15.415,-61.371,14852,0,68,14784
7/26/22,Dominica,15.415,-61.371,14852,0,68,14784
7/27/22,Dominica,15.415,-61.371,14852,0,68,14784
7/28/22,Dominica,15.415,-61.371,14852,0,68,14784
7/29/22,Dominica,15.415,-61.371,14852,0,68,14784
7/30/22,Dominica,15.415,-61.371,14852,0,68,14784
7/31/22,Dominica,15.415,-61.371,14852,0,68,14784
8/1/22,Dominica,15.415,-61.371,14852,0,68,14784
8/2/22,Dominica,15.415,-61.371,14852,0,68,14784
8/3/22,Dominica,15.415,-61.371,14852,0,68,14784
8/4/22,Dominica,15.415,-61.371,14852,0,68,14784
8/5/22,Dominica,15.415,-61.371,14852,0,68,14784
8/6/22,Dominica,15.415,-61.371,14852,0,68,14784
8/7/22,Dominica,15.415,-61.371,14852,0,68,14784
8/8/22,Dominica,15.415,-61.371,14852,0,68,14784
8/9/22,Dominica,15.415,-61.371,14852,0,68,14784
8/10/22,Dominica,15.415,-61.371,14852,0,68,14784
8/11/22,Dominica,15.415,-61.371,14852,0,68,14784
8/12/22,Dominica,15.415,-61.371,14852,0,68,14784
8/13/22,Dominica,15.415,-61.371,14852,0,68,14784
8/14/22,Dominica,15.415,-61.371,14852,0,68,14784
8/15/22,Dominica,15.415,-61.371,14852,0,68,14784
8/16/22,Dominica,15.415,-61.371,14852,0,68,14784
8/17/22,Dominica,15.415,-61.371,14852,0,68,14784
8/18/22,Dominica,15.415,-61.371,14852,0,68,14784
8/19/22,Dominica,15.415,-61.371,14852,0,68,14784
8/20/22,Dominica,15.415,-61.371,14852,0,68,14784
8/21/22,Dominica,15.415,-61.371,14852,0,68,14784
8/22/22,Dominica,15.415,-61.371,14852,0,68,14784
8/23/22,Dominica,15.415,-61.371,14852,0,68,14784
8/24/22,Dominica,15.415,-61.371,14852,0,68,14784
8/25/22,Dominica,15.415,-61.371,14852,0,68,14784
8/26/22,Dominica,15.415,-61.371,14852,0,68,14784
8/27/22,Dominica,15.415,-61.371,14852,0,68,14784
8/28/22,Dominica,15.415,-61.371,14852,0,68,14784
8/29/22,Dominica,15.415,-61.371,14852,0,68,14784
8/30/22,Dominica,15.415,-61.371,14852,0,68,14784
8/31/22,Dominica,15.415,-61.371,14852,0,68,14784
9/1/22,Dominica,15.415,-61.371,14852,0,68,14784
9/2/22,Dominica,15.415,-61.371,14852,0,68,14784
9/3/22,Dominica,15.415,-61.371,14852,0,68,14784
9/4/22,Dominica,15.415,-61.371,14852,0,68,14784
9/5/22,Dominica,15.415,-61.371,14852,0,68,14784
9/6/22,Dominica,15.415,-61.371,14852,0,68,14784
9/7/22,Dominica,15.415,-61.371,14852,0,68,14784
9/8/22,Dominica,15.415,-61.371,14852,0,68,14784
9/9/22,Dominica,15.415,-61.371,14852,0,68,14784
9/10/22,Dominica,15.415,-61.371,14852,0,68,14784
9/11/22,Dominica,15.415,-61.371,14852,0,68,14784
9/12/22,Dominica,15.415,-61.371,14852,0,68,14784
9/13/22,Dominica,15.415,-61.371,14852,0,68,14784
9/14/22,Dominica,15.415,-61.371,14852,0,68,14784
9/15/22,Dominica,15.415,-61.371,14852,0,68,14784
9/16/22,Dominica,15.415,-61.371,14852,0,68,14784
9/17/22,Dominica,15.415,-61.371,14852,0,68,14784
9/18/22,Dominica,15.415,-61.371,14852,0,68,14784
9/19/22,Dominica,15.415,-61.371,14852,0,68,14784
9/20/22,Dominica,15.415,-61.371,14852,0,68,14784
9/21/22,Dominica,15.415,-61.371,14852,0,68,14784
9/22/22,Dominica,15.415,-61.371,14852,0,68,14784
9/23/22,Dominica,15.415,-61.371,14852,0,68,14784
9/24/22,Dominica,15.415,-61.371,14852,0,68,14784
9/25/22,Dominica,15.415,-61.371,14852,0,68,14784
9/26/22,Dominica,15.415,-61.371,14852,0,68,14784
9/27/22,Dominica,15.415,-61.371,15747,0,74,15673
9/28/22,Dominica,15.415,-61.371,15747,0,74,15673
9/29/22,Dominica,15.415,-61.371,15747,0,74,15673
9/30/22,Dominica,15.415,-61.371,15747,0,74,15673
10/1/22,Dominica,15.415,-61.371,15747,0,74,15673
10/2/22,Dominica,15.415,-61.371,15747,0,74,15673
10/3/22,Dominica,15.415,-61.371,15747,0,74,15673
10/4/22,Dominica,15.415,-61.371,15747,0,74,15673
10/5/22,Dominica,15.415,-61.371,15747,0,74,15673
10/6/22,Dominica,15.415,-61.371,15760,0,74,15686
10/7/22,Dominica,15.415,-61.371,15760,0,74,15686
10/8/22,Dominica,15.415,-61.371,15760,0,74,15686
10/9/22,Dominica,15.415,-61.371,15760,0,74,15686
10/10/22,Dominica,15.415,-61.371,15760,0,74,15686
10/11/22,Dominica,15.415,-61.371,15760,0,74,15686
10/12/22,Dominica,15.415,-61.371,15760,0,74,15686
10/13/22,Dominica,15.415,-61.371,15760,0,74,15686
10/14/22,Dominica,15.415,-61.371,15760,0,74,15686
10/15/22,Dominica,15.415,-61.371,15760,0,74,15686
10/16/22,Dominica,15.415,-61.371,15760,0,74,15686
10/17/22,Dominica,15.415,-61.371,15760,0,74,15686
10/18/22,Dominica,15.415,-61.371,15760,0,74,15686
10/19/22,Dominica,15.415,-61.371,15760,0,74,15686
10/20/22,Dominica,15.415,-61.371,15760,0,74,15686
10/21/22,Dominica,15.415,-61.371,15760,0,74,15686
10/22/22,Dominica,15.415,-61.371,15760,0,74,15686
10/23/22,Dominica,15.415,-61.371,15760,0,74,15686
10/24/22,Dominica,15.415,-61.371,15760,0,74,15686
10/25/22,Dominica,15.415,-61.371,15760,0,74,15686
10/26/22,Dominica,15.415,-61.371,15760,0,74,15686
10/27/22,Dominica,15.415,-61.371,15760,0,74,15686
10/28/22,Dominica,15.415,-61.371,15760,0,74,15686
10/29/22,Dominica,15.415,-61.371,15760,0,74,15686
10/30/22,Dominica,15.415,-61.371,15760,0,74,15686
10/31/22,Dominica,15.415,-61.371,15760,0,74,15686
11/1/22,Dominica,15.415,-61.371,15760,0,74,15686
11/2/22,Dominica,15.415,-61.371,15760,0,74,15686
11/3/22,Dominica,15.415,-61.371,15760,0,74,15686
11/4/22,Dominica,15.415,-61.371,15760,0,74,15686
11/5/22,Dominica,15.415,-61.371,15760,0,74,15686
11/6/22,Dominica,15.415,-61.371,15760,0,74,15686
11/7/22,Dominica,15.415,-61.371,15760,0,74,15686
11/8/22,Dominica,15.415,-61.371,15760,0,74,15686
11/9/22,Dominica,15.415,-61.371,15760,0,74,15686
11/10/22,Dominica,15.415,-61.371,15760,0,74,15686
11/11/22,Dominica,15.415,-61.371,15760,0,74,15686
11/12/22,Dominica,15.415,-61.371,15760,0,74,15686
11/13/22,Dominica,15.415,-61.371,15760,0,74,15686
11/14/22,Dominica,15.415,-61.371,15760,0,74,15686
11/15/22,Dominica,15.415,-61.371,15760,0,74,15686
11/16/22,Dominica,15.415,-61.371,15760,0,74,15686
11/17/22,Dominica,15.415,-61.371,15760,0,74,15686
11/18/22,Dominica,15.415,-61.371,15760,0,74,15686
11/19/22,Dominica,15.415,-61.371,15760,0,74,15686
11/20/22,Dominica,15.415,-61.371,15760,0,74,15686
11/21/22,Dominica,15.415,-61.371,15760,0,74,15686
11/22/22,Dominica,15.415,-61.371,15760,0,74,15686
11/23/22,Dominica,15.415,-61.371,15760,0,74,15686
11/24/22,Dominica,15.415,-61.371,15760,0,74,15686
11/25/22,Dominica,15.415,-61.371,15760,0,74,15686
11/26/22,Dominica,15.415,-61.371,15760,0,74,15686
11/27/22,Dominica,15.415,-61.371,15760,0,74,15686
11/28/22,Dominica,15.415,-61.371,15760,0,74,15686
11/29/22,Dominica,15.415,-61.371,15760,0,74,15686
11/30/22,Dominica,15.415,-61.371,15760,0,74,15686
12/1/22,Dominica,15.415,-61.371,15760,0,74,15686
12/2/22,Dominica,15.415,-61.371,15760,0,74,15686
12/3/22,Dominica,15.415,-61.371,15760,0,74,15686
12/4/22,Dominica,15.415,-61.371,15760,0,74,15686
12/5/22,Dominica,15.415,-61.371,15760,0,74,15686
12/6/22,Dominica,15.415,-61.371,15760,0,74,15686
12/7/22,Dominica,15.415,-61.371,15760,0,74,15686
12/8/22,Dominica,15.415,-61.371,15760,0,74,15686
12/9/22,Dominica,15.415,-61.371,15760,0,74,15686
12/10/22,Dominica,15.415,-61.371,15760,0,74,15686
12/11/22,Dominica,15.415,-61.371,15760,0,74,15686
12/12/22,Dominica,15.415,-61.371,15760,0,74,15686
12/13/22,Dominica,15.415,-61.371,15760,0,74,15686
12/14/22,Dominica,15.415,-61.371,15760,0,74,15686
12/15/22,Dominica,15.415,-61.371,15760,0,74,15686
12/16/22,Dominica,15.415,-61.371,15760,0,74,15686
12/17/22,Dominica,15.415,-61.371,15760,0,74,15686
1/1/22,Dominican Republic,18.7357,-70.1627,419927,0,4247,415680
1/2/22,Dominican Republic,18.7357,-70.1627,421953,0,4249,417704
1/3/22,Dominican Republic,18.7357,-70.1627,424809,0,4251,420558
1/4/22,Dominican Republic,18.7357,-70.1627,428509,0,4252,424257
1/5/22,Dominican Republic,18.7357,-70.1627,433710,0,4252,429458
1/6/22,Dominican Republic,18.7357,-70.1627,439017,0,4252,434765
1/7/22,Dominican Republic,18.7357,-70.1627,444985,0,4252,440733
1/8/22,Dominican Republic,18.7357,-70.1627,451185,0,4255,446930
1/9/22,Dominican Republic,18.7357,-70.1627,457227,0,4255,452972
1/10/22,Dominican Republic,18.7357,-70.1627,462382,0,4255,458127
1/11/22,Dominican Republic,18.7357,-70.1627,469065,0,4255,464810
1/12/22,Dominican Republic,18.7357,-70.1627,476504,0,4259,472245
1/13/22,Dominican Republic,18.7357,-70.1627,482457,0,4259,478198
1/14/22,Dominican Republic,18.7357,-70.1627,489631,0,4266,485365
1/15/22,Dominican Republic,18.7357,-70.1627,494595,0,4268,490327
1/16/22,Dominican Republic,18.7357,-70.1627,498583,0,4268,494315
1/17/22,Dominican Republic,18.7357,-70.1627,504914,0,4269,500645
1/18/22,Dominican Republic,18.7357,-70.1627,510458,0,4269,506189
1/19/22,Dominican Republic,18.7357,-70.1627,517611,0,4274,513337
1/20/22,Dominican Republic,18.7357,-70.1627,524635,0,4274,520361
1/21/22,Dominican Republic,18.7357,-70.1627,530998,0,4279,526719
1/22/22,Dominican Republic,18.7357,-70.1627,536767,0,4285,532482
1/23/22,Dominican Republic,18.7357,-70.1627,539580,0,4287,535293
1/24/22,Dominican Republic,18.7357,-70.1627,542056,0,4289,537767
1/25/22,Dominican Republic,18.7357,-70.1627,544328,0,4291,540037
1/26/22,Dominican Republic,18.7357,-70.1627,547091,0,4293,542798
1/27/22,Dominican Republic,18.7357,-70.1627,550020,0,4295,545725
1/28/22,Dominican Republic,18.7357,-70.1627,551528,0,4298,547230
1/29/22,Dominican Republic,18.7357,-70.1627,552831,0,4301,548530
1/30/22,Dominican Republic,18.7357,-70.1627,554052,0,4305,549747
1/31/22,Dominican Republic,18.7357,-70.1627,555245,0,4307,550938
2/1/22,Dominican Republic,18.7357,-70.1627,556520,0,4310,552210
2/2/22,Dominican Republic,18.7357,-70.1627,557919,0,4313,553606
2/3/22,Dominican Republic,18.7357,-70.1627,558936,0,4315,554621
2/4/22,Dominican Republic,18.7357,-70.1627,560037,0,4319,555718
2/5/22,Dominican Republic,18.7357,-70.1627,561657,0,4322,557335
2/6/22,Dominican Republic,18.7357,-70.1627,562613,0,4325,558288
2/7/22,Dominican Republic,18.7357,-70.1627,563657,0,4329,559328
2/8/22,Dominican Republic,18.7357,-70.1627,564467,0,4332,560135
2/9/22,Dominican Republic,18.7357,-70.1627,565862,0,4336,561526
2/10/22,Dominican Republic,18.7357,-70.1627,567085,0,4339,562746
2/11/22,Dominican Republic,18.7357,-70.1627,567895,0,4341,563554
2/12/22,Dominican Republic,18.7357,-70.1627,569024,0,4343,564681
2/13/22,Dominican Republic,18.7357,-70.1627,569446,0,4347,565099
2/14/22,Dominican Republic,18.7357,-70.1627,569702,0,4347,565355
2/15/22,Dominican Republic,18.7357,-70.1627,570236,0,4349,565887
2/16/22,Dominican Republic,18.7357,-70.1627,570636,0,4351,566285
2/17/22,Dominican Republic,18.7357,-70.1627,570889,0,4354,566535
2/18/22,Dominican Republic,18.7357,-70.1627,571200,0,4354,566846
2/19/22,Dominican Republic,18.7357,-70.1627,571552,0,4357,567195
2/20/22,Dominican Republic,18.7357,-70.1627,571856,0,4357,567499
2/21/22,Dominican Republic,18.7357,-70.1627,572290,0,4357,567933
2/22/22,Dominican Republic,18.7357,-70.1627,572596,0,4360,568236
2/23/22,Dominican Republic,18.7357,-70.1627,572596,0,4360,568236
2/24/22,Dominican Republic,18.7357,-70.1627,573458,0,4363,569095
2/25/22,Dominican Republic,18.7357,-70.1627,573776,0,4365,569411
2/26/22,Dominican Republic,18.7357,-70.1627,574071,0,4368,569703
2/27/22,Dominican Republic,18.7357,-70.1627,574071,0,4368,569703
2/28/22,Dominican Republic,18.7357,-70.1627,574556,0,4368,570188
3/1/22,Dominican Republic,18.7357,-70.1627,574912,0,4369,570543
3/2/22,Dominican Republic,18.7357,-70.1627,575157,0,4370,570787
3/3/22,Dominican Republic,18.7357,-70.1627,575437,0,4370,571067
3/4/22,Dominican Republic,18.7357,-70.1627,575592,0,4370,571222
3/5/22,Dominican Republic,18.7357,-70.1627,575883,0,4371,571512
3/6/22,Dominican Republic,18.7357,-70.1627,575949,0,4371,571578
3/7/22,Dominican Republic,18.7357,-70.1627,576003,0,4371,571632
3/8/22,Dominican Republic,18.7357,-70.1627,576129,0,4371,571758
3/9/22,Dominican Republic,18.7357,-70.1627,576220,0,4372,571848
3/10/22,Dominican Republic,18.7357,-70.1627,576220,0,4372,571848
3/11/22,Dominican Republic,18.7357,-70.1627,576367,0,4374,571993
3/12/22,Dominican Republic,18.7357,-70.1627,576367,0,4374,571993
3/13/22,Dominican Republic,18.7357,-70.1627,576641,0,4374,572267
3/14/22,Dominican Republic,18.7357,-70.1627,576641,0,4374,572267
3/15/22,Dominican Republic,18.7357,-70.1627,576788,0,4374,572414
3/16/22,Dominican Republic,18.7357,-70.1627,576904,0,4375,572529
3/17/22,Dominican Republic,18.7357,-70.1627,577070,0,4375,572695
3/18/22,Dominican Republic,18.7357,-70.1627,577241,0,4375,572866
3/19/22,Dominican Republic,18.7357,-70.1627,577317,0,4375,572942
3/20/22,Dominican Republic,18.7357,-70.1627,577317,0,4375,572942
3/21/22,Dominican Republic,18.7357,-70.1627,577354,0,4375,572979
3/22/22,Dominican Republic,18.7357,-70.1627,577476,0,4375,573101
3/23/22,Dominican Republic,18.7357,-70.1627,577476,0,4375,573101
3/24/22,Dominican Republic,18.7357,-70.1627,577673,0,4375,573298
3/25/22,Dominican Republic,18.7357,-70.1627,577673,0,4375,573298
3/26/22,Dominican Republic,18.7357,-70.1627,577841,0,4375,573466
3/27/22,Dominican Republic,18.7357,-70.1627,577841,0,4375,573466
3/28/22,Dominican Republic,18.7357,-70.1627,577910,0,4375,573535
3/29/22,Dominican Republic,18.7357,-70.1627,577910,0,4375,573535
3/30/22,Dominican Republic,18.7357,-70.1627,578020,0,4375,573645
3/31/22,Dominican Republic,18.7357,-70.1627,578020,0,4375,573645
4/1/22,Dominican Republic,18.7357,-70.1627,578130,0,4375,573755
4/2/22,Dominican Republic,18.7357,-70.1627,578130,0,4375,573755
4/3/22,Dominican Republic,18.7357,-70.1627,578130,0,4375,573755
4/4/22,Dominican Republic,18.7357,-70.1627,578209,0,4375,573834
4/5/22,Dominican Republic,18.7357,-70.1627,578319,0,4375,573944
4/6/22,Dominican Republic,18.7357,-70.1627,578319,0,4375,573944
4/7/22,Dominican Republic,18.7357,-70.1627,578416,0,4375,574041
4/8/22,Dominican Republic,18.7357,-70.1627,578416,0,4375,574041
4/9/22,Dominican Republic,18.7357,-70.1627,578416,0,4375,574041
4/10/22,Dominican Republic,18.7357,-70.1627,578531,0,4375,574156
4/11/22,Dominican Republic,18.7357,-70.1627,578531,0,4375,574156
4/12/22,Dominican Republic,18.7357,-70.1627,578626,0,4375,574251
4/13/22,Dominican Republic,18.7357,-70.1627,578626,0,4375,574251
4/14/22,Dominican Republic,18.7357,-70.1627,578663,0,4375,574288
4/15/22,Dominican Republic,18.7357,-70.1627,578663,0,4375,574288
4/16/22,Dominican Republic,18.7357,-70.1627,578733,0,4375,574358
4/17/22,Dominican Republic,18.7357,-70.1627,578733,0,4375,574358
4/18/22,Dominican Republic,18.7357,-70.1627,578789,0,4375,574414
4/19/22,Dominican Republic,18.7357,-70.1627,578789,0,4375,574414
4/20/22,Dominican Republic,18.7357,-70.1627,578789,0,4375,574414
4/21/22,Dominican Republic,18.7357,-70.1627,578954,0,4376,574578
4/22/22,Dominican Republic,18.7357,-70.1627,578954,0,4376,574578
4/23/22,Dominican Republic,18.7357,-70.1627,578954,0,4376,574578
4/24/22,Dominican Republic,18.7357,-70.1627,579114,0,4376,574738
4/25/22,Dominican Republic,18.7357,-70.1627,579114,0,4376,574738
4/26/22,Dominican Republic,18.7357,-70.1627,579114,0,4376,574738
4/27/22,Dominican Republic,18.7357,-70.1627,579248,0,4376,574872
4/28/22,Dominican Republic,18.7357,-70.1627,579248,0,4376,574872
4/29/22,Dominican Republic,18.7357,-70.1627,579248,0,4376,574872
4/30/22,Dominican Republic,18.7357,-70.1627,579248,0,4376,574872
5/1/22,Dominican Republic,18.7357,-70.1627,579443,0,4376,575067
5/2/22,Dominican Republic,18.7357,-70.1627,579443,0,4376,575067
5/3/22,Dominican Republic,18.7357,-70.1627,579443,0,4376,575067
5/4/22,Dominican Republic,18.7357,-70.1627,579572,0,4376,575196
5/5/22,Dominican Republic,18.7357,-70.1627,579572,0,4376,575196
5/6/22,Dominican Republic,18.7357,-70.1627,579743,0,4376,575367
5/7/22,Dominican Republic,18.7357,-70.1627,579743,0,4376,575367
5/8/22,Dominican Republic,18.7357,-70.1627,579743,0,4376,575367
5/9/22,Dominican Republic,18.7357,-70.1627,579743,0,4376,575367
5/10/22,Dominican Republic,18.7357,-70.1627,580020,0,4376,575644
5/11/22,Dominican Republic,18.7357,-70.1627,580020,0,4376,575644
5/12/22,Dominican Republic,18.7357,-70.1627,580201,0,4376,575825
5/13/22,Dominican Republic,18.7357,-70.1627,580336,0,4376,575960
5/14/22,Dominican Republic,18.7357,-70.1627,580412,0,4376,576036
5/15/22,Dominican Republic,18.7357,-70.1627,580412,0,4376,576036
5/16/22,Dominican Republic,18.7357,-70.1627,580661,0,4377,576284
5/17/22,Dominican Republic,18.7357,-70.1627,580661,0,4377,576284
5/18/22,Dominican Republic,18.7357,-70.1627,580661,0,4377,576284
5/19/22,Dominican Republic,18.7357,-70.1627,581044,0,4377,576667
5/20/22,Dominican Republic,18.7357,-70.1627,581044,0,4377,576667
5/21/22,Dominican Republic,18.7357,-70.1627,581153,0,4377,576776
5/22/22,Dominican Republic,18.7357,-70.1627,581153,0,4377,576776
5/23/22,Dominican Republic,18.7357,-70.1627,581464,0,4377,577087
5/24/22,Dominican Republic,18.7357,-70.1627,581647,0,4377,577270
5/25/22,Dominican Republic,18.7357,-70.1627,581869,0,4377,577492
5/26/22,Dominican Republic,18.7357,-70.1627,582193,0,4377,577816
5/27/22,Dominican Republic,18.7357,-70.1627,582693,0,4377,578316
5/28/22,Dominican Republic,18.7357,-70.1627,583159,0,4377,578782
5/29/22,Dominican Republic,18.7357,-70.1627,583159,0,4377,578782
5/30/22,Dominican Republic,18.7357,-70.1627,583722,0,4377,579345
5/31/22,Dominican Republic,18.7357,-70.1627,584029,0,4377,579652
6/1/22,Dominican Republic,18.7357,-70.1627,584029,0,4377,579652
6/2/22,Dominican Republic,18.7357,-70.1627,584526,0,4377,580149
6/3/22,Dominican Republic,18.7357,-70.1627,585567,0,4377,581190
6/4/22,Dominican Republic,18.7357,-70.1627,586099,0,4377,581722
6/5/22,Dominican Republic,18.7357,-70.1627,586926,0,4377,582549
6/6/22,Dominican Republic,18.7357,-70.1627,586926,0,4377,582549
6/7/22,Dominican Republic,18.7357,-70.1627,588408,0,4379,584029
6/8/22,Dominican Republic,18.7357,-70.1627,588978,0,4380,584598
6/9/22,Dominican Republic,18.7357,-70.1627,589521,0,4380,585141
6/10/22,Dominican Republic,18.7357,-70.1627,589521,0,4380,585141
6/11/22,Dominican Republic,18.7357,-70.1627,590764,0,4380,586384
6/12/22,Dominican Republic,18.7357,-70.1627,590764,0,4380,586384
6/13/22,Dominican Republic,18.7357,-70.1627,592578,0,4382,588196
6/14/22,Dominican Republic,18.7357,-70.1627,593324,0,4382,588942
6/15/22,Dominican Republic,18.7357,-70.1627,593324,0,4382,588942
6/16/22,Dominican Republic,18.7357,-70.1627,594964,0,4382,590582
6/17/22,Dominican Republic,18.7357,-70.1627,595927,0,4382,591545
6/18/22,Dominican Republic,18.7357,-70.1627,595927,0,4382,591545
6/19/22,Dominican Republic,18.7357,-70.1627,595927,0,4382,591545
6/20/22,Dominican Republic,18.7357,-70.1627,598079,0,4383,593696
6/21/22,Dominican Republic,18.7357,-70.1627,598594,0,4383,594211
6/22/22,Dominican Republic,18.7357,-70.1627,599469,0,4383,595086
6/23/22,Dominican Republic,18.7357,-70.1627,600410,0,4383,596027
6/24/22,Dominican Republic,18.7357,-70.1627,600410,0,4383,596027
6/25/22,Dominican Republic,18.7357,-70.1627,600410,0,4383,596027
6/26/22,Dominican Republic,18.7357,-70.1627,603256,0,4383,598873
6/27/22,Dominican Republic,18.7357,-70.1627,603256,0,4383,598873
6/28/22,Dominican Republic,18.7357,-70.1627,603256,0,4383,598873
6/29/22,Dominican Republic,18.7357,-70.1627,605784,0,4383,601401
6/30/22,Dominican Republic,18.7357,-70.1627,605784,0,4383,601401
7/1/22,Dominican Republic,18.7357,-70.1627,608176,0,4383,603793
7/2/22,Dominican Republic,18.7357,-70.1627,608176,0,4383,603793
7/3/22,Dominican Republic,18.7357,-70.1627,608176,0,4383,603793
7/4/22,Dominican Republic,18.7357,-70.1627,611581,0,4383,607198
7/5/22,Dominican Republic,18.7357,-70.1627,612548,0,4383,608165
7/6/22,Dominican Republic,18.7357,-70.1627,613628,0,4383,609245
7/7/22,Dominican Republic,18.7357,-70.1627,614707,0,4383,610324
7/8/22,Dominican Republic,18.7357,-70.1627,616024,0,4383,611641
7/9/22,Dominican Republic,18.7357,-70.1627,616024,0,4383,611641
7/10/22,Dominican Republic,18.7357,-70.1627,616024,0,4383,611641
7/11/22,Dominican Republic,18.7357,-70.1627,618873,0,4383,614490
7/12/22,Dominican Republic,18.7357,-70.1627,619501,0,4383,615118
7/13/22,Dominican Republic,18.7357,-70.1627,620237,0,4383,615854
7/14/22,Dominican Republic,18.7357,-70.1627,621047,0,4383,616664
7/15/22,Dominican Republic,18.7357,-70.1627,621047,0,4383,616664
7/16/22,Dominican Republic,18.7357,-70.1627,621047,0,4383,616664
7/17/22,Dominican Republic,18.7357,-70.1627,621047,0,4383,616664
7/18/22,Dominican Republic,18.7357,-70.1627,622432,0,4383,618049
7/19/22,Dominican Republic,18.7357,-70.1627,623105,0,4383,618722
7/20/22,Dominican Republic,18.7357,-70.1627,624167,0,4383,619784
7/21/22,Dominican Republic,18.7357,-70.1627,624167,0,4383,619784
7/22/22,Dominican Republic,18.7357,-70.1627,625156,0,4383,620773
7/23/22,Dominican Republic,18.7357,-70.1627,625156,0,4383,620773
7/24/22,Dominican Republic,18.7357,-70.1627,625156,0,4383,620773
7/25/22,Dominican Republic,18.7357,-70.1627,626611,0,4383,622228
7/26/22,Dominican Republic,18.7357,-70.1627,626611,0,4383,622228
7/27/22,Dominican Republic,18.7357,-70.1627,626611,0,4383,622228
7/28/22,Dominican Republic,18.7357,-70.1627,627460,0,4383,623077
7/29/22,Dominican Republic,18.7357,-70.1627,628213,0,4383,623830
7/30/22,Dominican Republic,18.7357,-70.1627,628213,0,4383,623830
7/31/22,Dominican Republic,18.7357,-70.1627,628213,0,4383,623830
8/1/22,Dominican Republic,18.7357,-70.1627,629643,0,4383,625260
8/2/22,Dominican Republic,18.7357,-70.1627,629643,0,4383,625260
8/3/22,Dominican Republic,18.7357,-70.1627,631040,0,4383,626657
8/4/22,Dominican Republic,18.7357,-70.1627,631040,0,4383,626657
8/5/22,Dominican Republic,18.7357,-70.1627,631040,0,4383,626657
8/6/22,Dominican Republic,18.7357,-70.1627,632655,0,4384,628271
8/7/22,Dominican Republic,18.7357,-70.1627,632655,0,4384,628271
8/8/22,Dominican Republic,18.7357,-70.1627,632655,0,4384,628271
8/9/22,Dominican Republic,18.7357,-70.1627,632655,0,4384,628271
8/10/22,Dominican Republic,18.7357,-70.1627,633689,0,4384,629305
8/11/22,Dominican Republic,18.7357,-70.1627,633689,0,4384,629305
8/12/22,Dominican Republic,18.7357,-70.1627,633689,0,4384,629305
8/13/22,Dominican Republic,18.7357,-70.1627,633689,0,4384,629305
8/14/22,Dominican Republic,18.7357,-70.1627,634866,0,4384,630482
8/15/22,Dominican Republic,18.7357,-70.1627,634866,0,4384,630482
8/16/22,Dominican Republic,18.7357,-70.1627,635461,0,4384,631077
8/17/22,Dominican Republic,18.7357,-70.1627,635461,0,4384,631077
8/18/22,Dominican Republic,18.7357,-70.1627,635461,0,4384,631077
8/19/22,Dominican Republic,18.7357,-70.1627,635461,0,4384,631077
8/20/22,Dominican Republic,18.7357,-70.1627,635461,0,4384,631077
8/21/22,Dominican Republic,18.7357,-70.1627,636416,0,4384,632032
8/22/22,Dominican Republic,18.7357,-70.1627,636416,0,4384,632032
8/23/22,Dominican Republic,18.7357,-70.1627,636416,0,4384,632032
8/24/22,Dominican Republic,18.7357,-70.1627,636416,0,4384,632032
8/25/22,Dominican Republic,18.7357,-70.1627,637573,0,4384,633189
8/26/22,Dominican Republic,18.7357,-70.1627,637573,0,4384,633189
8/27/22,Dominican Republic,18.7357,-70.1627,637573,0,4384,633189
8/28/22,Dominican Republic,18.7357,-70.1627,637573,0,4384,633189
8/29/22,Dominican Republic,18.7357,-70.1627,638500,0,4384,634116
8/30/22,Dominican Republic,18.7357,-70.1627,638500,0,4384,634116
8/31/22,Dominican Republic,18.7357,-70.1627,638500,0,4384,634116
9/1/22,Dominican Republic,18.7357,-70.1627,638500,0,4384,634116
9/2/22,Dominican Republic,18.7357,-70.1627,638500,0,4384,634116
9/3/22,Dominican Republic,18.7357,-70.1627,638500,0,4384,634116
9/4/22,Dominican Republic,18.7357,-70.1627,640064,0,4384,635680
9/5/22,Dominican Republic,18.7357,-70.1627,640064,0,4384,635680
9/6/22,Dominican Republic,18.7357,-70.1627,640064,0,4384,635680
9/7/22,Dominican Republic,18.7357,-70.1627,640064,0,4384,635680
9/8/22,Dominican Republic,18.7357,-70.1627,640064,0,4384,635680
9/9/22,Dominican Republic,18.7357,-70.1627,640064,0,4384,635680
9/10/22,Dominican Republic,18.7357,-70.1627,641677,0,4384,637293
9/11/22,Dominican Republic,18.7357,-70.1627,641677,0,4384,637293
9/12/22,Dominican Republic,18.7357,-70.1627,641677,0,4384,637293
9/13/22,Dominican Republic,18.7357,-70.1627,641677,0,4384,637293
9/14/22,Dominican Republic,18.7357,-70.1627,641677,0,4384,637293
9/15/22,Dominican Republic,18.7357,-70.1627,641677,0,4384,637293
9/16/22,Dominican Republic,18.7357,-70.1627,641677,0,4384,637293
9/17/22,Dominican Republic,18.7357,-70.1627,641677,0,4384,637293
9/18/22,Dominican Republic,18.7357,-70.1627,644016,0,4384,639632
9/19/22,Dominican Republic,18.7357,-70.1627,644016,0,4384,639632
9/20/22,Dominican Republic,18.7357,-70.1627,644356,0,4384,639972
9/21/22,Dominican Republic,18.7357,-70.1627,644356,0,4384,639972
9/22/22,Dominican Republic,18.7357,-70.1627,644356,0,4384,639972
9/23/22,Dominican Republic,18.7357,-70.1627,644356,0,4384,639972
9/24/22,Dominican Republic,18.7357,-70.1627,644356,0,4384,639972
9/25/22,Dominican Republic,18.7357,-70.1627,644356,0,4384,639972
9/26/22,Dominican Republic,18.7357,-70.1627,644356,0,4384,639972
9/27/22,Dominican Republic,18.7357,-70.1627,644356,0,4384,639972
9/28/22,Dominican Republic,18.7357,-70.1627,644356,0,4384,639972
9/29/22,Dominican Republic,18.7357,-70.1627,644356,0,4384,639972
9/30/22,Dominican Republic,18.7357,-70.1627,644356,0,4384,639972
10/1/22,Dominican Republic,18.7357,-70.1627,645952,0,4384,641568
10/2/22,Dominican Republic,18.7357,-70.1627,645952,0,4384,641568
10/3/22,Dominican Republic,18.7357,-70.1627,645952,0,4384,641568
10/4/22,Dominican Republic,18.7357,-70.1627,646209,0,4384,641825
10/5/22,Dominican Republic,18.7357,-70.1627,646209,0,4384,641825
10/6/22,Dominican Republic,18.7357,-70.1627,646209,0,4384,641825
10/7/22,Dominican Republic,18.7357,-70.1627,646209,0,4384,641825
10/8/22,Dominican Republic,18.7357,-70.1627,646209,0,4384,641825
10/9/22,Dominican Republic,18.7357,-70.1627,646209,0,4384,641825
10/10/22,Dominican Republic,18.7357,-70.1627,646209,0,4384,641825
10/11/22,Dominican Republic,18.7357,-70.1627,646209,0,4384,641825
10/12/22,Dominican Republic,18.7357,-70.1627,646209,0,4384,641825
10/13/22,Dominican Republic,18.7357,-70.1627,646209,0,4384,641825
10/14/22,Dominican Republic,18.7357,-70.1627,646209,0,4384,641825
10/15/22,Dominican Republic,18.7357,-70.1627,646209,0,4384,641825
10/16/22,Dominican Republic,18.7357,-70.1627,647205,0,4384,642821
10/17/22,Dominican Republic,18.7357,-70.1627,647205,0,4384,642821
10/18/22,Dominican Republic,18.7357,-70.1627,647205,0,4384,642821
10/19/22,Dominican Republic,18.7357,-70.1627,647205,0,4384,642821
10/20/22,Dominican Republic,18.7357,-70.1627,647205,0,4384,642821
10/21/22,Dominican Republic,18.7357,-70.1627,647205,0,4384,642821
10/22/22,Dominican Republic,18.7357,-70.1627,647205,0,4384,642821
10/23/22,Dominican Republic,18.7357,-70.1627,647205,0,4384,642821
10/24/22,Dominican Republic,18.7357,-70.1627,647205,0,4384,642821
10/25/22,Dominican Republic,18.7357,-70.1627,647205,0,4384,642821
10/26/22,Dominican Republic,18.7357,-70.1627,647205,0,4384,642821
10/27/22,Dominican Republic,18.7357,-70.1627,647205,0,4384,642821
10/28/22,Dominican Republic,18.7357,-70.1627,647205,0,4384,642821
10/29/22,Dominican Republic,18.7357,-70.1627,647205,0,4384,642821
10/30/22,Dominican Republic,18.7357,-70.1627,647205,0,4384,642821
10/31/22,Dominican Republic,18.7357,-70.1627,647272,0,4384,642888
11/1/22,Dominican Republic,18.7357,-70.1627,647425,0,4384,643041
11/2/22,Dominican Republic,18.7357,-70.1627,647425,0,4384,643041
11/3/22,Dominican Republic,18.7357,-70.1627,647425,0,4384,643041
11/4/22,Dominican Republic,18.7357,-70.1627,647425,0,4384,643041
11/5/22,Dominican Republic,18.7357,-70.1627,647425,0,4384,643041
11/6/22,Dominican Republic,18.7357,-70.1627,647425,0,4384,643041
11/7/22,Dominican Republic,18.7357,-70.1627,647425,0,4384,643041
11/8/22,Dominican Republic,18.7357,-70.1627,647653,0,4384,643269
11/9/22,Dominican Republic,18.7357,-70.1627,647653,0,4384,643269
11/10/22,Dominican Republic,18.7357,-70.1627,647717,0,4384,643333
11/11/22,Dominican Republic,18.7357,-70.1627,647717,0,4384,643333
11/12/22,Dominican Republic,18.7357,-70.1627,647717,0,4384,643333
11/13/22,Dominican Republic,18.7357,-70.1627,647717,0,4384,643333
11/14/22,Dominican Republic,18.7357,-70.1627,647868,0,4384,643484
11/15/22,Dominican Republic,18.7357,-70.1627,647868,0,4384,643484
11/16/22,Dominican Republic,18.7357,-70.1627,647868,0,4384,643484
11/17/22,Dominican Republic,18.7357,-70.1627,647868,0,4384,643484
11/18/22,Dominican Republic,18.7357,-70.1627,647868,0,4384,643484
11/19/22,Dominican Republic,18.7357,-70.1627,647868,0,4384,643484
11/20/22,Dominican Republic,18.7357,-70.1627,647868,0,4384,643484
11/21/22,Dominican Republic,18.7357,-70.1627,648216,0,4384,643832
11/22/22,Dominican Republic,18.7357,-70.1627,648456,0,4384,644072
11/23/22,Dominican Republic,18.7357,-70.1627,648456,0,4384,644072
11/24/22,Dominican Republic,18.7357,-70.1627,648456,0,4384,644072
11/25/22,Dominican Republic,18.7357,-70.1627,649150,0,4384,644766
11/26/22,Dominican Republic,18.7357,-70.1627,649150,0,4384,644766
11/27/22,Dominican Republic,18.7357,-70.1627,649834,0,4384,645450
11/28/22,Dominican Republic,18.7357,-70.1627,649834,0,4384,645450
11/29/22,Dominican Republic,18.7357,-70.1627,650381,0,4384,645997
11/30/22,Dominican Republic,18.7357,-70.1627,650381,0,4384,645997
12/1/22,Dominican Republic,18.7357,-70.1627,650381,0,4384,645997
12/2/22,Dominican Republic,18.7357,-70.1627,650381,0,4384,645997
12/3/22,Dominican Republic,18.7357,-70.1627,650990,0,4384,646606
12/4/22,Dominican Republic,18.7357,-70.1627,650990,0,4384,646606
12/5/22,Dominican Republic,18.7357,-70.1627,650990,0,4384,646606
12/6/22,Dominican Republic,18.7357,-70.1627,650990,0,4384,646606
12/7/22,Dominican Republic,18.7357,-70.1627,650990,0,4384,646606
12/8/22,Dominican Republic,18.7357,-70.1627,650990,0,4384,646606
12/9/22,Dominican Republic,18.7357,-70.1627,650990,0,4384,646606
12/10/22,Dominican Republic,18.7357,-70.1627,650990,0,4384,646606
12/11/22,Dominican Republic,18.7357,-70.1627,650990,0,4384,646606
12/12/22,Dominican Republic,18.7357,-70.1627,650990,0,4384,646606
12/13/22,Dominican Republic,18.7357,-70.1627,652925,0,4384,648541
12/14/22,Dominican Republic,18.7357,-70.1627,654759,0,4384,650375
12/15/22,Dominican Republic,18.7357,-70.1627,654759,0,4384,650375
12/16/22,Dominican Republic,18.7357,-70.1627,655540,0,4384,651156
12/17/22,Dominican Republic,18.7357,-70.1627,655540,0,4384,651156
1/1/22,Ecuador,-1.8312,-78.1834,551620,0,33682,517938
1/2/22,Ecuador,-1.8312,-78.1834,552324,0,33683,518641
1/3/22,Ecuador,-1.8312,-78.1834,553201,0,33686,519515
1/4/22,Ecuador,-1.8312,-78.1834,554436,0,33690,520746
1/5/22,Ecuador,-1.8312,-78.1834,557273,0,33699,523574
1/6/22,Ecuador,-1.8312,-78.1834,559950,0,33699,526251
1/7/22,Ecuador,-1.8312,-78.1834,561285,0,33702,527583
1/8/22,Ecuador,-1.8312,-78.1834,564238,0,33706,530532
1/9/22,Ecuador,-1.8312,-78.1834,567332,0,33709,533623
1/10/22,Ecuador,-1.8312,-78.1834,569184,0,33713,535471
1/11/22,Ecuador,-1.8312,-78.1834,578525,0,34122,544403
1/12/22,Ecuador,-1.8312,-78.1834,588871,0,34162,554709
1/13/22,Ecuador,-1.8312,-78.1834,593664,0,34189,559475
1/14/22,Ecuador,-1.8312,-78.1834,602942,0,34206,568736
1/15/22,Ecuador,-1.8312,-78.1834,614032,0,34219,579813
1/16/22,Ecuador,-1.8312,-78.1834,625059,0,34227,590832
1/17/22,Ecuador,-1.8312,-78.1834,629507,0,34232,595275
1/18/22,Ecuador,-1.8312,-78.1834,639135,0,34237,604898
1/19/22,Ecuador,-1.8312,-78.1834,649557,0,34247,615310
1/20/22,Ecuador,-1.8312,-78.1834,658045,0,34279,623766
1/21/22,Ecuador,-1.8312,-78.1834,664664,0,34287,630377
1/22/22,Ecuador,-1.8312,-78.1834,674963,0,34315,640648
1/23/22,Ecuador,-1.8312,-78.1834,681382,0,34329,647053
1/24/22,Ecuador,-1.8312,-78.1834,684068,0,34338,649730
1/25/22,Ecuador,-1.8312,-78.1834,691898,0,34362,657536
1/26/22,Ecuador,-1.8312,-78.1834,697609,0,34420,663189
1/27/22,Ecuador,-1.8312,-78.1834,707224,0,34442,672782
1/28/22,Ecuador,-1.8312,-78.1834,717085,0,34489,682596
1/29/22,Ecuador,-1.8312,-78.1834,725936,0,34513,691423
1/30/22,Ecuador,-1.8312,-78.1834,729760,0,34514,695246
1/31/22,Ecuador,-1.8312,-78.1834,732038,0,34533,697505
2/1/22,Ecuador,-1.8312,-78.1834,739297,0,34572,704725
2/2/22,Ecuador,-1.8312,-78.1834,745819,0,34639,711180
2/3/22,Ecuador,-1.8312,-78.1834,752635,0,34676,717959
2/4/22,Ecuador,-1.8312,-78.1834,761321,0,34716,726605
2/5/22,Ecuador,-1.8312,-78.1834,766398,0,34730,731668
2/6/22,Ecuador,-1.8312,-78.1834,769149,0,34739,734410
2/7/22,Ecuador,-1.8312,-78.1834,769149,0,34739,734410
2/8/22,Ecuador,-1.8312,-78.1834,769149,0,34739,734410
2/9/22,Ecuador,-1.8312,-78.1834,769149,0,34739,734410
2/10/22,Ecuador,-1.8312,-78.1834,781470,0,34854,746616
2/11/22,Ecuador,-1.8312,-78.1834,781470,0,34854,746616
2/12/22,Ecuador,-1.8312,-78.1834,781470,0,34854,746616
2/13/22,Ecuador,-1.8312,-78.1834,781470,0,34854,746616
2/14/22,Ecuador,-1.8312,-78.1834,799140,0,35036,764104
2/15/22,Ecuador,-1.8312,-78.1834,800320,0,35038,765282
2/16/22,Ecuador,-1.8312,-78.1834,800320,0,35038,765282
2/17/22,Ecuador,-1.8312,-78.1834,808925,0,35105,773820
2/18/22,Ecuador,-1.8312,-78.1834,808925,0,35105,773820
2/19/22,Ecuador,-1.8312,-78.1834,808925,0,35105,773820
2/20/22,Ecuador,-1.8312,-78.1834,808925,0,35105,773820
2/21/22,Ecuador,-1.8312,-78.1834,819886,0,35160,784726
2/22/22,Ecuador,-1.8312,-78.1834,820541,0,35172,785369
2/23/22,Ecuador,-1.8312,-78.1834,820541,0,35172,785369
2/24/22,Ecuador,-1.8312,-78.1834,827760,0,35223,792537
2/25/22,Ecuador,-1.8312,-78.1834,827760,0,35223,792537
2/26/22,Ecuador,-1.8312,-78.1834,827760,0,35223,792537
2/27/22,Ecuador,-1.8312,-78.1834,827760,0,35223,792537
2/28/22,Ecuador,-1.8312,-78.1834,827760,0,35223,792537
3/1/22,Ecuador,-1.8312,-78.1834,827760,0,35223,792537
3/2/22,Ecuador,-1.8312,-78.1834,833291,0,35249,798042
3/3/22,Ecuador,-1.8312,-78.1834,836216,0,35264,800952
3/4/22,Ecuador,-1.8312,-78.1834,836216,0,35264,800952
3/5/22,Ecuador,-1.8312,-78.1834,836216,0,35264,800952
3/6/22,Ecuador,-1.8312,-78.1834,836216,0,35264,800952
3/7/22,Ecuador,-1.8312,-78.1834,841575,0,35309,806266
3/8/22,Ecuador,-1.8312,-78.1834,841575,0,35309,806266
3/9/22,Ecuador,-1.8312,-78.1834,843760,0,35316,808444
3/10/22,Ecuador,-1.8312,-78.1834,843760,0,35316,808444
3/11/22,Ecuador,-1.8312,-78.1834,843760,0,35316,808444
3/12/22,Ecuador,-1.8312,-78.1834,843760,0,35316,808444
3/13/22,Ecuador,-1.8312,-78.1834,843760,0,35316,808444
3/14/22,Ecuador,-1.8312,-78.1834,849386,0,35347,814039
3/15/22,Ecuador,-1.8312,-78.1834,849699,0,35348,814351
3/16/22,Ecuador,-1.8312,-78.1834,849699,0,35348,814351
3/17/22,Ecuador,-1.8312,-78.1834,849699,0,35348,814351
3/18/22,Ecuador,-1.8312,-78.1834,849699,0,35348,814351
3/19/22,Ecuador,-1.8312,-78.1834,849699,0,35348,814351
3/20/22,Ecuador,-1.8312,-78.1834,853850,0,35410,818440
3/21/22,Ecuador,-1.8312,-78.1834,854252,0,35410,818842
3/22/22,Ecuador,-1.8312,-78.1834,854252,0,35410,818842
3/23/22,Ecuador,-1.8312,-78.1834,854252,0,35410,818842
3/24/22,Ecuador,-1.8312,-78.1834,855314,0,35413,819901
3/25/22,Ecuador,-1.8312,-78.1834,857299,0,35418,821881
3/26/22,Ecuador,-1.8312,-78.1834,857299,0,35418,821881
3/27/22,Ecuador,-1.8312,-78.1834,857299,0,35418,821881
3/28/22,Ecuador,-1.8312,-78.1834,857299,0,35418,821881
3/29/22,Ecuador,-1.8312,-78.1834,859207,0,35421,823786
3/30/22,Ecuador,-1.8312,-78.1834,859890,0,35421,824469
3/31/22,Ecuador,-1.8312,-78.1834,859890,0,35421,824469
4/1/22,Ecuador,-1.8312,-78.1834,859890,0,35421,824469
4/2/22,Ecuador,-1.8312,-78.1834,859890,0,35421,824469
4/3/22,Ecuador,-1.8312,-78.1834,859890,0,35421,824469
4/4/22,Ecuador,-1.8312,-78.1834,862321,0,35449,826872
4/5/22,Ecuador,-1.8312,-78.1834,862321,0,35449,826872
4/6/22,Ecuador,-1.8312,-78.1834,862321,0,35449,826872
4/7/22,Ecuador,-1.8312,-78.1834,863398,0,35461,827937
4/8/22,Ecuador,-1.8312,-78.1834,863398,0,35461,827937
4/9/22,Ecuador,-1.8312,-78.1834,863398,0,35461,827937
4/10/22,Ecuador,-1.8312,-78.1834,863398,0,35461,827937
4/11/22,Ecuador,-1.8312,-78.1834,865263,0,35508,829755
4/12/22,Ecuador,-1.8312,-78.1834,865263,0,35508,829755
4/13/22,Ecuador,-1.8312,-78.1834,865585,0,35513,830072
4/14/22,Ecuador,-1.8312,-78.1834,865585,0,35513,830072
4/15/22,Ecuador,-1.8312,-78.1834,865585,0,35513,830072
4/16/22,Ecuador,-1.8312,-78.1834,865585,0,35513,830072
4/17/22,Ecuador,-1.8312,-78.1834,865585,0,35513,830072
4/18/22,Ecuador,-1.8312,-78.1834,866884,0,35528,831356
4/19/22,Ecuador,-1.8312,-78.1834,866925,0,35528,831397
4/20/22,Ecuador,-1.8312,-78.1834,866925,0,35528,831397
4/21/22,Ecuador,-1.8312,-78.1834,867170,0,35543,831627
4/22/22,Ecuador,-1.8312,-78.1834,867170,0,35543,831627
4/23/22,Ecuador,-1.8312,-78.1834,868053,0,35581,832472
4/24/22,Ecuador,-1.8312,-78.1834,868053,0,35581,832472
4/25/22,Ecuador,-1.8312,-78.1834,868285,0,35581,832704
4/26/22,Ecuador,-1.8312,-78.1834,868285,0,35581,832704
4/27/22,Ecuador,-1.8312,-78.1834,868285,0,35581,832704
4/28/22,Ecuador,-1.8312,-78.1834,869124,0,35588,833536
4/29/22,Ecuador,-1.8312,-78.1834,869124,0,35588,833536
4/30/22,Ecuador,-1.8312,-78.1834,869696,0,35598,834098
5/1/22,Ecuador,-1.8312,-78.1834,869696,0,35598,834098
5/2/22,Ecuador,-1.8312,-78.1834,869696,0,35598,834098
5/3/22,Ecuador,-1.8312,-78.1834,869696,0,35598,834098
5/4/22,Ecuador,-1.8312,-78.1834,869956,0,35598,834358
5/5/22,Ecuador,-1.8312,-78.1834,870526,0,35598,834928
5/6/22,Ecuador,-1.8312,-78.1834,870526,0,35598,834928
5/7/22,Ecuador,-1.8312,-78.1834,870526,0,35598,834928
5/8/22,Ecuador,-1.8312,-78.1834,870526,0,35598,834928
5/9/22,Ecuador,-1.8312,-78.1834,871029,0,35602,835427
5/10/22,Ecuador,-1.8312,-78.1834,871046,0,35602,835444
5/11/22,Ecuador,-1.8312,-78.1834,871046,0,35602,835444
5/12/22,Ecuador,-1.8312,-78.1834,871046,0,35602,835444
5/13/22,Ecuador,-1.8312,-78.1834,872268,0,35607,836661
5/14/22,Ecuador,-1.8312,-78.1834,872268,0,35607,836661
5/15/22,Ecuador,-1.8312,-78.1834,872268,0,35607,836661
5/16/22,Ecuador,-1.8312,-78.1834,872542,0,35610,836932
5/17/22,Ecuador,-1.8312,-78.1834,872542,0,35610,836932
5/18/22,Ecuador,-1.8312,-78.1834,872542,0,35610,836932
5/19/22,Ecuador,-1.8312,-78.1834,873609,0,35613,837996
5/20/22,Ecuador,-1.8312,-78.1834,873609,0,35613,837996
5/21/22,Ecuador,-1.8312,-78.1834,873609,0,35613,837996
5/22/22,Ecuador,-1.8312,-78.1834,874599,0,35617,838982
5/23/22,Ecuador,-1.8312,-78.1834,874719,0,35617,839102
5/24/22,Ecuador,-1.8312,-78.1834,874750,0,35617,839133
5/25/22,Ecuador,-1.8312,-78.1834,874750,0,35617,839133
5/26/22,Ecuador,-1.8312,-78.1834,876009,0,35622,840387
5/27/22,Ecuador,-1.8312,-78.1834,876009,0,35622,840387
5/28/22,Ecuador,-1.8312,-78.1834,876665,0,35624,841041
5/29/22,Ecuador,-1.8312,-78.1834,876665,0,35624,841041
5/30/22,Ecuador,-1.8312,-78.1834,877282,0,35637,841645
5/31/22,Ecuador,-1.8312,-78.1834,877282,0,35637,841645
6/1/22,Ecuador,-1.8312,-78.1834,878196,0,35645,842551
6/2/22,Ecuador,-1.8312,-78.1834,878196,0,35645,842551
6/3/22,Ecuador,-1.8312,-78.1834,878196,0,35645,842551
6/4/22,Ecuador,-1.8312,-78.1834,878196,0,35645,842551
6/5/22,Ecuador,-1.8312,-78.1834,878196,0,35645,842551
6/6/22,Ecuador,-1.8312,-78.1834,885318,0,35649,849669
6/7/22,Ecuador,-1.8312,-78.1834,885318,0,35649,849669
6/8/22,Ecuador,-1.8312,-78.1834,886223,0,35649,850574
6/9/22,Ecuador,-1.8312,-78.1834,887478,0,35652,851826
6/10/22,Ecuador,-1.8312,-78.1834,887478,0,35652,851826
6/11/22,Ecuador,-1.8312,-78.1834,887478,0,35652,851826
6/12/22,Ecuador,-1.8312,-78.1834,887478,0,35652,851826
6/13/22,Ecuador,-1.8312,-78.1834,890852,0,35659,855193
6/14/22,Ecuador,-1.8312,-78.1834,890852,0,35659,855193
6/15/22,Ecuador,-1.8312,-78.1834,892176,0,35662,856514
6/16/22,Ecuador,-1.8312,-78.1834,892176,0,35662,856514
6/17/22,Ecuador,-1.8312,-78.1834,896483,0,35693,860790
6/18/22,Ecuador,-1.8312,-78.1834,896483,0,35693,860790
6/19/22,Ecuador,-1.8312,-78.1834,896483,0,35693,860790
6/20/22,Ecuador,-1.8312,-78.1834,896483,0,35693,860790
6/21/22,Ecuador,-1.8312,-78.1834,898667,0,35695,862972
6/22/22,Ecuador,-1.8312,-78.1834,898667,0,35695,862972
6/23/22,Ecuador,-1.8312,-78.1834,898667,0,35695,862972
6/24/22,Ecuador,-1.8312,-78.1834,898667,0,35695,862972
6/25/22,Ecuador,-1.8312,-78.1834,901739,0,35705,866034
6/26/22,Ecuador,-1.8312,-78.1834,901739,0,35705,866034
6/27/22,Ecuador,-1.8312,-78.1834,901739,0,35705,866034
6/28/22,Ecuador,-1.8312,-78.1834,901739,0,35705,866034
6/29/22,Ecuador,-1.8312,-78.1834,909882,0,35725,874157
6/30/22,Ecuador,-1.8312,-78.1834,909882,0,35725,874157
7/1/22,Ecuador,-1.8312,-78.1834,909882,0,35725,874157
7/2/22,Ecuador,-1.8312,-78.1834,909882,0,35725,874157
7/3/22,Ecuador,-1.8312,-78.1834,909882,0,35725,874157
7/4/22,Ecuador,-1.8312,-78.1834,913798,0,35745,878053
7/5/22,Ecuador,-1.8312,-78.1834,915679,0,35747,879932
7/6/22,Ecuador,-1.8312,-78.1834,915679,0,35747,879932
7/7/22,Ecuador,-1.8312,-78.1834,915679,0,35747,879932
7/8/22,Ecuador,-1.8312,-78.1834,918479,0,35749,882730
7/9/22,Ecuador,-1.8312,-78.1834,918479,0,35749,882730
7/10/22,Ecuador,-1.8312,-78.1834,918479,0,35749,882730
7/11/22,Ecuador,-1.8312,-78.1834,922166,0,35755,886411
7/12/22,Ecuador,-1.8312,-78.1834,922398,0,35755,886643
7/13/22,Ecuador,-1.8312,-78.1834,927700,0,35769,891931
7/14/22,Ecuador,-1.8312,-78.1834,927700,0,35769,891931
7/15/22,Ecuador,-1.8312,-78.1834,927700,0,35769,891931
7/16/22,Ecuador,-1.8312,-78.1834,927700,0,35769,891931
7/17/22,Ecuador,-1.8312,-78.1834,927700,0,35769,891931
7/18/22,Ecuador,-1.8312,-78.1834,935211,0,35774,899437
7/19/22,Ecuador,-1.8312,-78.1834,936227,0,35774,900453
7/20/22,Ecuador,-1.8312,-78.1834,940179,0,35781,904398
7/21/22,Ecuador,-1.8312,-78.1834,946487,0,35786,910701
7/22/22,Ecuador,-1.8312,-78.1834,946487,0,35786,910701
7/23/22,Ecuador,-1.8312,-78.1834,946487,0,35786,910701
7/24/22,Ecuador,-1.8312,-78.1834,946487,0,35786,910701
7/25/22,Ecuador,-1.8312,-78.1834,955583,0,35793,919790
7/26/22,Ecuador,-1.8312,-78.1834,955583,0,35793,919790
7/27/22,Ecuador,-1.8312,-78.1834,955583,0,35793,919790
7/28/22,Ecuador,-1.8312,-78.1834,961345,0,35801,925544
7/29/22,Ecuador,-1.8312,-78.1834,961345,0,35801,925544
7/30/22,Ecuador,-1.8312,-78.1834,961345,0,35801,925544
7/31/22,Ecuador,-1.8312,-78.1834,961345,0,35801,925544
8/1/22,Ecuador,-1.8312,-78.1834,961345,0,35801,925544
8/2/22,Ecuador,-1.8312,-78.1834,963668,0,35801,927867
8/3/22,Ecuador,-1.8312,-78.1834,973870,0,35810,938060
8/4/22,Ecuador,-1.8312,-78.1834,975234,0,35811,939423
8/5/22,Ecuador,-1.8312,-78.1834,975234,0,35811,939423
8/6/22,Ecuador,-1.8312,-78.1834,975234,0,35811,939423
8/7/22,Ecuador,-1.8312,-78.1834,975234,0,35811,939423
8/8/22,Ecuador,-1.8312,-78.1834,975234,0,35811,939423
8/9/22,Ecuador,-1.8312,-78.1834,975234,0,35811,939423
8/10/22,Ecuador,-1.8312,-78.1834,975234,0,35811,939423
8/11/22,Ecuador,-1.8312,-78.1834,975234,0,35811,939423
8/12/22,Ecuador,-1.8312,-78.1834,975234,0,35811,939423
8/13/22,Ecuador,-1.8312,-78.1834,975234,0,35811,939423
8/14/22,Ecuador,-1.8312,-78.1834,975234,0,35811,939423
8/15/22,Ecuador,-1.8312,-78.1834,975234,0,35811,939423
8/16/22,Ecuador,-1.8312,-78.1834,983615,0,35811,947804
8/17/22,Ecuador,-1.8312,-78.1834,983615,0,35811,947804
8/18/22,Ecuador,-1.8312,-78.1834,986502,0,35811,950691
8/19/22,Ecuador,-1.8312,-78.1834,988583,0,35812,952771
8/20/22,Ecuador,-1.8312,-78.1834,988583,0,35812,952771
8/21/22,Ecuador,-1.8312,-78.1834,988583,0,35812,952771
8/22/22,Ecuador,-1.8312,-78.1834,990405,0,35815,954590
8/23/22,Ecuador,-1.8312,-78.1834,990405,0,35815,954590
8/24/22,Ecuador,-1.8312,-78.1834,992838,0,35824,957014
8/25/22,Ecuador,-1.8312,-78.1834,992838,0,35824,957014
8/26/22,Ecuador,-1.8312,-78.1834,993858,0,35830,958028
8/27/22,Ecuador,-1.8312,-78.1834,993858,0,35830,958028
8/28/22,Ecuador,-1.8312,-78.1834,993858,0,35830,958028
8/29/22,Ecuador,-1.8312,-78.1834,995147,0,35832,959315
8/30/22,Ecuador,-1.8312,-78.1834,995147,0,35832,959315
8/31/22,Ecuador,-1.8312,-78.1834,995968,0,35843,960125
9/1/22,Ecuador,-1.8312,-78.1834,995968,0,35843,960125
9/2/22,Ecuador,-1.8312,-78.1834,997224,0,35861,961363
9/3/22,Ecuador,-1.8312,-78.1834,997224,0,35861,961363
9/4/22,Ecuador,-1.8312,-78.1834,997224,0,35861,961363
9/5/22,Ecuador,-1.8312,-78.1834,997540,0,35862,961678
9/6/22,Ecuador,-1.8312,-78.1834,997791,0,35873,961918
9/7/22,Ecuador,-1.8312,-78.1834,997791,0,35873,961918
9/8/22,Ecuador,-1.8312,-78.1834,997791,0,35873,961918
9/9/22,Ecuador,-1.8312,-78.1834,998202,0,35876,962326
9/10/22,Ecuador,-1.8312,-78.1834,998202,0,35876,962326
9/11/22,Ecuador,-1.8312,-78.1834,998202,0,35876,962326
9/12/22,Ecuador,-1.8312,-78.1834,998202,0,35876,962326
9/13/22,Ecuador,-1.8312,-78.1834,998202,0,35876,962326
9/14/22,Ecuador,-1.8312,-78.1834,1000214,0,35885,964329
9/15/22,Ecuador,-1.8312,-78.1834,1000214,0,35885,964329
9/16/22,Ecuador,-1.8312,-78.1834,1000214,0,35885,964329
9/17/22,Ecuador,-1.8312,-78.1834,1000214,0,35885,964329
9/18/22,Ecuador,-1.8312,-78.1834,1000214,0,35885,964329
9/19/22,Ecuador,-1.8312,-78.1834,1000214,0,35885,964329
9/20/22,Ecuador,-1.8312,-78.1834,1002057,0,35887,966170
9/21/22,Ecuador,-1.8312,-78.1834,1002057,0,35887,966170
9/22/22,Ecuador,-1.8312,-78.1834,1002057,0,35887,966170
9/23/22,Ecuador,-1.8312,-78.1834,1002057,0,35887,966170
9/24/22,Ecuador,-1.8312,-78.1834,1002057,0,35887,966170
9/25/22,Ecuador,-1.8312,-78.1834,1002057,0,35887,966170
9/26/22,Ecuador,-1.8312,-78.1834,1002057,0,35887,966170
9/27/22,Ecuador,-1.8312,-78.1834,1003778,0,35894,967884
9/28/22,Ecuador,-1.8312,-78.1834,1003778,0,35894,967884
9/29/22,Ecuador,-1.8312,-78.1834,1003778,0,35894,967884
9/30/22,Ecuador,-1.8312,-78.1834,1003778,0,35894,967884
10/1/22,Ecuador,-1.8312,-78.1834,1005521,0,35899,969622
10/2/22,Ecuador,-1.8312,-78.1834,1005521,0,35899,969622
10/3/22,Ecuador,-1.8312,-78.1834,1005521,0,35899,969622
10/4/22,Ecuador,-1.8312,-78.1834,1005521,0,35899,969622
10/5/22,Ecuador,-1.8312,-78.1834,1006070,0,35900,970170
10/6/22,Ecuador,-1.8312,-78.1834,1006070,0,35900,970170
10/7/22,Ecuador,-1.8312,-78.1834,1006070,0,35900,970170
10/8/22,Ecuador,-1.8312,-78.1834,1006070,0,35900,970170
10/9/22,Ecuador,-1.8312,-78.1834,1006070,0,35900,970170
10/10/22,Ecuador,-1.8312,-78.1834,1006070,0,35900,970170
10/11/22,Ecuador,-1.8312,-78.1834,1006070,0,35900,970170
10/12/22,Ecuador,-1.8312,-78.1834,1006070,0,35900,970170
10/13/22,Ecuador,-1.8312,-78.1834,1006922,0,35904,971018
10/14/22,Ecuador,-1.8312,-78.1834,1006922,0,35904,971018
10/15/22,Ecuador,-1.8312,-78.1834,1006922,0,35904,971018
10/16/22,Ecuador,-1.8312,-78.1834,1006922,0,35904,971018
10/17/22,Ecuador,-1.8312,-78.1834,1006922,0,35904,971018
10/18/22,Ecuador,-1.8312,-78.1834,1006922,0,35904,971018
10/19/22,Ecuador,-1.8312,-78.1834,1006922,0,35904,971018
10/20/22,Ecuador,-1.8312,-78.1834,1006922,0,35904,971018
10/21/22,Ecuador,-1.8312,-78.1834,1007553,0,35908,971645
10/22/22,Ecuador,-1.8312,-78.1834,1007553,0,35908,971645
10/23/22,Ecuador,-1.8312,-78.1834,1007553,0,35908,971645
10/24/22,Ecuador,-1.8312,-78.1834,1007553,0,35908,971645
10/25/22,Ecuador,-1.8312,-78.1834,1007553,0,35908,971645
10/26/22,Ecuador,-1.8312,-78.1834,1007553,0,35908,971645
10/27/22,Ecuador,-1.8312,-78.1834,1008035,0,35920,972115
10/28/22,Ecuador,-1.8312,-78.1834,1008035,0,35920,972115
10/29/22,Ecuador,-1.8312,-78.1834,1008035,0,35920,972115
10/30/22,Ecuador,-1.8312,-78.1834,1008035,0,35920,972115
10/31/22,Ecuador,-1.8312,-78.1834,1008035,0,35920,972115
11/1/22,Ecuador,-1.8312,-78.1834,1008035,0,35920,972115
11/2/22,Ecuador,-1.8312,-78.1834,1008035,0,35920,972115
11/3/22,Ecuador,-1.8312,-78.1834,1008035,0,35920,972115
11/4/22,Ecuador,-1.8312,-78.1834,1009044,0,35934,973110
11/5/22,Ecuador,-1.8312,-78.1834,1009044,0,35934,973110
11/6/22,Ecuador,-1.8312,-78.1834,1009044,0,35934,973110
11/7/22,Ecuador,-1.8312,-78.1834,1009044,0,35934,973110
11/8/22,Ecuador,-1.8312,-78.1834,1009044,0,35934,973110
11/9/22,Ecuador,-1.8312,-78.1834,1009388,0,35935,973453
11/10/22,Ecuador,-1.8312,-78.1834,1009388,0,35935,973453
11/11/22,Ecuador,-1.8312,-78.1834,1009388,0,35935,973453
11/12/22,Ecuador,-1.8312,-78.1834,1009388,0,35935,973453
11/13/22,Ecuador,-1.8312,-78.1834,1009388,0,35935,973453
11/14/22,Ecuador,-1.8312,-78.1834,1009388,0,35935,973453
11/15/22,Ecuador,-1.8312,-78.1834,1009388,0,35935,973453
11/16/22,Ecuador,-1.8312,-78.1834,1009388,0,35935,973453
11/17/22,Ecuador,-1.8312,-78.1834,1009388,0,35935,973453
11/18/22,Ecuador,-1.8312,-78.1834,1009388,0,35935,973453
11/19/22,Ecuador,-1.8312,-78.1834,1009388,0,35935,973453
11/20/22,Ecuador,-1.8312,-78.1834,1009388,0,35935,973453
11/21/22,Ecuador,-1.8312,-78.1834,1009388,0,35935,973453
11/22/22,Ecuador,-1.8312,-78.1834,1009958,0,35940,974018
11/23/22,Ecuador,-1.8312,-78.1834,1009958,0,35940,974018
11/24/22,Ecuador,-1.8312,-78.1834,1009958,0,35940,974018
11/25/22,Ecuador,-1.8312,-78.1834,1009958,0,35940,974018
11/26/22,Ecuador,-1.8312,-78.1834,1009958,0,35940,974018
11/27/22,Ecuador,-1.8312,-78.1834,1009958,0,35940,974018
11/28/22,Ecuador,-1.8312,-78.1834,1011132,0,35940,975192
11/29/22,Ecuador,-1.8312,-78.1834,1011132,0,35940,975192
11/30/22,Ecuador,-1.8312,-78.1834,1011132,0,35940,975192
12/1/22,Ecuador,-1.8312,-78.1834,1011132,0,35940,975192
12/2/22,Ecuador,-1.8312,-78.1834,1011132,0,35940,975192
12/3/22,Ecuador,-1.8312,-78.1834,1011132,0,35940,975192
12/4/22,Ecuador,-1.8312,-78.1834,1011132,0,35940,975192
12/5/22,Ecuador,-1.8312,-78.1834,1011132,0,35940,975192
12/6/22,Ecuador,-1.8312,-78.1834,1013912,0,35940,977972
12/7/22,Ecuador,-1.8312,-78.1834,1013912,0,35940,977972
12/8/22,Ecuador,-1.8312,-78.1834,1018179,0,35940,982239
12/9/22,Ecuador,-1.8312,-78.1834,1018179,0,35940,982239
12/10/22,Ecuador,-1.8312,-78.1834,1018179,0,35940,982239
12/11/22,Ecuador,-1.8312,-78.1834,1018179,0,35940,982239
12/12/22,Ecuador,-1.8312,-78.1834,1018179,0,35940,982239
12/13/22,Ecuador,-1.8312,-78.1834,1024914,0,35940,988974
12/14/22,Ecuador,-1.8312,-78.1834,1024914,0,35940,988974
12/15/22,Ecuador,-1.8312,-78.1834,1024914,0,35940,988974
12/16/22,Ecuador,-1.8312,-78.1834,1024914,0,35940,988974
12/17/22,Ecuador,-1.8312,-78.1834,1024914,0,35940,988974
1/1/22,Egypt,26.820553,30.802498,386358,0,21768,364590
1/2/22,Egypt,26.820553,30.802498,387159,0,21797,365362
1/3/22,Egypt,26.820553,30.802498,387882,0,21817,366065
1/4/22,Egypt,26.820553,30.802498,388651,0,21836,366815
1/5/22,Egypt,26.820553,30.802498,389454,0,21863,367591
1/6/22,Egypt,26.820553,30.802498,390294,0,21882,368412
1/7/22,Egypt,26.820553,30.802498,391115,0,21909,369206
1/8/22,Egypt,26.820553,30.802498,391945,0,21938,370007
1/9/22,Egypt,26.820553,30.802498,392857,0,21964,370893
1/10/22,Egypt,26.820553,30.802498,393808,0,21995,371813
1/11/22,Egypt,26.820553,30.802498,394740,0,22014,372726
1/12/22,Egypt,26.820553,30.802498,395688,0,22042,373646
1/13/22,Egypt,26.820553,30.802498,396699,0,22063,374636
1/14/22,Egypt,26.820553,30.802498,397778,0,22097,375681
1/15/22,Egypt,26.820553,30.802498,398879,0,22123,376756
1/16/22,Egypt,26.820553,30.802498,400076,0,22148,377928
1/17/22,Egypt,26.820553,30.802498,401308,0,22179,379129
1/18/22,Egypt,26.820553,30.802498,402611,0,22205,380406
1/19/22,Egypt,26.820553,30.802498,403990,0,22238,381752
1/20/22,Egypt,26.820553,30.802498,405393,0,22260,383133
1/21/22,Egypt,26.820553,30.802498,406926,0,22289,384637
1/22/22,Egypt,26.820553,30.802498,408495,0,22330,386165
1/23/22,Egypt,26.820553,30.802498,410098,0,22368,387730
1/24/22,Egypt,26.820553,30.802498,411749,0,22396,389353
1/25/22,Egypt,26.820553,30.802498,413558,0,22431,391127
1/26/22,Egypt,26.820553,30.802498,415468,0,22460,393008
1/27/22,Egypt,26.820553,30.802498,417453,0,22496,394957
1/28/22,Egypt,26.820553,30.802498,419460,0,22522,396938
1/29/22,Egypt,26.820553,30.802498,421478,0,22566,398912
1/30/22,Egypt,26.820553,30.802498,423688,0,22604,401084
1/31/22,Egypt,26.820553,30.802498,425911,0,22635,403276
2/1/22,Egypt,26.820553,30.802498,428202,0,22683,405519
2/2/22,Egypt,26.820553,30.802498,430480,0,22735,407745
2/3/22,Egypt,26.820553,30.802498,432761,0,22780,409981
2/4/22,Egypt,26.820553,30.802498,435052,0,22819,412233
2/5/22,Egypt,26.820553,30.802498,437350,0,22877,414473
2/6/22,Egypt,26.820553,30.802498,439651,0,22936,416715
2/7/22,Egypt,26.820553,30.802498,441923,0,22993,418930
2/8/22,Egypt,26.820553,30.802498,444117,0,23053,421064
2/9/22,Egypt,26.820553,30.802498,446308,0,23110,423198
2/10/22,Egypt,26.820553,30.802498,448497,0,23172,425325
2/11/22,Egypt,26.820553,30.802498,450676,0,23233,427443
2/12/22,Egypt,26.820553,30.802498,452821,0,23292,429529
2/13/22,Egypt,26.820553,30.802498,452821,0,23292,429529
2/14/22,Egypt,26.820553,30.802498,457081,0,23409,433672
2/15/22,Egypt,26.820553,30.802498,459198,0,23465,435733
2/16/22,Egypt,26.820553,30.802498,461299,0,23519,437780
2/17/22,Egypt,26.820553,30.802498,463370,0,23580,439790
2/18/22,Egypt,26.820553,30.802498,465423,0,23632,441791
2/19/22,Egypt,26.820553,30.802498,467448,0,23694,443754
2/20/22,Egypt,26.820553,30.802498,469457,0,23752,445705
2/21/22,Egypt,26.820553,30.802498,471460,0,23806,447654
2/22/22,Egypt,26.820553,30.802498,473449,0,23857,449592
2/23/22,Egypt,26.820553,30.802498,475341,0,23889,451452
2/24/22,Egypt,26.820553,30.802498,477173,0,23927,453246
2/25/22,Egypt,26.820553,30.802498,478984,0,23957,455027
2/26/22,Egypt,26.820553,30.802498,480727,0,23992,456735
2/27/22,Egypt,26.820553,30.802498,482248,0,24040,458208
2/28/22,Egypt,26.820553,30.802498,483771,0,24074,459697
3/1/22,Egypt,26.820553,30.802498,485093,0,24110,460983
3/2/22,Egypt,26.820553,30.802498,486381,0,24132,462249
3/3/22,Egypt,26.820553,30.802498,487642,0,24149,463493
3/4/22,Egypt,26.820553,30.802498,488763,0,24162,464601
3/5/22,Egypt,26.820553,30.802498,489876,0,24172,465704
3/6/22,Egypt,26.820553,30.802498,490969,0,24197,466772
3/7/22,Egypt,26.820553,30.802498,491892,0,24222,467670
3/8/22,Egypt,26.820553,30.802498,492774,0,24244,468530
3/9/22,Egypt,26.820553,30.802498,493658,0,24257,469401
3/10/22,Egypt,26.820553,30.802498,494519,0,24269,470250
3/11/22,Egypt,26.820553,30.802498,495373,0,24277,471096
3/12/22,Egypt,26.820553,30.802498,495373,0,24277,471096
3/13/22,Egypt,26.820553,30.802498,495373,0,24277,471096
3/14/22,Egypt,26.820553,30.802498,495373,0,24277,471096
3/15/22,Egypt,26.820553,30.802498,495373,0,24277,471096
3/16/22,Egypt,26.820553,30.802498,495373,0,24277,471096
3/17/22,Egypt,26.820553,30.802498,495373,0,24277,471096
3/18/22,Egypt,26.820553,30.802498,495373,0,24277,471096
3/19/22,Egypt,26.820553,30.802498,495373,0,24277,471096
3/20/22,Egypt,26.820553,30.802498,495373,0,24277,471096
3/21/22,Egypt,26.820553,30.802498,500889,0,24361,476528
3/22/22,Egypt,26.820553,30.802498,500889,0,24361,476528
3/23/22,Egypt,26.820553,30.802498,500889,0,24361,476528
3/24/22,Egypt,26.820553,30.802498,500889,0,24361,476528
3/25/22,Egypt,26.820553,30.802498,500889,0,24361,476528
3/26/22,Egypt,26.820553,30.802498,500889,0,24361,476528
3/27/22,Egypt,26.820553,30.802498,500889,0,24361,476528
3/28/22,Egypt,26.820553,30.802498,505264,0,24417,480847
3/29/22,Egypt,26.820553,30.802498,505264,0,24417,480847
3/30/22,Egypt,26.820553,30.802498,505264,0,24417,480847
3/31/22,Egypt,26.820553,30.802498,505264,0,24417,480847
4/1/22,Egypt,26.820553,30.802498,505264,0,24417,480847
4/2/22,Egypt,26.820553,30.802498,505264,0,24417,480847
4/3/22,Egypt,26.820553,30.802498,505264,0,24417,480847
4/4/22,Egypt,26.820553,30.802498,509177,0,24473,484704
4/5/22,Egypt,26.820553,30.802498,509177,0,24473,484704
4/6/22,Egypt,26.820553,30.802498,509177,0,24473,484704
4/7/22,Egypt,26.820553,30.802498,509177,0,24473,484704
4/8/22,Egypt,26.820553,30.802498,509177,0,24473,484704
4/9/22,Egypt,26.820553,30.802498,509177,0,24473,484704
4/10/22,Egypt,26.820553,30.802498,509177,0,24473,484704
4/11/22,Egypt,26.820553,30.802498,511977,0,24522,487455
4/12/22,Egypt,26.820553,30.802498,511977,0,24522,487455
4/13/22,Egypt,26.820553,30.802498,511977,0,24522,487455
4/14/22,Egypt,26.820553,30.802498,511977,0,24522,487455
4/15/22,Egypt,26.820553,30.802498,511977,0,24522,487455
4/16/22,Egypt,26.820553,30.802498,511977,0,24522,487455
4/17/22,Egypt,26.820553,30.802498,511977,0,24522,487455
4/18/22,Egypt,26.820553,30.802498,511977,0,24522,487455
4/19/22,Egypt,26.820553,30.802498,515645,0,24613,491032
4/20/22,Egypt,26.820553,30.802498,515645,0,24613,491032
4/21/22,Egypt,26.820553,30.802498,515645,0,24613,491032
4/22/22,Egypt,26.820553,30.802498,515645,0,24613,491032
4/23/22,Egypt,26.820553,30.802498,515645,0,24613,491032
4/24/22,Egypt,26.820553,30.802498,515645,0,24613,491032
4/25/22,Egypt,26.820553,30.802498,515645,0,24613,491032
4/26/22,Egypt,26.820553,30.802498,515645,0,24613,491032
4/27/22,Egypt,26.820553,30.802498,515645,0,24613,491032
4/28/22,Egypt,26.820553,30.802498,515645,0,24613,491032
4/29/22,Egypt,26.820553,30.802498,515645,0,24613,491032
4/30/22,Egypt,26.820553,30.802498,515645,0,24613,491032
5/1/22,Egypt,26.820553,30.802498,515645,0,24613,491032
5/2/22,Egypt,26.820553,30.802498,515645,0,24613,491032
5/3/22,Egypt,26.820553,30.802498,515645,0,24613,491032
5/4/22,Egypt,26.820553,30.802498,515645,0,24641,491004
5/5/22,Egypt,26.820553,30.802498,515645,0,24641,491004
5/6/22,Egypt,26.820553,30.802498,515645,0,24641,491004
5/7/22,Egypt,26.820553,30.802498,515645,0,24641,491004
5/8/22,Egypt,26.820553,30.802498,515645,0,24641,491004
5/9/22,Egypt,26.820553,30.802498,515645,0,24669,490976
5/10/22,Egypt,26.820553,30.802498,515645,0,24669,490976
5/11/22,Egypt,26.820553,30.802498,515645,0,24669,490976
5/12/22,Egypt,26.820553,30.802498,515645,0,24669,490976
5/13/22,Egypt,26.820553,30.802498,515645,0,24669,490976
5/14/22,Egypt,26.820553,30.802498,515645,0,24669,490976
5/15/22,Egypt,26.820553,30.802498,515645,0,24669,490976
5/16/22,Egypt,26.820553,30.802498,515645,0,24690,490955
5/17/22,Egypt,26.820553,30.802498,515645,0,24690,490955
5/18/22,Egypt,26.820553,30.802498,515645,0,24690,490955
5/19/22,Egypt,26.820553,30.802498,515645,0,24690,490955
5/20/22,Egypt,26.820553,30.802498,515645,0,24690,490955
5/21/22,Egypt,26.820553,30.802498,515645,0,24690,490955
5/22/22,Egypt,26.820553,30.802498,515645,0,24690,490955
5/23/22,Egypt,26.820553,30.802498,515645,0,24704,490941
5/24/22,Egypt,26.820553,30.802498,515645,0,24704,490941
5/25/22,Egypt,26.820553,30.802498,515645,0,24704,490941
5/26/22,Egypt,26.820553,30.802498,515645,0,24704,490941
5/27/22,Egypt,26.820553,30.802498,515645,0,24704,490941
5/28/22,Egypt,26.820553,30.802498,515645,0,24704,490941
5/29/22,Egypt,26.820553,30.802498,515645,0,24704,490941
5/30/22,Egypt,26.820553,30.802498,515645,0,24718,490927
5/31/22,Egypt,26.820553,30.802498,515645,0,24718,490927
6/1/22,Egypt,26.820553,30.802498,515645,0,24718,490927
6/2/22,Egypt,26.820553,30.802498,515645,0,24718,490927
6/3/22,Egypt,26.820553,30.802498,515645,0,24718,490927
6/4/22,Egypt,26.820553,30.802498,515645,0,24718,490927
6/5/22,Egypt,26.820553,30.802498,515645,0,24718,490927
6/6/22,Egypt,26.820553,30.802498,515645,0,24719,490926
6/7/22,Egypt,26.820553,30.802498,515645,0,24719,490926
6/8/22,Egypt,26.820553,30.802498,515645,0,24719,490926
6/9/22,Egypt,26.820553,30.802498,515645,0,24719,490926
6/10/22,Egypt,26.820553,30.802498,515645,0,24719,490926
6/11/22,Egypt,26.820553,30.802498,515645,0,24719,490926
6/12/22,Egypt,26.820553,30.802498,515645,0,24719,490926
6/13/22,Egypt,26.820553,30.802498,515645,0,24720,490925
6/14/22,Egypt,26.820553,30.802498,515645,0,24720,490925
6/15/22,Egypt,26.820553,30.802498,515645,0,24720,490925
6/16/22,Egypt,26.820553,30.802498,515645,0,24720,490925
6/17/22,Egypt,26.820553,30.802498,515645,0,24720,490925
6/18/22,Egypt,26.820553,30.802498,515645,0,24720,490925
6/19/22,Egypt,26.820553,30.802498,515645,0,24720,490925
6/20/22,Egypt,26.820553,30.802498,515645,0,24722,490923
6/21/22,Egypt,26.820553,30.802498,515645,0,24722,490923
6/22/22,Egypt,26.820553,30.802498,515645,0,24722,490923
6/23/22,Egypt,26.820553,30.802498,515645,0,24722,490923
6/24/22,Egypt,26.820553,30.802498,515645,0,24722,490923
6/25/22,Egypt,26.820553,30.802498,515645,0,24722,490923
6/26/22,Egypt,26.820553,30.802498,515645,0,24722,490923
6/27/22,Egypt,26.820553,30.802498,515645,0,24723,490922
6/28/22,Egypt,26.820553,30.802498,515645,0,24723,490922
6/29/22,Egypt,26.820553,30.802498,515645,0,24723,490922
6/30/22,Egypt,26.820553,30.802498,515645,0,24723,490922
7/1/22,Egypt,26.820553,30.802498,515645,0,24723,490922
7/2/22,Egypt,26.820553,30.802498,515645,0,24723,490922
7/3/22,Egypt,26.820553,30.802498,515645,0,24723,490922
7/4/22,Egypt,26.820553,30.802498,515645,0,24723,490922
7/5/22,Egypt,26.820553,30.802498,515645,0,24724,490921
7/6/22,Egypt,26.820553,30.802498,515645,0,24724,490921
7/7/22,Egypt,26.820553,30.802498,515645,0,24724,490921
7/8/22,Egypt,26.820553,30.802498,515645,0,24724,490921
7/9/22,Egypt,26.820553,30.802498,515645,0,24724,490921
7/10/22,Egypt,26.820553,30.802498,515645,0,24724,490921
7/11/22,Egypt,26.820553,30.802498,515645,0,24724,490921
7/12/22,Egypt,26.820553,30.802498,515645,0,24725,490920
7/13/22,Egypt,26.820553,30.802498,515645,0,24725,490920
7/14/22,Egypt,26.820553,30.802498,515645,0,24725,490920
7/15/22,Egypt,26.820553,30.802498,515645,0,24725,490920
7/16/22,Egypt,26.820553,30.802498,515645,0,24725,490920
7/17/22,Egypt,26.820553,30.802498,515645,0,24725,490920
7/18/22,Egypt,26.820553,30.802498,515645,0,24750,490895
7/19/22,Egypt,26.820553,30.802498,515645,0,24750,490895
7/20/22,Egypt,26.820553,30.802498,515645,0,24750,490895
7/21/22,Egypt,26.820553,30.802498,515645,0,24750,490895
7/22/22,Egypt,26.820553,30.802498,515645,0,24750,490895
7/23/22,Egypt,26.820553,30.802498,515645,0,24750,490895
7/24/22,Egypt,26.820553,30.802498,515645,0,24750,490895
7/25/22,Egypt,26.820553,30.802498,515645,0,24765,490880
7/26/22,Egypt,26.820553,30.802498,515645,0,24765,490880
7/27/22,Egypt,26.820553,30.802498,515645,0,24765,490880
7/28/22,Egypt,26.820553,30.802498,515645,0,24765,490880
7/29/22,Egypt,26.820553,30.802498,515645,0,24765,490880
7/30/22,Egypt,26.820553,30.802498,515645,0,24765,490880
7/31/22,Egypt,26.820553,30.802498,515645,0,24765,490880
8/1/22,Egypt,26.820553,30.802498,515645,0,24765,490880
8/2/22,Egypt,26.820553,30.802498,515645,0,24775,490870
8/3/22,Egypt,26.820553,30.802498,515645,0,24775,490870
8/4/22,Egypt,26.820553,30.802498,515645,0,24775,490870
8/5/22,Egypt,26.820553,30.802498,515645,0,24775,490870
8/6/22,Egypt,26.820553,30.802498,515645,0,24775,490870
8/7/22,Egypt,26.820553,30.802498,515645,0,24775,490870
8/8/22,Egypt,26.820553,30.802498,515645,0,24781,490864
8/9/22,Egypt,26.820553,30.802498,515645,0,24781,490864
8/10/22,Egypt,26.820553,30.802498,515645,0,24781,490864
8/11/22,Egypt,26.820553,30.802498,515645,0,24781,490864
8/12/22,Egypt,26.820553,30.802498,515645,0,24781,490864
8/13/22,Egypt,26.820553,30.802498,515645,0,24781,490864
8/14/22,Egypt,26.820553,30.802498,515645,0,24781,490864
8/15/22,Egypt,26.820553,30.802498,515645,0,24786,490859
8/16/22,Egypt,26.820553,30.802498,515645,0,24786,490859
8/17/22,Egypt,26.820553,30.802498,515645,0,24786,490859
8/18/22,Egypt,26.820553,30.802498,515645,0,24786,490859
8/19/22,Egypt,26.820553,30.802498,515645,0,24786,490859
8/20/22,Egypt,26.820553,30.802498,515645,0,24786,490859
8/21/22,Egypt,26.820553,30.802498,515645,0,24786,490859
8/22/22,Egypt,26.820553,30.802498,515645,0,24791,490854
8/23/22,Egypt,26.820553,30.802498,515645,0,24791,490854
8/24/22,Egypt,26.820553,30.802498,515645,0,24791,490854
8/25/22,Egypt,26.820553,30.802498,515645,0,24791,490854
8/26/22,Egypt,26.820553,30.802498,515645,0,24791,490854
8/27/22,Egypt,26.820553,30.802498,515645,0,24791,490854
8/28/22,Egypt,26.820553,30.802498,515645,0,24791,490854
8/29/22,Egypt,26.820553,30.802498,515645,0,24791,490854
8/30/22,Egypt,26.820553,30.802498,515645,0,24794,490851
8/31/22,Egypt,26.820553,30.802498,515645,0,24794,490851
9/1/22,Egypt,26.820553,30.802498,515645,0,24794,490851
9/2/22,Egypt,26.820553,30.802498,515645,0,24794,490851
9/3/22,Egypt,26.820553,30.802498,515645,0,24794,490851
9/4/22,Egypt,26.820553,30.802498,515645,0,24794,490851
9/5/22,Egypt,26.820553,30.802498,515645,0,24796,490849
9/6/22,Egypt,26.820553,30.802498,515645,0,24796,490849
9/7/22,Egypt,26.820553,30.802498,515645,0,24796,490849
9/8/22,Egypt,26.820553,30.802498,515645,0,24796,490849
9/9/22,Egypt,26.820553,30.802498,515645,0,24796,490849
9/10/22,Egypt,26.820553,30.802498,515645,0,24796,490849
9/11/22,Egypt,26.820553,30.802498,515645,0,24796,490849
9/12/22,Egypt,26.820553,30.802498,515645,0,24796,490849
9/13/22,Egypt,26.820553,30.802498,515645,0,24796,490849
9/14/22,Egypt,26.820553,30.802498,515645,0,24796,490849
9/15/22,Egypt,26.820553,30.802498,515645,0,24796,490849
9/16/22,Egypt,26.820553,30.802498,515645,0,24796,490849
9/17/22,Egypt,26.820553,30.802498,515645,0,24796,490849
9/18/22,Egypt,26.820553,30.802498,515645,0,24796,490849
9/19/22,Egypt,26.820553,30.802498,515645,0,24797,490848
9/20/22,Egypt,26.820553,30.802498,515645,0,24797,490848
9/21/22,Egypt,26.820553,30.802498,515645,0,24797,490848
9/22/22,Egypt,26.820553,30.802498,515645,0,24797,490848
9/23/22,Egypt,26.820553,30.802498,515645,0,24797,490848
9/24/22,Egypt,26.820553,30.802498,515645,0,24797,490848
9/25/22,Egypt,26.820553,30.802498,515645,0,24797,490848
9/26/22,Egypt,26.820553,30.802498,515645,0,24797,490848
9/27/22,Egypt,26.820553,30.802498,515645,0,24797,490848
9/28/22,Egypt,26.820553,30.802498,515645,0,24797,490848
9/29/22,Egypt,26.820553,30.802498,515645,0,24797,490848
9/30/22,Egypt,26.820553,30.802498,515645,0,24797,490848
10/1/22,Egypt,26.820553,30.802498,515645,0,24797,490848
10/2/22,Egypt,26.820553,30.802498,515645,0,24797,490848
10/3/22,Egypt,26.820553,30.802498,515645,0,24797,490848
10/4/22,Egypt,26.820553,30.802498,515645,0,24797,490848
10/5/22,Egypt,26.820553,30.802498,515645,0,24797,490848
10/6/22,Egypt,26.820553,30.802498,515645,0,24797,490848
10/7/22,Egypt,26.820553,30.802498,515645,0,24797,490848
10/8/22,Egypt,26.820553,30.802498,515645,0,24797,490848
10/9/22,Egypt,26.820553,30.802498,515645,0,24797,490848
10/10/22,Egypt,26.820553,30.802498,515645,0,24797,490848
10/11/22,Egypt,26.820553,30.802498,515645,0,24797,490848
10/12/22,Egypt,26.820553,30.802498,515645,0,24797,490848
10/13/22,Egypt,26.820553,30.802498,515645,0,24797,490848
10/14/22,Egypt,26.820553,30.802498,515645,0,24797,490848
10/15/22,Egypt,26.820553,30.802498,515645,0,24797,490848
10/16/22,Egypt,26.820553,30.802498,515645,0,24797,490848
10/17/22,Egypt,26.820553,30.802498,515645,0,24797,490848
10/18/22,Egypt,26.820553,30.802498,515645,0,24797,490848
10/19/22,Egypt,26.820553,30.802498,515645,0,24798,490847
10/20/22,Egypt,26.820553,30.802498,515645,0,24798,490847
10/21/22,Egypt,26.820553,30.802498,515645,0,24798,490847
10/22/22,Egypt,26.820553,30.802498,515645,0,24798,490847
10/23/22,Egypt,26.820553,30.802498,515645,0,24798,490847
10/24/22,Egypt,26.820553,30.802498,515645,0,24798,490847
10/25/22,Egypt,26.820553,30.802498,515645,0,24798,490847
10/26/22,Egypt,26.820553,30.802498,515645,0,24798,490847
10/27/22,Egypt,26.820553,30.802498,515645,0,24798,490847
10/28/22,Egypt,26.820553,30.802498,515645,0,24798,490847
10/29/22,Egypt,26.820553,30.802498,515645,0,24798,490847
10/30/22,Egypt,26.820553,30.802498,515645,0,24798,490847
10/31/22,Egypt,26.820553,30.802498,515645,0,24798,490847
11/1/22,Egypt,26.820553,30.802498,515645,0,24798,490847
11/2/22,Egypt,26.820553,30.802498,515645,0,24798,490847
11/3/22,Egypt,26.820553,30.802498,515645,0,24798,490847
11/4/22,Egypt,26.820553,30.802498,515645,0,24798,490847
11/5/22,Egypt,26.820553,30.802498,515645,0,24798,490847
11/6/22,Egypt,26.820553,30.802498,515645,0,24798,490847
11/7/22,Egypt,26.820553,30.802498,515645,0,24798,490847
11/8/22,Egypt,26.820553,30.802498,515645,0,24798,490847
11/9/22,Egypt,26.820553,30.802498,515645,0,24798,490847
11/10/22,Egypt,26.820553,30.802498,515645,0,24798,490847
11/11/22,Egypt,26.820553,30.802498,515645,0,24798,490847
11/12/22,Egypt,26.820553,30.802498,515645,0,24798,490847
11/13/22,Egypt,26.820553,30.802498,515645,0,24798,490847
11/14/22,Egypt,26.820553,30.802498,515645,0,24798,490847
11/15/22,Egypt,26.820553,30.802498,515645,0,24798,490847
11/16/22,Egypt,26.820553,30.802498,515645,0,24798,490847
11/17/22,Egypt,26.820553,30.802498,515645,0,24798,490847
11/18/22,Egypt,26.820553,30.802498,515645,0,24798,490847
11/19/22,Egypt,26.820553,30.802498,515645,0,24798,490847
11/20/22,Egypt,26.820553,30.802498,515645,0,24798,490847
11/21/22,Egypt,26.820553,30.802498,515645,0,24798,490847
11/22/22,Egypt,26.820553,30.802498,515645,0,24798,490847
11/23/22,Egypt,26.820553,30.802498,515645,0,24798,490847
11/24/22,Egypt,26.820553,30.802498,515645,0,24798,490847
11/25/22,Egypt,26.820553,30.802498,515645,0,24798,490847
11/26/22,Egypt,26.820553,30.802498,515645,0,24798,490847
11/27/22,Egypt,26.820553,30.802498,515645,0,24798,490847
11/28/22,Egypt,26.820553,30.802498,515645,0,24798,490847
11/29/22,Egypt,26.820553,30.802498,515645,0,24798,490847
11/30/22,Egypt,26.820553,30.802498,515645,0,24798,490847
12/1/22,Egypt,26.820553,30.802498,515645,0,24798,490847
12/2/22,Egypt,26.820553,30.802498,515645,0,24798,490847
12/3/22,Egypt,26.820553,30.802498,515645,0,24798,490847
12/4/22,Egypt,26.820553,30.802498,515645,0,24798,490847
12/5/22,Egypt,26.820553,30.802498,515645,0,24799,490846
12/6/22,Egypt,26.820553,30.802498,515645,0,24799,490846
12/7/22,Egypt,26.820553,30.802498,515645,0,24799,490846
12/8/22,Egypt,26.820553,30.802498,515645,0,24799,490846
12/9/22,Egypt,26.820553,30.802498,515645,0,24799,490846
12/10/22,Egypt,26.820553,30.802498,515645,0,24799,490846
12/11/22,Egypt,26.820553,30.802498,515645,0,24799,490846
12/12/22,Egypt,26.820553,30.802498,515645,0,24799,490846
12/13/22,Egypt,26.820553,30.802498,515645,0,24800,490845
12/14/22,Egypt,26.820553,30.802498,515645,0,24800,490845
12/15/22,Egypt,26.820553,30.802498,515645,0,24800,490845
12/16/22,Egypt,26.820553,30.802498,515645,0,24800,490845
12/17/22,Egypt,26.820553,30.802498,515645,0,24800,490845
1/1/22,El Salvador,13.7942,-88.8965,121945,0,3824,118121
1/2/22,El Salvador,13.7942,-88.8965,121945,0,3825,118120
1/3/22,El Salvador,13.7942,-88.8965,122063,0,3826,118237
1/4/22,El Salvador,13.7942,-88.8965,122063,0,3826,118237
1/5/22,El Salvador,13.7942,-88.8965,122063,0,3826,118237
1/6/22,El Salvador,13.7942,-88.8965,122063,0,3826,118237
1/7/22,El Salvador,13.7942,-88.8965,122234,0,3826,118408
1/8/22,El Salvador,13.7942,-88.8965,122234,0,3827,118407
1/9/22,El Salvador,13.7942,-88.8965,122469,0,3827,118642
1/10/22,El Salvador,13.7942,-88.8965,122628,0,3827,118801
1/11/22,El Salvador,13.7942,-88.8965,122628,0,3827,118801
1/12/22,El Salvador,13.7942,-88.8965,123025,0,3828,119197
1/13/22,El Salvador,13.7942,-88.8965,123025,0,3829,119196
1/14/22,El Salvador,13.7942,-88.8965,123577,0,3832,119745
1/15/22,El Salvador,13.7942,-88.8965,123577,0,3832,119745
1/16/22,El Salvador,13.7942,-88.8965,123577,0,3834,119743
1/17/22,El Salvador,13.7942,-88.8965,123577,0,3834,119743
1/18/22,El Salvador,13.7942,-88.8965,123577,0,3837,119740
1/19/22,El Salvador,13.7942,-88.8965,123577,0,3840,119737
1/20/22,El Salvador,13.7942,-88.8965,123577,0,3843,119734
1/21/22,El Salvador,13.7942,-88.8965,127012,0,3847,123165
1/22/22,El Salvador,13.7942,-88.8965,127012,0,3851,123161
1/23/22,El Salvador,13.7942,-88.8965,127012,0,3855,123157
1/24/22,El Salvador,13.7942,-88.8965,127012,0,3857,123155
1/25/22,El Salvador,13.7942,-88.8965,127012,0,3862,123150
1/26/22,El Salvador,13.7942,-88.8965,127012,0,3866,123146
1/27/22,El Salvador,13.7942,-88.8965,127012,0,3871,123141
1/28/22,El Salvador,13.7942,-88.8965,127012,0,3877,123135
1/29/22,El Salvador,13.7942,-88.8965,133262,0,3884,129378
1/30/22,El Salvador,13.7942,-88.8965,134155,0,3891,130264
1/31/22,El Salvador,13.7942,-88.8965,135109,0,3899,131210
2/1/22,El Salvador,13.7942,-88.8965,135109,0,3908,131201
2/2/22,El Salvador,13.7942,-88.8965,135109,0,3914,131195
2/3/22,El Salvador,13.7942,-88.8965,135109,0,3921,131188
2/4/22,El Salvador,13.7942,-88.8965,135109,0,3927,131182
2/5/22,El Salvador,13.7942,-88.8965,135109,0,3933,131176
2/6/22,El Salvador,13.7942,-88.8965,135109,0,3942,131167
2/7/22,El Salvador,13.7942,-88.8965,135109,0,3952,131157
2/8/22,El Salvador,13.7942,-88.8965,135109,0,3960,131149
2/9/22,El Salvador,13.7942,-88.8965,135109,0,3967,131142
2/10/22,El Salvador,13.7942,-88.8965,135109,0,3975,131134
2/11/22,El Salvador,13.7942,-88.8965,135109,0,3982,131127
2/12/22,El Salvador,13.7942,-88.8965,135109,0,3989,131120
2/13/22,El Salvador,13.7942,-88.8965,135109,0,3994,131115
2/14/22,El Salvador,13.7942,-88.8965,147786,0,4002,143784
2/15/22,El Salvador,13.7942,-88.8965,147786,0,4011,143775
2/16/22,El Salvador,13.7942,-88.8965,147786,0,4019,143767
2/17/22,El Salvador,13.7942,-88.8965,147786,0,4027,143759
2/18/22,El Salvador,13.7942,-88.8965,147786,0,4032,143754
2/19/22,El Salvador,13.7942,-88.8965,147786,0,4032,143754
2/20/22,El Salvador,13.7942,-88.8965,147786,0,4041,143745
2/21/22,El Salvador,13.7942,-88.8965,147786,0,4044,143742
2/22/22,El Salvador,13.7942,-88.8965,147786,0,4048,143738
2/23/22,El Salvador,13.7942,-88.8965,147786,0,4054,143732
2/24/22,El Salvador,13.7942,-88.8965,147786,0,4058,143728
2/25/22,El Salvador,13.7942,-88.8965,147786,0,4062,143724
2/26/22,El Salvador,13.7942,-88.8965,147786,0,4062,143724
2/27/22,El Salvador,13.7942,-88.8965,147786,0,4068,143718
2/28/22,El Salvador,13.7942,-88.8965,156364,0,4071,152293
3/1/22,El Salvador,13.7942,-88.8965,156364,0,4074,152290
3/2/22,El Salvador,13.7942,-88.8965,156364,0,4077,152287
3/3/22,El Salvador,13.7942,-88.8965,156364,0,4081,152283
3/4/22,El Salvador,13.7942,-88.8965,156364,0,4083,152281
3/5/22,El Salvador,13.7942,-88.8965,156364,0,4086,152278
3/6/22,El Salvador,13.7942,-88.8965,156364,0,4088,152276
3/7/22,El Salvador,13.7942,-88.8965,156364,0,4091,152273
3/8/22,El Salvador,13.7942,-88.8965,156364,0,4092,152272
3/9/22,El Salvador,13.7942,-88.8965,156364,0,4093,152271
3/10/22,El Salvador,13.7942,-88.8965,156364,0,4094,152270
3/11/22,El Salvador,13.7942,-88.8965,156364,0,4095,152269
3/12/22,El Salvador,13.7942,-88.8965,156364,0,4095,152269
3/13/22,El Salvador,13.7942,-88.8965,156364,0,4100,152264
3/14/22,El Salvador,13.7942,-88.8965,156364,0,4101,152263
3/15/22,El Salvador,13.7942,-88.8965,156364,0,4102,152262
3/16/22,El Salvador,13.7942,-88.8965,156364,0,4104,152260
3/17/22,El Salvador,13.7942,-88.8965,160305,0,4105,156200
3/18/22,El Salvador,13.7942,-88.8965,160942,0,4107,156835
3/19/22,El Salvador,13.7942,-88.8965,161052,0,4109,156943
3/20/22,El Salvador,13.7942,-88.8965,161052,0,4109,156943
3/21/22,El Salvador,13.7942,-88.8965,161052,0,4113,156939
3/22/22,El Salvador,13.7942,-88.8965,161052,0,4113,156939
3/23/22,El Salvador,13.7942,-88.8965,161052,0,4114,156938
3/24/22,El Salvador,13.7942,-88.8965,161052,0,4115,156937
3/25/22,El Salvador,13.7942,-88.8965,161052,0,4115,156937
3/26/22,El Salvador,13.7942,-88.8965,161052,0,4116,156936
3/27/22,El Salvador,13.7942,-88.8965,161052,0,4116,156936
3/28/22,El Salvador,13.7942,-88.8965,161052,0,4117,156935
3/29/22,El Salvador,13.7942,-88.8965,161052,0,4118,156934
3/30/22,El Salvador,13.7942,-88.8965,161052,0,4118,156934
3/31/22,El Salvador,13.7942,-88.8965,161052,0,4119,156933
4/1/22,El Salvador,13.7942,-88.8965,161052,0,4119,156933
4/2/22,El Salvador,13.7942,-88.8965,161052,0,4119,156933
4/3/22,El Salvador,13.7942,-88.8965,161570,0,4120,157450
4/4/22,El Salvador,13.7942,-88.8965,161570,0,4120,157450
4/5/22,El Salvador,13.7942,-88.8965,161570,0,4121,157449
4/6/22,El Salvador,13.7942,-88.8965,161570,0,4121,157449
4/7/22,El Salvador,13.7942,-88.8965,161570,0,4121,157449
4/8/22,El Salvador,13.7942,-88.8965,161570,0,4121,157449
4/9/22,El Salvador,13.7942,-88.8965,161945,0,4121,157824
4/10/22,El Salvador,13.7942,-88.8965,162089,0,4122,157967
4/11/22,El Salvador,13.7942,-88.8965,162089,0,4122,157967
4/12/22,El Salvador,13.7942,-88.8965,162089,0,4124,157965
4/13/22,El Salvador,13.7942,-88.8965,162089,0,4124,157965
4/14/22,El Salvador,13.7942,-88.8965,162089,0,4124,157965
4/15/22,El Salvador,13.7942,-88.8965,162089,0,4125,157964
4/16/22,El Salvador,13.7942,-88.8965,162089,0,4125,157964
4/17/22,El Salvador,13.7942,-88.8965,162089,0,4125,157964
4/18/22,El Salvador,13.7942,-88.8965,162089,0,4125,157964
4/19/22,El Salvador,13.7942,-88.8965,162089,0,4126,157963
4/20/22,El Salvador,13.7942,-88.8965,162089,0,4126,157963
4/21/22,El Salvador,13.7942,-88.8965,162089,0,4127,157962
4/22/22,El Salvador,13.7942,-88.8965,162089,0,4127,157962
4/23/22,El Salvador,13.7942,-88.8965,162089,0,4127,157962
4/24/22,El Salvador,13.7942,-88.8965,162089,0,4127,157962
4/25/22,El Salvador,13.7942,-88.8965,162089,0,4128,157961
4/26/22,El Salvador,13.7942,-88.8965,162089,0,4128,157961
4/27/22,El Salvador,13.7942,-88.8965,162089,0,4128,157961
4/28/22,El Salvador,13.7942,-88.8965,162089,0,4128,157961
4/29/22,El Salvador,13.7942,-88.8965,162089,0,4128,157961
4/30/22,El Salvador,13.7942,-88.8965,162089,0,4128,157961
5/1/22,El Salvador,13.7942,-88.8965,162089,0,4128,157961
5/2/22,El Salvador,13.7942,-88.8965,162089,0,4128,157961
5/3/22,El Salvador,13.7942,-88.8965,162089,0,4128,157961
5/4/22,El Salvador,13.7942,-88.8965,162089,0,4128,157961
5/5/22,El Salvador,13.7942,-88.8965,162089,0,4128,157961
5/6/22,El Salvador,13.7942,-88.8965,162089,0,4128,157961
5/7/22,El Salvador,13.7942,-88.8965,162089,0,4128,157961
5/8/22,El Salvador,13.7942,-88.8965,162089,0,4128,157961
5/9/22,El Salvador,13.7942,-88.8965,162089,0,4128,157961
5/10/22,El Salvador,13.7942,-88.8965,162089,0,4129,157960
5/11/22,El Salvador,13.7942,-88.8965,162089,0,4129,157960
5/12/22,El Salvador,13.7942,-88.8965,162089,0,4129,157960
5/13/22,El Salvador,13.7942,-88.8965,162089,0,4129,157960
5/14/22,El Salvador,13.7942,-88.8965,162089,0,4129,157960
5/15/22,El Salvador,13.7942,-88.8965,162089,0,4129,157960
5/16/22,El Salvador,13.7942,-88.8965,162089,0,4130,157959
5/17/22,El Salvador,13.7942,-88.8965,162089,0,4130,157959
5/18/22,El Salvador,13.7942,-88.8965,162089,0,4130,157959
5/19/22,El Salvador,13.7942,-88.8965,162089,0,4130,157959
5/20/22,El Salvador,13.7942,-88.8965,162089,0,4130,157959
5/21/22,El Salvador,13.7942,-88.8965,162089,0,4130,157959
5/22/22,El Salvador,13.7942,-88.8965,162089,0,4130,157959
5/23/22,El Salvador,13.7942,-88.8965,162089,0,4131,157958
5/24/22,El Salvador,13.7942,-88.8965,162089,0,4131,157958
5/25/22,El Salvador,13.7942,-88.8965,162089,0,4131,157958
5/26/22,El Salvador,13.7942,-88.8965,162755,0,4131,158624
5/27/22,El Salvador,13.7942,-88.8965,162755,0,4131,158624
5/28/22,El Salvador,13.7942,-88.8965,162755,0,4131,158624
5/29/22,El Salvador,13.7942,-88.8965,162755,0,4131,158624
5/30/22,El Salvador,13.7942,-88.8965,162755,0,4132,158623
5/31/22,El Salvador,13.7942,-88.8965,162755,0,4132,158623
6/1/22,El Salvador,13.7942,-88.8965,162755,0,4132,158623
6/2/22,El Salvador,13.7942,-88.8965,162755,0,4132,158623
6/3/22,El Salvador,13.7942,-88.8965,162755,0,4132,158623
6/4/22,El Salvador,13.7942,-88.8965,162755,0,4132,158623
6/5/22,El Salvador,13.7942,-88.8965,163735,0,4133,159602
6/6/22,El Salvador,13.7942,-88.8965,163735,0,4133,159602
6/7/22,El Salvador,13.7942,-88.8965,164134,0,4133,160001
6/8/22,El Salvador,13.7942,-88.8965,164134,0,4134,160000
6/9/22,El Salvador,13.7942,-88.8965,164134,0,4134,160000
6/10/22,El Salvador,13.7942,-88.8965,164134,0,4134,160000
6/11/22,El Salvador,13.7942,-88.8965,164134,0,4135,159999
6/12/22,El Salvador,13.7942,-88.8965,164134,0,4135,159999
6/13/22,El Salvador,13.7942,-88.8965,164134,0,4135,159999
6/14/22,El Salvador,13.7942,-88.8965,164134,0,4135,159999
6/15/22,El Salvador,13.7942,-88.8965,164134,0,4135,159999
6/16/22,El Salvador,13.7942,-88.8965,164134,0,4135,159999
6/17/22,El Salvador,13.7942,-88.8965,164134,0,4136,159998
6/18/22,El Salvador,13.7942,-88.8965,164134,0,4137,159997
6/19/22,El Salvador,13.7942,-88.8965,164134,0,4137,159997
6/20/22,El Salvador,13.7942,-88.8965,164134,0,4137,159997
6/21/22,El Salvador,13.7942,-88.8965,169646,0,4138,165508
6/22/22,El Salvador,13.7942,-88.8965,169646,0,4139,165507
6/23/22,El Salvador,13.7942,-88.8965,169646,0,4139,165507
6/24/22,El Salvador,13.7942,-88.8965,169646,0,4139,165507
6/25/22,El Salvador,13.7942,-88.8965,169646,0,4139,165507
6/26/22,El Salvador,13.7942,-88.8965,169646,0,4139,165507
6/27/22,El Salvador,13.7942,-88.8965,169646,0,4141,165505
6/28/22,El Salvador,13.7942,-88.8965,169646,0,4141,165505
6/29/22,El Salvador,13.7942,-88.8965,169646,0,4142,165504
6/30/22,El Salvador,13.7942,-88.8965,169646,0,4144,165502
7/1/22,El Salvador,13.7942,-88.8965,169646,0,4146,165500
7/2/22,El Salvador,13.7942,-88.8965,169646,0,4146,165500
7/3/22,El Salvador,13.7942,-88.8965,169646,0,4149,165497
7/4/22,El Salvador,13.7942,-88.8965,169646,0,4150,165496
7/5/22,El Salvador,13.7942,-88.8965,169646,0,4152,165494
7/6/22,El Salvador,13.7942,-88.8965,169646,0,4152,165494
7/7/22,El Salvador,13.7942,-88.8965,169646,0,4153,165493
7/8/22,El Salvador,13.7942,-88.8965,180970,0,4155,176815
7/9/22,El Salvador,13.7942,-88.8965,180970,0,4156,176814
7/10/22,El Salvador,13.7942,-88.8965,180970,0,4160,176810
7/11/22,El Salvador,13.7942,-88.8965,180970,0,4163,176807
7/12/22,El Salvador,13.7942,-88.8965,180970,0,4164,176806
7/13/22,El Salvador,13.7942,-88.8965,180970,0,4165,176805
7/14/22,El Salvador,13.7942,-88.8965,180970,0,4167,176803
7/15/22,El Salvador,13.7942,-88.8965,180970,0,4171,176799
7/16/22,El Salvador,13.7942,-88.8965,180970,0,4174,176796
7/17/22,El Salvador,13.7942,-88.8965,180970,0,4174,176796
7/18/22,El Salvador,13.7942,-88.8965,180970,0,4177,176793
7/19/22,El Salvador,13.7942,-88.8965,180970,0,4178,176792
7/20/22,El Salvador,13.7942,-88.8965,180970,0,4181,176789
7/21/22,El Salvador,13.7942,-88.8965,180970,0,4184,176786
7/22/22,El Salvador,13.7942,-88.8965,180970,0,4184,176786
7/23/22,El Salvador,13.7942,-88.8965,180970,0,4184,176786
7/24/22,El Salvador,13.7942,-88.8965,180970,0,4184,176786
7/25/22,El Salvador,13.7942,-88.8965,180970,0,4189,176781
7/26/22,El Salvador,13.7942,-88.8965,180970,0,4190,176780
7/27/22,El Salvador,13.7942,-88.8965,190818,0,4192,186626
7/28/22,El Salvador,13.7942,-88.8965,190818,0,4194,186624
7/29/22,El Salvador,13.7942,-88.8965,190818,0,4194,186624
7/30/22,El Salvador,13.7942,-88.8965,190818,0,4194,186624
7/31/22,El Salvador,13.7942,-88.8965,190818,0,4194,186624
8/1/22,El Salvador,13.7942,-88.8965,190818,0,4199,186619
8/2/22,El Salvador,13.7942,-88.8965,190818,0,4201,186617
8/3/22,El Salvador,13.7942,-88.8965,190818,0,4204,186614
8/4/22,El Salvador,13.7942,-88.8965,190818,0,4206,186612
8/5/22,El Salvador,13.7942,-88.8965,190818,0,4208,186610
8/6/22,El Salvador,13.7942,-88.8965,190818,0,4210,186608
8/7/22,El Salvador,13.7942,-88.8965,190818,0,4213,186605
8/8/22,El Salvador,13.7942,-88.8965,190818,0,4214,186604
8/9/22,El Salvador,13.7942,-88.8965,190818,0,4216,186602
8/10/22,El Salvador,13.7942,-88.8965,190818,0,4216,186602
8/11/22,El Salvador,13.7942,-88.8965,190818,0,4216,186602
8/12/22,El Salvador,13.7942,-88.8965,190818,0,4217,186601
8/13/22,El Salvador,13.7942,-88.8965,190818,0,4217,186601
8/14/22,El Salvador,13.7942,-88.8965,190818,0,4217,186601
8/15/22,El Salvador,13.7942,-88.8965,190818,0,4217,186601
8/16/22,El Salvador,13.7942,-88.8965,190818,0,4217,186601
8/17/22,El Salvador,13.7942,-88.8965,190818,0,4217,186601
8/18/22,El Salvador,13.7942,-88.8965,190818,0,4218,186600
8/19/22,El Salvador,13.7942,-88.8965,190818,0,4218,186600
8/20/22,El Salvador,13.7942,-88.8965,190818,0,4219,186599
8/21/22,El Salvador,13.7942,-88.8965,190818,0,4219,186599
8/22/22,El Salvador,13.7942,-88.8965,190818,0,4219,186599
8/23/22,El Salvador,13.7942,-88.8965,190818,0,4220,186598
8/24/22,El Salvador,13.7942,-88.8965,190818,0,4220,186598
8/25/22,El Salvador,13.7942,-88.8965,190818,0,4221,186597
8/26/22,El Salvador,13.7942,-88.8965,190818,0,4221,186597
8/27/22,El Salvador,13.7942,-88.8965,190818,0,4221,186597
8/28/22,El Salvador,13.7942,-88.8965,190818,0,4221,186597
8/29/22,El Salvador,13.7942,-88.8965,190818,0,4222,186596
8/30/22,El Salvador,13.7942,-88.8965,201785,0,4223,197562
8/31/22,El Salvador,13.7942,-88.8965,201785,0,4223,197562
9/1/22,El Salvador,13.7942,-88.8965,201785,0,4224,197561
9/2/22,El Salvador,13.7942,-88.8965,201785,0,4224,197561
9/3/22,El Salvador,13.7942,-88.8965,201785,0,4224,197561
9/4/22,El Salvador,13.7942,-88.8965,201785,0,4224,197561
9/5/22,El Salvador,13.7942,-88.8965,201785,0,4224,197561
9/6/22,El Salvador,13.7942,-88.8965,201785,0,4224,197561
9/7/22,El Salvador,13.7942,-88.8965,201785,0,4226,197559
9/8/22,El Salvador,13.7942,-88.8965,201785,0,4226,197559
9/9/22,El Salvador,13.7942,-88.8965,201785,0,4227,197558
9/10/22,El Salvador,13.7942,-88.8965,201785,0,4227,197558
9/11/22,El Salvador,13.7942,-88.8965,201785,0,4227,197558
9/12/22,El Salvador,13.7942,-88.8965,201785,0,4228,197557
9/13/22,El Salvador,13.7942,-88.8965,201785,0,4228,197557
9/14/22,El Salvador,13.7942,-88.8965,201785,0,4228,197557
9/15/22,El Salvador,13.7942,-88.8965,201785,0,4228,197557
9/16/22,El Salvador,13.7942,-88.8965,201785,0,4228,197557
9/17/22,El Salvador,13.7942,-88.8965,201785,0,4228,197557
9/18/22,El Salvador,13.7942,-88.8965,201785,0,4228,197557
9/19/22,El Salvador,13.7942,-88.8965,201785,0,4228,197557
9/20/22,El Salvador,13.7942,-88.8965,201785,0,4228,197557
9/21/22,El Salvador,13.7942,-88.8965,201785,0,4229,197556
9/22/22,El Salvador,13.7942,-88.8965,201785,0,4229,197556
9/23/22,El Salvador,13.7942,-88.8965,201785,0,4229,197556
9/24/22,El Salvador,13.7942,-88.8965,201785,0,4229,197556
9/25/22,El Salvador,13.7942,-88.8965,201785,0,4229,197556
9/26/22,El Salvador,13.7942,-88.8965,201785,0,4229,197556
9/27/22,El Salvador,13.7942,-88.8965,201785,0,4229,197556
9/28/22,El Salvador,13.7942,-88.8965,201785,0,4229,197556
9/29/22,El Salvador,13.7942,-88.8965,201785,0,4229,197556
9/30/22,El Salvador,13.7942,-88.8965,201785,0,4229,197556
10/1/22,El Salvador,13.7942,-88.8965,201785,0,4229,197556
10/2/22,El Salvador,13.7942,-88.8965,201785,0,4229,197556
10/3/22,El Salvador,13.7942,-88.8965,201785,0,4229,197556
10/4/22,El Salvador,13.7942,-88.8965,201785,0,4229,197556
10/5/22,El Salvador,13.7942,-88.8965,201785,0,4230,197555
10/6/22,El Salvador,13.7942,-88.8965,201785,0,4230,197555
10/7/22,El Salvador,13.7942,-88.8965,201785,0,4230,197555
10/8/22,El Salvador,13.7942,-88.8965,201785,0,4230,197555
10/9/22,El Salvador,13.7942,-88.8965,201785,0,4230,197555
10/10/22,El Salvador,13.7942,-88.8965,201785,0,4230,197555
10/11/22,El Salvador,13.7942,-88.8965,201785,0,4230,197555
10/12/22,El Salvador,13.7942,-88.8965,201785,0,4230,197555
10/13/22,El Salvador,13.7942,-88.8965,201785,0,4230,197555
10/14/22,El Salvador,13.7942,-88.8965,201785,0,4230,197555
10/15/22,El Salvador,13.7942,-88.8965,201785,0,4230,197555
10/16/22,El Salvador,13.7942,-88.8965,201785,0,4230,197555
10/17/22,El Salvador,13.7942,-88.8965,201785,0,4230,197555
10/18/22,El Salvador,13.7942,-88.8965,201785,0,4230,197555
10/19/22,El Salvador,13.7942,-88.8965,201785,0,4230,197555
10/20/22,El Salvador,13.7942,-88.8965,201785,0,4230,197555
10/21/22,El Salvador,13.7942,-88.8965,201785,0,4230,197555
10/22/22,El Salvador,13.7942,-88.8965,201785,0,4230,197555
10/23/22,El Salvador,13.7942,-88.8965,201785,0,4230,197555
10/24/22,El Salvador,13.7942,-88.8965,201785,0,4230,197555
10/25/22,El Salvador,13.7942,-88.8965,201785,0,4230,197555
10/26/22,El Salvador,13.7942,-88.8965,201785,0,4230,197555
10/27/22,El Salvador,13.7942,-88.8965,201785,0,4230,197555
10/28/22,El Salvador,13.7942,-88.8965,201785,0,4230,197555
10/29/22,El Salvador,13.7942,-88.8965,201785,0,4230,197555
10/30/22,El Salvador,13.7942,-88.8965,201785,0,4230,197555
10/31/22,El Salvador,13.7942,-88.8965,201785,0,4230,197555
11/1/22,El Salvador,13.7942,-88.8965,201785,0,4230,197555
11/2/22,El Salvador,13.7942,-88.8965,201785,0,4230,197555
11/3/22,El Salvador,13.7942,-88.8965,201785,0,4230,197555
11/4/22,El Salvador,13.7942,-88.8965,201785,0,4230,197555
11/5/22,El Salvador,13.7942,-88.8965,201785,0,4230,197555
11/6/22,El Salvador,13.7942,-88.8965,201785,0,4230,197555
11/7/22,El Salvador,13.7942,-88.8965,201785,0,4230,197555
11/8/22,El Salvador,13.7942,-88.8965,201785,0,4230,197555
11/9/22,El Salvador,13.7942,-88.8965,201785,0,4230,197555
11/10/22,El Salvador,13.7942,-88.8965,201785,0,4230,197555
11/11/22,El Salvador,13.7942,-88.8965,201785,0,4230,197555
11/12/22,El Salvador,13.7942,-88.8965,201785,0,4230,197555
11/13/22,El Salvador,13.7942,-88.8965,201785,0,4230,197555
11/14/22,El Salvador,13.7942,-88.8965,201785,0,4230,197555
11/15/22,El Salvador,13.7942,-88.8965,201785,0,4230,197555
11/16/22,El Salvador,13.7942,-88.8965,201785,0,4230,197555
11/17/22,El Salvador,13.7942,-88.8965,201785,0,4230,197555
11/18/22,El Salvador,13.7942,-88.8965,201785,0,4230,197555
11/19/22,El Salvador,13.7942,-88.8965,201785,0,4230,197555
11/20/22,El Salvador,13.7942,-88.8965,201785,0,4230,197555
11/21/22,El Salvador,13.7942,-88.8965,201785,0,4230,197555
11/22/22,El Salvador,13.7942,-88.8965,201785,0,4230,197555
11/23/22,El Salvador,13.7942,-88.8965,201785,0,4230,197555
11/24/22,El Salvador,13.7942,-88.8965,201785,0,4230,197555
11/25/22,El Salvador,13.7942,-88.8965,201785,0,4230,197555
11/26/22,El Salvador,13.7942,-88.8965,201785,0,4230,197555
11/27/22,El Salvador,13.7942,-88.8965,201785,0,4230,197555
11/28/22,El Salvador,13.7942,-88.8965,201785,0,4230,197555
11/29/22,El Salvador,13.7942,-88.8965,201785,0,4230,197555
11/30/22,El Salvador,13.7942,-88.8965,201785,0,4230,197555
12/1/22,El Salvador,13.7942,-88.8965,201785,0,4230,197555
12/2/22,El Salvador,13.7942,-88.8965,201785,0,4230,197555
12/3/22,El Salvador,13.7942,-88.8965,201785,0,4230,197555
12/4/22,El Salvador,13.7942,-88.8965,201785,0,4230,197555
12/5/22,El Salvador,13.7942,-88.8965,201785,0,4230,197555
12/6/22,El Salvador,13.7942,-88.8965,201785,0,4230,197555
12/7/22,El Salvador,13.7942,-88.8965,201785,0,4230,197555
12/8/22,El Salvador,13.7942,-88.8965,201785,0,4230,197555
12/9/22,El Salvador,13.7942,-88.8965,201785,0,4230,197555
12/10/22,El Salvador,13.7942,-88.8965,201785,0,4230,197555
12/11/22,El Salvador,13.7942,-88.8965,201785,0,4230,197555
12/12/22,El Salvador,13.7942,-88.8965,201785,0,4230,197555
12/13/22,El Salvador,13.7942,-88.8965,201785,0,4230,197555
12/14/22,El Salvador,13.7942,-88.8965,201785,0,4230,197555
12/15/22,El Salvador,13.7942,-88.8965,201785,0,4230,197555
12/16/22,El Salvador,13.7942,-88.8965,201785,0,4230,197555
12/17/22,El Salvador,13.7942,-88.8965,201785,0,4230,197555
1/1/22,Equatorial Guinea,1.6508,10.2679,13710,0,175,13535
1/2/22,Equatorial Guinea,1.6508,10.2679,13710,0,175,13535
1/3/22,Equatorial Guinea,1.6508,10.2679,13710,0,175,13535
1/4/22,Equatorial Guinea,1.6508,10.2679,13710,0,175,13535
1/5/22,Equatorial Guinea,1.6508,10.2679,13876,0,175,13701
1/6/22,Equatorial Guinea,1.6508,10.2679,13876,0,175,13701
1/7/22,Equatorial Guinea,1.6508,10.2679,14401,0,177,14224
1/8/22,Equatorial Guinea,1.6508,10.2679,14401,0,177,14224
1/9/22,Equatorial Guinea,1.6508,10.2679,14401,0,177,14224
1/10/22,Equatorial Guinea,1.6508,10.2679,14871,0,177,14694
1/11/22,Equatorial Guinea,1.6508,10.2679,14871,0,177,14694
1/12/22,Equatorial Guinea,1.6508,10.2679,14871,0,177,14694
1/13/22,Equatorial Guinea,1.6508,10.2679,14871,0,177,14694
1/14/22,Equatorial Guinea,1.6508,10.2679,15319,0,178,15141
1/15/22,Equatorial Guinea,1.6508,10.2679,15319,0,178,15141
1/16/22,Equatorial Guinea,1.6508,10.2679,15319,0,178,15141
1/17/22,Equatorial Guinea,1.6508,10.2679,15492,0,178,15314
1/18/22,Equatorial Guinea,1.6508,10.2679,15492,0,178,15314
1/19/22,Equatorial Guinea,1.6508,10.2679,15558,0,179,15379
1/20/22,Equatorial Guinea,1.6508,10.2679,15558,0,179,15379
1/21/22,Equatorial Guinea,1.6508,10.2679,15558,0,179,15379
1/22/22,Equatorial Guinea,1.6508,10.2679,15690,0,179,15511
1/23/22,Equatorial Guinea,1.6508,10.2679,15690,0,179,15511
1/24/22,Equatorial Guinea,1.6508,10.2679,15732,0,181,15551
1/25/22,Equatorial Guinea,1.6508,10.2679,15732,0,181,15551
1/26/22,Equatorial Guinea,1.6508,10.2679,15774,0,182,15592
1/27/22,Equatorial Guinea,1.6508,10.2679,15774,0,182,15592
1/28/22,Equatorial Guinea,1.6508,10.2679,15802,0,182,15620
1/29/22,Equatorial Guinea,1.6508,10.2679,15802,0,182,15620
1/30/22,Equatorial Guinea,1.6508,10.2679,15802,0,182,15620
1/31/22,Equatorial Guinea,1.6508,10.2679,15802,0,182,15620
2/1/22,Equatorial Guinea,1.6508,10.2679,15828,0,182,15646
2/2/22,Equatorial Guinea,1.6508,10.2679,15828,0,182,15646
2/3/22,Equatorial Guinea,1.6508,10.2679,15828,0,182,15646
2/4/22,Equatorial Guinea,1.6508,10.2679,15845,0,182,15663
2/5/22,Equatorial Guinea,1.6508,10.2679,15845,0,182,15663
2/6/22,Equatorial Guinea,1.6508,10.2679,15845,0,182,15663
2/7/22,Equatorial Guinea,1.6508,10.2679,15850,0,182,15668
2/8/22,Equatorial Guinea,1.6508,10.2679,15850,0,182,15668
2/9/22,Equatorial Guinea,1.6508,10.2679,15850,0,182,15668
2/10/22,Equatorial Guinea,1.6508,10.2679,15853,0,182,15671
2/11/22,Equatorial Guinea,1.6508,10.2679,15853,0,182,15671
2/12/22,Equatorial Guinea,1.6508,10.2679,15859,0,182,15677
2/13/22,Equatorial Guinea,1.6508,10.2679,15859,0,182,15677
2/14/22,Equatorial Guinea,1.6508,10.2679,15859,0,182,15677
2/15/22,Equatorial Guinea,1.6508,10.2679,15869,0,182,15687
2/16/22,Equatorial Guinea,1.6508,10.2679,15869,0,182,15687
2/17/22,Equatorial Guinea,1.6508,10.2679,15870,0,182,15688
2/18/22,Equatorial Guinea,1.6508,10.2679,15870,0,182,15688
2/19/22,Equatorial Guinea,1.6508,10.2679,15870,0,182,15688
2/20/22,Equatorial Guinea,1.6508,10.2679,15870,0,182,15688
2/21/22,Equatorial Guinea,1.6508,10.2679,15874,0,182,15692
2/22/22,Equatorial Guinea,1.6508,10.2679,15874,0,182,15692
2/23/22,Equatorial Guinea,1.6508,10.2679,15874,0,182,15692
2/24/22,Equatorial Guinea,1.6508,10.2679,15877,0,182,15695
2/25/22,Equatorial Guinea,1.6508,10.2679,15877,0,182,15695
2/26/22,Equatorial Guinea,1.6508,10.2679,15877,0,182,15695
2/27/22,Equatorial Guinea,1.6508,10.2679,15877,0,182,15695
2/28/22,Equatorial Guinea,1.6508,10.2679,15884,0,182,15702
3/1/22,Equatorial Guinea,1.6508,10.2679,15884,0,182,15702
3/2/22,Equatorial Guinea,1.6508,10.2679,15885,0,183,15702
3/3/22,Equatorial Guinea,1.6508,10.2679,15885,0,183,15702
3/4/22,Equatorial Guinea,1.6508,10.2679,15885,0,183,15702
3/5/22,Equatorial Guinea,1.6508,10.2679,15889,0,183,15706
3/6/22,Equatorial Guinea,1.6508,10.2679,15889,0,183,15706
3/7/22,Equatorial Guinea,1.6508,10.2679,15894,0,183,15711
3/8/22,Equatorial Guinea,1.6508,10.2679,15894,0,183,15711
3/9/22,Equatorial Guinea,1.6508,10.2679,15894,0,183,15711
3/10/22,Equatorial Guinea,1.6508,10.2679,15894,0,183,15711
3/11/22,Equatorial Guinea,1.6508,10.2679,15894,0,183,15711
3/12/22,Equatorial Guinea,1.6508,10.2679,15895,0,183,15712
3/13/22,Equatorial Guinea,1.6508,10.2679,15895,0,183,15712
3/14/22,Equatorial Guinea,1.6508,10.2679,15898,0,183,15715
3/15/22,Equatorial Guinea,1.6508,10.2679,15898,0,183,15715
3/16/22,Equatorial Guinea,1.6508,10.2679,15898,0,183,15715
3/17/22,Equatorial Guinea,1.6508,10.2679,15899,0,183,15716
3/18/22,Equatorial Guinea,1.6508,10.2679,15899,0,183,15716
3/19/22,Equatorial Guinea,1.6508,10.2679,15899,0,183,15716
3/20/22,Equatorial Guinea,1.6508,10.2679,15899,0,183,15716
3/21/22,Equatorial Guinea,1.6508,10.2679,15899,0,183,15716
3/22/22,Equatorial Guinea,1.6508,10.2679,15902,0,183,15719
3/23/22,Equatorial Guinea,1.6508,10.2679,15999,0,183,15816
3/24/22,Equatorial Guinea,1.6508,10.2679,15999,0,183,15816
3/25/22,Equatorial Guinea,1.6508,10.2679,15999,0,183,15816
3/26/22,Equatorial Guinea,1.6508,10.2679,15999,0,183,15816
3/27/22,Equatorial Guinea,1.6508,10.2679,15999,0,183,15816
3/28/22,Equatorial Guinea,1.6508,10.2679,16000,0,183,15817
3/29/22,Equatorial Guinea,1.6508,10.2679,16000,0,183,15817
3/30/22,Equatorial Guinea,1.6508,10.2679,16000,0,183,15817
3/31/22,Equatorial Guinea,1.6508,10.2679,16000,0,183,15817
4/1/22,Equatorial Guinea,1.6508,10.2679,16000,0,183,15817
4/2/22,Equatorial Guinea,1.6508,10.2679,16000,0,183,15817
4/3/22,Equatorial Guinea,1.6508,10.2679,16000,0,183,15817
4/4/22,Equatorial Guinea,1.6508,10.2679,16000,0,183,15817
4/5/22,Equatorial Guinea,1.6508,10.2679,16000,0,183,15817
4/6/22,Equatorial Guinea,1.6508,10.2679,16001,0,183,15818
4/7/22,Equatorial Guinea,1.6508,10.2679,16001,0,183,15818
4/8/22,Equatorial Guinea,1.6508,10.2679,16001,0,183,15818
4/9/22,Equatorial Guinea,1.6508,10.2679,16001,0,183,15818
4/10/22,Equatorial Guinea,1.6508,10.2679,16001,0,183,15818
4/11/22,Equatorial Guinea,1.6508,10.2679,15904,0,183,15721
4/12/22,Equatorial Guinea,1.6508,10.2679,15904,0,183,15721
4/13/22,Equatorial Guinea,1.6508,10.2679,15906,0,183,15723
4/14/22,Equatorial Guinea,1.6508,10.2679,15906,0,183,15723
4/15/22,Equatorial Guinea,1.6508,10.2679,15906,0,183,15723
4/16/22,Equatorial Guinea,1.6508,10.2679,15906,0,183,15723
4/17/22,Equatorial Guinea,1.6508,10.2679,15906,0,183,15723
4/18/22,Equatorial Guinea,1.6508,10.2679,15906,0,183,15723
4/19/22,Equatorial Guinea,1.6508,10.2679,15907,0,183,15724
4/20/22,Equatorial Guinea,1.6508,10.2679,15907,0,183,15724
4/21/22,Equatorial Guinea,1.6508,10.2679,15907,0,183,15724
4/22/22,Equatorial Guinea,1.6508,10.2679,15907,0,183,15724
4/23/22,Equatorial Guinea,1.6508,10.2679,15907,0,183,15724
4/24/22,Equatorial Guinea,1.6508,10.2679,15907,0,183,15724
4/25/22,Equatorial Guinea,1.6508,10.2679,15907,0,183,15724
4/26/22,Equatorial Guinea,1.6508,10.2679,15907,0,183,15724
4/27/22,Equatorial Guinea,1.6508,10.2679,15907,0,183,15724
4/28/22,Equatorial Guinea,1.6508,10.2679,15907,0,183,15724
4/29/22,Equatorial Guinea,1.6508,10.2679,15907,0,183,15724
4/30/22,Equatorial Guinea,1.6508,10.2679,15907,0,183,15724
5/1/22,Equatorial Guinea,1.6508,10.2679,15907,0,183,15724
5/2/22,Equatorial Guinea,1.6508,10.2679,15907,0,183,15724
5/3/22,Equatorial Guinea,1.6508,10.2679,15908,0,183,15725
5/4/22,Equatorial Guinea,1.6508,10.2679,15908,0,183,15725
5/5/22,Equatorial Guinea,1.6508,10.2679,15910,0,183,15727
5/6/22,Equatorial Guinea,1.6508,10.2679,15910,0,183,15727
5/7/22,Equatorial Guinea,1.6508,10.2679,15910,0,183,15727
5/8/22,Equatorial Guinea,1.6508,10.2679,15910,0,183,15727
5/9/22,Equatorial Guinea,1.6508,10.2679,15910,0,183,15727
5/10/22,Equatorial Guinea,1.6508,10.2679,15910,0,183,15727
5/11/22,Equatorial Guinea,1.6508,10.2679,15910,0,183,15727
5/12/22,Equatorial Guinea,1.6508,10.2679,15910,0,183,15727
5/13/22,Equatorial Guinea,1.6508,10.2679,15910,0,183,15727
5/14/22,Equatorial Guinea,1.6508,10.2679,15910,0,183,15727
5/15/22,Equatorial Guinea,1.6508,10.2679,15910,0,183,15727
5/16/22,Equatorial Guinea,1.6508,10.2679,15910,0,183,15727
5/17/22,Equatorial Guinea,1.6508,10.2679,15910,0,183,15727
5/18/22,Equatorial Guinea,1.6508,10.2679,15910,0,183,15727
5/19/22,Equatorial Guinea,1.6508,10.2679,15910,0,183,15727
5/20/22,Equatorial Guinea,1.6508,10.2679,15910,0,183,15727
5/21/22,Equatorial Guinea,1.6508,10.2679,15910,0,183,15727
5/22/22,Equatorial Guinea,1.6508,10.2679,15910,0,183,15727
5/23/22,Equatorial Guinea,1.6508,10.2679,15910,0,183,15727
5/24/22,Equatorial Guinea,1.6508,10.2679,15910,0,183,15727
5/25/22,Equatorial Guinea,1.6508,10.2679,15910,0,183,15727
5/26/22,Equatorial Guinea,1.6508,10.2679,15914,0,183,15731
5/27/22,Equatorial Guinea,1.6508,10.2679,15915,0,183,15732
5/28/22,Equatorial Guinea,1.6508,10.2679,15915,0,183,15732
5/29/22,Equatorial Guinea,1.6508,10.2679,15915,0,183,15732
5/30/22,Equatorial Guinea,1.6508,10.2679,15921,0,183,15738
5/31/22,Equatorial Guinea,1.6508,10.2679,15921,0,183,15738
6/1/22,Equatorial Guinea,1.6508,10.2679,15923,0,183,15740
6/2/22,Equatorial Guinea,1.6508,10.2679,15923,0,183,15740
6/3/22,Equatorial Guinea,1.6508,10.2679,15923,0,183,15740
6/4/22,Equatorial Guinea,1.6508,10.2679,15924,0,183,15741
6/5/22,Equatorial Guinea,1.6508,10.2679,15924,0,183,15741
6/6/22,Equatorial Guinea,1.6508,10.2679,15924,0,183,15741
6/7/22,Equatorial Guinea,1.6508,10.2679,15927,0,183,15744
6/8/22,Equatorial Guinea,1.6508,10.2679,15931,0,183,15748
6/9/22,Equatorial Guinea,1.6508,10.2679,15933,0,183,15750
6/10/22,Equatorial Guinea,1.6508,10.2679,15937,0,183,15754
6/11/22,Equatorial Guinea,1.6508,10.2679,15937,0,183,15754
6/12/22,Equatorial Guinea,1.6508,10.2679,15937,0,183,15754
6/13/22,Equatorial Guinea,1.6508,10.2679,15945,0,183,15762
6/14/22,Equatorial Guinea,1.6508,10.2679,15945,0,183,15762
6/15/22,Equatorial Guinea,1.6508,10.2679,15945,0,183,15762
6/16/22,Equatorial Guinea,1.6508,10.2679,15945,0,183,15762
6/17/22,Equatorial Guinea,1.6508,10.2679,15951,0,183,15768
6/18/22,Equatorial Guinea,1.6508,10.2679,15951,0,183,15768
6/19/22,Equatorial Guinea,1.6508,10.2679,15951,0,183,15768
6/20/22,Equatorial Guinea,1.6508,10.2679,15951,0,183,15768
6/21/22,Equatorial Guinea,1.6508,10.2679,15955,0,183,15772
6/22/22,Equatorial Guinea,1.6508,10.2679,15962,0,183,15779
6/23/22,Equatorial Guinea,1.6508,10.2679,15962,0,183,15779
6/24/22,Equatorial Guinea,1.6508,10.2679,15995,0,183,15812
6/25/22,Equatorial Guinea,1.6508,10.2679,15995,0,183,15812
6/26/22,Equatorial Guinea,1.6508,10.2679,15995,0,183,15812
6/27/22,Equatorial Guinea,1.6508,10.2679,15995,0,183,15812
6/28/22,Equatorial Guinea,1.6508,10.2679,16034,0,183,15851
6/29/22,Equatorial Guinea,1.6508,10.2679,16034,0,183,15851
6/30/22,Equatorial Guinea,1.6508,10.2679,16034,0,183,15851
7/1/22,Equatorial Guinea,1.6508,10.2679,16087,0,183,15904
7/2/22,Equatorial Guinea,1.6508,10.2679,16087,0,183,15904
7/3/22,Equatorial Guinea,1.6508,10.2679,16087,0,183,15904
7/4/22,Equatorial Guinea,1.6508,10.2679,16114,0,183,15931
7/5/22,Equatorial Guinea,1.6508,10.2679,16191,0,183,16008
7/6/22,Equatorial Guinea,1.6508,10.2679,16191,0,183,16008
7/7/22,Equatorial Guinea,1.6508,10.2679,16191,0,183,16008
7/8/22,Equatorial Guinea,1.6508,10.2679,16383,0,183,16200
7/9/22,Equatorial Guinea,1.6508,10.2679,16383,0,183,16200
7/10/22,Equatorial Guinea,1.6508,10.2679,16383,0,183,16200
7/11/22,Equatorial Guinea,1.6508,10.2679,16467,0,183,16284
7/12/22,Equatorial Guinea,1.6508,10.2679,16504,0,183,16321
7/13/22,Equatorial Guinea,1.6508,10.2679,16504,0,183,16321
7/14/22,Equatorial Guinea,1.6508,10.2679,16504,0,183,16321
7/15/22,Equatorial Guinea,1.6508,10.2679,16584,0,183,16401
7/16/22,Equatorial Guinea,1.6508,10.2679,16584,0,183,16401
7/17/22,Equatorial Guinea,1.6508,10.2679,16584,0,183,16401
7/18/22,Equatorial Guinea,1.6508,10.2679,16621,0,183,16438
7/19/22,Equatorial Guinea,1.6508,10.2679,16621,0,183,16438
7/20/22,Equatorial Guinea,1.6508,10.2679,16654,0,183,16471
7/21/22,Equatorial Guinea,1.6508,10.2679,16654,0,183,16471
7/22/22,Equatorial Guinea,1.6508,10.2679,16654,0,183,16471
7/23/22,Equatorial Guinea,1.6508,10.2679,16654,0,183,16471
7/24/22,Equatorial Guinea,1.6508,10.2679,16654,0,183,16471
7/25/22,Equatorial Guinea,1.6508,10.2679,16704,0,183,16521
7/26/22,Equatorial Guinea,1.6508,10.2679,16704,0,183,16521
7/27/22,Equatorial Guinea,1.6508,10.2679,16708,0,183,16525
7/28/22,Equatorial Guinea,1.6508,10.2679,16708,0,183,16525
7/29/22,Equatorial Guinea,1.6508,10.2679,16723,0,183,16540
7/30/22,Equatorial Guinea,1.6508,10.2679,16723,0,183,16540
7/31/22,Equatorial Guinea,1.6508,10.2679,16723,0,183,16540
8/1/22,Equatorial Guinea,1.6508,10.2679,16741,0,183,16558
8/2/22,Equatorial Guinea,1.6508,10.2679,16741,0,183,16558
8/3/22,Equatorial Guinea,1.6508,10.2679,16741,0,183,16558
8/4/22,Equatorial Guinea,1.6508,10.2679,16741,0,183,16558
8/5/22,Equatorial Guinea,1.6508,10.2679,16771,0,183,16588
8/6/22,Equatorial Guinea,1.6508,10.2679,16776,0,183,16593
8/7/22,Equatorial Guinea,1.6508,10.2679,16776,0,183,16593
8/8/22,Equatorial Guinea,1.6508,10.2679,16785,0,183,16602
8/9/22,Equatorial Guinea,1.6508,10.2679,16789,0,183,16606
8/10/22,Equatorial Guinea,1.6508,10.2679,16789,0,183,16606
8/11/22,Equatorial Guinea,1.6508,10.2679,16795,0,183,16612
8/12/22,Equatorial Guinea,1.6508,10.2679,16892,0,183,16709
8/13/22,Equatorial Guinea,1.6508,10.2679,16892,0,183,16709
8/14/22,Equatorial Guinea,1.6508,10.2679,16892,0,183,16709
8/15/22,Equatorial Guinea,1.6508,10.2679,16898,0,183,16715
8/16/22,Equatorial Guinea,1.6508,10.2679,16898,0,183,16715
8/17/22,Equatorial Guinea,1.6508,10.2679,16914,0,183,16731
8/18/22,Equatorial Guinea,1.6508,10.2679,16914,0,183,16731
8/19/22,Equatorial Guinea,1.6508,10.2679,16917,0,183,16734
8/20/22,Equatorial Guinea,1.6508,10.2679,16917,0,183,16734
8/21/22,Equatorial Guinea,1.6508,10.2679,16917,0,183,16734
8/22/22,Equatorial Guinea,1.6508,10.2679,16920,0,183,16737
8/23/22,Equatorial Guinea,1.6508,10.2679,16937,0,183,16754
8/24/22,Equatorial Guinea,1.6508,10.2679,16938,0,183,16755
8/25/22,Equatorial Guinea,1.6508,10.2679,16938,0,183,16755
8/26/22,Equatorial Guinea,1.6508,10.2679,16945,0,183,16762
8/27/22,Equatorial Guinea,1.6508,10.2679,16945,0,183,16762
8/28/22,Equatorial Guinea,1.6508,10.2679,16945,0,183,16762
8/29/22,Equatorial Guinea,1.6508,10.2679,16946,0,183,16763
8/30/22,Equatorial Guinea,1.6508,10.2679,16950,0,183,16767
8/31/22,Equatorial Guinea,1.6508,10.2679,16956,0,183,16773
9/1/22,Equatorial Guinea,1.6508,10.2679,16956,0,183,16773
9/2/22,Equatorial Guinea,1.6508,10.2679,16957,0,183,16774
9/3/22,Equatorial Guinea,1.6508,10.2679,16957,0,183,16774
9/4/22,Equatorial Guinea,1.6508,10.2679,16957,0,183,16774
9/5/22,Equatorial Guinea,1.6508,10.2679,16957,0,183,16774
9/6/22,Equatorial Guinea,1.6508,10.2679,16962,0,183,16779
9/7/22,Equatorial Guinea,1.6508,10.2679,16964,0,183,16781
9/8/22,Equatorial Guinea,1.6508,10.2679,16964,0,183,16781
9/9/22,Equatorial Guinea,1.6508,10.2679,16965,0,183,16782
9/10/22,Equatorial Guinea,1.6508,10.2679,16965,0,183,16782
9/11/22,Equatorial Guinea,1.6508,10.2679,16965,0,183,16782
9/12/22,Equatorial Guinea,1.6508,10.2679,16965,0,183,16782
9/13/22,Equatorial Guinea,1.6508,10.2679,16970,0,183,16787
9/14/22,Equatorial Guinea,1.6508,10.2679,16990,0,183,16807
9/15/22,Equatorial Guinea,1.6508,10.2679,16991,0,183,16808
9/16/22,Equatorial Guinea,1.6508,10.2679,16991,0,183,16808
9/17/22,Equatorial Guinea,1.6508,10.2679,16991,0,183,16808
9/18/22,Equatorial Guinea,1.6508,10.2679,16991,0,183,16808
9/19/22,Equatorial Guinea,1.6508,10.2679,16991,0,183,16808
9/20/22,Equatorial Guinea,1.6508,10.2679,16994,0,183,16811
9/21/22,Equatorial Guinea,1.6508,10.2679,17006,0,183,16823
9/22/22,Equatorial Guinea,1.6508,10.2679,17006,0,183,16823
9/23/22,Equatorial Guinea,1.6508,10.2679,17009,0,183,16826
9/24/22,Equatorial Guinea,1.6508,10.2679,17009,0,183,16826
9/25/22,Equatorial Guinea,1.6508,10.2679,17009,0,183,16826
9/26/22,Equatorial Guinea,1.6508,10.2679,17010,0,183,16827
9/27/22,Equatorial Guinea,1.6508,10.2679,17010,0,183,16827
9/28/22,Equatorial Guinea,1.6508,10.2679,17010,0,183,16827
9/29/22,Equatorial Guinea,1.6508,10.2679,17012,0,183,16829
9/30/22,Equatorial Guinea,1.6508,10.2679,17012,0,183,16829
10/1/22,Equatorial Guinea,1.6508,10.2679,17012,0,183,16829
10/2/22,Equatorial Guinea,1.6508,10.2679,17012,0,183,16829
10/3/22,Equatorial Guinea,1.6508,10.2679,17016,0,183,16833
10/4/22,Equatorial Guinea,1.6508,10.2679,17016,0,183,16833
10/5/22,Equatorial Guinea,1.6508,10.2679,17025,0,183,16842
10/6/22,Equatorial Guinea,1.6508,10.2679,17025,0,183,16842
10/7/22,Equatorial Guinea,1.6508,10.2679,17030,0,183,16847
10/8/22,Equatorial Guinea,1.6508,10.2679,17030,0,183,16847
10/9/22,Equatorial Guinea,1.6508,10.2679,17030,0,183,16847
10/10/22,Equatorial Guinea,1.6508,10.2679,17040,0,183,16857
10/11/22,Equatorial Guinea,1.6508,10.2679,17046,0,183,16863
10/12/22,Equatorial Guinea,1.6508,10.2679,17046,0,183,16863
10/13/22,Equatorial Guinea,1.6508,10.2679,17046,0,183,16863
10/14/22,Equatorial Guinea,1.6508,10.2679,17081,0,183,16898
10/15/22,Equatorial Guinea,1.6508,10.2679,17081,0,183,16898
10/16/22,Equatorial Guinea,1.6508,10.2679,17081,0,183,16898
10/17/22,Equatorial Guinea,1.6508,10.2679,17117,0,183,16934
10/18/22,Equatorial Guinea,1.6508,10.2679,17117,0,183,16934
10/19/22,Equatorial Guinea,1.6508,10.2679,17131,0,183,16948
10/20/22,Equatorial Guinea,1.6508,10.2679,17133,0,183,16950
10/21/22,Equatorial Guinea,1.6508,10.2679,17133,0,183,16950
10/22/22,Equatorial Guinea,1.6508,10.2679,17133,0,183,16950
10/23/22,Equatorial Guinea,1.6508,10.2679,17133,0,183,16950
10/24/22,Equatorial Guinea,1.6508,10.2679,17133,0,183,16950
10/25/22,Equatorial Guinea,1.6508,10.2679,17153,0,183,16970
10/26/22,Equatorial Guinea,1.6508,10.2679,17163,0,183,16980
10/27/22,Equatorial Guinea,1.6508,10.2679,17171,0,183,16988
10/28/22,Equatorial Guinea,1.6508,10.2679,17171,0,183,16988
10/29/22,Equatorial Guinea,1.6508,10.2679,17171,0,183,16988
10/30/22,Equatorial Guinea,1.6508,10.2679,17171,0,183,16988
10/31/22,Equatorial Guinea,1.6508,10.2679,17171,0,183,16988
11/1/22,Equatorial Guinea,1.6508,10.2679,17173,0,183,16990
11/2/22,Equatorial Guinea,1.6508,10.2679,17174,0,183,16991
11/3/22,Equatorial Guinea,1.6508,10.2679,17174,0,183,16991
11/4/22,Equatorial Guinea,1.6508,10.2679,17174,0,183,16991
11/5/22,Equatorial Guinea,1.6508,10.2679,17174,0,183,16991
11/6/22,Equatorial Guinea,1.6508,10.2679,17174,0,183,16991
11/7/22,Equatorial Guinea,1.6508,10.2679,17174,0,183,16991
11/8/22,Equatorial Guinea,1.6508,10.2679,17178,0,183,16995
11/9/22,Equatorial Guinea,1.6508,10.2679,17178,0,183,16995
11/10/22,Equatorial Guinea,1.6508,10.2679,17182,0,183,16999
11/11/22,Equatorial Guinea,1.6508,10.2679,17182,0,183,16999
11/12/22,Equatorial Guinea,1.6508,10.2679,17182,0,183,16999
11/13/22,Equatorial Guinea,1.6508,10.2679,17182,0,183,16999
11/14/22,Equatorial Guinea,1.6508,10.2679,17182,0,183,16999
11/15/22,Equatorial Guinea,1.6508,10.2679,17182,0,183,16999
11/16/22,Equatorial Guinea,1.6508,10.2679,17182,0,183,16999
11/17/22,Equatorial Guinea,1.6508,10.2679,17182,0,183,16999
11/18/22,Equatorial Guinea,1.6508,10.2679,17182,0,183,16999
11/19/22,Equatorial Guinea,1.6508,10.2679,17182,0,183,16999
11/20/22,Equatorial Guinea,1.6508,10.2679,17182,0,183,16999
11/21/22,Equatorial Guinea,1.6508,10.2679,17182,0,183,16999
11/22/22,Equatorial Guinea,1.6508,10.2679,17182,0,183,16999
11/23/22,Equatorial Guinea,1.6508,10.2679,17182,0,183,16999
11/24/22,Equatorial Guinea,1.6508,10.2679,17182,0,183,16999
11/25/22,Equatorial Guinea,1.6508,10.2679,17182,0,183,16999
11/26/22,Equatorial Guinea,1.6508,10.2679,17182,0,183,16999
11/27/22,Equatorial Guinea,1.6508,10.2679,17182,0,183,16999
11/28/22,Equatorial Guinea,1.6508,10.2679,17182,0,183,16999
11/29/22,Equatorial Guinea,1.6508,10.2679,17183,0,183,17000
11/30/22,Equatorial Guinea,1.6508,10.2679,17183,0,183,17000
12/1/22,Equatorial Guinea,1.6508,10.2679,17183,0,183,17000
12/2/22,Equatorial Guinea,1.6508,10.2679,17183,0,183,17000
12/3/22,Equatorial Guinea,1.6508,10.2679,17183,0,183,17000
12/4/22,Equatorial Guinea,1.6508,10.2679,17183,0,183,17000
12/5/22,Equatorial Guinea,1.6508,10.2679,17183,0,183,17000
12/6/22,Equatorial Guinea,1.6508,10.2679,17184,0,183,17001
12/7/22,Equatorial Guinea,1.6508,10.2679,17184,0,183,17001
12/8/22,Equatorial Guinea,1.6508,10.2679,17184,0,183,17001
12/9/22,Equatorial Guinea,1.6508,10.2679,17184,0,183,17001
12/10/22,Equatorial Guinea,1.6508,10.2679,17184,0,183,17001
12/11/22,Equatorial Guinea,1.6508,10.2679,17184,0,183,17001
12/12/22,Equatorial Guinea,1.6508,10.2679,17184,0,183,17001
12/13/22,Equatorial Guinea,1.6508,10.2679,17184,0,183,17001
12/14/22,Equatorial Guinea,1.6508,10.2679,17186,0,183,17003
12/15/22,Equatorial Guinea,1.6508,10.2679,17186,0,183,17003
12/16/22,Equatorial Guinea,1.6508,10.2679,17186,0,183,17003
12/17/22,Equatorial Guinea,1.6508,10.2679,17186,0,183,17003
1/1/22,Eritrea,15.1794,39.7823,8026,0,76,7950
1/2/22,Eritrea,15.1794,39.7823,8049,0,76,7973
1/3/22,Eritrea,15.1794,39.7823,8063,0,76,7987
1/4/22,Eritrea,15.1794,39.7823,8128,0,77,8051
1/5/22,Eritrea,15.1794,39.7823,8161,0,78,8083
1/6/22,Eritrea,15.1794,39.7823,8211,0,79,8132
1/7/22,Eritrea,15.1794,39.7823,8262,0,80,8182
1/8/22,Eritrea,15.1794,39.7823,8303,0,82,8221
1/9/22,Eritrea,15.1794,39.7823,8335,0,82,8253
1/10/22,Eritrea,15.1794,39.7823,8419,0,82,8337
1/11/22,Eritrea,15.1794,39.7823,8559,0,84,8475
1/12/22,Eritrea,15.1794,39.7823,8653,0,84,8569
1/13/22,Eritrea,15.1794,39.7823,8755,0,85,8670
1/14/22,Eritrea,15.1794,39.7823,8845,0,85,8760
1/15/22,Eritrea,15.1794,39.7823,8876,0,86,8790
1/16/22,Eritrea,15.1794,39.7823,8910,0,87,8823
1/17/22,Eritrea,15.1794,39.7823,9002,0,88,8914
1/18/22,Eritrea,15.1794,39.7823,9085,0,89,8996
1/19/22,Eritrea,15.1794,39.7823,9115,0,89,9026
1/20/22,Eritrea,15.1794,39.7823,9160,0,89,9071
1/21/22,Eritrea,15.1794,39.7823,9192,0,90,9102
1/22/22,Eritrea,15.1794,39.7823,9250,0,91,9159
1/23/22,Eritrea,15.1794,39.7823,9297,0,93,9204
1/24/22,Eritrea,15.1794,39.7823,9332,0,95,9237
1/25/22,Eritrea,15.1794,39.7823,9390,0,95,9295
1/26/22,Eritrea,15.1794,39.7823,9408,0,96,9312
1/27/22,Eritrea,15.1794,39.7823,9436,0,97,9339
1/28/22,Eritrea,15.1794,39.7823,9489,0,97,9392
1/29/22,Eritrea,15.1794,39.7823,9508,0,97,9411
1/30/22,Eritrea,15.1794,39.7823,9525,0,98,9427
1/31/22,Eritrea,15.1794,39.7823,9536,0,98,9438
2/1/22,Eritrea,15.1794,39.7823,9536,0,98,9438
2/2/22,Eritrea,15.1794,39.7823,9580,0,99,9481
2/3/22,Eritrea,15.1794,39.7823,9601,0,99,9502
2/4/22,Eritrea,15.1794,39.7823,9619,0,100,9519
2/5/22,Eritrea,15.1794,39.7823,9631,0,100,9531
2/6/22,Eritrea,15.1794,39.7823,9637,0,100,9537
2/7/22,Eritrea,15.1794,39.7823,9644,0,101,9543
2/8/22,Eritrea,15.1794,39.7823,9651,0,101,9550
2/9/22,Eritrea,15.1794,39.7823,9652,0,102,9550
2/10/22,Eritrea,15.1794,39.7823,9660,0,102,9558
2/11/22,Eritrea,15.1794,39.7823,9662,0,102,9560
2/12/22,Eritrea,15.1794,39.7823,9664,0,103,9561
2/13/22,Eritrea,15.1794,39.7823,9668,0,103,9565
2/14/22,Eritrea,15.1794,39.7823,9675,0,103,9572
2/15/22,Eritrea,15.1794,39.7823,9679,0,103,9576
2/16/22,Eritrea,15.1794,39.7823,9680,0,103,9577
2/17/22,Eritrea,15.1794,39.7823,9681,0,103,9578
2/18/22,Eritrea,15.1794,39.7823,9683,0,103,9580
2/19/22,Eritrea,15.1794,39.7823,9687,0,103,9584
2/20/22,Eritrea,15.1794,39.7823,9687,0,103,9584
2/21/22,Eritrea,15.1794,39.7823,9689,0,103,9586
2/22/22,Eritrea,15.1794,39.7823,9689,0,103,9586
2/23/22,Eritrea,15.1794,39.7823,9694,0,103,9591
2/24/22,Eritrea,15.1794,39.7823,9696,0,103,9593
2/25/22,Eritrea,15.1794,39.7823,9698,0,103,9595
2/26/22,Eritrea,15.1794,39.7823,9700,0,103,9597
2/27/22,Eritrea,15.1794,39.7823,9700,0,103,9597
2/28/22,Eritrea,15.1794,39.7823,9701,0,103,9598
3/1/22,Eritrea,15.1794,39.7823,9704,0,103,9601
3/2/22,Eritrea,15.1794,39.7823,9705,0,103,9602
3/3/22,Eritrea,15.1794,39.7823,9707,0,103,9604
3/4/22,Eritrea,15.1794,39.7823,9708,0,103,9605
3/5/22,Eritrea,15.1794,39.7823,9715,0,103,9612
3/6/22,Eritrea,15.1794,39.7823,9715,0,103,9612
3/7/22,Eritrea,15.1794,39.7823,9716,0,103,9613
3/8/22,Eritrea,15.1794,39.7823,9716,0,103,9613
3/9/22,Eritrea,15.1794,39.7823,9718,0,103,9615
3/10/22,Eritrea,15.1794,39.7823,9719,0,103,9616
3/11/22,Eritrea,15.1794,39.7823,9720,0,103,9617
3/12/22,Eritrea,15.1794,39.7823,9721,0,103,9618
3/13/22,Eritrea,15.1794,39.7823,9721,0,103,9618
3/14/22,Eritrea,15.1794,39.7823,9722,0,103,9619
3/15/22,Eritrea,15.1794,39.7823,9722,0,103,9619
3/16/22,Eritrea,15.1794,39.7823,9722,0,103,9619
3/17/22,Eritrea,15.1794,39.7823,9722,0,103,9619
3/18/22,Eritrea,15.1794,39.7823,9723,0,103,9620
3/19/22,Eritrea,15.1794,39.7823,9723,0,103,9620
3/20/22,Eritrea,15.1794,39.7823,9723,0,103,9620
3/21/22,Eritrea,15.1794,39.7823,9723,0,103,9620
3/22/22,Eritrea,15.1794,39.7823,9723,0,103,9620
3/23/22,Eritrea,15.1794,39.7823,9723,0,103,9620
3/24/22,Eritrea,15.1794,39.7823,9723,0,103,9620
3/25/22,Eritrea,15.1794,39.7823,9724,0,103,9621
3/26/22,Eritrea,15.1794,39.7823,9724,0,103,9621
3/27/22,Eritrea,15.1794,39.7823,9724,0,103,9621
3/28/22,Eritrea,15.1794,39.7823,9724,0,103,9621
3/29/22,Eritrea,15.1794,39.7823,9724,0,103,9621
3/30/22,Eritrea,15.1794,39.7823,9727,0,103,9624
3/31/22,Eritrea,15.1794,39.7823,9728,0,103,9625
4/1/22,Eritrea,15.1794,39.7823,9728,0,103,9625
4/2/22,Eritrea,15.1794,39.7823,9728,0,103,9625
4/3/22,Eritrea,15.1794,39.7823,9728,0,103,9625
4/4/22,Eritrea,15.1794,39.7823,9728,0,103,9625
4/5/22,Eritrea,15.1794,39.7823,9728,0,103,9625
4/6/22,Eritrea,15.1794,39.7823,9728,0,103,9625
4/7/22,Eritrea,15.1794,39.7823,9728,0,103,9625
4/8/22,Eritrea,15.1794,39.7823,9729,0,103,9626
4/9/22,Eritrea,15.1794,39.7823,9729,0,103,9626
4/10/22,Eritrea,15.1794,39.7823,9731,0,103,9628
4/11/22,Eritrea,15.1794,39.7823,9732,0,103,9629
4/12/22,Eritrea,15.1794,39.7823,9732,0,103,9629
4/13/22,Eritrea,15.1794,39.7823,9733,0,103,9630
4/14/22,Eritrea,15.1794,39.7823,9733,0,103,9630
4/15/22,Eritrea,15.1794,39.7823,9733,0,103,9630
4/16/22,Eritrea,15.1794,39.7823,9733,0,103,9630
4/17/22,Eritrea,15.1794,39.7823,9733,0,103,9630
4/18/22,Eritrea,15.1794,39.7823,9733,0,103,9630
4/19/22,Eritrea,15.1794,39.7823,9733,0,103,9630
4/20/22,Eritrea,15.1794,39.7823,9733,0,103,9630
4/21/22,Eritrea,15.1794,39.7823,9733,0,103,9630
4/22/22,Eritrea,15.1794,39.7823,9734,0,103,9631
4/23/22,Eritrea,15.1794,39.7823,9734,0,103,9631
4/24/22,Eritrea,15.1794,39.7823,9734,0,103,9631
4/25/22,Eritrea,15.1794,39.7823,9734,0,103,9631
4/26/22,Eritrea,15.1794,39.7823,9734,0,103,9631
4/27/22,Eritrea,15.1794,39.7823,9734,0,103,9631
4/28/22,Eritrea,15.1794,39.7823,9734,0,103,9631
4/29/22,Eritrea,15.1794,39.7823,9734,0,103,9631
4/30/22,Eritrea,15.1794,39.7823,9734,0,103,9631
5/1/22,Eritrea,15.1794,39.7823,9734,0,103,9631
5/2/22,Eritrea,15.1794,39.7823,9734,0,103,9631
5/3/22,Eritrea,15.1794,39.7823,9734,0,103,9631
5/4/22,Eritrea,15.1794,39.7823,9735,0,103,9632
5/5/22,Eritrea,15.1794,39.7823,9735,0,103,9632
5/6/22,Eritrea,15.1794,39.7823,9737,0,103,9634
5/7/22,Eritrea,15.1794,39.7823,9737,0,103,9634
5/8/22,Eritrea,15.1794,39.7823,9737,0,103,9634
5/9/22,Eritrea,15.1794,39.7823,9738,0,103,9635
5/10/22,Eritrea,15.1794,39.7823,9738,0,103,9635
5/11/22,Eritrea,15.1794,39.7823,9738,0,103,9635
5/12/22,Eritrea,15.1794,39.7823,9740,0,103,9637
5/13/22,Eritrea,15.1794,39.7823,9745,0,103,9642
5/14/22,Eritrea,15.1794,39.7823,9745,0,103,9642
5/15/22,Eritrea,15.1794,39.7823,9745,0,103,9642
5/16/22,Eritrea,15.1794,39.7823,9745,0,103,9642
5/17/22,Eritrea,15.1794,39.7823,9751,0,103,9648
5/18/22,Eritrea,15.1794,39.7823,9751,0,103,9648
5/19/22,Eritrea,15.1794,39.7823,9751,0,103,9648
5/20/22,Eritrea,15.1794,39.7823,9753,0,103,9650
5/21/22,Eritrea,15.1794,39.7823,9754,0,103,9651
5/22/22,Eritrea,15.1794,39.7823,9754,0,103,9651
5/23/22,Eritrea,15.1794,39.7823,9755,0,103,9652
5/24/22,Eritrea,15.1794,39.7823,9755,0,103,9652
5/25/22,Eritrea,15.1794,39.7823,9756,0,103,9653
5/26/22,Eritrea,15.1794,39.7823,9756,0,103,9653
5/27/22,Eritrea,15.1794,39.7823,9757,0,103,9654
5/28/22,Eritrea,15.1794,39.7823,9757,0,103,9654
5/29/22,Eritrea,15.1794,39.7823,9757,0,103,9654
5/30/22,Eritrea,15.1794,39.7823,9759,0,103,9656
5/31/22,Eritrea,15.1794,39.7823,9759,0,103,9656
6/1/22,Eritrea,15.1794,39.7823,9764,0,103,9661
6/2/22,Eritrea,15.1794,39.7823,9765,0,103,9662
6/3/22,Eritrea,15.1794,39.7823,9767,0,103,9664
6/4/22,Eritrea,15.1794,39.7823,9767,0,103,9664
6/5/22,Eritrea,15.1794,39.7823,9767,0,103,9664
6/6/22,Eritrea,15.1794,39.7823,9768,0,103,9665
6/7/22,Eritrea,15.1794,39.7823,9768,0,103,9665
6/8/22,Eritrea,15.1794,39.7823,9768,0,103,9665
6/9/22,Eritrea,15.1794,39.7823,9768,0,103,9665
6/10/22,Eritrea,15.1794,39.7823,9769,0,103,9666
6/11/22,Eritrea,15.1794,39.7823,9769,0,103,9666
6/12/22,Eritrea,15.1794,39.7823,9771,0,103,9668
6/13/22,Eritrea,15.1794,39.7823,9771,0,103,9668
6/14/22,Eritrea,15.1794,39.7823,9773,0,103,9670
6/15/22,Eritrea,15.1794,39.7823,9773,0,103,9670
6/16/22,Eritrea,15.1794,39.7823,9775,0,103,9672
6/17/22,Eritrea,15.1794,39.7823,9775,0,103,9672
6/18/22,Eritrea,15.1794,39.7823,9777,0,103,9674
6/19/22,Eritrea,15.1794,39.7823,9777,0,103,9674
6/20/22,Eritrea,15.1794,39.7823,9777,0,103,9674
6/21/22,Eritrea,15.1794,39.7823,9782,0,103,9679
6/22/22,Eritrea,15.1794,39.7823,9784,0,103,9681
6/23/22,Eritrea,15.1794,39.7823,9785,0,103,9682
6/24/22,Eritrea,15.1794,39.7823,9788,0,103,9685
6/25/22,Eritrea,15.1794,39.7823,9788,0,103,9685
6/26/22,Eritrea,15.1794,39.7823,9788,0,103,9685
6/27/22,Eritrea,15.1794,39.7823,9792,0,103,9689
6/28/22,Eritrea,15.1794,39.7823,9796,0,103,9693
6/29/22,Eritrea,15.1794,39.7823,9796,0,103,9693
6/30/22,Eritrea,15.1794,39.7823,9799,0,103,9696
7/1/22,Eritrea,15.1794,39.7823,9801,0,103,9698
7/2/22,Eritrea,15.1794,39.7823,9801,0,103,9698
7/3/22,Eritrea,15.1794,39.7823,9801,0,103,9698
7/4/22,Eritrea,15.1794,39.7823,9805,0,103,9702
7/5/22,Eritrea,15.1794,39.7823,9810,0,103,9707
7/6/22,Eritrea,15.1794,39.7823,9811,0,103,9708
7/7/22,Eritrea,15.1794,39.7823,9811,0,103,9708
7/8/22,Eritrea,15.1794,39.7823,9811,0,103,9708
7/9/22,Eritrea,15.1794,39.7823,9824,0,103,9721
7/10/22,Eritrea,15.1794,39.7823,9824,0,103,9721
7/11/22,Eritrea,15.1794,39.7823,9827,0,103,9724
7/12/22,Eritrea,15.1794,39.7823,9827,0,103,9724
7/13/22,Eritrea,15.1794,39.7823,9844,0,103,9741
7/14/22,Eritrea,15.1794,39.7823,9852,0,103,9749
7/15/22,Eritrea,15.1794,39.7823,9852,0,103,9749
7/16/22,Eritrea,15.1794,39.7823,9864,0,103,9761
7/17/22,Eritrea,15.1794,39.7823,9878,0,103,9775
7/18/22,Eritrea,15.1794,39.7823,9882,0,103,9779
7/19/22,Eritrea,15.1794,39.7823,9892,0,103,9789
7/20/22,Eritrea,15.1794,39.7823,9898,0,103,9795
7/21/22,Eritrea,15.1794,39.7823,9907,0,103,9804
7/22/22,Eritrea,15.1794,39.7823,9916,0,103,9813
7/23/22,Eritrea,15.1794,39.7823,9928,0,103,9825
7/24/22,Eritrea,15.1794,39.7823,9928,0,103,9825
7/25/22,Eritrea,15.1794,39.7823,9944,0,103,9841
7/26/22,Eritrea,15.1794,39.7823,9966,0,103,9863
7/27/22,Eritrea,15.1794,39.7823,9980,0,103,9877
7/28/22,Eritrea,15.1794,39.7823,9995,0,103,9892
7/29/22,Eritrea,15.1794,39.7823,10014,0,103,9911
7/30/22,Eritrea,15.1794,39.7823,10032,0,103,9929
7/31/22,Eritrea,15.1794,39.7823,10045,0,103,9942
8/1/22,Eritrea,15.1794,39.7823,10054,0,103,9951
8/2/22,Eritrea,15.1794,39.7823,10074,0,103,9971
8/3/22,Eritrea,15.1794,39.7823,10087,0,103,9984
8/4/22,Eritrea,15.1794,39.7823,10095,0,103,9992
8/5/22,Eritrea,15.1794,39.7823,10109,0,103,10006
8/6/22,Eritrea,15.1794,39.7823,10116,0,103,10013
8/7/22,Eritrea,15.1794,39.7823,10118,0,103,10015
8/8/22,Eritrea,15.1794,39.7823,10124,0,103,10021
8/9/22,Eritrea,15.1794,39.7823,10126,0,103,10023
8/10/22,Eritrea,15.1794,39.7823,10126,0,103,10023
8/11/22,Eritrea,15.1794,39.7823,10130,0,103,10027
8/12/22,Eritrea,15.1794,39.7823,10133,0,103,10030
8/13/22,Eritrea,15.1794,39.7823,10134,0,103,10031
8/14/22,Eritrea,15.1794,39.7823,10136,0,103,10033
8/15/22,Eritrea,15.1794,39.7823,10137,0,103,10034
8/16/22,Eritrea,15.1794,39.7823,10141,0,103,10038
8/17/22,Eritrea,15.1794,39.7823,10143,0,103,10040
8/18/22,Eritrea,15.1794,39.7823,10146,0,103,10043
8/19/22,Eritrea,15.1794,39.7823,10149,0,103,10046
8/20/22,Eritrea,15.1794,39.7823,10149,0,103,10046
8/21/22,Eritrea,15.1794,39.7823,10149,0,103,10046
8/22/22,Eritrea,15.1794,39.7823,10149,0,103,10046
8/23/22,Eritrea,15.1794,39.7823,10149,0,103,10046
8/24/22,Eritrea,15.1794,39.7823,10149,0,103,10046
8/25/22,Eritrea,15.1794,39.7823,10149,0,103,10046
8/26/22,Eritrea,15.1794,39.7823,10151,0,103,10048
8/27/22,Eritrea,15.1794,39.7823,10151,0,103,10048
8/28/22,Eritrea,15.1794,39.7823,10154,0,103,10051
8/29/22,Eritrea,15.1794,39.7823,10154,0,103,10051
8/30/22,Eritrea,15.1794,39.7823,10154,0,103,10051
8/31/22,Eritrea,15.1794,39.7823,10154,0,103,10051
9/1/22,Eritrea,15.1794,39.7823,10155,0,103,10052
9/2/22,Eritrea,15.1794,39.7823,10155,0,103,10052
9/3/22,Eritrea,15.1794,39.7823,10155,0,103,10052
9/4/22,Eritrea,15.1794,39.7823,10155,0,103,10052
9/5/22,Eritrea,15.1794,39.7823,10157,0,103,10054
9/6/22,Eritrea,15.1794,39.7823,10158,0,103,10055
9/7/22,Eritrea,15.1794,39.7823,10158,0,103,10055
9/8/22,Eritrea,15.1794,39.7823,10158,0,103,10055
9/9/22,Eritrea,15.1794,39.7823,10163,0,103,10060
9/10/22,Eritrea,15.1794,39.7823,10163,0,103,10060
9/11/22,Eritrea,15.1794,39.7823,10163,0,103,10060
9/12/22,Eritrea,15.1794,39.7823,10163,0,103,10060
9/13/22,Eritrea,15.1794,39.7823,10163,0,103,10060
9/14/22,Eritrea,15.1794,39.7823,10164,0,103,10061
9/15/22,Eritrea,15.1794,39.7823,10164,0,103,10061
9/16/22,Eritrea,15.1794,39.7823,10164,0,103,10061
9/17/22,Eritrea,15.1794,39.7823,10164,0,103,10061
9/18/22,Eritrea,15.1794,39.7823,10164,0,103,10061
9/19/22,Eritrea,15.1794,39.7823,10164,0,103,10061
9/20/22,Eritrea,15.1794,39.7823,10164,0,103,10061
9/21/22,Eritrea,15.1794,39.7823,10168,0,103,10065
9/22/22,Eritrea,15.1794,39.7823,10168,0,103,10065
9/23/22,Eritrea,15.1794,39.7823,10168,0,103,10065
9/24/22,Eritrea,15.1794,39.7823,10168,0,103,10065
9/25/22,Eritrea,15.1794,39.7823,10168,0,103,10065
9/26/22,Eritrea,15.1794,39.7823,10169,0,103,10066
9/27/22,Eritrea,15.1794,39.7823,10169,0,103,10066
9/28/22,Eritrea,15.1794,39.7823,10169,0,103,10066
9/29/22,Eritrea,15.1794,39.7823,10169,0,103,10066
9/30/22,Eritrea,15.1794,39.7823,10170,0,103,10067
10/1/22,Eritrea,15.1794,39.7823,10170,0,103,10067
10/2/22,Eritrea,15.1794,39.7823,10170,0,103,10067
10/3/22,Eritrea,15.1794,39.7823,10173,0,103,10070
10/4/22,Eritrea,15.1794,39.7823,10173,0,103,10070
10/5/22,Eritrea,15.1794,39.7823,10175,0,103,10072
10/6/22,Eritrea,15.1794,39.7823,10175,0,103,10072
10/7/22,Eritrea,15.1794,39.7823,10175,0,103,10072
10/8/22,Eritrea,15.1794,39.7823,10177,0,103,10074
10/9/22,Eritrea,15.1794,39.7823,10180,0,103,10077
10/10/22,Eritrea,15.1794,39.7823,10180,0,103,10077
10/11/22,Eritrea,15.1794,39.7823,10180,0,103,10077
10/12/22,Eritrea,15.1794,39.7823,10182,0,103,10079
10/13/22,Eritrea,15.1794,39.7823,10182,0,103,10079
10/14/22,Eritrea,15.1794,39.7823,10182,0,103,10079
10/15/22,Eritrea,15.1794,39.7823,10182,0,103,10079
10/16/22,Eritrea,15.1794,39.7823,10182,0,103,10079
10/17/22,Eritrea,15.1794,39.7823,10182,0,103,10079
10/18/22,Eritrea,15.1794,39.7823,10182,0,103,10079
10/19/22,Eritrea,15.1794,39.7823,10185,0,103,10082
10/20/22,Eritrea,15.1794,39.7823,10185,0,103,10082
10/21/22,Eritrea,15.1794,39.7823,10185,0,103,10082
10/22/22,Eritrea,15.1794,39.7823,10185,0,103,10082
10/23/22,Eritrea,15.1794,39.7823,10185,0,103,10082
10/24/22,Eritrea,15.1794,39.7823,10187,0,103,10084
10/25/22,Eritrea,15.1794,39.7823,10187,0,103,10084
10/26/22,Eritrea,15.1794,39.7823,10187,0,103,10084
10/27/22,Eritrea,15.1794,39.7823,10187,0,103,10084
10/28/22,Eritrea,15.1794,39.7823,10188,0,103,10085
10/29/22,Eritrea,15.1794,39.7823,10188,0,103,10085
10/30/22,Eritrea,15.1794,39.7823,10188,0,103,10085
10/31/22,Eritrea,15.1794,39.7823,10189,0,103,10086
11/1/22,Eritrea,15.1794,39.7823,10189,0,103,10086
11/2/22,Eritrea,15.1794,39.7823,10189,0,103,10086
11/3/22,Eritrea,15.1794,39.7823,10189,0,103,10086
11/4/22,Eritrea,15.1794,39.7823,10189,0,103,10086
11/5/22,Eritrea,15.1794,39.7823,10189,0,103,10086
11/6/22,Eritrea,15.1794,39.7823,10189,0,103,10086
11/7/22,Eritrea,15.1794,39.7823,10189,0,103,10086
11/8/22,Eritrea,15.1794,39.7823,10189,0,103,10086
11/9/22,Eritrea,15.1794,39.7823,10189,0,103,10086
11/10/22,Eritrea,15.1794,39.7823,10189,0,103,10086
11/11/22,Eritrea,15.1794,39.7823,10189,0,103,10086
11/12/22,Eritrea,15.1794,39.7823,10189,0,103,10086
11/13/22,Eritrea,15.1794,39.7823,10189,0,103,10086
11/14/22,Eritrea,15.1794,39.7823,10189,0,103,10086
11/15/22,Eritrea,15.1794,39.7823,10189,0,103,10086
11/16/22,Eritrea,15.1794,39.7823,10189,0,103,10086
11/17/22,Eritrea,15.1794,39.7823,10189,0,103,10086
11/18/22,Eritrea,15.1794,39.7823,10189,0,103,10086
11/19/22,Eritrea,15.1794,39.7823,10189,0,103,10086
11/20/22,Eritrea,15.1794,39.7823,10189,0,103,10086
11/21/22,Eritrea,15.1794,39.7823,10189,0,103,10086
11/22/22,Eritrea,15.1794,39.7823,10189,0,103,10086
11/23/22,Eritrea,15.1794,39.7823,10189,0,103,10086
11/24/22,Eritrea,15.1794,39.7823,10189,0,103,10086
11/25/22,Eritrea,15.1794,39.7823,10189,0,103,10086
11/26/22,Eritrea,15.1794,39.7823,10189,0,103,10086
11/27/22,Eritrea,15.1794,39.7823,10189,0,103,10086
11/28/22,Eritrea,15.1794,39.7823,10189,0,103,10086
11/29/22,Eritrea,15.1794,39.7823,10189,0,103,10086
11/30/22,Eritrea,15.1794,39.7823,10189,0,103,10086
12/1/22,Eritrea,15.1794,39.7823,10189,0,103,10086
12/2/22,Eritrea,15.1794,39.7823,10189,0,103,10086
12/3/22,Eritrea,15.1794,39.7823,10189,0,103,10086
12/4/22,Eritrea,15.1794,39.7823,10189,0,103,10086
12/5/22,Eritrea,15.1794,39.7823,10189,0,103,10086
12/6/22,Eritrea,15.1794,39.7823,10189,0,103,10086
12/7/22,Eritrea,15.1794,39.7823,10189,0,103,10086
12/8/22,Eritrea,15.1794,39.7823,10189,0,103,10086
12/9/22,Eritrea,15.1794,39.7823,10189,0,103,10086
12/10/22,Eritrea,15.1794,39.7823,10189,0,103,10086
12/11/22,Eritrea,15.1794,39.7823,10189,0,103,10086
12/12/22,Eritrea,15.1794,39.7823,10189,0,103,10086
12/13/22,Eritrea,15.1794,39.7823,10189,0,103,10086
12/14/22,Eritrea,15.1794,39.7823,10189,0,103,10086
12/15/22,Eritrea,15.1794,39.7823,10189,0,103,10086
12/16/22,Eritrea,15.1794,39.7823,10189,0,103,10086
12/17/22,Eritrea,15.1794,39.7823,10189,0,103,10086
1/1/22,Estonia,58.5953,25.0136,242123,0,1938,240185
1/2/22,Estonia,58.5953,25.0136,242552,0,1938,240614
1/3/22,Estonia,58.5953,25.0136,243236,0,1939,241297
1/4/22,Estonia,58.5953,25.0136,244733,0,1940,242793
1/5/22,Estonia,58.5953,25.0136,246221,0,1942,244279
1/6/22,Estonia,58.5953,25.0136,247863,0,1945,245918
1/7/22,Estonia,58.5953,25.0136,249592,0,1951,247641
1/8/22,Estonia,58.5953,25.0136,251239,0,1954,249285
1/9/22,Estonia,58.5953,25.0136,252517,0,1955,250562
1/10/22,Estonia,58.5953,25.0136,253775,0,1956,251819
1/11/22,Estonia,58.5953,25.0136,255755,0,1959,253796
1/12/22,Estonia,58.5953,25.0136,257958,0,1963,255995
1/13/22,Estonia,58.5953,25.0136,260396,0,1967,258429
1/14/22,Estonia,58.5953,25.0136,262482,0,1970,260512
1/15/22,Estonia,58.5953,25.0136,264702,0,1976,262726
1/16/22,Estonia,58.5953,25.0136,267095,0,1979,265116
1/17/22,Estonia,58.5953,25.0136,269199,0,1984,267215
1/18/22,Estonia,58.5953,25.0136,271500,0,1987,269513
1/19/22,Estonia,58.5953,25.0136,274658,0,1990,272668
1/20/22,Estonia,58.5953,25.0136,278498,0,1994,276504
1/21/22,Estonia,58.5953,25.0136,282977,0,1999,280978
1/22/22,Estonia,58.5953,25.0136,287757,0,2003,285754
1/23/22,Estonia,58.5953,25.0136,291426,0,2005,289421
1/24/22,Estonia,58.5953,25.0136,296466,0,2008,294458
1/25/22,Estonia,58.5953,25.0136,301608,0,2013,299595
1/26/22,Estonia,58.5953,25.0136,307451,0,2018,305433
1/27/22,Estonia,58.5953,25.0136,313685,0,2023,311662
1/28/22,Estonia,58.5953,25.0136,319505,0,2025,317480
1/29/22,Estonia,58.5953,25.0136,326629,0,2025,324604
1/30/22,Estonia,58.5953,25.0136,332580,0,2036,330544
1/31/22,Estonia,58.5953,25.0136,337543,0,2033,335510
2/1/22,Estonia,58.5953,25.0136,344060,0,2037,342023
2/2/22,Estonia,58.5953,25.0136,351240,0,2039,349201
2/3/22,Estonia,58.5953,25.0136,358087,0,2047,356040
2/4/22,Estonia,58.5953,25.0136,366089,0,2053,364036
2/5/22,Estonia,58.5953,25.0136,373900,0,2056,371844
2/6/22,Estonia,58.5953,25.0136,380946,0,2059,378887
2/7/22,Estonia,58.5953,25.0136,385567,0,2065,383502
2/8/22,Estonia,58.5953,25.0136,391849,0,2075,389774
2/9/22,Estonia,58.5953,25.0136,398519,0,2088,396431
2/10/22,Estonia,58.5953,25.0136,405101,0,2095,403006
2/11/22,Estonia,58.5953,25.0136,410210,0,2100,408110
2/12/22,Estonia,58.5953,25.0136,415994,0,2106,413888
2/13/22,Estonia,58.5953,25.0136,420604,0,2113,418491
2/14/22,Estonia,58.5953,25.0136,423499,0,2115,421384
2/15/22,Estonia,58.5953,25.0136,427010,0,2122,424888
2/16/22,Estonia,58.5953,25.0136,435448,0,2139,433309
2/17/22,Estonia,58.5953,25.0136,441941,0,2148,439793
2/18/22,Estonia,58.5953,25.0136,448666,0,2152,446514
2/19/22,Estonia,58.5953,25.0136,455636,0,2158,453478
2/20/22,Estonia,58.5953,25.0136,459747,0,2162,457585
2/21/22,Estonia,58.5953,25.0136,462728,0,2170,460558
2/22/22,Estonia,58.5953,25.0136,467989,0,2181,465808
2/23/22,Estonia,58.5953,25.0136,474550,0,2188,472362
2/24/22,Estonia,58.5953,25.0136,478941,0,2195,476746
2/25/22,Estonia,58.5953,25.0136,483955,0,2204,481751
2/26/22,Estonia,58.5953,25.0136,487955,0,2213,485742
2/27/22,Estonia,58.5953,25.0136,492149,0,2225,489924
2/28/22,Estonia,58.5953,25.0136,494430,0,2236,492194
3/1/22,Estonia,58.5953,25.0136,499083,0,2250,496833
3/2/22,Estonia,58.5953,25.0136,504148,0,2259,501889
3/3/22,Estonia,58.5953,25.0136,507711,0,2267,505444
3/4/22,Estonia,58.5953,25.0136,511022,0,2275,508747
3/5/22,Estonia,58.5953,25.0136,514067,0,2290,511777
3/6/22,Estonia,58.5953,25.0136,515708,0,2290,513418
3/7/22,Estonia,58.5953,25.0136,517102,0,2299,514803
3/8/22,Estonia,58.5953,25.0136,520407,0,2308,518099
3/9/22,Estonia,58.5953,25.0136,523279,0,2320,520959
3/10/22,Estonia,58.5953,25.0136,525748,0,2327,523421
3/11/22,Estonia,58.5953,25.0136,527913,0,2337,525576
3/12/22,Estonia,58.5953,25.0136,529793,0,2346,527447
3/13/22,Estonia,58.5953,25.0136,531164,0,2353,528811
3/14/22,Estonia,58.5953,25.0136,532089,0,2359,529730
3/15/22,Estonia,58.5953,25.0136,534788,0,2367,532421
3/16/22,Estonia,58.5953,25.0136,536924,0,2371,534553
3/17/22,Estonia,58.5953,25.0136,538673,0,2376,536297
3/18/22,Estonia,58.5953,25.0136,540184,0,2385,537799
3/19/22,Estonia,58.5953,25.0136,541551,0,2385,539166
3/20/22,Estonia,58.5953,25.0136,542386,0,2392,539994
3/21/22,Estonia,58.5953,25.0136,543053,0,2397,540656
3/22/22,Estonia,58.5953,25.0136,545057,0,2399,542658
3/23/22,Estonia,58.5953,25.0136,546885,0,2418,544467
3/24/22,Estonia,58.5953,25.0136,548333,0,2423,545910
3/25/22,Estonia,58.5953,25.0136,549793,0,2429,547364
3/26/22,Estonia,58.5953,25.0136,551067,0,2436,548631
3/27/22,Estonia,58.5953,25.0136,551714,0,2439,549275
3/28/22,Estonia,58.5953,25.0136,552287,0,2444,549843
3/29/22,Estonia,58.5953,25.0136,553736,0,2448,551288
3/30/22,Estonia,58.5953,25.0136,555140,0,2451,552689
3/31/22,Estonia,58.5953,25.0136,556304,0,2459,553845
4/1/22,Estonia,58.5953,25.0136,557314,0,2463,554851
4/2/22,Estonia,58.5953,25.0136,558253,0,2466,555787
4/3/22,Estonia,58.5953,25.0136,558706,0,2468,556238
4/4/22,Estonia,58.5953,25.0136,559133,0,2469,556664
4/5/22,Estonia,58.5953,25.0136,560233,0,2475,557758
4/6/22,Estonia,58.5953,25.0136,561228,0,2479,558749
4/7/22,Estonia,58.5953,25.0136,562114,0,2481,559633
4/8/22,Estonia,58.5953,25.0136,562939,0,2486,560453
4/9/22,Estonia,58.5953,25.0136,563684,0,2490,561194
4/10/22,Estonia,58.5953,25.0136,564031,0,2494,561537
4/11/22,Estonia,58.5953,25.0136,564309,0,2495,561814
4/12/22,Estonia,58.5953,25.0136,565213,0,2498,562715
4/13/22,Estonia,58.5953,25.0136,565839,0,2501,563338
4/14/22,Estonia,58.5953,25.0136,566467,0,2505,563962
4/15/22,Estonia,58.5953,25.0136,566923,0,2508,564415
4/16/22,Estonia,58.5953,25.0136,567183,0,2511,564672
4/17/22,Estonia,58.5953,25.0136,567463,0,2516,564947
4/18/22,Estonia,58.5953,25.0136,567644,0,2522,565122
4/19/22,Estonia,58.5953,25.0136,568335,0,2525,565810
4/20/22,Estonia,58.5953,25.0136,568543,0,2526,566017
4/21/22,Estonia,58.5953,25.0136,569347,0,2528,566819
4/22/22,Estonia,58.5953,25.0136,569722,0,2531,567191
4/23/22,Estonia,58.5953,25.0136,570076,0,2531,567545
4/24/22,Estonia,58.5953,25.0136,570257,0,2531,567726
4/25/22,Estonia,58.5953,25.0136,570405,0,2533,567872
4/26/22,Estonia,58.5953,25.0136,570931,0,2533,568398
4/27/22,Estonia,58.5953,25.0136,571300,0,2533,568767
4/28/22,Estonia,58.5953,25.0136,571625,0,2537,569088
4/29/22,Estonia,58.5953,25.0136,571917,0,2538,569379
4/30/22,Estonia,58.5953,25.0136,572193,0,2539,569654
5/1/22,Estonia,58.5953,25.0136,572193,0,2539,569654
5/2/22,Estonia,58.5953,25.0136,572193,0,2539,569654
5/3/22,Estonia,58.5953,25.0136,572434,0,2548,569886
5/4/22,Estonia,58.5953,25.0136,572434,0,2548,569886
5/5/22,Estonia,58.5953,25.0136,572434,0,2548,569886
5/6/22,Estonia,58.5953,25.0136,572434,0,2548,569886
5/7/22,Estonia,58.5953,25.0136,572434,0,2548,569886
5/8/22,Estonia,58.5953,25.0136,572434,0,2548,569886
5/9/22,Estonia,58.5953,25.0136,572434,0,2548,569886
5/10/22,Estonia,58.5953,25.0136,573922,0,2556,571366
5/11/22,Estonia,58.5953,25.0136,573922,0,2556,571366
5/12/22,Estonia,58.5953,25.0136,573922,0,2556,571366
5/13/22,Estonia,58.5953,25.0136,573922,0,2556,571366
5/14/22,Estonia,58.5953,25.0136,573922,0,2556,571366
5/15/22,Estonia,58.5953,25.0136,573922,0,2556,571366
5/16/22,Estonia,58.5953,25.0136,573922,0,2556,571366
5/17/22,Estonia,58.5953,25.0136,575046,0,2561,572485
5/18/22,Estonia,58.5953,25.0136,575046,0,2561,572485
5/19/22,Estonia,58.5953,25.0136,575046,0,2561,572485
5/20/22,Estonia,58.5953,25.0136,575046,0,2561,572485
5/21/22,Estonia,58.5953,25.0136,575046,0,2561,572485
5/22/22,Estonia,58.5953,25.0136,575046,0,2561,572485
5/23/22,Estonia,58.5953,25.0136,575046,0,2561,572485
5/24/22,Estonia,58.5953,25.0136,576047,0,2561,573486
5/25/22,Estonia,58.5953,25.0136,576047,0,2561,573486
5/26/22,Estonia,58.5953,25.0136,576047,0,2561,573486
5/27/22,Estonia,58.5953,25.0136,576047,0,2561,573486
5/28/22,Estonia,58.5953,25.0136,576047,0,2561,573486
5/29/22,Estonia,58.5953,25.0136,576047,0,2561,573486
5/30/22,Estonia,58.5953,25.0136,576047,0,2561,573486
5/31/22,Estonia,58.5953,25.0136,576870,0,2574,574296
6/1/22,Estonia,58.5953,25.0136,576870,0,2574,574296
6/2/22,Estonia,58.5953,25.0136,576870,0,2574,574296
6/3/22,Estonia,58.5953,25.0136,576870,0,2574,574296
6/4/22,Estonia,58.5953,25.0136,576870,0,2574,574296
6/5/22,Estonia,58.5953,25.0136,576870,0,2574,574296
6/6/22,Estonia,58.5953,25.0136,576870,0,2574,574296
6/7/22,Estonia,58.5953,25.0136,577655,0,2574,575081
6/8/22,Estonia,58.5953,25.0136,577655,0,2574,575081
6/9/22,Estonia,58.5953,25.0136,577655,0,2574,575081
6/10/22,Estonia,58.5953,25.0136,577655,0,2574,575081
6/11/22,Estonia,58.5953,25.0136,577655,0,2574,575081
6/12/22,Estonia,58.5953,25.0136,577655,0,2574,575081
6/13/22,Estonia,58.5953,25.0136,577655,0,2574,575081
6/14/22,Estonia,58.5953,25.0136,578494,0,2586,575908
6/15/22,Estonia,58.5953,25.0136,578494,0,2586,575908
6/16/22,Estonia,58.5953,25.0136,578494,0,2586,575908
6/17/22,Estonia,58.5953,25.0136,578494,0,2586,575908
6/18/22,Estonia,58.5953,25.0136,578494,0,2586,575908
6/19/22,Estonia,58.5953,25.0136,578494,0,2586,575908
6/20/22,Estonia,58.5953,25.0136,578494,0,2586,575908
6/21/22,Estonia,58.5953,25.0136,579316,0,2588,576728
6/22/22,Estonia,58.5953,25.0136,579316,0,2588,576728
6/23/22,Estonia,58.5953,25.0136,579316,0,2588,576728
6/24/22,Estonia,58.5953,25.0136,579316,0,2588,576728
6/25/22,Estonia,58.5953,25.0136,579316,0,2588,576728
6/26/22,Estonia,58.5953,25.0136,579316,0,2588,576728
6/27/22,Estonia,58.5953,25.0136,579316,0,2588,576728
6/28/22,Estonia,58.5953,25.0136,580111,0,2591,577520
6/29/22,Estonia,58.5953,25.0136,580114,0,2591,577523
6/30/22,Estonia,58.5953,25.0136,580114,0,2591,577523
7/1/22,Estonia,58.5953,25.0136,580114,0,2591,577523
7/2/22,Estonia,58.5953,25.0136,580114,0,2591,577523
7/3/22,Estonia,58.5953,25.0136,580114,0,2591,577523
7/4/22,Estonia,58.5953,25.0136,580114,0,2591,577523
7/5/22,Estonia,58.5953,25.0136,581560,0,2591,578969
7/6/22,Estonia,58.5953,25.0136,581560,0,2599,578961
7/7/22,Estonia,58.5953,25.0136,581560,0,2599,578961
7/8/22,Estonia,58.5953,25.0136,581560,0,2599,578961
7/9/22,Estonia,58.5953,25.0136,581560,0,2599,578961
7/10/22,Estonia,58.5953,25.0136,581560,0,2599,578961
7/11/22,Estonia,58.5953,25.0136,581560,0,2599,578961
7/12/22,Estonia,58.5953,25.0136,585143,0,2608,582535
7/13/22,Estonia,58.5953,25.0136,585143,0,2608,582535
7/14/22,Estonia,58.5953,25.0136,585143,0,2608,582535
7/15/22,Estonia,58.5953,25.0136,585143,0,2608,582535
7/16/22,Estonia,58.5953,25.0136,585143,0,2608,582535
7/17/22,Estonia,58.5953,25.0136,585143,0,2608,582535
7/18/22,Estonia,58.5953,25.0136,585143,0,2608,582535
7/19/22,Estonia,58.5953,25.0136,584373,0,2612,581761
7/20/22,Estonia,58.5953,25.0136,584373,0,2612,581761
7/21/22,Estonia,58.5953,25.0136,584373,0,2612,581761
7/22/22,Estonia,58.5953,25.0136,584373,0,2612,581761
7/23/22,Estonia,58.5953,25.0136,584373,0,2612,581761
7/24/22,Estonia,58.5953,25.0136,584373,0,2612,581761
7/25/22,Estonia,58.5953,25.0136,584373,0,2612,581761
7/26/22,Estonia,58.5953,25.0136,586399,0,2620,583779
7/27/22,Estonia,58.5953,25.0136,586399,0,2620,583779
7/28/22,Estonia,58.5953,25.0136,586399,0,2620,583779
7/29/22,Estonia,58.5953,25.0136,586399,0,2620,583779
7/30/22,Estonia,58.5953,25.0136,586399,0,2620,583779
7/31/22,Estonia,58.5953,25.0136,586399,0,2620,583779
8/1/22,Estonia,58.5953,25.0136,586399,0,2620,583779
8/2/22,Estonia,58.5953,25.0136,591377,0,2628,588749
8/3/22,Estonia,58.5953,25.0136,591377,0,2628,588749
8/4/22,Estonia,58.5953,25.0136,591377,0,2628,588749
8/5/22,Estonia,58.5953,25.0136,591377,0,2628,588749
8/6/22,Estonia,58.5953,25.0136,591377,0,2628,588749
8/7/22,Estonia,58.5953,25.0136,591377,0,2628,588749
8/8/22,Estonia,58.5953,25.0136,591377,0,2628,588749
8/9/22,Estonia,58.5953,25.0136,593571,0,2634,590937
8/10/22,Estonia,58.5953,25.0136,593571,0,2634,590937
8/11/22,Estonia,58.5953,25.0136,593571,0,2634,590937
8/12/22,Estonia,58.5953,25.0136,593571,0,2634,590937
8/13/22,Estonia,58.5953,25.0136,593571,0,2634,590937
8/14/22,Estonia,58.5953,25.0136,593571,0,2634,590937
8/15/22,Estonia,58.5953,25.0136,593571,0,2634,590937
8/16/22,Estonia,58.5953,25.0136,595419,0,2642,592777
8/17/22,Estonia,58.5953,25.0136,595419,0,2642,592777
8/18/22,Estonia,58.5953,25.0136,595419,0,2642,592777
8/19/22,Estonia,58.5953,25.0136,595419,0,2642,592777
8/20/22,Estonia,58.5953,25.0136,595419,0,2642,592777
8/21/22,Estonia,58.5953,25.0136,595419,0,2642,592777
8/22/22,Estonia,58.5953,25.0136,595419,0,2642,592777
8/23/22,Estonia,58.5953,25.0136,596763,0,2647,594116
8/24/22,Estonia,58.5953,25.0136,596763,0,2647,594116
8/25/22,Estonia,58.5953,25.0136,596763,0,2647,594116
8/26/22,Estonia,58.5953,25.0136,596763,0,2647,594116
8/27/22,Estonia,58.5953,25.0136,596763,0,2647,594116
8/28/22,Estonia,58.5953,25.0136,596763,0,2647,594116
8/29/22,Estonia,58.5953,25.0136,596763,0,2647,594116
8/30/22,Estonia,58.5953,25.0136,597838,0,2651,595187
8/31/22,Estonia,58.5953,25.0136,597838,0,2651,595187
9/1/22,Estonia,58.5953,25.0136,597838,0,2651,595187
9/2/22,Estonia,58.5953,25.0136,597838,0,2651,595187
9/3/22,Estonia,58.5953,25.0136,597838,0,2651,595187
9/4/22,Estonia,58.5953,25.0136,597838,0,2651,595187
9/5/22,Estonia,58.5953,25.0136,597838,0,2651,595187
9/6/22,Estonia,58.5953,25.0136,598636,0,2657,595979
9/7/22,Estonia,58.5953,25.0136,598636,0,2657,595979
9/8/22,Estonia,58.5953,25.0136,598636,0,2657,595979
9/9/22,Estonia,58.5953,25.0136,598636,0,2657,595979
9/10/22,Estonia,58.5953,25.0136,598636,0,2657,595979
9/11/22,Estonia,58.5953,25.0136,598636,0,2657,595979
9/12/22,Estonia,58.5953,25.0136,598636,0,2657,595979
9/13/22,Estonia,58.5953,25.0136,599596,0,2661,596935
9/14/22,Estonia,58.5953,25.0136,599596,0,2661,596935
9/15/22,Estonia,58.5953,25.0136,599596,0,2661,596935
9/16/22,Estonia,58.5953,25.0136,599596,0,2661,596935
9/17/22,Estonia,58.5953,25.0136,599596,0,2661,596935
9/18/22,Estonia,58.5953,25.0136,599596,0,2661,596935
9/19/22,Estonia,58.5953,25.0136,599596,0,2661,596935
9/20/22,Estonia,58.5953,25.0136,600796,0,2667,598129
9/21/22,Estonia,58.5953,25.0136,600796,0,2667,598129
9/22/22,Estonia,58.5953,25.0136,600796,0,2667,598129
9/23/22,Estonia,58.5953,25.0136,600796,0,2667,598129
9/24/22,Estonia,58.5953,25.0136,600796,0,2667,598129
9/25/22,Estonia,58.5953,25.0136,600796,0,2667,598129
9/26/22,Estonia,58.5953,25.0136,600796,0,2667,598129
9/27/22,Estonia,58.5953,25.0136,601869,0,2681,599188
9/28/22,Estonia,58.5953,25.0136,601993,0,2681,599312
9/29/22,Estonia,58.5953,25.0136,601993,0,2681,599312
9/30/22,Estonia,58.5953,25.0136,601993,0,2681,599312
10/1/22,Estonia,58.5953,25.0136,601993,0,2681,599312
10/2/22,Estonia,58.5953,25.0136,601993,0,2681,599312
10/3/22,Estonia,58.5953,25.0136,601993,0,2681,599312
10/4/22,Estonia,58.5953,25.0136,603347,0,2692,600655
10/5/22,Estonia,58.5953,25.0136,603347,0,2692,600655
10/6/22,Estonia,58.5953,25.0136,603347,0,2692,600655
10/7/22,Estonia,58.5953,25.0136,603347,0,2692,600655
10/8/22,Estonia,58.5953,25.0136,603347,0,2692,600655
10/9/22,Estonia,58.5953,25.0136,603347,0,2692,600655
10/10/22,Estonia,58.5953,25.0136,603347,0,2692,600655
10/11/22,Estonia,58.5953,25.0136,604552,0,2713,601839
10/12/22,Estonia,58.5953,25.0136,604552,0,2713,601839
10/13/22,Estonia,58.5953,25.0136,604552,0,2713,601839
10/14/22,Estonia,58.5953,25.0136,604552,0,2713,601839
10/15/22,Estonia,58.5953,25.0136,604552,0,2713,601839
10/16/22,Estonia,58.5953,25.0136,604552,0,2713,601839
10/17/22,Estonia,58.5953,25.0136,604552,0,2713,601839
10/18/22,Estonia,58.5953,25.0136,605622,0,2729,602893
10/19/22,Estonia,58.5953,25.0136,605622,0,2729,602893
10/20/22,Estonia,58.5953,25.0136,605622,0,2729,602893
10/21/22,Estonia,58.5953,25.0136,605622,0,2729,602893
10/22/22,Estonia,58.5953,25.0136,605622,0,2729,602893
10/23/22,Estonia,58.5953,25.0136,605622,0,2729,602893
10/24/22,Estonia,58.5953,25.0136,605622,0,2729,602893
10/25/22,Estonia,58.5953,25.0136,606498,0,2739,603759
10/26/22,Estonia,58.5953,25.0136,606633,0,2739,603894
10/27/22,Estonia,58.5953,25.0136,606633,0,2739,603894
10/28/22,Estonia,58.5953,25.0136,606633,0,2739,603894
10/29/22,Estonia,58.5953,25.0136,606633,0,2739,603894
10/30/22,Estonia,58.5953,25.0136,606633,0,2739,603894
10/31/22,Estonia,58.5953,25.0136,606633,0,2739,603894
11/1/22,Estonia,58.5953,25.0136,607300,0,2748,604552
11/2/22,Estonia,58.5953,25.0136,607300,0,2748,604552
11/3/22,Estonia,58.5953,25.0136,607300,0,2748,604552
11/4/22,Estonia,58.5953,25.0136,607300,0,2748,604552
11/5/22,Estonia,58.5953,25.0136,607300,0,2748,604552
11/6/22,Estonia,58.5953,25.0136,607300,0,2748,604552
11/7/22,Estonia,58.5953,25.0136,607300,0,2748,604552
11/8/22,Estonia,58.5953,25.0136,607300,0,2748,604552
11/9/22,Estonia,58.5953,25.0136,607844,0,2757,605087
11/10/22,Estonia,58.5953,25.0136,607844,0,2757,605087
11/11/22,Estonia,58.5953,25.0136,607844,0,2757,605087
11/12/22,Estonia,58.5953,25.0136,607844,0,2757,605087
11/13/22,Estonia,58.5953,25.0136,607844,0,2757,605087
11/14/22,Estonia,58.5953,25.0136,607844,0,2757,605087
11/15/22,Estonia,58.5953,25.0136,608332,0,2757,605575
11/16/22,Estonia,58.5953,25.0136,608332,0,2757,605575
11/17/22,Estonia,58.5953,25.0136,608332,0,2757,605575
11/18/22,Estonia,58.5953,25.0136,608332,0,2757,605575
11/19/22,Estonia,58.5953,25.0136,608332,0,2757,605575
11/20/22,Estonia,58.5953,25.0136,608332,0,2757,605575
11/21/22,Estonia,58.5953,25.0136,608332,0,2757,605575
11/22/22,Estonia,58.5953,25.0136,608796,0,2757,606039
11/23/22,Estonia,58.5953,25.0136,608796,0,2757,606039
11/24/22,Estonia,58.5953,25.0136,608796,0,2757,606039
11/25/22,Estonia,58.5953,25.0136,608796,0,2781,606015
11/26/22,Estonia,58.5953,25.0136,608796,0,2781,606015
11/27/22,Estonia,58.5953,25.0136,608796,0,2781,606015
11/28/22,Estonia,58.5953,25.0136,608796,0,2781,606015
11/29/22,Estonia,58.5953,25.0136,609297,0,2790,606507
11/30/22,Estonia,58.5953,25.0136,609297,0,2790,606507
12/1/22,Estonia,58.5953,25.0136,609297,0,2790,606507
12/2/22,Estonia,58.5953,25.0136,609297,0,2790,606507
12/3/22,Estonia,58.5953,25.0136,609297,0,2790,606507
12/4/22,Estonia,58.5953,25.0136,609297,0,2790,606507
12/5/22,Estonia,58.5953,25.0136,609297,0,2790,606507
12/6/22,Estonia,58.5953,25.0136,609827,0,2799,607028
12/7/22,Estonia,58.5953,25.0136,609827,0,2799,607028
12/8/22,Estonia,58.5953,25.0136,609827,0,2799,607028
12/9/22,Estonia,58.5953,25.0136,609827,0,2799,607028
12/10/22,Estonia,58.5953,25.0136,609827,0,2799,607028
12/11/22,Estonia,58.5953,25.0136,609827,0,2799,607028
12/12/22,Estonia,58.5953,25.0136,609827,0,2799,607028
12/13/22,Estonia,58.5953,25.0136,610473,0,2799,607674
12/14/22,Estonia,58.5953,25.0136,610473,0,2799,607674
12/15/22,Estonia,58.5953,25.0136,610473,0,2814,607659
12/16/22,Estonia,58.5953,25.0136,610473,0,2814,607659
12/17/22,Estonia,58.5953,25.0136,610473,0,2814,607659
1/1/22,Eswatini,-26.5225,31.4659,66241,0,1308,64933
1/2/22,Eswatini,-26.5225,31.4659,66286,0,1310,64976
1/3/22,Eswatini,-26.5225,31.4659,66441,0,1315,65126
1/4/22,Eswatini,-26.5225,31.4659,66674,0,1318,65356
1/5/22,Eswatini,-26.5225,31.4659,66873,0,1320,65553
1/6/22,Eswatini,-26.5225,31.4659,67021,0,1326,65695
1/7/22,Eswatini,-26.5225,31.4659,67171,0,1329,65842
1/8/22,Eswatini,-26.5225,31.4659,67240,0,1332,65908
1/9/22,Eswatini,-26.5225,31.4659,67294,0,1336,65958
1/10/22,Eswatini,-26.5225,31.4659,67373,0,1341,66032
1/11/22,Eswatini,-26.5225,31.4659,67492,0,1345,66147
1/12/22,Eswatini,-26.5225,31.4659,67564,0,1349,66215
1/13/22,Eswatini,-26.5225,31.4659,67676,0,1352,66324
1/14/22,Eswatini,-26.5225,31.4659,67777,0,1356,66421
1/15/22,Eswatini,-26.5225,31.4659,67830,0,1357,66473
1/16/22,Eswatini,-26.5225,31.4659,67849,0,1363,66486
1/17/22,Eswatini,-26.5225,31.4659,67878,0,1363,66515
1/18/22,Eswatini,-26.5225,31.4659,67935,0,1365,66570
1/19/22,Eswatini,-26.5225,31.4659,67975,0,1365,66610
1/20/22,Eswatini,-26.5225,31.4659,68003,0,1366,66637
1/21/22,Eswatini,-26.5225,31.4659,68047,0,1366,66681
1/22/22,Eswatini,-26.5225,31.4659,68061,0,1367,66694
1/23/22,Eswatini,-26.5225,31.4659,68081,0,1369,66712
1/24/22,Eswatini,-26.5225,31.4659,68118,0,1370,66748
1/25/22,Eswatini,-26.5225,31.4659,68164,0,1370,66794
1/26/22,Eswatini,-26.5225,31.4659,68205,0,1371,66834
1/27/22,Eswatini,-26.5225,31.4659,68239,0,1373,66866
1/28/22,Eswatini,-26.5225,31.4659,68301,0,1373,66928
1/29/22,Eswatini,-26.5225,31.4659,68329,0,1374,66955
1/30/22,Eswatini,-26.5225,31.4659,68342,0,1375,66967
1/31/22,Eswatini,-26.5225,31.4659,68367,0,1375,66992
2/1/22,Eswatini,-26.5225,31.4659,68423,0,1375,67048
2/2/22,Eswatini,-26.5225,31.4659,68454,0,1376,67078
2/3/22,Eswatini,-26.5225,31.4659,68505,0,1376,67129
2/4/22,Eswatini,-26.5225,31.4659,68540,0,1377,67163
2/5/22,Eswatini,-26.5225,31.4659,68551,0,1377,67174
2/6/22,Eswatini,-26.5225,31.4659,68553,0,1378,67175
2/7/22,Eswatini,-26.5225,31.4659,68579,0,1378,67201
2/8/22,Eswatini,-26.5225,31.4659,68661,0,1380,67281
2/9/22,Eswatini,-26.5225,31.4659,68702,0,1381,67321
2/10/22,Eswatini,-26.5225,31.4659,68727,0,1381,67346
2/11/22,Eswatini,-26.5225,31.4659,68762,0,1382,67380
2/12/22,Eswatini,-26.5225,31.4659,68781,0,1383,67398
2/13/22,Eswatini,-26.5225,31.4659,68795,0,1383,67412
2/14/22,Eswatini,-26.5225,31.4659,68815,0,1384,67431
2/15/22,Eswatini,-26.5225,31.4659,68858,0,1384,67474
2/16/22,Eswatini,-26.5225,31.4659,68900,0,1386,67514
2/17/22,Eswatini,-26.5225,31.4659,68925,0,1386,67539
2/18/22,Eswatini,-26.5225,31.4659,68957,0,1386,67571
2/19/22,Eswatini,-26.5225,31.4659,68972,0,1388,67584
2/20/22,Eswatini,-26.5225,31.4659,68978,0,1388,67590
2/21/22,Eswatini,-26.5225,31.4659,68993,0,1389,67604
2/22/22,Eswatini,-26.5225,31.4659,69021,0,1390,67631
2/23/22,Eswatini,-26.5225,31.4659,69050,0,1390,67660
2/24/22,Eswatini,-26.5225,31.4659,69095,0,1390,67705
2/25/22,Eswatini,-26.5225,31.4659,69119,0,1390,67729
2/26/22,Eswatini,-26.5225,31.4659,69125,0,1390,67735
2/27/22,Eswatini,-26.5225,31.4659,69130,0,1390,67740
2/28/22,Eswatini,-26.5225,31.4659,69160,0,1390,67770
3/1/22,Eswatini,-26.5225,31.4659,69191,0,1390,67801
3/2/22,Eswatini,-26.5225,31.4659,69211,0,1390,67821
3/3/22,Eswatini,-26.5225,31.4659,69258,0,1391,67867
3/4/22,Eswatini,-26.5225,31.4659,69290,0,1391,67899
3/5/22,Eswatini,-26.5225,31.4659,69297,0,1391,67906
3/6/22,Eswatini,-26.5225,31.4659,69298,0,1391,67907
3/7/22,Eswatini,-26.5225,31.4659,69307,0,1391,67916
3/8/22,Eswatini,-26.5225,31.4659,69331,0,1391,67940
3/9/22,Eswatini,-26.5225,31.4659,69351,0,1391,67960
3/10/22,Eswatini,-26.5225,31.4659,69379,0,1392,67987
3/11/22,Eswatini,-26.5225,31.4659,69408,0,1392,68016
3/12/22,Eswatini,-26.5225,31.4659,69429,0,1392,68037
3/13/22,Eswatini,-26.5225,31.4659,69435,0,1392,68043
3/14/22,Eswatini,-26.5225,31.4659,69459,0,1392,68067
3/15/22,Eswatini,-26.5225,31.4659,69478,0,1392,68086
3/16/22,Eswatini,-26.5225,31.4659,69507,0,1392,68115
3/17/22,Eswatini,-26.5225,31.4659,69527,0,1392,68135
3/18/22,Eswatini,-26.5225,31.4659,69541,0,1392,68149
3/19/22,Eswatini,-26.5225,31.4659,69548,0,1392,68156
3/20/22,Eswatini,-26.5225,31.4659,69552,0,1392,68160
3/21/22,Eswatini,-26.5225,31.4659,69563,0,1392,68171
3/22/22,Eswatini,-26.5225,31.4659,69597,0,1392,68205
3/23/22,Eswatini,-26.5225,31.4659,69610,0,1393,68217
3/24/22,Eswatini,-26.5225,31.4659,69633,0,1393,68240
3/25/22,Eswatini,-26.5225,31.4659,69658,0,1393,68265
3/26/22,Eswatini,-26.5225,31.4659,69663,0,1393,68270
3/27/22,Eswatini,-26.5225,31.4659,69664,0,1393,68271
3/28/22,Eswatini,-26.5225,31.4659,69672,0,1394,68278
3/29/22,Eswatini,-26.5225,31.4659,69695,0,1394,68301
3/30/22,Eswatini,-26.5225,31.4659,69723,0,1394,68329
3/31/22,Eswatini,-26.5225,31.4659,69771,0,1394,68377
4/1/22,Eswatini,-26.5225,31.4659,69832,0,1394,68438
4/2/22,Eswatini,-26.5225,31.4659,69838,0,1394,68444
4/3/22,Eswatini,-26.5225,31.4659,69851,0,1394,68457
4/4/22,Eswatini,-26.5225,31.4659,69862,0,1394,68468
4/5/22,Eswatini,-26.5225,31.4659,69897,0,1395,68502
4/6/22,Eswatini,-26.5225,31.4659,69927,0,1395,68532
4/7/22,Eswatini,-26.5225,31.4659,69947,0,1395,68552
4/8/22,Eswatini,-26.5225,31.4659,69959,0,1395,68564
4/9/22,Eswatini,-26.5225,31.4659,69966,0,1395,68571
4/10/22,Eswatini,-26.5225,31.4659,69968,0,1395,68573
4/11/22,Eswatini,-26.5225,31.4659,69990,0,1395,68595
4/12/22,Eswatini,-26.5225,31.4659,70014,0,1395,68619
4/13/22,Eswatini,-26.5225,31.4659,70048,0,1395,68653
4/14/22,Eswatini,-26.5225,31.4659,70072,0,1395,68677
4/15/22,Eswatini,-26.5225,31.4659,70097,0,1395,68702
4/16/22,Eswatini,-26.5225,31.4659,70098,0,1395,68703
4/17/22,Eswatini,-26.5225,31.4659,70102,0,1395,68707
4/18/22,Eswatini,-26.5225,31.4659,70102,0,1395,68707
4/19/22,Eswatini,-26.5225,31.4659,70107,0,1395,68712
4/20/22,Eswatini,-26.5225,31.4659,70144,0,1395,68749
4/21/22,Eswatini,-26.5225,31.4659,70190,0,1395,68795
4/22/22,Eswatini,-26.5225,31.4659,70253,0,1396,68857
4/23/22,Eswatini,-26.5225,31.4659,70284,0,1397,68887
4/24/22,Eswatini,-26.5225,31.4659,70294,0,1397,68897
4/25/22,Eswatini,-26.5225,31.4659,70303,0,1397,68906
4/26/22,Eswatini,-26.5225,31.4659,70354,0,1397,68957
4/27/22,Eswatini,-26.5225,31.4659,70456,0,1397,69059
4/28/22,Eswatini,-26.5225,31.4659,70528,0,1397,69131
4/29/22,Eswatini,-26.5225,31.4659,70626,0,1397,69229
4/30/22,Eswatini,-26.5225,31.4659,70643,0,1397,69246
5/1/22,Eswatini,-26.5225,31.4659,70657,0,1397,69260
5/2/22,Eswatini,-26.5225,31.4659,70678,0,1397,69281
5/3/22,Eswatini,-26.5225,31.4659,70740,0,1397,69343
5/4/22,Eswatini,-26.5225,31.4659,70833,0,1398,69435
5/5/22,Eswatini,-26.5225,31.4659,70964,0,1399,69565
5/6/22,Eswatini,-26.5225,31.4659,71072,0,1399,69673
5/7/22,Eswatini,-26.5225,31.4659,71089,0,1400,69689
5/8/22,Eswatini,-26.5225,31.4659,71102,0,1400,69702
5/9/22,Eswatini,-26.5225,31.4659,71215,0,1401,69814
5/10/22,Eswatini,-26.5225,31.4659,71341,0,1402,69939
5/11/22,Eswatini,-26.5225,31.4659,71480,0,1402,70078
5/12/22,Eswatini,-26.5225,31.4659,71583,0,1402,70181
5/13/22,Eswatini,-26.5225,31.4659,71667,0,1402,70265
5/14/22,Eswatini,-26.5225,31.4659,71698,0,1402,70296
5/15/22,Eswatini,-26.5225,31.4659,71705,0,1403,70302
5/16/22,Eswatini,-26.5225,31.4659,71775,0,1403,70372
5/17/22,Eswatini,-26.5225,31.4659,71867,0,1403,70464
5/18/22,Eswatini,-26.5225,31.4659,71934,0,1403,70531
5/19/22,Eswatini,-26.5225,31.4659,72024,0,1404,70620
5/20/22,Eswatini,-26.5225,31.4659,72097,0,1404,70693
5/21/22,Eswatini,-26.5225,31.4659,72125,0,1404,70721
5/22/22,Eswatini,-26.5225,31.4659,72150,0,1404,70746
5/23/22,Eswatini,-26.5225,31.4659,72202,0,1404,70798
5/24/22,Eswatini,-26.5225,31.4659,72257,0,1406,70851
5/25/22,Eswatini,-26.5225,31.4659,72300,0,1406,70894
5/26/22,Eswatini,-26.5225,31.4659,72334,0,1406,70928
5/27/22,Eswatini,-26.5225,31.4659,72371,0,1406,70965
5/28/22,Eswatini,-26.5225,31.4659,72390,0,1406,70984
5/29/22,Eswatini,-26.5225,31.4659,72397,0,1407,70990
5/30/22,Eswatini,-26.5225,31.4659,72474,0,1407,71067
5/31/22,Eswatini,-26.5225,31.4659,72510,0,1409,71101
6/1/22,Eswatini,-26.5225,31.4659,72571,0,1409,71162
6/2/22,Eswatini,-26.5225,31.4659,72617,0,1410,71207
6/3/22,Eswatini,-26.5225,31.4659,72662,0,1410,71252
6/4/22,Eswatini,-26.5225,31.4659,72685,0,1410,71275
6/5/22,Eswatini,-26.5225,31.4659,72688,0,1410,71278
6/6/22,Eswatini,-26.5225,31.4659,72703,0,1410,71293
6/7/22,Eswatini,-26.5225,31.4659,72749,0,1410,71339
6/8/22,Eswatini,-26.5225,31.4659,72781,0,1410,71371
6/9/22,Eswatini,-26.5225,31.4659,72822,0,1410,71412
6/10/22,Eswatini,-26.5225,31.4659,72870,0,1410,71460
6/11/22,Eswatini,-26.5225,31.4659,72879,0,1410,71469
6/12/22,Eswatini,-26.5225,31.4659,72891,0,1410,71481
6/13/22,Eswatini,-26.5225,31.4659,72904,0,1410,71494
6/14/22,Eswatini,-26.5225,31.4659,72935,0,1410,71525
6/15/22,Eswatini,-26.5225,31.4659,72957,0,1411,71546
6/16/22,Eswatini,-26.5225,31.4659,72980,0,1412,71568
6/17/22,Eswatini,-26.5225,31.4659,72999,0,1413,71586
6/18/22,Eswatini,-26.5225,31.4659,73003,0,1414,71589
6/19/22,Eswatini,-26.5225,31.4659,73006,0,1415,71591
6/20/22,Eswatini,-26.5225,31.4659,73013,0,1415,71598
6/21/22,Eswatini,-26.5225,31.4659,73028,0,1415,71613
6/22/22,Eswatini,-26.5225,31.4659,73049,0,1415,71634
6/23/22,Eswatini,-26.5225,31.4659,73060,0,1415,71645
6/24/22,Eswatini,-26.5225,31.4659,73069,0,1415,71654
6/25/22,Eswatini,-26.5225,31.4659,73071,0,1415,71656
6/26/22,Eswatini,-26.5225,31.4659,73073,0,1415,71658
6/27/22,Eswatini,-26.5225,31.4659,73076,0,1415,71661
6/28/22,Eswatini,-26.5225,31.4659,73091,0,1416,71675
6/29/22,Eswatini,-26.5225,31.4659,73098,0,1416,71682
6/30/22,Eswatini,-26.5225,31.4659,73109,0,1416,71693
7/1/22,Eswatini,-26.5225,31.4659,73131,0,1416,71715
7/2/22,Eswatini,-26.5225,31.4659,73133,0,1416,71717
7/3/22,Eswatini,-26.5225,31.4659,73136,0,1416,71720
7/4/22,Eswatini,-26.5225,31.4659,73148,0,1416,71732
7/5/22,Eswatini,-26.5225,31.4659,73155,0,1416,71739
7/6/22,Eswatini,-26.5225,31.4659,73177,0,1416,71761
7/7/22,Eswatini,-26.5225,31.4659,73185,0,1417,71768
7/8/22,Eswatini,-26.5225,31.4659,73205,0,1417,71788
7/9/22,Eswatini,-26.5225,31.4659,73213,0,1417,71796
7/10/22,Eswatini,-26.5225,31.4659,73215,0,1417,71798
7/11/22,Eswatini,-26.5225,31.4659,73219,0,1417,71802
7/12/22,Eswatini,-26.5225,31.4659,73227,0,1417,71810
7/13/22,Eswatini,-26.5225,31.4659,73229,0,1417,71812
7/14/22,Eswatini,-26.5225,31.4659,73230,0,1417,71813
7/15/22,Eswatini,-26.5225,31.4659,73235,0,1417,71818
7/16/22,Eswatini,-26.5225,31.4659,73242,0,1417,71825
7/17/22,Eswatini,-26.5225,31.4659,73242,0,1417,71825
7/18/22,Eswatini,-26.5225,31.4659,73243,0,1417,71826
7/19/22,Eswatini,-26.5225,31.4659,73245,0,1417,71828
7/20/22,Eswatini,-26.5225,31.4659,73247,0,1417,71830
7/21/22,Eswatini,-26.5225,31.4659,73247,0,1417,71830
7/22/22,Eswatini,-26.5225,31.4659,73250,0,1417,71833
7/23/22,Eswatini,-26.5225,31.4659,73253,0,1417,71836
7/24/22,Eswatini,-26.5225,31.4659,73256,0,1417,71839
7/25/22,Eswatini,-26.5225,31.4659,73259,0,1417,71842
7/26/22,Eswatini,-26.5225,31.4659,73267,0,1417,71850
7/27/22,Eswatini,-26.5225,31.4659,73267,0,1417,71850
7/28/22,Eswatini,-26.5225,31.4659,73273,0,1417,71856
7/29/22,Eswatini,-26.5225,31.4659,73274,0,1417,71857
7/30/22,Eswatini,-26.5225,31.4659,73279,0,1417,71862
7/31/22,Eswatini,-26.5225,31.4659,73280,0,1417,71863
8/1/22,Eswatini,-26.5225,31.4659,73282,0,1417,71865
8/2/22,Eswatini,-26.5225,31.4659,73284,0,1417,71867
8/3/22,Eswatini,-26.5225,31.4659,73290,0,1417,71873
8/4/22,Eswatini,-26.5225,31.4659,73294,0,1417,71877
8/5/22,Eswatini,-26.5225,31.4659,73297,0,1417,71880
8/6/22,Eswatini,-26.5225,31.4659,73301,0,1419,71882
8/7/22,Eswatini,-26.5225,31.4659,73305,0,1419,71886
8/8/22,Eswatini,-26.5225,31.4659,73307,0,1419,71888
8/9/22,Eswatini,-26.5225,31.4659,73311,0,1419,71892
8/10/22,Eswatini,-26.5225,31.4659,73316,0,1419,71897
8/11/22,Eswatini,-26.5225,31.4659,73318,0,1419,71899
8/12/22,Eswatini,-26.5225,31.4659,73322,0,1419,71903
8/13/22,Eswatini,-26.5225,31.4659,73326,0,1419,71907
8/14/22,Eswatini,-26.5225,31.4659,73327,0,1419,71908
8/15/22,Eswatini,-26.5225,31.4659,73330,0,1419,71911
8/16/22,Eswatini,-26.5225,31.4659,73334,0,1419,71915
8/17/22,Eswatini,-26.5225,31.4659,73336,0,1419,71917
8/18/22,Eswatini,-26.5225,31.4659,73342,0,1419,71923
8/19/22,Eswatini,-26.5225,31.4659,73344,0,1419,71925
8/20/22,Eswatini,-26.5225,31.4659,73344,0,1419,71925
8/21/22,Eswatini,-26.5225,31.4659,73344,0,1419,71925
8/22/22,Eswatini,-26.5225,31.4659,73344,0,1419,71925
8/23/22,Eswatini,-26.5225,31.4659,73344,0,1419,71925
8/24/22,Eswatini,-26.5225,31.4659,73345,0,1421,71924
8/25/22,Eswatini,-26.5225,31.4659,73353,0,1422,71931
8/26/22,Eswatini,-26.5225,31.4659,73358,0,1422,71936
8/27/22,Eswatini,-26.5225,31.4659,73358,0,1422,71936
8/28/22,Eswatini,-26.5225,31.4659,73358,0,1422,71936
8/29/22,Eswatini,-26.5225,31.4659,73361,0,1422,71939
8/30/22,Eswatini,-26.5225,31.4659,73361,0,1422,71939
8/31/22,Eswatini,-26.5225,31.4659,73367,0,1422,71945
9/1/22,Eswatini,-26.5225,31.4659,73367,0,1422,71945
9/2/22,Eswatini,-26.5225,31.4659,73367,0,1422,71945
9/3/22,Eswatini,-26.5225,31.4659,73368,0,1422,71946
9/4/22,Eswatini,-26.5225,31.4659,73368,0,1422,71946
9/5/22,Eswatini,-26.5225,31.4659,73368,0,1422,71946
9/6/22,Eswatini,-26.5225,31.4659,73368,0,1422,71946
9/7/22,Eswatini,-26.5225,31.4659,73368,0,1422,71946
9/8/22,Eswatini,-26.5225,31.4659,73368,0,1422,71946
9/9/22,Eswatini,-26.5225,31.4659,73368,0,1422,71946
9/10/22,Eswatini,-26.5225,31.4659,73368,0,1422,71946
9/11/22,Eswatini,-26.5225,31.4659,73374,0,1422,71952
9/12/22,Eswatini,-26.5225,31.4659,73374,0,1422,71952
9/13/22,Eswatini,-26.5225,31.4659,73374,0,1422,71952
9/14/22,Eswatini,-26.5225,31.4659,73374,0,1422,71952
9/15/22,Eswatini,-26.5225,31.4659,73374,0,1422,71952
9/16/22,Eswatini,-26.5225,31.4659,73374,0,1422,71952
9/17/22,Eswatini,-26.5225,31.4659,73374,0,1422,71952
9/18/22,Eswatini,-26.5225,31.4659,73379,0,1422,71957
9/19/22,Eswatini,-26.5225,31.4659,73379,0,1422,71957
9/20/22,Eswatini,-26.5225,31.4659,73379,0,1422,71957
9/21/22,Eswatini,-26.5225,31.4659,73379,0,1422,71957
9/22/22,Eswatini,-26.5225,31.4659,73379,0,1422,71957
9/23/22,Eswatini,-26.5225,31.4659,73379,0,1422,71957
9/24/22,Eswatini,-26.5225,31.4659,73379,0,1422,71957
9/25/22,Eswatini,-26.5225,31.4659,73379,0,1422,71957
9/26/22,Eswatini,-26.5225,31.4659,73390,0,1422,71968
9/27/22,Eswatini,-26.5225,31.4659,73390,0,1422,71968
9/28/22,Eswatini,-26.5225,31.4659,73390,0,1422,71968
9/29/22,Eswatini,-26.5225,31.4659,73390,0,1422,71968
9/30/22,Eswatini,-26.5225,31.4659,73390,0,1422,71968
10/1/22,Eswatini,-26.5225,31.4659,73390,0,1422,71968
10/2/22,Eswatini,-26.5225,31.4659,73390,0,1422,71968
10/3/22,Eswatini,-26.5225,31.4659,73410,0,1422,71988
10/4/22,Eswatini,-26.5225,31.4659,73410,0,1422,71988
10/5/22,Eswatini,-26.5225,31.4659,73410,0,1422,71988
10/6/22,Eswatini,-26.5225,31.4659,73410,0,1422,71988
10/7/22,Eswatini,-26.5225,31.4659,73410,0,1422,71988
10/8/22,Eswatini,-26.5225,31.4659,73410,0,1422,71988
10/9/22,Eswatini,-26.5225,31.4659,73436,0,1422,72014
10/10/22,Eswatini,-26.5225,31.4659,73436,0,1422,72014
10/11/22,Eswatini,-26.5225,31.4659,73436,0,1422,72014
10/12/22,Eswatini,-26.5225,31.4659,73436,0,1422,72014
10/13/22,Eswatini,-26.5225,31.4659,73436,0,1422,72014
10/14/22,Eswatini,-26.5225,31.4659,73436,0,1422,72014
10/15/22,Eswatini,-26.5225,31.4659,73436,0,1422,72014
10/16/22,Eswatini,-26.5225,31.4659,73436,0,1422,72014
10/17/22,Eswatini,-26.5225,31.4659,73436,0,1422,72014
10/18/22,Eswatini,-26.5225,31.4659,73436,0,1422,72014
10/19/22,Eswatini,-26.5225,31.4659,73436,0,1422,72014
10/20/22,Eswatini,-26.5225,31.4659,73436,0,1422,72014
10/21/22,Eswatini,-26.5225,31.4659,73436,0,1422,72014
10/22/22,Eswatini,-26.5225,31.4659,73436,0,1422,72014
10/23/22,Eswatini,-26.5225,31.4659,73526,0,1422,72104
10/24/22,Eswatini,-26.5225,31.4659,73526,0,1422,72104
10/25/22,Eswatini,-26.5225,31.4659,73526,0,1422,72104
10/26/22,Eswatini,-26.5225,31.4659,73526,0,1422,72104
10/27/22,Eswatini,-26.5225,31.4659,73526,0,1422,72104
10/28/22,Eswatini,-26.5225,31.4659,73526,0,1422,72104
10/29/22,Eswatini,-26.5225,31.4659,73526,0,1422,72104
10/30/22,Eswatini,-26.5225,31.4659,73558,0,1422,72136
10/31/22,Eswatini,-26.5225,31.4659,73558,0,1422,72136
11/1/22,Eswatini,-26.5225,31.4659,73558,0,1422,72136
11/2/22,Eswatini,-26.5225,31.4659,73558,0,1422,72136
11/3/22,Eswatini,-26.5225,31.4659,73558,0,1422,72136
11/4/22,Eswatini,-26.5225,31.4659,73558,0,1422,72136
11/5/22,Eswatini,-26.5225,31.4659,73558,0,1422,72136
11/6/22,Eswatini,-26.5225,31.4659,73558,0,1422,72136
11/7/22,Eswatini,-26.5225,31.4659,73618,0,1422,72196
11/8/22,Eswatini,-26.5225,31.4659,73618,0,1422,72196
11/9/22,Eswatini,-26.5225,31.4659,73618,0,1422,72196
11/10/22,Eswatini,-26.5225,31.4659,73618,0,1422,72196
11/11/22,Eswatini,-26.5225,31.4659,73618,0,1422,72196
11/12/22,Eswatini,-26.5225,31.4659,73618,0,1422,72196
11/13/22,Eswatini,-26.5225,31.4659,73708,0,1422,72286
11/14/22,Eswatini,-26.5225,31.4659,73708,0,1422,72286
11/15/22,Eswatini,-26.5225,31.4659,73708,0,1422,72286
11/16/22,Eswatini,-26.5225,31.4659,73708,0,1422,72286
11/17/22,Eswatini,-26.5225,31.4659,73708,0,1422,72286
11/18/22,Eswatini,-26.5225,31.4659,73708,0,1422,72286
11/19/22,Eswatini,-26.5225,31.4659,73708,0,1422,72286
11/20/22,Eswatini,-26.5225,31.4659,73770,0,1422,72348
11/21/22,Eswatini,-26.5225,31.4659,73770,0,1422,72348
11/22/22,Eswatini,-26.5225,31.4659,73770,0,1422,72348
11/23/22,Eswatini,-26.5225,31.4659,73770,0,1422,72348
11/24/22,Eswatini,-26.5225,31.4659,73770,0,1422,72348
11/25/22,Eswatini,-26.5225,31.4659,73770,0,1422,72348
11/26/22,Eswatini,-26.5225,31.4659,73770,0,1422,72348
11/27/22,Eswatini,-26.5225,31.4659,73770,0,1422,72348
11/28/22,Eswatini,-26.5225,31.4659,73770,0,1422,72348
11/29/22,Eswatini,-26.5225,31.4659,73770,0,1422,72348
11/30/22,Eswatini,-26.5225,31.4659,73770,0,1422,72348
12/1/22,Eswatini,-26.5225,31.4659,73770,0,1422,72348
12/2/22,Eswatini,-26.5225,31.4659,73770,0,1422,72348
12/3/22,Eswatini,-26.5225,31.4659,73770,0,1422,72348
12/4/22,Eswatini,-26.5225,31.4659,73908,0,1422,72486
12/5/22,Eswatini,-26.5225,31.4659,73908,0,1422,72486
12/6/22,Eswatini,-26.5225,31.4659,73908,0,1422,72486
12/7/22,Eswatini,-26.5225,31.4659,73908,0,1422,72486
12/8/22,Eswatini,-26.5225,31.4659,73908,0,1422,72486
12/9/22,Eswatini,-26.5225,31.4659,73908,0,1422,72486
12/10/22,Eswatini,-26.5225,31.4659,73908,0,1422,72486
12/11/22,Eswatini,-26.5225,31.4659,73908,0,1422,72486
12/12/22,Eswatini,-26.5225,31.4659,73908,0,1422,72486
12/13/22,Eswatini,-26.5225,31.4659,73908,0,1422,72486
12/14/22,Eswatini,-26.5225,31.4659,73962,0,1422,72540
12/15/22,Eswatini,-26.5225,31.4659,73962,0,1422,72540
12/16/22,Eswatini,-26.5225,31.4659,73962,0,1422,72540
12/17/22,Eswatini,-26.5225,31.4659,73962,0,1422,72540
1/1/22,Ethiopia,9.145,40.4897,424340,0,6947,417393
1/2/22,Ethiopia,9.145,40.4897,426656,0,6958,419698
1/3/22,Ethiopia,9.145,40.4897,428796,0,6969,421827
1/4/22,Ethiopia,9.145,40.4897,432807,0,6981,425826
1/5/22,Ethiopia,9.145,40.4897,436586,0,6988,429598
1/6/22,Ethiopia,9.145,40.4897,440024,0,7005,433019
1/7/22,Ethiopia,9.145,40.4897,442187,0,7012,435175
1/8/22,Ethiopia,9.145,40.4897,443339,0,7020,436319
1/9/22,Ethiopia,9.145,40.4897,444124,0,7030,437094
1/10/22,Ethiopia,9.145,40.4897,446268,0,7042,439226
1/11/22,Ethiopia,9.145,40.4897,448728,0,7066,441662
1/12/22,Ethiopia,9.145,40.4897,450997,0,7090,443907
1/13/22,Ethiopia,9.145,40.4897,453128,0,7109,446019
1/14/22,Ethiopia,9.145,40.4897,454556,0,7117,447439
1/15/22,Ethiopia,9.145,40.4897,456279,0,7131,449148
1/16/22,Ethiopia,9.145,40.4897,457322,0,7147,450175
1/17/22,Ethiopia,9.145,40.4897,458203,0,7162,451041
1/18/22,Ethiopia,9.145,40.4897,459486,0,7184,452302
1/19/22,Ethiopia,9.145,40.4897,459959,0,7190,452769
1/20/22,Ethiopia,9.145,40.4897,460602,0,7212,453390
1/21/22,Ethiopia,9.145,40.4897,461252,0,7226,454026
1/22/22,Ethiopia,9.145,40.4897,461733,0,7236,454497
1/23/22,Ethiopia,9.145,40.4897,462107,0,7244,454863
1/24/22,Ethiopia,9.145,40.4897,462514,0,7265,455249
1/25/22,Ethiopia,9.145,40.4897,463047,0,7280,455767
1/26/22,Ethiopia,9.145,40.4897,463465,0,7292,456173
1/27/22,Ethiopia,9.145,40.4897,463921,0,7303,456618
1/28/22,Ethiopia,9.145,40.4897,464383,0,7311,457072
1/29/22,Ethiopia,9.145,40.4897,464754,0,7327,457427
1/30/22,Ethiopia,9.145,40.4897,464930,0,7331,457599
1/31/22,Ethiopia,9.145,40.4897,465158,0,7337,457821
2/1/22,Ethiopia,9.145,40.4897,465477,0,7343,458134
2/2/22,Ethiopia,9.145,40.4897,465792,0,7346,458446
2/3/22,Ethiopia,9.145,40.4897,466126,0,7353,458773
2/4/22,Ethiopia,9.145,40.4897,466289,0,7355,458934
2/5/22,Ethiopia,9.145,40.4897,466455,0,7356,459099
2/6/22,Ethiopia,9.145,40.4897,466539,0,7363,459176
2/7/22,Ethiopia,9.145,40.4897,466677,0,7373,459304
2/8/22,Ethiopia,9.145,40.4897,466840,0,7385,459455
2/9/22,Ethiopia,9.145,40.4897,467001,0,7397,459604
2/10/22,Ethiopia,9.145,40.4897,467153,0,7407,459746
2/11/22,Ethiopia,9.145,40.4897,467288,0,7417,459871
2/12/22,Ethiopia,9.145,40.4897,467399,0,7421,459978
2/13/22,Ethiopia,9.145,40.4897,467498,0,7424,460074
2/14/22,Ethiopia,9.145,40.4897,467575,0,7426,460149
2/15/22,Ethiopia,9.145,40.4897,467691,0,7428,460263
2/16/22,Ethiopia,9.145,40.4897,467860,0,7429,460431
2/17/22,Ethiopia,9.145,40.4897,467975,0,7430,460545
2/18/22,Ethiopia,9.145,40.4897,468234,0,7435,460799
2/19/22,Ethiopia,9.145,40.4897,468284,0,7438,460846
2/20/22,Ethiopia,9.145,40.4897,468345,0,7438,460907
2/21/22,Ethiopia,9.145,40.4897,468379,0,7440,460939
2/22/22,Ethiopia,9.145,40.4897,468426,0,7441,460985
2/23/22,Ethiopia,9.145,40.4897,468495,0,7446,461049
2/24/22,Ethiopia,9.145,40.4897,468564,0,7450,461114
2/25/22,Ethiopia,9.145,40.4897,468606,0,7454,461152
2/26/22,Ethiopia,9.145,40.4897,468625,0,7458,461167
2/27/22,Ethiopia,9.145,40.4897,468674,0,7460,461214
2/28/22,Ethiopia,9.145,40.4897,468727,0,7462,461265
3/1/22,Ethiopia,9.145,40.4897,468770,0,7463,461307
3/2/22,Ethiopia,9.145,40.4897,468786,0,7467,461319
3/3/22,Ethiopia,9.145,40.4897,468850,0,7473,461377
3/4/22,Ethiopia,9.145,40.4897,468895,0,7476,461419
3/5/22,Ethiopia,9.145,40.4897,468930,0,7476,461454
3/6/22,Ethiopia,9.145,40.4897,468966,0,7476,461490
3/7/22,Ethiopia,9.145,40.4897,469007,0,7476,461531
3/8/22,Ethiopia,9.145,40.4897,469047,0,7477,461570
3/9/22,Ethiopia,9.145,40.4897,469095,0,7482,461613
3/10/22,Ethiopia,9.145,40.4897,469134,0,7484,461650
3/11/22,Ethiopia,9.145,40.4897,469153,0,7484,461669
3/12/22,Ethiopia,9.145,40.4897,469170,0,7485,461685
3/13/22,Ethiopia,9.145,40.4897,469184,0,7486,461698
3/14/22,Ethiopia,9.145,40.4897,469222,0,7486,461736
3/15/22,Ethiopia,9.145,40.4897,469291,0,7486,461805
3/16/22,Ethiopia,9.145,40.4897,469329,0,7488,461841
3/17/22,Ethiopia,9.145,40.4897,469393,0,7488,461905
3/18/22,Ethiopia,9.145,40.4897,469419,0,7488,461931
3/19/22,Ethiopia,9.145,40.4897,469441,0,7489,461952
3/20/22,Ethiopia,9.145,40.4897,469455,0,7489,461966
3/21/22,Ethiopia,9.145,40.4897,469469,0,7489,461980
3/22/22,Ethiopia,9.145,40.4897,469494,0,7489,462005
3/23/22,Ethiopia,9.145,40.4897,469523,0,7491,462032
3/24/22,Ethiopia,9.145,40.4897,469544,0,7491,462053
3/25/22,Ethiopia,9.145,40.4897,469604,0,7491,462113
3/26/22,Ethiopia,9.145,40.4897,469611,0,7492,462119
3/27/22,Ethiopia,9.145,40.4897,469621,0,7492,462129
3/28/22,Ethiopia,9.145,40.4897,469656,0,7492,462164
3/29/22,Ethiopia,9.145,40.4897,469679,0,7492,462187
3/30/22,Ethiopia,9.145,40.4897,469704,0,7492,462212
3/31/22,Ethiopia,9.145,40.4897,469758,0,7497,462261
4/1/22,Ethiopia,9.145,40.4897,469784,0,7500,462284
4/2/22,Ethiopia,9.145,40.4897,469806,0,7504,462302
4/3/22,Ethiopia,9.145,40.4897,469819,0,7504,462315
4/4/22,Ethiopia,9.145,40.4897,469843,0,7508,462335
4/5/22,Ethiopia,9.145,40.4897,469879,0,7508,462371
4/6/22,Ethiopia,9.145,40.4897,469916,0,7508,462408
4/7/22,Ethiopia,9.145,40.4897,469979,0,7508,462471
4/8/22,Ethiopia,9.145,40.4897,470005,0,7508,462497
4/9/22,Ethiopia,9.145,40.4897,470025,0,7509,462516
4/10/22,Ethiopia,9.145,40.4897,470050,0,7509,462541
4/11/22,Ethiopia,9.145,40.4897,470096,0,7509,462587
4/12/22,Ethiopia,9.145,40.4897,470108,0,7509,462599
4/13/22,Ethiopia,9.145,40.4897,470151,0,7509,462642
4/14/22,Ethiopia,9.145,40.4897,470165,0,7509,462656
4/15/22,Ethiopia,9.145,40.4897,470232,0,7509,462723
4/16/22,Ethiopia,9.145,40.4897,470259,0,7509,462750
4/17/22,Ethiopia,9.145,40.4897,470273,0,7509,462764
4/18/22,Ethiopia,9.145,40.4897,470288,0,7509,462779
4/19/22,Ethiopia,9.145,40.4897,470305,0,7509,462796
4/20/22,Ethiopia,9.145,40.4897,470352,0,7510,462842
4/21/22,Ethiopia,9.145,40.4897,470389,0,7510,462879
4/22/22,Ethiopia,9.145,40.4897,470405,0,7510,462895
4/23/22,Ethiopia,9.145,40.4897,470417,0,7510,462907
4/24/22,Ethiopia,9.145,40.4897,470434,0,7510,462924
4/25/22,Ethiopia,9.145,40.4897,470442,0,7510,462932
4/26/22,Ethiopia,9.145,40.4897,470468,0,7510,462958
4/27/22,Ethiopia,9.145,40.4897,470492,0,7510,462982
4/28/22,Ethiopia,9.145,40.4897,470515,0,7510,463005
4/29/22,Ethiopia,9.145,40.4897,470550,0,7510,463040
4/30/22,Ethiopia,9.145,40.4897,470568,0,7510,463058
5/1/22,Ethiopia,9.145,40.4897,470581,0,7510,463071
5/2/22,Ethiopia,9.145,40.4897,470587,0,7510,463077
5/3/22,Ethiopia,9.145,40.4897,470609,0,7510,463099
5/4/22,Ethiopia,9.145,40.4897,470647,0,7510,463137
5/5/22,Ethiopia,9.145,40.4897,470686,0,7510,463176
5/6/22,Ethiopia,9.145,40.4897,470704,0,7510,463194
5/7/22,Ethiopia,9.145,40.4897,470730,0,7510,463220
5/8/22,Ethiopia,9.145,40.4897,470740,0,7510,463230
5/9/22,Ethiopia,9.145,40.4897,470760,0,7510,463250
5/10/22,Ethiopia,9.145,40.4897,470798,0,7510,463288
5/11/22,Ethiopia,9.145,40.4897,470833,0,7510,463323
5/12/22,Ethiopia,9.145,40.4897,470851,0,7510,463341
5/13/22,Ethiopia,9.145,40.4897,470899,0,7510,463389
5/14/22,Ethiopia,9.145,40.4897,470937,0,7510,463427
5/15/22,Ethiopia,9.145,40.4897,470949,0,7510,463439
5/16/22,Ethiopia,9.145,40.4897,470991,0,7512,463479
5/17/22,Ethiopia,9.145,40.4897,471040,0,7512,463528
5/18/22,Ethiopia,9.145,40.4897,471089,0,7512,463577
5/19/22,Ethiopia,9.145,40.4897,471145,0,7512,463633
5/20/22,Ethiopia,9.145,40.4897,471227,0,7512,463715
5/21/22,Ethiopia,9.145,40.4897,471343,0,7512,463831
5/22/22,Ethiopia,9.145,40.4897,471373,0,7512,463861
5/23/22,Ethiopia,9.145,40.4897,471423,0,7512,463911
5/24/22,Ethiopia,9.145,40.4897,471527,0,7512,464015
5/25/22,Ethiopia,9.145,40.4897,471678,0,7513,464165
5/26/22,Ethiopia,9.145,40.4897,471879,0,7513,464366
5/27/22,Ethiopia,9.145,40.4897,472048,0,7513,464535
5/28/22,Ethiopia,9.145,40.4897,472232,0,7513,464719
5/29/22,Ethiopia,9.145,40.4897,472232,0,7513,464719
5/30/22,Ethiopia,9.145,40.4897,472447,0,7513,464934
5/31/22,Ethiopia,9.145,40.4897,472743,0,7513,465230
6/1/22,Ethiopia,9.145,40.4897,473188,0,7513,465675
6/2/22,Ethiopia,9.145,40.4897,473635,0,7514,466121
6/3/22,Ethiopia,9.145,40.4897,473979,0,7514,466465
6/4/22,Ethiopia,9.145,40.4897,474715,0,7515,467200
6/5/22,Ethiopia,9.145,40.4897,475012,0,7515,467497
6/6/22,Ethiopia,9.145,40.4897,475321,0,7515,467806
6/7/22,Ethiopia,9.145,40.4897,475764,0,7515,468249
6/8/22,Ethiopia,9.145,40.4897,476398,0,7516,468882
6/9/22,Ethiopia,9.145,40.4897,477006,0,7516,469490
6/10/22,Ethiopia,9.145,40.4897,477742,0,7516,470226
6/11/22,Ethiopia,9.145,40.4897,478544,0,7516,471028
6/12/22,Ethiopia,9.145,40.4897,478963,0,7516,471447
6/13/22,Ethiopia,9.145,40.4897,479484,0,7517,471967
6/14/22,Ethiopia,9.145,40.4897,480450,0,7517,472933
6/15/22,Ethiopia,9.145,40.4897,481225,0,7518,473707
6/16/22,Ethiopia,9.145,40.4897,482032,0,7518,474514
6/17/22,Ethiopia,9.145,40.4897,482888,0,7522,475366
6/18/22,Ethiopia,9.145,40.4897,483739,0,7522,476217
6/19/22,Ethiopia,9.145,40.4897,484138,0,7523,476615
6/20/22,Ethiopia,9.145,40.4897,484536,0,7524,477012
6/21/22,Ethiopia,9.145,40.4897,485047,0,7525,477522
6/22/22,Ethiopia,9.145,40.4897,485774,0,7526,478248
6/23/22,Ethiopia,9.145,40.4897,486373,0,7526,478847
6/24/22,Ethiopia,9.145,40.4897,486831,0,7527,479304
6/25/22,Ethiopia,9.145,40.4897,487217,0,7530,479687
6/26/22,Ethiopia,9.145,40.4897,487430,0,7530,479900
6/27/22,Ethiopia,9.145,40.4897,487683,0,7532,480151
6/28/22,Ethiopia,9.145,40.4897,488108,0,7535,480573
6/29/22,Ethiopia,9.145,40.4897,488433,0,7536,480897
6/30/22,Ethiopia,9.145,40.4897,488724,0,7536,481188
7/1/22,Ethiopia,9.145,40.4897,489005,0,7537,481468
7/2/22,Ethiopia,9.145,40.4897,489255,0,7538,481717
7/3/22,Ethiopia,9.145,40.4897,489341,0,7541,481800
7/4/22,Ethiopia,9.145,40.4897,489502,0,7542,481960
7/5/22,Ethiopia,9.145,40.4897,489656,0,7544,482112
7/6/22,Ethiopia,9.145,40.4897,489846,0,7548,482298
7/7/22,Ethiopia,9.145,40.4897,490031,0,7549,482482
7/8/22,Ethiopia,9.145,40.4897,490182,0,7550,482632
7/9/22,Ethiopia,9.145,40.4897,490296,0,7551,482745
7/10/22,Ethiopia,9.145,40.4897,490370,0,7552,482818
7/11/22,Ethiopia,9.145,40.4897,490486,0,7552,482934
7/12/22,Ethiopia,9.145,40.4897,490557,0,7552,483005
7/13/22,Ethiopia,9.145,40.4897,490695,0,7559,483136
7/14/22,Ethiopia,9.145,40.4897,490816,0,7559,483257
7/15/22,Ethiopia,9.145,40.4897,490925,0,7561,483364
7/16/22,Ethiopia,9.145,40.4897,491031,0,7561,483470
7/17/22,Ethiopia,9.145,40.4897,491086,0,7561,483525
7/18/22,Ethiopia,9.145,40.4897,491086,0,7561,483525
7/19/22,Ethiopia,9.145,40.4897,491285,0,7563,483722
7/20/22,Ethiopia,9.145,40.4897,491409,0,7563,483846
7/21/22,Ethiopia,9.145,40.4897,491508,0,7564,483944
7/22/22,Ethiopia,9.145,40.4897,491642,0,7566,484076
7/23/22,Ethiopia,9.145,40.4897,491729,0,7566,484163
7/24/22,Ethiopia,9.145,40.4897,491759,0,7566,484193
7/25/22,Ethiopia,9.145,40.4897,491834,0,7567,484267
7/26/22,Ethiopia,9.145,40.4897,491917,0,7568,484349
7/27/22,Ethiopia,9.145,40.4897,491979,0,7568,484411
7/28/22,Ethiopia,9.145,40.4897,492046,0,7568,484478
7/29/22,Ethiopia,9.145,40.4897,492125,0,7568,484557
7/30/22,Ethiopia,9.145,40.4897,492194,0,7568,484626
7/31/22,Ethiopia,9.145,40.4897,492237,0,7568,484669
8/1/22,Ethiopia,9.145,40.4897,492278,0,7568,484710
8/2/22,Ethiopia,9.145,40.4897,492316,0,7568,484748
8/3/22,Ethiopia,9.145,40.4897,492375,0,7568,484807
8/4/22,Ethiopia,9.145,40.4897,492412,0,7569,484843
8/5/22,Ethiopia,9.145,40.4897,492461,0,7569,484892
8/6/22,Ethiopia,9.145,40.4897,492476,0,7569,484907
8/7/22,Ethiopia,9.145,40.4897,492491,0,7569,484922
8/8/22,Ethiopia,9.145,40.4897,492549,0,7569,484980
8/9/22,Ethiopia,9.145,40.4897,492590,0,7569,485021
8/10/22,Ethiopia,9.145,40.4897,492631,0,7569,485062
8/11/22,Ethiopia,9.145,40.4897,492667,0,7569,485098
8/12/22,Ethiopia,9.145,40.4897,492713,0,7569,485144
8/13/22,Ethiopia,9.145,40.4897,492738,0,7569,485169
8/14/22,Ethiopia,9.145,40.4897,492753,0,7571,485182
8/15/22,Ethiopia,9.145,40.4897,492816,0,7571,485245
8/16/22,Ethiopia,9.145,40.4897,492848,0,7571,485277
8/17/22,Ethiopia,9.145,40.4897,492874,0,7571,485303
8/18/22,Ethiopia,9.145,40.4897,492894,0,7571,485323
8/19/22,Ethiopia,9.145,40.4897,492935,0,7571,485364
8/20/22,Ethiopia,9.145,40.4897,492960,0,7571,485389
8/21/22,Ethiopia,9.145,40.4897,492968,0,7571,485397
8/22/22,Ethiopia,9.145,40.4897,493010,0,7571,485439
8/23/22,Ethiopia,9.145,40.4897,493032,0,7571,485461
8/24/22,Ethiopia,9.145,40.4897,493076,0,7571,485505
8/25/22,Ethiopia,9.145,40.4897,493089,0,7571,485518
8/26/22,Ethiopia,9.145,40.4897,493132,0,7571,485561
8/27/22,Ethiopia,9.145,40.4897,493142,0,7571,485571
8/28/22,Ethiopia,9.145,40.4897,493144,0,7571,485573
8/29/22,Ethiopia,9.145,40.4897,493167,0,7571,485596
8/30/22,Ethiopia,9.145,40.4897,493180,0,7572,485608
8/31/22,Ethiopia,9.145,40.4897,493190,0,7572,485618
9/1/22,Ethiopia,9.145,40.4897,493197,0,7572,485625
9/2/22,Ethiopia,9.145,40.4897,493224,0,7572,485652
9/3/22,Ethiopia,9.145,40.4897,493234,0,7572,485662
9/4/22,Ethiopia,9.145,40.4897,493237,0,7572,485665
9/5/22,Ethiopia,9.145,40.4897,493272,0,7572,485700
9/6/22,Ethiopia,9.145,40.4897,493278,0,7572,485706
9/7/22,Ethiopia,9.145,40.4897,493305,0,7572,485733
9/8/22,Ethiopia,9.145,40.4897,493316,0,7572,485744
9/9/22,Ethiopia,9.145,40.4897,493333,0,7572,485761
9/10/22,Ethiopia,9.145,40.4897,493340,0,7572,485768
9/11/22,Ethiopia,9.145,40.4897,493340,0,7572,485768
9/12/22,Ethiopia,9.145,40.4897,493346,0,7572,485774
9/13/22,Ethiopia,9.145,40.4897,493367,0,7572,485795
9/14/22,Ethiopia,9.145,40.4897,493385,0,7572,485813
9/15/22,Ethiopia,9.145,40.4897,493403,0,7572,485831
9/16/22,Ethiopia,9.145,40.4897,493423,0,7572,485851
9/17/22,Ethiopia,9.145,40.4897,493429,0,7572,485857
9/18/22,Ethiopia,9.145,40.4897,493430,0,7572,485858
9/19/22,Ethiopia,9.145,40.4897,493456,0,7572,485884
9/20/22,Ethiopia,9.145,40.4897,493461,0,7572,485889
9/21/22,Ethiopia,9.145,40.4897,493478,0,7572,485906
9/22/22,Ethiopia,9.145,40.4897,493490,0,7572,485918
9/23/22,Ethiopia,9.145,40.4897,493498,0,7572,485926
9/24/22,Ethiopia,9.145,40.4897,493505,0,7572,485933
9/25/22,Ethiopia,9.145,40.4897,493510,0,7572,485938
9/26/22,Ethiopia,9.145,40.4897,493528,0,7572,485956
9/27/22,Ethiopia,9.145,40.4897,493534,0,7572,485962
9/28/22,Ethiopia,9.145,40.4897,493555,0,7572,485983
9/29/22,Ethiopia,9.145,40.4897,493563,0,7572,485991
9/30/22,Ethiopia,9.145,40.4897,493579,0,7572,486007
10/1/22,Ethiopia,9.145,40.4897,493587,0,7572,486015
10/2/22,Ethiopia,9.145,40.4897,493588,0,7572,486016
10/3/22,Ethiopia,9.145,40.4897,493616,0,7572,486044
10/4/22,Ethiopia,9.145,40.4897,493627,0,7572,486055
10/5/22,Ethiopia,9.145,40.4897,493640,0,7572,486068
10/6/22,Ethiopia,9.145,40.4897,493654,0,7572,486082
10/7/22,Ethiopia,9.145,40.4897,493671,0,7572,486099
10/8/22,Ethiopia,9.145,40.4897,493682,0,7572,486110
10/9/22,Ethiopia,9.145,40.4897,493684,0,7572,486112
10/10/22,Ethiopia,9.145,40.4897,493698,0,7572,486126
10/11/22,Ethiopia,9.145,40.4897,493708,0,7572,486136
10/12/22,Ethiopia,9.145,40.4897,493723,0,7572,486151
10/13/22,Ethiopia,9.145,40.4897,493738,0,7572,486166
10/14/22,Ethiopia,9.145,40.4897,493767,0,7572,486195
10/15/22,Ethiopia,9.145,40.4897,493781,0,7572,486209
10/16/22,Ethiopia,9.145,40.4897,493783,0,7572,486211
10/17/22,Ethiopia,9.145,40.4897,493783,0,7572,486211
10/18/22,Ethiopia,9.145,40.4897,493803,0,7572,486231
10/19/22,Ethiopia,9.145,40.4897,493818,0,7572,486246
10/20/22,Ethiopia,9.145,40.4897,493837,0,7572,486265
10/21/22,Ethiopia,9.145,40.4897,493837,0,7572,486265
10/22/22,Ethiopia,9.145,40.4897,493864,0,7572,486292
10/23/22,Ethiopia,9.145,40.4897,493875,0,7572,486303
10/24/22,Ethiopia,9.145,40.4897,493885,0,7572,486313
10/25/22,Ethiopia,9.145,40.4897,493894,0,7572,486322
10/26/22,Ethiopia,9.145,40.4897,493905,0,7572,486333
10/27/22,Ethiopia,9.145,40.4897,493912,0,7572,486340
10/28/22,Ethiopia,9.145,40.4897,493937,0,7572,486365
10/29/22,Ethiopia,9.145,40.4897,493939,0,7572,486367
10/30/22,Ethiopia,9.145,40.4897,493940,0,7572,486368
10/31/22,Ethiopia,9.145,40.4897,493960,0,7572,486388
11/1/22,Ethiopia,9.145,40.4897,493972,0,7572,486400
11/2/22,Ethiopia,9.145,40.4897,493988,0,7572,486416
11/3/22,Ethiopia,9.145,40.4897,493996,0,7572,486424
11/4/22,Ethiopia,9.145,40.4897,494024,0,7572,486452
11/5/22,Ethiopia,9.145,40.4897,494039,0,7572,486467
11/6/22,Ethiopia,9.145,40.4897,494042,0,7572,486470
11/7/22,Ethiopia,9.145,40.4897,494086,0,7572,486514
11/8/22,Ethiopia,9.145,40.4897,494106,0,7572,486534
11/9/22,Ethiopia,9.145,40.4897,494119,0,7572,486547
11/10/22,Ethiopia,9.145,40.4897,494119,0,7572,486547
11/11/22,Ethiopia,9.145,40.4897,494166,0,7572,486594
11/12/22,Ethiopia,9.145,40.4897,494180,0,7572,486608
11/13/22,Ethiopia,9.145,40.4897,494185,0,7572,486613
11/14/22,Ethiopia,9.145,40.4897,494202,0,7572,486630
11/15/22,Ethiopia,9.145,40.4897,494217,0,7572,486645
11/16/22,Ethiopia,9.145,40.4897,494240,0,7572,486668
11/17/22,Ethiopia,9.145,40.4897,494270,0,7572,486698
11/18/22,Ethiopia,9.145,40.4897,494285,0,7572,486713
11/19/22,Ethiopia,9.145,40.4897,494300,0,7572,486728
11/20/22,Ethiopia,9.145,40.4897,494314,0,7572,486742
11/21/22,Ethiopia,9.145,40.4897,494327,0,7572,486755
11/22/22,Ethiopia,9.145,40.4897,494349,0,7572,486777
11/23/22,Ethiopia,9.145,40.4897,494372,0,7572,486800
11/24/22,Ethiopia,9.145,40.4897,494428,0,7572,486856
11/25/22,Ethiopia,9.145,40.4897,494450,0,7572,486878
11/26/22,Ethiopia,9.145,40.4897,494462,0,7572,486890
11/27/22,Ethiopia,9.145,40.4897,494497,0,7572,486925
11/28/22,Ethiopia,9.145,40.4897,494520,0,7572,486948
11/29/22,Ethiopia,9.145,40.4897,494531,0,7572,486959
11/30/22,Ethiopia,9.145,40.4897,494578,0,7572,487006
12/1/22,Ethiopia,9.145,40.4897,494645,0,7572,487073
12/2/22,Ethiopia,9.145,40.4897,494687,0,7572,487115
12/3/22,Ethiopia,9.145,40.4897,494726,0,7572,487154
12/4/22,Ethiopia,9.145,40.4897,494760,0,7572,487188
12/5/22,Ethiopia,9.145,40.4897,494786,0,7572,487214
12/6/22,Ethiopia,9.145,40.4897,494857,0,7572,487285
12/7/22,Ethiopia,9.145,40.4897,494926,0,7572,487354
12/8/22,Ethiopia,9.145,40.4897,495021,0,7572,487449
12/9/22,Ethiopia,9.145,40.4897,495105,0,7572,487533
12/10/22,Ethiopia,9.145,40.4897,495196,0,7572,487624
12/11/22,Ethiopia,9.145,40.4897,495241,0,7572,487669
12/12/22,Ethiopia,9.145,40.4897,495284,0,7572,487712
12/13/22,Ethiopia,9.145,40.4897,495420,0,7572,487848
12/14/22,Ethiopia,9.145,40.4897,495420,0,7572,487848
12/15/22,Ethiopia,9.145,40.4897,495747,0,7572,488175
12/16/22,Ethiopia,9.145,40.4897,495965,0,7572,488393
12/17/22,Ethiopia,9.145,40.4897,496083,0,7572,488511
1/1/22,Fiji,-17.7134,178.065,54147,0,700,53447
1/2/22,Fiji,-17.7134,178.065,54147,0,700,53447
1/3/22,Fiji,-17.7134,178.065,55009,0,702,54307
1/4/22,Fiji,-17.7134,178.065,55009,0,702,54307
1/5/22,Fiji,-17.7134,178.065,55649,0,704,54945
1/6/22,Fiji,-17.7134,178.065,55649,0,704,54945
1/7/22,Fiji,-17.7134,178.065,55649,0,704,54945
1/8/22,Fiji,-17.7134,178.065,57257,0,709,56548
1/9/22,Fiji,-17.7134,178.065,57257,0,709,56548
1/10/22,Fiji,-17.7134,178.065,57849,0,714,57135
1/11/22,Fiji,-17.7134,178.065,57849,0,714,57135
1/12/22,Fiji,-17.7134,178.065,58491,0,721,57770
1/13/22,Fiji,-17.7134,178.065,58491,0,721,57770
1/14/22,Fiji,-17.7134,178.065,58491,0,721,57770
1/15/22,Fiji,-17.7134,178.065,59418,0,730,58688
1/16/22,Fiji,-17.7134,178.065,59418,0,730,58688
1/17/22,Fiji,-17.7134,178.065,59785,0,746,59039
1/18/22,Fiji,-17.7134,178.065,59785,0,746,59039
1/19/22,Fiji,-17.7134,178.065,60509,0,752,59757
1/20/22,Fiji,-17.7134,178.065,60509,0,752,59757
1/21/22,Fiji,-17.7134,178.065,60931,0,768,60163
1/22/22,Fiji,-17.7134,178.065,60931,0,768,60163
1/23/22,Fiji,-17.7134,178.065,60931,0,768,60163
1/24/22,Fiji,-17.7134,178.065,61898,0,779,61119
1/25/22,Fiji,-17.7134,178.065,61968,0,779,61189
1/26/22,Fiji,-17.7134,178.065,62203,0,791,61412
1/27/22,Fiji,-17.7134,178.065,62203,0,791,61412
1/28/22,Fiji,-17.7134,178.065,62373,0,798,61575
1/29/22,Fiji,-17.7134,178.065,62373,0,798,61575
1/30/22,Fiji,-17.7134,178.065,62373,0,798,61575
1/31/22,Fiji,-17.7134,178.065,62855,0,801,62054
2/1/22,Fiji,-17.7134,178.065,62855,0,801,62054
2/2/22,Fiji,-17.7134,178.065,63147,0,809,62338
2/3/22,Fiji,-17.7134,178.065,63147,0,809,62338
2/4/22,Fiji,-17.7134,178.065,63274,0,811,62463
2/5/22,Fiji,-17.7134,178.065,63274,0,811,62463
2/6/22,Fiji,-17.7134,178.065,63274,0,811,62463
2/7/22,Fiji,-17.7134,178.065,63356,0,813,62543
2/8/22,Fiji,-17.7134,178.065,63356,0,813,62543
2/9/22,Fiji,-17.7134,178.065,63398,0,816,62582
2/10/22,Fiji,-17.7134,178.065,63398,0,816,62582
2/11/22,Fiji,-17.7134,178.065,63476,0,819,62657
2/12/22,Fiji,-17.7134,178.065,63476,0,819,62657
2/13/22,Fiji,-17.7134,178.065,63476,0,819,62657
2/14/22,Fiji,-17.7134,178.065,63509,0,820,62689
2/15/22,Fiji,-17.7134,178.065,63509,0,820,62689
2/16/22,Fiji,-17.7134,178.065,63543,0,823,62720
2/17/22,Fiji,-17.7134,178.065,63543,0,823,62720
2/18/22,Fiji,-17.7134,178.065,63624,0,824,62800
2/19/22,Fiji,-17.7134,178.065,63624,0,824,62800
2/20/22,Fiji,-17.7134,178.065,63624,0,824,62800
2/21/22,Fiji,-17.7134,178.065,63650,0,826,62824
2/22/22,Fiji,-17.7134,178.065,63650,0,826,62824
2/23/22,Fiji,-17.7134,178.065,63687,0,826,62861
2/24/22,Fiji,-17.7134,178.065,63687,0,826,62861
2/25/22,Fiji,-17.7134,178.065,63756,0,833,62923
2/26/22,Fiji,-17.7134,178.065,63756,0,833,62923
2/27/22,Fiji,-17.7134,178.065,63756,0,833,62923
2/28/22,Fiji,-17.7134,178.065,63930,0,834,63096
3/1/22,Fiji,-17.7134,178.065,63930,0,834,63096
3/2/22,Fiji,-17.7134,178.065,63999,0,834,63165
3/3/22,Fiji,-17.7134,178.065,63999,0,834,63165
3/4/22,Fiji,-17.7134,178.065,64019,0,834,63185
3/5/22,Fiji,-17.7134,178.065,64019,0,834,63185
3/6/22,Fiji,-17.7134,178.065,64019,0,834,63185
3/7/22,Fiji,-17.7134,178.065,64034,0,834,63200
3/8/22,Fiji,-17.7134,178.065,64034,0,834,63200
3/9/22,Fiji,-17.7134,178.065,64060,0,834,63226
3/10/22,Fiji,-17.7134,178.065,64060,0,834,63226
3/11/22,Fiji,-17.7134,178.065,64067,0,834,63233
3/12/22,Fiji,-17.7134,178.065,64067,0,834,63233
3/13/22,Fiji,-17.7134,178.065,64067,0,834,63233
3/14/22,Fiji,-17.7134,178.065,64081,0,834,63247
3/15/22,Fiji,-17.7134,178.065,64081,0,834,63247
3/16/22,Fiji,-17.7134,178.065,64154,0,834,63320
3/17/22,Fiji,-17.7134,178.065,64154,0,834,63320
3/18/22,Fiji,-17.7134,178.065,64221,0,834,63387
3/19/22,Fiji,-17.7134,178.065,64221,0,834,63387
3/20/22,Fiji,-17.7134,178.065,64221,0,834,63387
3/21/22,Fiji,-17.7134,178.065,64327,0,834,63493
3/22/22,Fiji,-17.7134,178.065,64327,0,834,63493
3/23/22,Fiji,-17.7134,178.065,64335,0,834,63501
3/24/22,Fiji,-17.7134,178.065,64335,0,834,63501
3/25/22,Fiji,-17.7134,178.065,64376,0,834,63542
3/26/22,Fiji,-17.7134,178.065,64376,0,834,63542
3/27/22,Fiji,-17.7134,178.065,64376,0,834,63542
3/28/22,Fiji,-17.7134,178.065,64394,0,834,63560
3/29/22,Fiji,-17.7134,178.065,64394,0,834,63560
3/30/22,Fiji,-17.7134,178.065,64404,0,834,63570
3/31/22,Fiji,-17.7134,178.065,64404,0,834,63570
4/1/22,Fiji,-17.7134,178.065,64417,0,834,63583
4/2/22,Fiji,-17.7134,178.065,64417,0,834,63583
4/3/22,Fiji,-17.7134,178.065,64417,0,834,63583
4/4/22,Fiji,-17.7134,178.065,64425,0,834,63591
4/5/22,Fiji,-17.7134,178.065,64425,0,834,63591
4/6/22,Fiji,-17.7134,178.065,64471,0,834,63637
4/7/22,Fiji,-17.7134,178.065,64471,0,834,63637
4/8/22,Fiji,-17.7134,178.065,64492,0,834,63658
4/9/22,Fiji,-17.7134,178.065,64492,0,834,63658
4/10/22,Fiji,-17.7134,178.065,64492,0,834,63658
4/11/22,Fiji,-17.7134,178.065,64499,0,834,63665
4/12/22,Fiji,-17.7134,178.065,64499,0,834,63665
4/13/22,Fiji,-17.7134,178.065,64502,0,862,63640
4/14/22,Fiji,-17.7134,178.065,64502,0,862,63640
4/15/22,Fiji,-17.7134,178.065,64509,0,862,63647
4/16/22,Fiji,-17.7134,178.065,64509,0,862,63647
4/17/22,Fiji,-17.7134,178.065,64509,0,862,63647
4/18/22,Fiji,-17.7134,178.065,64513,0,862,63651
4/19/22,Fiji,-17.7134,178.065,64513,0,862,63651
4/20/22,Fiji,-17.7134,178.065,64524,0,862,63662
4/21/22,Fiji,-17.7134,178.065,64524,0,862,63662
4/22/22,Fiji,-17.7134,178.065,64524,0,862,63662
4/23/22,Fiji,-17.7134,178.065,64524,0,862,63662
4/24/22,Fiji,-17.7134,178.065,64524,0,862,63662
4/25/22,Fiji,-17.7134,178.065,64535,0,862,63673
4/26/22,Fiji,-17.7134,178.065,64535,0,862,63673
4/27/22,Fiji,-17.7134,178.065,64535,0,862,63673
4/28/22,Fiji,-17.7134,178.065,64634,0,862,63772
4/29/22,Fiji,-17.7134,178.065,64634,0,862,63772
4/30/22,Fiji,-17.7134,178.065,64634,0,862,63772
5/1/22,Fiji,-17.7134,178.065,64634,0,862,63772
5/2/22,Fiji,-17.7134,178.065,64646,0,862,63784
5/3/22,Fiji,-17.7134,178.065,64646,0,862,63784
5/4/22,Fiji,-17.7134,178.065,64646,0,862,63784
5/5/22,Fiji,-17.7134,178.065,64699,0,862,63837
5/6/22,Fiji,-17.7134,178.065,64699,0,862,63837
5/7/22,Fiji,-17.7134,178.065,64699,0,862,63837
5/8/22,Fiji,-17.7134,178.065,64699,0,862,63837
5/9/22,Fiji,-17.7134,178.065,64725,0,862,63863
5/10/22,Fiji,-17.7134,178.065,64725,0,862,63863
5/11/22,Fiji,-17.7134,178.065,64725,0,862,63863
5/12/22,Fiji,-17.7134,178.065,64725,0,862,63863
5/13/22,Fiji,-17.7134,178.065,64773,0,862,63911
5/14/22,Fiji,-17.7134,178.065,64773,0,862,63911
5/15/22,Fiji,-17.7134,178.065,64773,0,862,63911
5/16/22,Fiji,-17.7134,178.065,64812,0,862,63950
5/17/22,Fiji,-17.7134,178.065,64812,0,862,63950
5/18/22,Fiji,-17.7134,178.065,64812,0,862,63950
5/19/22,Fiji,-17.7134,178.065,64841,0,862,63979
5/20/22,Fiji,-17.7134,178.065,64841,0,862,63979
5/21/22,Fiji,-17.7134,178.065,64841,0,862,63979
5/22/22,Fiji,-17.7134,178.065,64841,0,862,63979
5/23/22,Fiji,-17.7134,178.065,64898,0,862,64036
5/24/22,Fiji,-17.7134,178.065,64898,0,862,64036
5/25/22,Fiji,-17.7134,178.065,64898,0,862,64036
5/26/22,Fiji,-17.7134,178.065,64941,0,863,64078
5/27/22,Fiji,-17.7134,178.065,64941,0,863,64078
5/28/22,Fiji,-17.7134,178.065,64941,0,863,64078
5/29/22,Fiji,-17.7134,178.065,64941,0,863,64078
5/30/22,Fiji,-17.7134,178.065,65007,0,863,64144
5/31/22,Fiji,-17.7134,178.065,65007,0,864,64143
6/1/22,Fiji,-17.7134,178.065,65007,0,864,64143
6/2/22,Fiji,-17.7134,178.065,65063,0,864,64199
6/3/22,Fiji,-17.7134,178.065,65063,0,864,64199
6/4/22,Fiji,-17.7134,178.065,65063,0,864,64199
6/5/22,Fiji,-17.7134,178.065,65063,0,864,64199
6/6/22,Fiji,-17.7134,178.065,65103,0,864,64239
6/7/22,Fiji,-17.7134,178.065,65103,0,864,64239
6/8/22,Fiji,-17.7134,178.065,65103,0,864,64239
6/9/22,Fiji,-17.7134,178.065,65159,0,864,64295
6/10/22,Fiji,-17.7134,178.065,65159,0,864,64295
6/11/22,Fiji,-17.7134,178.065,65159,0,864,64295
6/12/22,Fiji,-17.7134,178.065,65159,0,864,64295
6/13/22,Fiji,-17.7134,178.065,65217,0,865,64352
6/14/22,Fiji,-17.7134,178.065,65217,0,865,64352
6/15/22,Fiji,-17.7134,178.065,65217,0,865,64352
6/16/22,Fiji,-17.7134,178.065,65268,0,865,64403
6/17/22,Fiji,-17.7134,178.065,65268,0,865,64403
6/18/22,Fiji,-17.7134,178.065,65268,0,865,64403
6/19/22,Fiji,-17.7134,178.065,65268,0,865,64403
6/20/22,Fiji,-17.7134,178.065,65361,0,865,64496
6/21/22,Fiji,-17.7134,178.065,65361,0,865,64496
6/22/22,Fiji,-17.7134,178.065,65361,0,865,64496
6/23/22,Fiji,-17.7134,178.065,65465,0,865,64600
6/24/22,Fiji,-17.7134,178.065,65465,0,865,64600
6/25/22,Fiji,-17.7134,178.065,65465,0,865,64600
6/26/22,Fiji,-17.7134,178.065,65465,0,865,64600
6/27/22,Fiji,-17.7134,178.065,65558,0,865,64693
6/28/22,Fiji,-17.7134,178.065,65558,0,865,64693
6/29/22,Fiji,-17.7134,178.065,65558,0,865,64693
6/30/22,Fiji,-17.7134,178.065,65713,0,866,64847
7/1/22,Fiji,-17.7134,178.065,65713,0,866,64847
7/2/22,Fiji,-17.7134,178.065,65713,0,866,64847
7/3/22,Fiji,-17.7134,178.065,65713,0,866,64847
7/4/22,Fiji,-17.7134,178.065,65889,0,866,65023
7/5/22,Fiji,-17.7134,178.065,65889,0,866,65023
7/6/22,Fiji,-17.7134,178.065,65889,0,866,65023
7/7/22,Fiji,-17.7134,178.065,66126,0,866,65260
7/8/22,Fiji,-17.7134,178.065,66126,0,866,65260
7/9/22,Fiji,-17.7134,178.065,66126,0,866,65260
7/10/22,Fiji,-17.7134,178.065,66126,0,866,65260
7/11/22,Fiji,-17.7134,178.065,66405,0,869,65536
7/12/22,Fiji,-17.7134,178.065,66405,0,869,65536
7/13/22,Fiji,-17.7134,178.065,66405,0,869,65536
7/14/22,Fiji,-17.7134,178.065,66713,0,869,65844
7/15/22,Fiji,-17.7134,178.065,66713,0,869,65844
7/16/22,Fiji,-17.7134,178.065,66713,0,869,65844
7/17/22,Fiji,-17.7134,178.065,66713,0,869,65844
7/18/22,Fiji,-17.7134,178.065,66975,0,870,66105
7/19/22,Fiji,-17.7134,178.065,66975,0,870,66105
7/20/22,Fiji,-17.7134,178.065,66975,0,870,66105
7/21/22,Fiji,-17.7134,178.065,67191,0,870,66321
7/22/22,Fiji,-17.7134,178.065,67191,0,870,66321
7/23/22,Fiji,-17.7134,178.065,67191,0,870,66321
7/24/22,Fiji,-17.7134,178.065,67191,0,870,66321
7/25/22,Fiji,-17.7134,178.065,67356,0,870,66486
7/26/22,Fiji,-17.7134,178.065,67356,0,870,66486
7/27/22,Fiji,-17.7134,178.065,67356,0,870,66486
7/28/22,Fiji,-17.7134,178.065,67549,0,870,66679
7/29/22,Fiji,-17.7134,178.065,67549,0,870,66679
7/30/22,Fiji,-17.7134,178.065,67549,0,870,66679
7/31/22,Fiji,-17.7134,178.065,67549,0,870,66679
8/1/22,Fiji,-17.7134,178.065,67673,0,873,66800
8/2/22,Fiji,-17.7134,178.065,67673,0,873,66800
8/3/22,Fiji,-17.7134,178.065,67673,0,873,66800
8/4/22,Fiji,-17.7134,178.065,67805,0,874,66931
8/5/22,Fiji,-17.7134,178.065,67805,0,874,66931
8/6/22,Fiji,-17.7134,178.065,67805,0,874,66931
8/7/22,Fiji,-17.7134,178.065,67805,0,874,66931
8/8/22,Fiji,-17.7134,178.065,67869,0,874,66995
8/9/22,Fiji,-17.7134,178.065,67869,0,874,66995
8/10/22,Fiji,-17.7134,178.065,67869,0,874,66995
8/11/22,Fiji,-17.7134,178.065,67925,0,875,67050
8/12/22,Fiji,-17.7134,178.065,67925,0,875,67050
8/13/22,Fiji,-17.7134,178.065,67925,0,875,67050
8/14/22,Fiji,-17.7134,178.065,67925,0,875,67050
8/15/22,Fiji,-17.7134,178.065,67969,0,875,67094
8/16/22,Fiji,-17.7134,178.065,67969,0,875,67094
8/17/22,Fiji,-17.7134,178.065,67969,0,875,67094
8/18/22,Fiji,-17.7134,178.065,68028,0,875,67153
8/19/22,Fiji,-17.7134,178.065,68028,0,875,67153
8/20/22,Fiji,-17.7134,178.065,68028,0,875,67153
8/21/22,Fiji,-17.7134,178.065,68028,0,875,67153
8/22/22,Fiji,-17.7134,178.065,68083,0,877,67206
8/23/22,Fiji,-17.7134,178.065,68083,0,877,67206
8/24/22,Fiji,-17.7134,178.065,68083,0,877,67206
8/25/22,Fiji,-17.7134,178.065,68116,0,877,67239
8/26/22,Fiji,-17.7134,178.065,68116,0,877,67239
8/27/22,Fiji,-17.7134,178.065,68116,0,877,67239
8/28/22,Fiji,-17.7134,178.065,68116,0,877,67239
8/29/22,Fiji,-17.7134,178.065,68153,0,878,67275
8/30/22,Fiji,-17.7134,178.065,68153,0,878,67275
8/31/22,Fiji,-17.7134,178.065,68153,0,878,67275
9/1/22,Fiji,-17.7134,178.065,68177,0,878,67299
9/2/22,Fiji,-17.7134,178.065,68177,0,878,67299
9/3/22,Fiji,-17.7134,178.065,68177,0,878,67299
9/4/22,Fiji,-17.7134,178.065,68177,0,878,67299
9/5/22,Fiji,-17.7134,178.065,68177,0,878,67299
9/6/22,Fiji,-17.7134,178.065,68195,0,878,67317
9/7/22,Fiji,-17.7134,178.065,68195,0,878,67317
9/8/22,Fiji,-17.7134,178.065,68195,0,878,67317
9/9/22,Fiji,-17.7134,178.065,68207,0,878,67329
9/10/22,Fiji,-17.7134,178.065,68207,0,878,67329
9/11/22,Fiji,-17.7134,178.065,68207,0,878,67329
9/12/22,Fiji,-17.7134,178.065,68207,0,878,67329
9/13/22,Fiji,-17.7134,178.065,68207,0,878,67329
9/14/22,Fiji,-17.7134,178.065,68207,0,878,67329
9/15/22,Fiji,-17.7134,178.065,68223,0,878,67345
9/16/22,Fiji,-17.7134,178.065,68223,0,878,67345
9/17/22,Fiji,-17.7134,178.065,68223,0,878,67345
9/18/22,Fiji,-17.7134,178.065,68223,0,878,67345
9/19/22,Fiji,-17.7134,178.065,68223,0,878,67345
9/20/22,Fiji,-17.7134,178.065,68223,0,878,67345
9/21/22,Fiji,-17.7134,178.065,68223,0,878,67345
9/22/22,Fiji,-17.7134,178.065,68234,0,878,67356
9/23/22,Fiji,-17.7134,178.065,68234,0,878,67356
9/24/22,Fiji,-17.7134,178.065,68234,0,878,67356
9/25/22,Fiji,-17.7134,178.065,68234,0,878,67356
9/26/22,Fiji,-17.7134,178.065,68234,0,878,67356
9/27/22,Fiji,-17.7134,178.065,68234,0,878,67356
9/28/22,Fiji,-17.7134,178.065,68234,0,878,67356
9/29/22,Fiji,-17.7134,178.065,68242,0,878,67364
9/30/22,Fiji,-17.7134,178.065,68242,0,878,67364
10/1/22,Fiji,-17.7134,178.065,68242,0,878,67364
10/2/22,Fiji,-17.7134,178.065,68242,0,878,67364
10/3/22,Fiji,-17.7134,178.065,68242,0,878,67364
10/4/22,Fiji,-17.7134,178.065,68242,0,878,67364
10/5/22,Fiji,-17.7134,178.065,68242,0,878,67364
10/6/22,Fiji,-17.7134,178.065,68244,0,878,67366
10/7/22,Fiji,-17.7134,178.065,68245,0,878,67367
10/8/22,Fiji,-17.7134,178.065,68245,0,878,67367
10/9/22,Fiji,-17.7134,178.065,68245,0,878,67367
10/10/22,Fiji,-17.7134,178.065,68245,0,878,67367
10/11/22,Fiji,-17.7134,178.065,68245,0,878,67367
10/12/22,Fiji,-17.7134,178.065,68245,0,878,67367
10/13/22,Fiji,-17.7134,178.065,68248,0,878,67370
10/14/22,Fiji,-17.7134,178.065,68248,0,878,67370
10/15/22,Fiji,-17.7134,178.065,68248,0,878,67370
10/16/22,Fiji,-17.7134,178.065,68248,0,878,67370
10/17/22,Fiji,-17.7134,178.065,68248,0,878,67370
10/18/22,Fiji,-17.7134,178.065,68248,0,878,67370
10/19/22,Fiji,-17.7134,178.065,68248,0,878,67370
10/20/22,Fiji,-17.7134,178.065,68257,0,878,67379
10/21/22,Fiji,-17.7134,178.065,68257,0,878,67379
10/22/22,Fiji,-17.7134,178.065,68257,0,878,67379
10/23/22,Fiji,-17.7134,178.065,68257,0,878,67379
10/24/22,Fiji,-17.7134,178.065,68257,0,878,67379
10/25/22,Fiji,-17.7134,178.065,68257,0,878,67379
10/26/22,Fiji,-17.7134,178.065,68257,0,878,67379
10/27/22,Fiji,-17.7134,178.065,68264,0,878,67386
10/28/22,Fiji,-17.7134,178.065,68264,0,878,67386
10/29/22,Fiji,-17.7134,178.065,68264,0,878,67386
10/30/22,Fiji,-17.7134,178.065,68264,0,878,67386
10/31/22,Fiji,-17.7134,178.065,68264,0,878,67386
11/1/22,Fiji,-17.7134,178.065,68264,0,878,67386
11/2/22,Fiji,-17.7134,178.065,68264,0,878,67386
11/3/22,Fiji,-17.7134,178.065,68270,0,878,67392
11/4/22,Fiji,-17.7134,178.065,68270,0,878,67392
11/5/22,Fiji,-17.7134,178.065,68270,0,878,67392
11/6/22,Fiji,-17.7134,178.065,68270,0,878,67392
11/7/22,Fiji,-17.7134,178.065,68270,0,878,67392
11/8/22,Fiji,-17.7134,178.065,68270,0,878,67392
11/9/22,Fiji,-17.7134,178.065,68270,0,878,67392
11/10/22,Fiji,-17.7134,178.065,68287,0,878,67409
11/11/22,Fiji,-17.7134,178.065,68287,0,878,67409
11/12/22,Fiji,-17.7134,178.065,68287,0,878,67409
11/13/22,Fiji,-17.7134,178.065,68287,0,878,67409
11/14/22,Fiji,-17.7134,178.065,68287,0,878,67409
11/15/22,Fiji,-17.7134,178.065,68287,0,878,67409
11/16/22,Fiji,-17.7134,178.065,68287,0,878,67409
11/17/22,Fiji,-17.7134,178.065,68307,0,878,67429
11/18/22,Fiji,-17.7134,178.065,68307,0,878,67429
11/19/22,Fiji,-17.7134,178.065,68307,0,878,67429
11/20/22,Fiji,-17.7134,178.065,68307,0,878,67429
11/21/22,Fiji,-17.7134,178.065,68307,0,878,67429
11/22/22,Fiji,-17.7134,178.065,68307,0,878,67429
11/23/22,Fiji,-17.7134,178.065,68307,0,878,67429
11/24/22,Fiji,-17.7134,178.065,68375,0,878,67497
11/25/22,Fiji,-17.7134,178.065,68375,0,878,67497
11/26/22,Fiji,-17.7134,178.065,68375,0,878,67497
11/27/22,Fiji,-17.7134,178.065,68375,0,878,67497
11/28/22,Fiji,-17.7134,178.065,68375,0,878,67497
11/29/22,Fiji,-17.7134,178.065,68375,0,878,67497
11/30/22,Fiji,-17.7134,178.065,68375,0,878,67497
12/1/22,Fiji,-17.7134,178.065,68375,0,878,67497
12/2/22,Fiji,-17.7134,178.065,68451,0,878,67573
12/3/22,Fiji,-17.7134,178.065,68451,0,878,67573
12/4/22,Fiji,-17.7134,178.065,68451,0,878,67573
12/5/22,Fiji,-17.7134,178.065,68451,0,878,67573
12/6/22,Fiji,-17.7134,178.065,68451,0,878,67573
12/7/22,Fiji,-17.7134,178.065,68451,0,878,67573
12/8/22,Fiji,-17.7134,178.065,68451,0,878,67573
12/9/22,Fiji,-17.7134,178.065,68553,0,878,67675
12/10/22,Fiji,-17.7134,178.065,68553,0,878,67675
12/11/22,Fiji,-17.7134,178.065,68553,0,878,67675
12/12/22,Fiji,-17.7134,178.065,68553,0,878,67675
12/13/22,Fiji,-17.7134,178.065,68553,0,878,67675
12/14/22,Fiji,-17.7134,178.065,68553,0,878,67675
12/15/22,Fiji,-17.7134,178.065,68553,0,878,67675
12/16/22,Fiji,-17.7134,178.065,68553,0,878,67675
12/17/22,Fiji,-17.7134,178.065,68553,0,878,67675
1/1/22,Finland,61.92411,25.748151,277700,0,1728,275972
1/2/22,Finland,61.92411,25.748151,281702,0,1739,279963
1/3/22,Finland,61.92411,25.748151,286679,0,1751,284928
1/4/22,Finland,61.92411,25.748151,296204,0,1764,294440
1/5/22,Finland,61.92411,25.748151,306188,0,1777,304411
1/6/22,Finland,61.92411,25.748151,315915,0,1790,314125
1/7/22,Finland,61.92411,25.748151,323246,0,1801,321445
1/8/22,Finland,61.92411,25.748151,332270,0,1812,330458
1/9/22,Finland,61.92411,25.748151,338070,0,1822,336248
1/10/22,Finland,61.92411,25.748151,344711,0,1830,342881
1/11/22,Finland,61.92411,25.748151,355258,0,1839,353419
1/12/22,Finland,61.92411,25.748151,364470,0,1845,362625
1/13/22,Finland,61.92411,25.748151,373398,0,1851,371547
1/14/22,Finland,61.92411,25.748151,381673,0,1858,379815
1/15/22,Finland,61.92411,25.748151,389770,0,1864,387906
1/16/22,Finland,61.92411,25.748151,395472,0,1871,393601
1/17/22,Finland,61.92411,25.748151,401722,0,1875,399847
1/18/22,Finland,61.92411,25.748151,411849,0,1887,409962
1/19/22,Finland,61.92411,25.748151,421013,0,1891,419122
1/20/22,Finland,61.92411,25.748151,429525,0,1891,427634
1/21/22,Finland,61.92411,25.748151,437573,0,1893,435680
1/22/22,Finland,61.92411,25.748151,444869,0,1894,442975
1/23/22,Finland,61.92411,25.748151,449237,0,1894,447343
1/24/22,Finland,61.92411,25.748151,453833,0,1894,451939
1/25/22,Finland,61.92411,25.748151,461001,0,1894,459107
1/26/22,Finland,61.92411,25.748151,464394,0,1894,462500
1/27/22,Finland,61.92411,25.748151,470665,0,1919,468746
1/28/22,Finland,61.92411,25.748151,475431,0,1942,473489
1/29/22,Finland,61.92411,25.748151,475431,0,1942,473489
1/30/22,Finland,61.92411,25.748151,475431,0,1942,473489
1/31/22,Finland,61.92411,25.748151,489870,0,1990,487880
2/1/22,Finland,61.92411,25.748151,493114,0,1990,491124
2/2/22,Finland,61.92411,25.748151,501152,0,2012,499140
2/3/22,Finland,61.92411,25.748151,507940,0,2041,505899
2/4/22,Finland,61.92411,25.748151,514892,0,2058,512834
2/5/22,Finland,61.92411,25.748151,514892,0,2058,512834
2/6/22,Finland,61.92411,25.748151,514892,0,2058,512834
2/7/22,Finland,61.92411,25.748151,534790,0,2095,532695
2/8/22,Finland,61.92411,25.748151,542262,0,2097,540165
2/9/22,Finland,61.92411,25.748151,546782,0,2126,544656
2/10/22,Finland,61.92411,25.748151,559587,0,2141,557446
2/11/22,Finland,61.92411,25.748151,569973,0,2170,567803
2/12/22,Finland,61.92411,25.748151,569973,0,2170,567803
2/13/22,Finland,61.92411,25.748151,569973,0,2170,567803
2/14/22,Finland,61.92411,25.748151,582383,0,2214,580169
2/15/22,Finland,61.92411,25.748151,586809,0,2215,584594
2/16/22,Finland,61.92411,25.748151,592765,0,2242,590523
2/17/22,Finland,61.92411,25.748151,600718,0,2265,598453
2/18/22,Finland,61.92411,25.748151,605046,0,2277,602769
2/19/22,Finland,61.92411,25.748151,605046,0,2277,602769
2/20/22,Finland,61.92411,25.748151,605046,0,2277,602769
2/21/22,Finland,61.92411,25.748151,622717,0,2329,620388
2/22/22,Finland,61.92411,25.748151,625463,0,2329,623134
2/23/22,Finland,61.92411,25.748151,629727,0,2351,627376
2/24/22,Finland,61.92411,25.748151,637658,0,2364,635294
2/25/22,Finland,61.92411,25.748151,637729,0,2364,635365
2/26/22,Finland,61.92411,25.748151,637729,0,2364,635365
2/27/22,Finland,61.92411,25.748151,637729,0,2364,635365
2/28/22,Finland,61.92411,25.748151,637757,0,2366,635391
3/1/22,Finland,61.92411,25.748151,657443,0,2380,655063
3/2/22,Finland,61.92411,25.748151,658559,0,2381,656178
3/3/22,Finland,61.92411,25.748151,664588,0,2384,662204
3/4/22,Finland,61.92411,25.748151,671773,0,2387,669386
3/5/22,Finland,61.92411,25.748151,671773,0,2387,669386
3/6/22,Finland,61.92411,25.748151,671773,0,2387,669386
3/7/22,Finland,61.92411,25.748151,694142,0,2571,691571
3/8/22,Finland,61.92411,25.748151,694142,0,2571,691571
3/9/22,Finland,61.92411,25.748151,703052,0,2573,700479
3/10/22,Finland,61.92411,25.748151,713103,0,2573,710530
3/11/22,Finland,61.92411,25.748151,734262,0,2653,731609
3/12/22,Finland,61.92411,25.748151,734262,0,2653,731609
3/13/22,Finland,61.92411,25.748151,734262,0,2653,731609
3/14/22,Finland,61.92411,25.748151,761110,0,2717,758393
3/15/22,Finland,61.92411,25.748151,767220,0,2719,764501
3/16/22,Finland,61.92411,25.748151,778617,0,2763,775854
3/17/22,Finland,61.92411,25.748151,782912,0,2783,780129
3/18/22,Finland,61.92411,25.748151,786312,0,2783,783529
3/19/22,Finland,61.92411,25.748151,786312,0,2783,783529
3/20/22,Finland,61.92411,25.748151,786312,0,2783,783529
3/21/22,Finland,61.92411,25.748151,812017,0,2881,809136
3/22/22,Finland,61.92411,25.748151,812224,0,2881,809343
3/23/22,Finland,61.92411,25.748151,821536,0,2948,818588
3/24/22,Finland,61.92411,25.748151,834038,0,2951,831087
3/25/22,Finland,61.92411,25.748151,844713,0,2985,841728
3/26/22,Finland,61.92411,25.748151,844713,0,2985,841728
3/27/22,Finland,61.92411,25.748151,844713,0,2985,841728
3/28/22,Finland,61.92411,25.748151,859477,0,3054,856423
3/29/22,Finland,61.92411,25.748151,864815,0,3055,861760
3/30/22,Finland,61.92411,25.748151,874135,0,3105,871030
3/31/22,Finland,61.92411,25.748151,883676,0,3144,880532
4/1/22,Finland,61.92411,25.748151,889626,0,3178,886448
4/2/22,Finland,61.92411,25.748151,889626,0,3178,886448
4/3/22,Finland,61.92411,25.748151,889626,0,3178,886448
4/4/22,Finland,61.92411,25.748151,901336,0,3252,898084
4/5/22,Finland,61.92411,25.748151,907786,0,3254,904532
4/6/22,Finland,61.92411,25.748151,913476,0,3307,910169
4/7/22,Finland,61.92411,25.748151,920692,0,3334,917358
4/8/22,Finland,61.92411,25.748151,920692,0,3334,917358
4/9/22,Finland,61.92411,25.748151,920692,0,3334,917358
4/10/22,Finland,61.92411,25.748151,920692,0,3334,917358
4/11/22,Finland,61.92411,25.748151,920692,0,3334,917358
4/12/22,Finland,61.92411,25.748151,920692,0,3334,917358
4/13/22,Finland,61.92411,25.748151,920692,0,3334,917358
4/14/22,Finland,61.92411,25.748151,949583,0,3517,946066
4/15/22,Finland,61.92411,25.748151,949583,0,3517,946066
4/16/22,Finland,61.92411,25.748151,949583,0,3517,946066
4/17/22,Finland,61.92411,25.748151,949583,0,3517,946066
4/18/22,Finland,61.92411,25.748151,949583,0,3517,946066
4/19/22,Finland,61.92411,25.748151,949583,0,3517,946066
4/20/22,Finland,61.92411,25.748151,949583,0,3517,946066
4/21/22,Finland,61.92411,25.748151,1000472,0,3638,996834
4/22/22,Finland,61.92411,25.748151,1000472,0,3638,996834
4/23/22,Finland,61.92411,25.748151,1000472,0,3638,996834
4/24/22,Finland,61.92411,25.748151,1000472,0,3638,996834
4/25/22,Finland,61.92411,25.748151,1000472,0,3638,996834
4/26/22,Finland,61.92411,25.748151,1000472,0,3638,996834
4/27/22,Finland,61.92411,25.748151,1000472,0,3638,996834
4/28/22,Finland,61.92411,25.748151,1023013,0,3939,1019074
4/29/22,Finland,61.92411,25.748151,1023013,0,3939,1019074
4/30/22,Finland,61.92411,25.748151,1023013,0,3939,1019074
5/1/22,Finland,61.92411,25.748151,1023013,0,3939,1019074
5/2/22,Finland,61.92411,25.748151,1023013,0,3939,1019074
5/3/22,Finland,61.92411,25.748151,1023013,0,3939,1019074
5/4/22,Finland,61.92411,25.748151,1023013,0,3939,1019074
5/5/22,Finland,61.92411,25.748151,1052767,0,4150,1048617
5/6/22,Finland,61.92411,25.748151,1052767,0,4150,1048617
5/7/22,Finland,61.92411,25.748151,1052767,0,4150,1048617
5/8/22,Finland,61.92411,25.748151,1052767,0,4150,1048617
5/9/22,Finland,61.92411,25.748151,1052767,0,4150,1048617
5/10/22,Finland,61.92411,25.748151,1052767,0,4150,1048617
5/11/22,Finland,61.92411,25.748151,1052767,0,4150,1048617
5/12/22,Finland,61.92411,25.748151,1069740,0,4284,1065456
5/13/22,Finland,61.92411,25.748151,1069740,0,4284,1065456
5/14/22,Finland,61.92411,25.748151,1069740,0,4284,1065456
5/15/22,Finland,61.92411,25.748151,1069740,0,4284,1065456
5/16/22,Finland,61.92411,25.748151,1069740,0,4284,1065456
5/17/22,Finland,61.92411,25.748151,1069740,0,4284,1065456
5/18/22,Finland,61.92411,25.748151,1069740,0,4284,1065456
5/19/22,Finland,61.92411,25.748151,1081225,0,4406,1076819
5/20/22,Finland,61.92411,25.748151,1081225,0,4406,1076819
5/21/22,Finland,61.92411,25.748151,1081225,0,4406,1076819
5/22/22,Finland,61.92411,25.748151,1081225,0,4406,1076819
5/23/22,Finland,61.92411,25.748151,1081225,0,4406,1076819
5/24/22,Finland,61.92411,25.748151,1081225,0,4406,1076819
5/25/22,Finland,61.92411,25.748151,1081225,0,4406,1076819
5/26/22,Finland,61.92411,25.748151,1092193,0,4522,1087671
5/27/22,Finland,61.92411,25.748151,1092193,0,4522,1087671
5/28/22,Finland,61.92411,25.748151,1092193,0,4522,1087671
5/29/22,Finland,61.92411,25.748151,1092193,0,4522,1087671
5/30/22,Finland,61.92411,25.748151,1092193,0,4522,1087671
5/31/22,Finland,61.92411,25.748151,1092193,0,4522,1087671
6/1/22,Finland,61.92411,25.748151,1092193,0,4522,1087671
6/2/22,Finland,61.92411,25.748151,1105211,0,4627,1100584
6/3/22,Finland,61.92411,25.748151,1105211,0,4627,1100584
6/4/22,Finland,61.92411,25.748151,1105211,0,4627,1100584
6/5/22,Finland,61.92411,25.748151,1105211,0,4627,1100584
6/6/22,Finland,61.92411,25.748151,1105211,0,4627,1100584
6/7/22,Finland,61.92411,25.748151,1105211,0,4627,1100584
6/8/22,Finland,61.92411,25.748151,1105211,0,4627,1100584
6/9/22,Finland,61.92411,25.748151,1114573,0,4714,1109859
6/10/22,Finland,61.92411,25.748151,1114573,0,4714,1109859
6/11/22,Finland,61.92411,25.748151,1114573,0,4714,1109859
6/12/22,Finland,61.92411,25.748151,1114573,0,4714,1109859
6/13/22,Finland,61.92411,25.748151,1114573,0,4714,1109859
6/14/22,Finland,61.92411,25.748151,1114573,0,4714,1109859
6/15/22,Finland,61.92411,25.748151,1114573,0,4714,1109859
6/16/22,Finland,61.92411,25.748151,1125342,0,4771,1120571
6/17/22,Finland,61.92411,25.748151,1125342,0,4771,1120571
6/18/22,Finland,61.92411,25.748151,1125342,0,4771,1120571
6/19/22,Finland,61.92411,25.748151,1125342,0,4771,1120571
6/20/22,Finland,61.92411,25.748151,1125342,0,4771,1120571
6/21/22,Finland,61.92411,25.748151,1125342,0,4771,1120571
6/22/22,Finland,61.92411,25.748151,1125342,0,4771,1120571
6/23/22,Finland,61.92411,25.748151,1133597,0,4832,1128765
6/24/22,Finland,61.92411,25.748151,1133597,0,4832,1128765
6/25/22,Finland,61.92411,25.748151,1133597,0,4832,1128765
6/26/22,Finland,61.92411,25.748151,1133597,0,4832,1128765
6/27/22,Finland,61.92411,25.748151,1133597,0,4832,1128765
6/28/22,Finland,61.92411,25.748151,1133597,0,4832,1128765
6/29/22,Finland,61.92411,25.748151,1133597,0,4832,1128765
6/30/22,Finland,61.92411,25.748151,1145610,0,4875,1140735
7/1/22,Finland,61.92411,25.748151,1145610,0,4875,1140735
7/2/22,Finland,61.92411,25.748151,1145610,0,4875,1140735
7/3/22,Finland,61.92411,25.748151,1145610,0,4875,1140735
7/4/22,Finland,61.92411,25.748151,1145610,0,4875,1140735
7/5/22,Finland,61.92411,25.748151,1145610,0,4875,1140735
7/6/22,Finland,61.92411,25.748151,1145610,0,4875,1140735
7/7/22,Finland,61.92411,25.748151,1158485,0,4941,1153544
7/8/22,Finland,61.92411,25.748151,1158485,0,4941,1153544
7/9/22,Finland,61.92411,25.748151,1158485,0,4941,1153544
7/10/22,Finland,61.92411,25.748151,1158485,0,4941,1153544
7/11/22,Finland,61.92411,25.748151,1158485,0,4941,1153544
7/12/22,Finland,61.92411,25.748151,1158485,0,4941,1153544
7/13/22,Finland,61.92411,25.748151,1158485,0,4941,1153544
7/14/22,Finland,61.92411,25.748151,1171034,0,5012,1166022
7/15/22,Finland,61.92411,25.748151,1171034,0,5012,1166022
7/16/22,Finland,61.92411,25.748151,1171034,0,5012,1166022
7/17/22,Finland,61.92411,25.748151,1171034,0,5012,1166022
7/18/22,Finland,61.92411,25.748151,1171034,0,5012,1166022
7/19/22,Finland,61.92411,25.748151,1171034,0,5012,1166022
7/20/22,Finland,61.92411,25.748151,1171034,0,5012,1166022
7/21/22,Finland,61.92411,25.748151,1171034,0,5012,1166022
7/22/22,Finland,61.92411,25.748151,1171034,0,5012,1166022
7/23/22,Finland,61.92411,25.748151,1171034,0,5012,1166022
7/24/22,Finland,61.92411,25.748151,1171034,0,5012,1166022
7/25/22,Finland,61.92411,25.748151,1171034,0,5012,1166022
7/26/22,Finland,61.92411,25.748151,1171034,0,5012,1166022
7/27/22,Finland,61.92411,25.748151,1171034,0,5012,1166022
7/28/22,Finland,61.92411,25.748151,1171034,0,5012,1166022
7/29/22,Finland,61.92411,25.748151,1171034,0,5012,1166022
7/30/22,Finland,61.92411,25.748151,1171034,0,5012,1166022
7/31/22,Finland,61.92411,25.748151,1171034,0,5012,1166022
8/1/22,Finland,61.92411,25.748151,1171034,0,5012,1166022
8/2/22,Finland,61.92411,25.748151,1171034,0,5012,1166022
8/3/22,Finland,61.92411,25.748151,1171034,0,5012,1166022
8/4/22,Finland,61.92411,25.748151,1218216,0,5251,1212965
8/5/22,Finland,61.92411,25.748151,1218216,0,5251,1212965
8/6/22,Finland,61.92411,25.748151,1218216,0,5251,1212965
8/7/22,Finland,61.92411,25.748151,1218216,0,5251,1212965
8/8/22,Finland,61.92411,25.748151,1218216,0,5251,1212965
8/9/22,Finland,61.92411,25.748151,1218216,0,5251,1212965
8/10/22,Finland,61.92411,25.748151,1218216,0,5251,1212965
8/11/22,Finland,61.92411,25.748151,1238998,0,5350,1233648
8/12/22,Finland,61.92411,25.748151,1238998,0,5350,1233648
8/13/22,Finland,61.92411,25.748151,1238998,0,5350,1233648
8/14/22,Finland,61.92411,25.748151,1238998,0,5350,1233648
8/15/22,Finland,61.92411,25.748151,1238998,0,5350,1233648
8/16/22,Finland,61.92411,25.748151,1238998,0,5350,1233648
8/17/22,Finland,61.92411,25.748151,1238998,0,5350,1233648
8/18/22,Finland,61.92411,25.748151,1250557,0,5467,1245090
8/19/22,Finland,61.92411,25.748151,1250557,0,5467,1245090
8/20/22,Finland,61.92411,25.748151,1250557,0,5467,1245090
8/21/22,Finland,61.92411,25.748151,1250557,0,5467,1245090
8/22/22,Finland,61.92411,25.748151,1250557,0,5467,1245090
8/23/22,Finland,61.92411,25.748151,1250557,0,5467,1245090
8/24/22,Finland,61.92411,25.748151,1250557,0,5467,1245090
8/25/22,Finland,61.92411,25.748151,1258798,0,5577,1253221
8/26/22,Finland,61.92411,25.748151,1258798,0,5577,1253221
8/27/22,Finland,61.92411,25.748151,1258798,0,5577,1253221
8/28/22,Finland,61.92411,25.748151,1258798,0,5577,1253221
8/29/22,Finland,61.92411,25.748151,1258798,0,5577,1253221
8/30/22,Finland,61.92411,25.748151,1258798,0,5577,1253221
8/31/22,Finland,61.92411,25.748151,1258798,0,5577,1253221
9/1/22,Finland,61.92411,25.748151,1266917,0,5690,1261227
9/2/22,Finland,61.92411,25.748151,1266917,0,5690,1261227
9/3/22,Finland,61.92411,25.748151,1266917,0,5690,1261227
9/4/22,Finland,61.92411,25.748151,1266917,0,5690,1261227
9/5/22,Finland,61.92411,25.748151,1266917,0,5690,1261227
9/6/22,Finland,61.92411,25.748151,1266917,0,5690,1261227
9/7/22,Finland,61.92411,25.748151,1266917,0,5690,1261227
9/8/22,Finland,61.92411,25.748151,1271516,0,5768,1265748
9/9/22,Finland,61.92411,25.748151,1271516,0,5768,1265748
9/10/22,Finland,61.92411,25.748151,1271516,0,5768,1265748
9/11/22,Finland,61.92411,25.748151,1271516,0,5768,1265748
9/12/22,Finland,61.92411,25.748151,1271516,0,5768,1265748
9/13/22,Finland,61.92411,25.748151,1271516,0,5768,1265748
9/14/22,Finland,61.92411,25.748151,1271516,0,5768,1265748
9/15/22,Finland,61.92411,25.748151,1277473,0,5858,1271615
9/16/22,Finland,61.92411,25.748151,1277473,0,5858,1271615
9/17/22,Finland,61.92411,25.748151,1277473,0,5858,1271615
9/18/22,Finland,61.92411,25.748151,1277473,0,5858,1271615
9/19/22,Finland,61.92411,25.748151,1277473,0,5858,1271615
9/20/22,Finland,61.92411,25.748151,1277473,0,5858,1271615
9/21/22,Finland,61.92411,25.748151,1277473,0,5858,1271615
9/22/22,Finland,61.92411,25.748151,1287044,0,5928,1281116
9/23/22,Finland,61.92411,25.748151,1287044,0,5928,1281116
9/24/22,Finland,61.92411,25.748151,1287044,0,5928,1281116
9/25/22,Finland,61.92411,25.748151,1287044,0,5928,1281116
9/26/22,Finland,61.92411,25.748151,1287044,0,5928,1281116
9/27/22,Finland,61.92411,25.748151,1287044,0,5928,1281116
9/28/22,Finland,61.92411,25.748151,1287044,0,5928,1281116
9/29/22,Finland,61.92411,25.748151,1292940,0,5981,1286959
9/30/22,Finland,61.92411,25.748151,1292940,0,5981,1286959
10/1/22,Finland,61.92411,25.748151,1292940,0,5981,1286959
10/2/22,Finland,61.92411,25.748151,1292940,0,5981,1286959
10/3/22,Finland,61.92411,25.748151,1292940,0,5981,1286959
10/4/22,Finland,61.92411,25.748151,1292940,0,5981,1286959
10/5/22,Finland,61.92411,25.748151,1292940,0,5981,1286959
10/6/22,Finland,61.92411,25.748151,1297708,0,6025,1291683
10/7/22,Finland,61.92411,25.748151,1312634,0,6149,1306485
10/8/22,Finland,61.92411,25.748151,1312634,0,6149,1306485
10/9/22,Finland,61.92411,25.748151,1312634,0,6149,1306485
10/10/22,Finland,61.92411,25.748151,1312634,0,6149,1306485
10/11/22,Finland,61.92411,25.748151,1312634,0,6149,1306485
10/12/22,Finland,61.92411,25.748151,1312634,0,6149,1306485
10/13/22,Finland,61.92411,25.748151,1323455,0,6242,1317213
10/14/22,Finland,61.92411,25.748151,1323455,0,6242,1317213
10/15/22,Finland,61.92411,25.748151,1323455,0,6242,1317213
10/16/22,Finland,61.92411,25.748151,1323455,0,6242,1317213
10/17/22,Finland,61.92411,25.748151,1323455,0,6242,1317213
10/18/22,Finland,61.92411,25.748151,1323455,0,6242,1317213
10/19/22,Finland,61.92411,25.748151,1323455,0,6242,1317213
10/20/22,Finland,61.92411,25.748151,1335318,0,6407,1328911
10/21/22,Finland,61.92411,25.748151,1335318,0,6407,1328911
10/22/22,Finland,61.92411,25.748151,1335318,0,6407,1328911
10/23/22,Finland,61.92411,25.748151,1335318,0,6407,1328911
10/24/22,Finland,61.92411,25.748151,1335318,0,6407,1328911
10/25/22,Finland,61.92411,25.748151,1335318,0,6407,1328911
10/26/22,Finland,61.92411,25.748151,1335318,0,6407,1328911
10/27/22,Finland,61.92411,25.748151,1348737,0,6568,1342169
10/28/22,Finland,61.92411,25.748151,1348737,0,6568,1342169
10/29/22,Finland,61.92411,25.748151,1348737,0,6568,1342169
10/30/22,Finland,61.92411,25.748151,1348737,0,6568,1342169
10/31/22,Finland,61.92411,25.748151,1348737,0,6568,1342169
11/1/22,Finland,61.92411,25.748151,1348737,0,6568,1342169
11/2/22,Finland,61.92411,25.748151,1348737,0,6568,1342169
11/3/22,Finland,61.92411,25.748151,1360721,0,6741,1353980
11/4/22,Finland,61.92411,25.748151,1360721,0,6741,1353980
11/5/22,Finland,61.92411,25.748151,1360721,0,6741,1353980
11/6/22,Finland,61.92411,25.748151,1360721,0,6741,1353980
11/7/22,Finland,61.92411,25.748151,1360721,0,6741,1353980
11/8/22,Finland,61.92411,25.748151,1360721,0,6741,1353980
11/9/22,Finland,61.92411,25.748151,1360721,0,6741,1353980
11/10/22,Finland,61.92411,25.748151,1372651,0,6913,1365738
11/11/22,Finland,61.92411,25.748151,1372651,0,6913,1365738
11/12/22,Finland,61.92411,25.748151,1372651,0,6913,1365738
11/13/22,Finland,61.92411,25.748151,1372651,0,6913,1365738
11/14/22,Finland,61.92411,25.748151,1372651,0,6913,1365738
11/15/22,Finland,61.92411,25.748151,1372651,0,6913,1365738
11/16/22,Finland,61.92411,25.748151,1372651,0,6913,1365738
11/17/22,Finland,61.92411,25.748151,1384654,0,7173,1377481
11/18/22,Finland,61.92411,25.748151,1384654,0,7173,1377481
11/19/22,Finland,61.92411,25.748151,1384654,0,7173,1377481
11/20/22,Finland,61.92411,25.748151,1384654,0,7173,1377481
11/21/22,Finland,61.92411,25.748151,1384654,0,7173,1377481
11/22/22,Finland,61.92411,25.748151,1384654,0,7173,1377481
11/23/22,Finland,61.92411,25.748151,1384654,0,7173,1377481
11/24/22,Finland,61.92411,25.748151,1394254,0,7265,1386989
11/25/22,Finland,61.92411,25.748151,1394254,0,7265,1386989
11/26/22,Finland,61.92411,25.748151,1394254,0,7265,1386989
11/27/22,Finland,61.92411,25.748151,1394254,0,7265,1386989
11/28/22,Finland,61.92411,25.748151,1394254,0,7265,1386989
11/29/22,Finland,61.92411,25.748151,1394254,0,7265,1386989
11/30/22,Finland,61.92411,25.748151,1394254,0,7265,1386989
12/1/22,Finland,61.92411,25.748151,1405255,0,7448,1397807
12/2/22,Finland,61.92411,25.748151,1405255,0,7448,1397807
12/3/22,Finland,61.92411,25.748151,1405255,0,7448,1397807
12/4/22,Finland,61.92411,25.748151,1405255,0,7448,1397807
12/5/22,Finland,61.92411,25.748151,1405255,0,7448,1397807
12/6/22,Finland,61.92411,25.748151,1405255,0,7448,1397807
12/7/22,Finland,61.92411,25.748151,1405255,0,7448,1397807
12/8/22,Finland,61.92411,25.748151,1417909,0,7572,1410337
12/9/22,Finland,61.92411,25.748151,1417909,0,7572,1410337
12/10/22,Finland,61.92411,25.748151,1417909,0,7572,1410337
12/11/22,Finland,61.92411,25.748151,1417909,0,7572,1410337
12/12/22,Finland,61.92411,25.748151,1417909,0,7572,1410337
12/13/22,Finland,61.92411,25.748151,1417909,0,7572,1410337
12/14/22,Finland,61.92411,25.748151,1417909,0,7572,1410337
12/15/22,Finland,61.92411,25.748151,1428446,0,7783,1420663
12/16/22,Finland,61.92411,25.748151,1428446,0,7783,1420663
12/17/22,Finland,61.92411,25.748151,1428446,0,7783,1420663
1/1/22,France,46.2276,2.2137,10296909,0,124839,10172070
1/2/22,France,46.2276,2.2137,10355341,0,124930,10230411
1/3/22,France,46.2276,2.2137,10422830,0,125200,10297630
1/4/22,France,46.2276,2.2137,10694804,0,125551,10569253
1/5/22,France,46.2276,2.2137,11027112,0,125797,10901315
1/6/22,France,46.2276,2.2137,11290010,0,126002,11164008
1/7/22,France,46.2276,2.2137,11618256,0,126195,11492061
1/8/22,France,46.2276,2.2137,11921925,0,126337,11795588
1/9/22,France,46.2276,2.2137,12218022,0,126427,12091595
1/10/22,France,46.2276,2.2137,12311963,0,126707,12185256
1/11/22,France,46.2276,2.2137,12680780,0,127048,12553732
1/12/22,France,46.2276,2.2137,13042665,0,127294,12915371
1/13/22,France,46.2276,2.2137,13351053,0,127520,13223533
1/14/22,France,46.2276,2.2137,13680775,0,127711,13553064
1/15/22,France,46.2276,2.2137,14005385,0,127859,13877526
1/16/22,France,46.2276,2.2137,14283514,0,127940,14155574
1/17/22,France,46.2276,2.2137,14386178,0,128254,14257924
1/18/22,France,46.2276,2.2137,14851448,0,128629,14722819
1/19/22,France,46.2276,2.2137,15288014,0,128641,15159373
1/20/22,France,46.2276,2.2137,15715329,0,129105,15586224
1/21/22,France,46.2276,2.2137,16116748,0,129338,15987410
1/22/22,France,46.2276,2.2137,16506090,0,129505,16376585
1/23/22,France,46.2276,2.2137,16807733,0,129620,16678113
1/24/22,France,46.2276,2.2137,16917220,0,130013,16787207
1/25/22,France,46.2276,2.2137,17420569,0,130483,17290086
1/26/22,France,46.2276,2.2137,17848291,0,130739,17717552
1/27/22,France,46.2276,2.2137,18241888,0,131008,18110880
1/28/22,France,46.2276,2.2137,18596157,0,131271,18464886
1/29/22,France,46.2276,2.2137,18928572,0,131449,18797123
1/30/22,France,46.2276,2.2137,19178039,0,131576,19046463
1/31/22,France,46.2276,2.2137,19266496,0,131937,19134559
2/1/22,France,46.2276,2.2137,19681231,0,132307,19548924
2/2/22,France,46.2276,2.2137,19998301,0,132583,19865718
2/3/22,France,46.2276,2.2137,20274710,0,132847,20141863
2/4/22,France,46.2276,2.2137,20517059,0,133202,20383857
2/5/22,France,46.2276,2.2137,20731613,0,133372,20598241
2/6/22,France,46.2276,2.2137,20887052,0,133501,20753551
2/7/22,France,46.2276,2.2137,20935910,0,133918,20801992
2/8/22,France,46.2276,2.2137,21174600,0,134609,21039991
2/9/22,France,46.2276,2.2137,21177663,0,134609,21043054
2/10/22,France,46.2276,2.2137,21511997,0,135264,21376733
2/11/22,France,46.2276,2.2137,21646561,0,135534,21511027
2/12/22,France,46.2276,2.2137,21765182,0,135695,21629487
2/13/22,France,46.2276,2.2137,21851747,0,135802,21715945
2/14/22,France,46.2276,2.2137,21884370,0,136187,21748183
2/15/22,France,46.2276,2.2137,21886335,0,136187,21750148
2/16/22,France,46.2276,2.2137,22130264,0,136856,21993408
2/17/22,France,46.2276,2.2137,22223882,0,137143,22086739
2/18/22,France,46.2276,2.2137,22310014,0,137448,22172566
2/19/22,France,46.2276,2.2137,22386566,0,137595,22248971
2/20/22,France,46.2276,2.2137,22445580,0,137596,22307984
2/21/22,France,46.2276,2.2137,22466076,0,137619,22328457
2/22/22,France,46.2276,2.2137,22563594,0,138277,22425317
2/23/22,France,46.2276,2.2137,22638153,0,138502,22499651
2/24/22,France,46.2276,2.2137,22707110,0,138784,22568326
2/25/22,France,46.2276,2.2137,22765934,0,138972,22626962
2/26/22,France,46.2276,2.2137,22819557,0,139073,22680484
2/27/22,France,46.2276,2.2137,22862157,0,139149,22723008
2/28/22,France,46.2276,2.2137,22877926,0,139382,22738544
3/1/22,France,46.2276,2.2137,22959368,0,139594,22819774
3/2/22,France,46.2276,2.2137,23017711,0,139781,22877930
3/3/22,France,46.2276,2.2137,23079453,0,139962,22939491
3/4/22,France,46.2276,2.2137,23137902,0,140144,22997758
3/5/22,France,46.2276,2.2137,23191580,0,140264,23051316
3/6/22,France,46.2276,2.2137,23236908,0,140296,23096612
3/7/22,France,46.2276,2.2137,23253235,0,140473,23112762
3/8/22,France,46.2276,2.2137,23346927,0,140642,23206285
3/9/22,France,46.2276,2.2137,23417253,0,140797,23276456
3/10/22,France,46.2276,2.2137,23492815,0,140904,23351911
3/11/22,France,46.2276,2.2137,23565274,0,141054,23424220
3/12/22,France,46.2276,2.2137,23635798,0,141104,23494694
3/13/22,France,46.2276,2.2137,23694834,0,141132,23553702
3/14/22,France,46.2276,2.2137,23717460,0,141321,23576139
3/15/22,France,46.2276,2.2137,23834842,0,141467,23693375
3/16/22,France,46.2276,2.2137,23943801,0,141640,23802161
3/17/22,France,46.2276,2.2137,24046195,0,141757,23904438
3/18/22,France,46.2276,2.2137,24143852,0,141869,24001983
3/19/22,France,46.2276,2.2137,24241956,0,141931,24100025
3/20/22,France,46.2276,2.2137,24323239,0,141961,24181278
3/21/22,France,46.2276,2.2137,24347772,0,142114,24205658
3/22/22,France,46.2276,2.2137,24528957,0,142248,24386709
3/23/22,France,46.2276,2.2137,24683075,0,142362,24540713
3/24/22,France,46.2276,2.2137,24823603,0,142476,24681127
3/25/22,France,46.2276,2.2137,24967222,0,142597,24824625
3/26/22,France,46.2276,2.2137,25106739,0,142664,24964075
3/27/22,France,46.2276,2.2137,25216913,0,142705,25074208
3/28/22,France,46.2276,2.2137,25246720,0,142855,25103865
3/29/22,France,46.2276,2.2137,25464389,0,143019,25321370
3/30/22,France,46.2276,2.2137,25633476,0,143168,25490308
3/31/22,France,46.2276,2.2137,25803173,0,143307,25659866
4/1/22,France,46.2276,2.2137,25952226,0,143441,25808785
4/2/22,France,46.2276,2.2137,26084340,0,143509,25940831
4/3/22,France,46.2276,2.2137,26186606,0,143540,26043066
4/4/22,France,46.2276,2.2137,26218724,0,143699,26075025
4/5/22,France,46.2276,2.2137,26428476,0,143832,26284644
4/6/22,France,46.2276,2.2137,26579448,0,143949,26435499
4/7/22,France,46.2276,2.2137,26738483,0,144054,26594429
4/8/22,France,46.2276,2.2137,26887490,0,144193,26743297
4/9/22,France,46.2276,2.2137,27029271,0,144280,26884991
4/10/22,France,46.2276,2.2137,27136925,0,144325,26992600
4/11/22,France,46.2276,2.2137,27162463,0,144503,27017960
4/12/22,France,46.2276,2.2137,27353225,0,144662,27208563
4/13/22,France,46.2276,2.2137,27499728,0,144814,27354914
4/14/22,France,46.2276,2.2137,27637292,0,144947,27492345
4/15/22,France,46.2276,2.2137,27762686,0,145098,27617588
4/16/22,France,46.2276,2.2137,27874269,0,145159,27729110
4/17/22,France,46.2276,2.2137,27960919,0,145194,27815725
4/18/22,France,46.2276,2.2137,27980729,0,145242,27835487
4/19/22,France,46.2276,2.2137,28006219,0,145424,27860795
4/20/22,France,46.2276,2.2137,28162002,0,145651,28016351
4/21/22,France,46.2276,2.2137,28266009,0,145836,28120173
4/22/22,France,46.2276,2.2137,28354529,0,145982,28208547
4/23/22,France,46.2276,2.2137,28435100,0,146057,28289043
4/24/22,France,46.2276,2.2137,28494054,0,146097,28347957
4/25/22,France,46.2276,2.2137,28508116,0,146294,28361822
4/26/22,France,46.2276,2.2137,28605614,0,146464,28459150
4/27/22,France,46.2276,2.2137,28673411,0,146616,28526795
4/28/22,France,46.2276,2.2137,28733434,0,146748,28586686
4/29/22,France,46.2276,2.2137,28786413,0,146906,28639507
4/30/22,France,46.2276,2.2137,28835895,0,146967,28688928
5/1/22,France,46.2276,2.2137,28872621,0,146999,28725622
5/2/22,France,46.2276,2.2137,28881384,0,147179,28734205
5/3/22,France,46.2276,2.2137,28948497,0,147299,28801198
5/4/22,France,46.2276,2.2137,28996577,0,147413,28849164
5/5/22,France,46.2276,2.2137,29040934,0,147535,28893399
5/6/22,France,46.2276,2.2137,29081169,0,147645,28933524
5/7/22,France,46.2276,2.2137,29119127,0,147707,28971420
5/8/22,France,46.2276,2.2137,29148451,0,147761,29000690
5/9/22,France,46.2276,2.2137,29155815,0,147893,29007922
5/10/22,France,46.2276,2.2137,29212276,0,148016,29064260
5/11/22,France,46.2276,2.2137,29252875,0,148112,29104763
5/12/22,France,46.2276,2.2137,29289023,0,148196,29140827
5/13/22,France,46.2276,2.2137,29321831,0,148295,29173536
5/14/22,France,46.2276,2.2137,29352290,0,148306,29203984
5/15/22,France,46.2276,2.2137,29375134,0,148313,29226821
5/16/22,France,46.2276,2.2137,29381085,0,148516,29232569
5/17/22,France,46.2276,2.2137,29424812,0,148606,29276206
5/18/22,France,46.2276,2.2137,29489304,0,148686,29340618
5/19/22,France,46.2276,2.2137,29517146,0,148753,29368393
5/20/22,France,46.2276,2.2137,29541498,0,148818,29392680
5/21/22,France,46.2276,2.2137,29564005,0,148820,29415185
5/22/22,France,46.2276,2.2137,29580970,0,148823,29432147
5/23/22,France,46.2276,2.2137,29551335,0,148955,29402380
5/24/22,France,46.2276,2.2137,29583616,0,149044,29434572
5/25/22,France,46.2276,2.2137,29605758,0,149095,29456663
5/26/22,France,46.2276,2.2137,29626992,0,149123,29477869
5/27/22,France,46.2276,2.2137,29631816,0,149168,29482648
5/28/22,France,46.2276,2.2137,29655398,0,149168,29506230
5/29/22,France,46.2276,2.2137,29671838,0,149169,29522669
5/30/22,France,46.2276,2.2137,29676522,0,149290,29527232
5/31/22,France,46.2276,2.2137,29711870,0,149366,29562504
6/1/22,France,46.2276,2.2137,29738170,0,149424,29588746
6/2/22,France,46.2276,2.2137,29763546,0,149465,29614081
6/3/22,France,46.2276,2.2137,29788676,0,149503,29639173
6/4/22,France,46.2276,2.2137,29813848,0,149506,29664342
6/5/22,France,46.2276,2.2137,29834390,0,149509,29684881
6/6/22,France,46.2276,2.2137,29840626,0,149509,29691117
6/7/22,France,46.2276,2.2137,29852463,0,149630,29702833
6/8/22,France,46.2276,2.2137,29906452,0,149707,29756745
6/9/22,France,46.2276,2.2137,29946603,0,149749,29796854
6/10/22,France,46.2276,2.2137,29946697,0,149749,29796948
6/11/22,France,46.2276,2.2137,29946603,0,149788,29796815
6/12/22,France,46.2276,2.2137,29946603,0,149788,29796815
6/13/22,France,46.2276,2.2137,29946647,0,149788,29796859
6/14/22,France,46.2276,2.2137,30123426,0,149937,29973489
6/15/22,France,46.2276,2.2137,30175534,0,149986,30025548
6/16/22,France,46.2276,2.2137,30228615,0,150035,30078580
6/17/22,France,46.2276,2.2137,30279240,0,150078,30129162
6/18/22,France,46.2276,2.2137,30279240,0,150078,30129162
6/19/22,France,46.2276,2.2137,30279240,0,150078,30129162
6/20/22,France,46.2276,2.2137,30381221,0,150145,30231076
6/21/22,France,46.2276,2.2137,30476915,0,150201,30326714
6/22/22,France,46.2276,2.2137,30555038,0,150267,30404771
6/23/22,France,46.2276,2.2137,30634890,0,150307,30484583
6/24/22,France,46.2276,2.2137,30714200,0,150356,30563844
6/25/22,France,46.2276,2.2137,30714200,0,150356,30563844
6/26/22,France,46.2276,2.2137,30714200,0,150356,30563844
6/27/22,France,46.2276,2.2137,30879062,0,150445,30728617
6/28/22,France,46.2276,2.2137,31027099,0,150482,30876617
6/29/22,France,46.2276,2.2137,31151971,0,150530,31001441
6/30/22,France,46.2276,2.2137,31285317,0,150572,31134745
7/1/22,France,46.2276,2.2137,31410383,0,150624,31259759
7/2/22,France,46.2276,2.2137,31410383,0,150624,31259759
7/3/22,France,46.2276,2.2137,31410383,0,150624,31259759
7/4/22,France,46.2276,2.2137,31653749,0,150765,31502984
7/5/22,France,46.2276,2.2137,31861391,0,150840,31710551
7/6/22,France,46.2276,2.2137,32016207,0,150893,31865314
7/7/22,France,46.2276,2.2137,32177472,0,150982,32026490
7/8/22,France,46.2276,2.2137,32318670,0,151056,32167614
7/9/22,France,46.2276,2.2137,32318670,0,151056,32167614
7/10/22,France,46.2276,2.2137,32318670,0,151056,32167614
7/11/22,France,46.2276,2.2137,32570121,0,151218,32418903
7/12/22,France,46.2276,2.2137,32753754,0,151345,32602409
7/13/22,France,46.2276,2.2137,32881645,0,151454,32730191
7/14/22,France,46.2276,2.2137,32881645,0,151454,32730191
7/15/22,France,46.2276,2.2137,32881809,0,151454,32730355
7/16/22,France,46.2276,2.2137,32881809,0,151454,32730355
7/17/22,France,46.2276,2.2137,32881809,0,151454,32730355
7/18/22,France,46.2276,2.2137,33239622,0,151875,33087747
7/19/22,France,46.2276,2.2137,33375449,0,152019,33223430
7/20/22,France,46.2276,2.2137,33465759,0,152144,33313615
7/21/22,France,46.2276,2.2137,33546628,0,152277,33394351
7/22/22,France,46.2276,2.2137,33621366,0,152390,33468976
7/23/22,France,46.2276,2.2137,33621366,0,152390,33468976
7/24/22,France,46.2276,2.2137,33621366,0,152390,33468976
7/25/22,France,46.2276,2.2137,33751295,0,152600,33598695
7/26/22,France,46.2276,2.2137,33840851,0,152719,33688132
7/27/22,France,46.2276,2.2137,33899799,0,152822,33746977
7/28/22,France,46.2276,2.2137,33951450,0,152934,33798516
7/29/22,France,46.2276,2.2137,33997224,0,153023,33844201
7/30/22,France,46.2276,2.2137,33997224,0,153023,33844201
7/31/22,France,46.2276,2.2137,33997224,0,153023,33844201
8/1/22,France,46.2276,2.2137,34077286,0,153219,33924067
8/2/22,France,46.2276,2.2137,34133344,0,153320,33980024
8/3/22,France,46.2276,2.2137,34172819,0,153410,34019409
8/4/22,France,46.2276,2.2137,34206310,0,153497,34052813
8/5/22,France,46.2276,2.2137,34237067,0,153577,34083490
8/6/22,France,46.2276,2.2137,34237067,0,153577,34083490
8/7/22,France,46.2276,2.2137,34237067,0,153577,34083490
8/8/22,France,46.2276,2.2137,34292342,0,153751,34138591
8/9/22,France,46.2276,2.2137,34331725,0,153862,34177863
8/10/22,France,46.2276,2.2137,34359013,0,153950,34205063
8/11/22,France,46.2276,2.2137,34383344,0,154030,34229314
8/12/22,France,46.2276,2.2137,34406092,0,154104,34251988
8/13/22,France,46.2276,2.2137,34406092,0,154104,34251988
8/14/22,France,46.2276,2.2137,34406092,0,154104,34251988
8/15/22,France,46.2276,2.2137,34406296,0,154104,34252192
8/16/22,France,46.2276,2.2137,34455445,0,154282,34301163
8/17/22,France,46.2276,2.2137,34491381,0,154375,34337006
8/18/22,France,46.2276,2.2137,34514986,0,154467,34360519
8/19/22,France,46.2276,2.2137,34535255,0,154541,34380714
8/20/22,France,46.2276,2.2137,34535255,0,154541,34380714
8/21/22,France,46.2276,2.2137,34535255,0,154541,34380714
8/22/22,France,46.2276,2.2137,34573992,0,154657,34419335
8/23/22,France,46.2276,2.2137,34603400,0,154745,34448655
8/24/22,France,46.2276,2.2137,34624825,0,154802,34470023
8/25/22,France,46.2276,2.2137,34644718,0,154846,34489872
8/26/22,France,46.2276,2.2137,34662834,0,154897,34507937
8/27/22,France,46.2276,2.2137,34662834,0,154897,34507937
8/28/22,France,46.2276,2.2137,34662834,0,154897,34507937
8/29/22,France,46.2276,2.2137,34698583,0,155007,34543576
8/30/22,France,46.2276,2.2137,34726269,0,155079,34571190
8/31/22,France,46.2276,2.2137,34745833,0,155133,34590700
9/1/22,France,46.2276,2.2137,34764504,0,155174,34609330
9/2/22,France,46.2276,2.2137,34780903,0,155229,34625674
9/3/22,France,46.2276,2.2137,34780903,0,155229,34625674
9/4/22,France,46.2276,2.2137,34780903,0,155229,34625674
9/5/22,France,46.2276,2.2137,34812853,0,155313,34657540
9/6/22,France,46.2276,2.2137,34839791,0,155373,34684418
9/7/22,France,46.2276,2.2137,34859956,0,155419,34704537
9/8/22,France,46.2276,2.2137,34879822,0,155477,34724345
9/9/22,France,46.2276,2.2137,34898909,0,155508,34743401
9/10/22,France,46.2276,2.2137,34898909,0,155508,34743401
9/11/22,France,46.2276,2.2137,34898909,0,155508,34743401
9/12/22,France,46.2276,2.2137,34939449,0,155569,34783880
9/13/22,France,46.2276,2.2137,34985401,0,155633,34829768
9/14/22,France,46.2276,2.2137,35015024,0,155651,34859373
9/15/22,France,46.2276,2.2137,35048305,0,155684,34892621
9/16/22,France,46.2276,2.2137,35076991,0,155712,34921279
9/17/22,France,46.2276,2.2137,35076991,0,155712,34921279
9/18/22,France,46.2276,2.2137,35076991,0,155712,34921279
9/19/22,France,46.2276,2.2137,35138509,0,155783,34982726
9/20/22,France,46.2276,2.2137,35190357,0,155831,35034526
9/21/22,France,46.2276,2.2137,35228660,0,155864,35072796
9/22/22,France,46.2276,2.2137,35267124,0,155894,35111230
9/23/22,France,46.2276,2.2137,35304648,0,155927,35148721
9/24/22,France,46.2276,2.2137,35304648,0,155927,35148721
9/25/22,France,46.2276,2.2137,35304648,0,155927,35148721
9/26/22,France,46.2276,2.2137,35381526,0,156000,35225526
9/27/22,France,46.2276,2.2137,35456751,0,156049,35300702
9/28/22,France,46.2276,2.2137,35508658,0,156085,35352573
9/29/22,France,46.2276,2.2137,35560024,0,156118,35403906
9/30/22,France,46.2276,2.2137,35608285,0,156152,35452133
10/1/22,France,46.2276,2.2137,35608285,0,156152,35452133
10/2/22,France,46.2276,2.2137,35608285,0,156152,35452133
10/3/22,France,46.2276,2.2137,35701024,0,156238,35544786
10/4/22,France,46.2276,2.2137,35790213,0,156312,35633901
10/5/22,France,46.2276,2.2137,35856904,0,156359,35700545
10/6/22,France,46.2276,2.2137,35922441,0,156409,35766032
10/7/22,France,46.2276,2.2137,35983605,0,156462,35827143
10/8/22,France,46.2276,2.2137,35983605,0,156462,35827143
10/9/22,France,46.2276,2.2137,35983605,0,156462,35827143
10/10/22,France,46.2276,2.2137,36092874,0,156575,35936299
10/11/22,France,46.2276,2.2137,36187658,0,156660,36030998
10/12/22,France,46.2276,2.2137,36255606,0,156715,36098891
10/13/22,France,46.2276,2.2137,36319858,0,156777,36163081
10/14/22,France,46.2276,2.2137,36381207,0,156856,36224351
10/15/22,France,46.2276,2.2137,36381207,0,156856,36224351
10/16/22,France,46.2276,2.2137,36381207,0,156856,36224351
10/17/22,France,46.2276,2.2137,36487995,0,157020,36330975
10/18/22,France,46.2276,2.2137,36575661,0,157121,36418540
10/19/22,France,46.2276,2.2137,36638723,0,157227,36481496
10/20/22,France,46.2276,2.2137,36695541,0,157296,36538245
10/21/22,France,46.2276,2.2137,36744628,0,157377,36587251
10/22/22,France,46.2276,2.2137,36744628,0,157377,36587251
10/23/22,France,46.2276,2.2137,36744628,0,157377,36587251
10/24/22,France,46.2276,2.2137,36826751,0,157549,36669202
10/25/22,France,46.2276,2.2137,36886459,0,157680,36728779
10/26/22,France,46.2276,2.2137,36927700,0,157740,36769960
10/27/22,France,46.2276,2.2137,36964789,0,157811,36806978
10/28/22,France,46.2276,2.2137,36990572,0,157872,36832700
10/29/22,France,46.2276,2.2137,36990572,0,157872,36832700
10/30/22,France,46.2276,2.2137,36990572,0,157872,36832700
10/31/22,France,46.2276,2.2137,37033519,0,158034,36875485
11/1/22,France,46.2276,2.2137,37033582,0,158034,36875548
11/2/22,France,46.2276,2.2137,37068741,0,158184,36910557
11/3/22,France,46.2276,2.2137,37110800,0,158239,36952561
11/4/22,France,46.2276,2.2137,37140238,0,158317,36981921
11/5/22,France,46.2276,2.2137,37140238,0,158317,36981921
11/6/22,France,46.2276,2.2137,37140238,0,158317,36981921
11/7/22,France,46.2276,2.2137,37191901,0,158469,37033432
11/8/22,France,46.2276,2.2137,37232493,0,158586,37073907
11/9/22,France,46.2276,2.2137,37261364,0,158658,37102706
11/10/22,France,46.2276,2.2137,37288432,0,158711,37129721
11/11/22,France,46.2276,2.2137,37288432,0,158711,37129721
11/12/22,France,46.2276,2.2137,37288432,0,158711,37129721
11/13/22,France,46.2276,2.2137,37288432,0,158711,37129721
11/14/22,France,46.2276,2.2137,37354169,0,158861,37195308
11/15/22,France,46.2276,2.2137,37403757,0,158981,37244776
11/16/22,France,46.2276,2.2137,37437677,0,159042,37278635
11/17/22,France,46.2276,2.2137,37471008,0,159129,37311879
11/18/22,France,46.2276,2.2137,37508185,0,159203,37348982
11/19/22,France,46.2276,2.2137,37508185,0,159203,37348982
11/20/22,France,46.2276,2.2137,37508185,0,159203,37348982
11/21/22,France,46.2276,2.2137,37576243,0,159378,37416865
11/22/22,France,46.2276,2.2137,37641319,0,159467,37481852
11/23/22,France,46.2276,2.2137,37690658,0,159551,37531107
11/24/22,France,46.2276,2.2137,37741188,0,159611,37581577
11/25/22,France,46.2276,2.2137,37789817,0,159679,37630138
11/26/22,France,46.2276,2.2137,37789817,0,159679,37630138
11/27/22,France,46.2276,2.2137,37789817,0,159679,37630138
11/28/22,France,46.2276,2.2137,37885199,0,159811,37725388
11/29/22,France,46.2276,2.2137,37979248,0,159915,37819333
11/30/22,France,46.2276,2.2137,38046448,0,159990,37886458
12/1/22,France,46.2276,2.2137,38115885,0,160066,37955819
12/2/22,France,46.2276,2.2137,38174893,0,160133,38014760
12/3/22,France,46.2276,2.2137,38174893,0,160133,38014760
12/4/22,France,46.2276,2.2137,38174893,0,160133,38014760
12/5/22,France,46.2276,2.2137,38278536,0,160285,38118251
12/6/22,France,46.2276,2.2137,38384992,0,160402,38224590
12/7/22,France,46.2276,2.2137,38461021,0,160495,38300526
12/8/22,France,46.2276,2.2137,38532642,0,160558,38372084
12/9/22,France,46.2276,2.2137,38598292,0,160652,38437640
12/10/22,France,46.2276,2.2137,38598292,0,160652,38437640
12/11/22,France,46.2276,2.2137,38598292,0,160652,38437640
12/12/22,France,46.2276,2.2137,38717933,0,160913,38557020
12/13/22,France,46.2276,2.2137,38815319,0,161049,38654270
12/14/22,France,46.2276,2.2137,38885679,0,161163,38724516
12/15/22,France,46.2276,2.2137,38948220,0,161269,38786951
12/16/22,France,46.2276,2.2137,39004649,0,161400,38843249
12/17/22,France,46.2276,2.2137,39004649,0,161400,38843249
1/1/22,Gabon,-0.8037,11.6094,41798,0,288,41510
1/2/22,Gabon,-0.8037,11.6094,41798,0,288,41510
1/3/22,Gabon,-0.8037,11.6094,42640,0,290,42350
1/4/22,Gabon,-0.8037,11.6094,42640,0,290,42350
1/5/22,Gabon,-0.8037,11.6094,42640,0,290,42350
1/6/22,Gabon,-0.8037,11.6094,42640,0,290,42350
1/7/22,Gabon,-0.8037,11.6094,43939,0,295,43644
1/8/22,Gabon,-0.8037,11.6094,43939,0,295,43644
1/9/22,Gabon,-0.8037,11.6094,43939,0,295,43644
1/10/22,Gabon,-0.8037,11.6094,44409,0,295,44114
1/11/22,Gabon,-0.8037,11.6094,44409,0,295,44114
1/12/22,Gabon,-0.8037,11.6094,44806,0,297,44509
1/13/22,Gabon,-0.8037,11.6094,44806,0,297,44509
1/14/22,Gabon,-0.8037,11.6094,45152,0,297,44855
1/15/22,Gabon,-0.8037,11.6094,45152,0,297,44855
1/16/22,Gabon,-0.8037,11.6094,45152,0,297,44855
1/17/22,Gabon,-0.8037,11.6094,45405,0,299,45106
1/18/22,Gabon,-0.8037,11.6094,45405,0,299,45106
1/19/22,Gabon,-0.8037,11.6094,45405,0,299,45106
1/20/22,Gabon,-0.8037,11.6094,45663,0,299,45364
1/21/22,Gabon,-0.8037,11.6094,45909,0,300,45609
1/22/22,Gabon,-0.8037,11.6094,45909,0,300,45609
1/23/22,Gabon,-0.8037,11.6094,45909,0,300,45609
1/24/22,Gabon,-0.8037,11.6094,46198,0,300,45898
1/25/22,Gabon,-0.8037,11.6094,46198,0,300,45898
1/26/22,Gabon,-0.8037,11.6094,46469,0,301,46168
1/27/22,Gabon,-0.8037,11.6094,46469,0,301,46168
1/28/22,Gabon,-0.8037,11.6094,46722,0,301,46421
1/29/22,Gabon,-0.8037,11.6094,46722,0,301,46421
1/30/22,Gabon,-0.8037,11.6094,46722,0,301,46421
1/31/22,Gabon,-0.8037,11.6094,46925,0,301,46624
2/1/22,Gabon,-0.8037,11.6094,46925,0,301,46624
2/2/22,Gabon,-0.8037,11.6094,47148,0,301,46847
2/3/22,Gabon,-0.8037,11.6094,47148,0,301,46847
2/4/22,Gabon,-0.8037,11.6094,47247,0,302,46945
2/5/22,Gabon,-0.8037,11.6094,47247,0,302,46945
2/6/22,Gabon,-0.8037,11.6094,47247,0,302,46945
2/7/22,Gabon,-0.8037,11.6094,47362,0,302,47060
2/8/22,Gabon,-0.8037,11.6094,47362,0,302,47060
2/9/22,Gabon,-0.8037,11.6094,47399,0,302,47097
2/10/22,Gabon,-0.8037,11.6094,47399,0,302,47097
2/11/22,Gabon,-0.8037,11.6094,47399,0,302,47097
2/12/22,Gabon,-0.8037,11.6094,47426,0,302,47124
2/13/22,Gabon,-0.8037,11.6094,47426,0,302,47124
2/14/22,Gabon,-0.8037,11.6094,47446,0,302,47144
2/15/22,Gabon,-0.8037,11.6094,47446,0,302,47144
2/16/22,Gabon,-0.8037,11.6094,47446,0,302,47144
2/17/22,Gabon,-0.8037,11.6094,47467,0,302,47165
2/18/22,Gabon,-0.8037,11.6094,47484,0,303,47181
2/19/22,Gabon,-0.8037,11.6094,47484,0,303,47181
2/20/22,Gabon,-0.8037,11.6094,47484,0,303,47181
2/21/22,Gabon,-0.8037,11.6094,47506,0,303,47203
2/22/22,Gabon,-0.8037,11.6094,47506,0,303,47203
2/23/22,Gabon,-0.8037,11.6094,47520,0,303,47217
2/24/22,Gabon,-0.8037,11.6094,47520,0,303,47217
2/25/22,Gabon,-0.8037,11.6094,47520,0,303,47217
2/26/22,Gabon,-0.8037,11.6094,47520,0,303,47217
2/27/22,Gabon,-0.8037,11.6094,47534,0,303,47231
2/28/22,Gabon,-0.8037,11.6094,47543,0,303,47240
3/1/22,Gabon,-0.8037,11.6094,47543,0,303,47240
3/2/22,Gabon,-0.8037,11.6094,47543,0,303,47240
3/3/22,Gabon,-0.8037,11.6094,47543,0,303,47240
3/4/22,Gabon,-0.8037,11.6094,47543,0,303,47240
3/5/22,Gabon,-0.8037,11.6094,47559,0,303,47256
3/6/22,Gabon,-0.8037,11.6094,47559,0,303,47256
3/7/22,Gabon,-0.8037,11.6094,47559,0,303,47256
3/8/22,Gabon,-0.8037,11.6094,47562,0,303,47259
3/9/22,Gabon,-0.8037,11.6094,47564,0,303,47261
3/10/22,Gabon,-0.8037,11.6094,47564,0,303,47261
3/11/22,Gabon,-0.8037,11.6094,47564,0,303,47261
3/12/22,Gabon,-0.8037,11.6094,47564,0,303,47261
3/13/22,Gabon,-0.8037,11.6094,47564,0,303,47261
3/14/22,Gabon,-0.8037,11.6094,47570,0,303,47267
3/15/22,Gabon,-0.8037,11.6094,47570,0,303,47267
3/16/22,Gabon,-0.8037,11.6094,47570,0,303,47267
3/17/22,Gabon,-0.8037,11.6094,47570,0,303,47267
3/18/22,Gabon,-0.8037,11.6094,47570,0,303,47267
3/19/22,Gabon,-0.8037,11.6094,47570,0,303,47267
3/20/22,Gabon,-0.8037,11.6094,47570,0,303,47267
3/21/22,Gabon,-0.8037,11.6094,47581,0,303,47278
3/22/22,Gabon,-0.8037,11.6094,47581,0,303,47278
3/23/22,Gabon,-0.8037,11.6094,47581,0,303,47278
3/24/22,Gabon,-0.8037,11.6094,47584,0,303,47281
3/25/22,Gabon,-0.8037,11.6094,47584,0,303,47281
3/26/22,Gabon,-0.8037,11.6094,47584,0,303,47281
3/27/22,Gabon,-0.8037,11.6094,47584,0,303,47281
3/28/22,Gabon,-0.8037,11.6094,47584,0,303,47281
3/29/22,Gabon,-0.8037,11.6094,47584,0,303,47281
3/30/22,Gabon,-0.8037,11.6094,47584,0,303,47281
3/31/22,Gabon,-0.8037,11.6094,47584,0,303,47281
4/1/22,Gabon,-0.8037,11.6094,47586,0,303,47283
4/2/22,Gabon,-0.8037,11.6094,47586,0,303,47283
4/3/22,Gabon,-0.8037,11.6094,47586,0,303,47283
4/4/22,Gabon,-0.8037,11.6094,47588,0,303,47285
4/5/22,Gabon,-0.8037,11.6094,47588,0,303,47285
4/6/22,Gabon,-0.8037,11.6094,47588,0,303,47285
4/7/22,Gabon,-0.8037,11.6094,47588,0,303,47285
4/8/22,Gabon,-0.8037,11.6094,47588,0,303,47285
4/9/22,Gabon,-0.8037,11.6094,47588,0,303,47285
4/10/22,Gabon,-0.8037,11.6094,47588,0,303,47285
4/11/22,Gabon,-0.8037,11.6094,47588,0,303,47285
4/12/22,Gabon,-0.8037,11.6094,47588,0,303,47285
4/13/22,Gabon,-0.8037,11.6094,47591,0,303,47288
4/14/22,Gabon,-0.8037,11.6094,47591,0,303,47288
4/15/22,Gabon,-0.8037,11.6094,47591,0,303,47288
4/16/22,Gabon,-0.8037,11.6094,47594,0,303,47291
4/17/22,Gabon,-0.8037,11.6094,47594,0,303,47291
4/18/22,Gabon,-0.8037,11.6094,47594,0,303,47291
4/19/22,Gabon,-0.8037,11.6094,47594,0,303,47291
4/20/22,Gabon,-0.8037,11.6094,47594,0,303,47291
4/21/22,Gabon,-0.8037,11.6094,47594,0,303,47291
4/22/22,Gabon,-0.8037,11.6094,47594,0,303,47291
4/23/22,Gabon,-0.8037,11.6094,47597,0,303,47294
4/24/22,Gabon,-0.8037,11.6094,47597,0,303,47294
4/25/22,Gabon,-0.8037,11.6094,47597,0,303,47294
4/26/22,Gabon,-0.8037,11.6094,47597,0,303,47294
4/27/22,Gabon,-0.8037,11.6094,47597,0,303,47294
4/28/22,Gabon,-0.8037,11.6094,47602,0,304,47298
4/29/22,Gabon,-0.8037,11.6094,47602,0,304,47298
4/30/22,Gabon,-0.8037,11.6094,47602,0,304,47298
5/1/22,Gabon,-0.8037,11.6094,47602,0,304,47298
5/2/22,Gabon,-0.8037,11.6094,47602,0,304,47298
5/3/22,Gabon,-0.8037,11.6094,47602,0,304,47298
5/4/22,Gabon,-0.8037,11.6094,47602,0,304,47298
5/5/22,Gabon,-0.8037,11.6094,47602,0,304,47298
5/6/22,Gabon,-0.8037,11.6094,47602,0,304,47298
5/7/22,Gabon,-0.8037,11.6094,47602,0,304,47298
5/8/22,Gabon,-0.8037,11.6094,47602,0,304,47298
5/9/22,Gabon,-0.8037,11.6094,47608,0,304,47304
5/10/22,Gabon,-0.8037,11.6094,47608,0,304,47304
5/11/22,Gabon,-0.8037,11.6094,47608,0,304,47304
5/12/22,Gabon,-0.8037,11.6094,47608,0,304,47304
5/13/22,Gabon,-0.8037,11.6094,47608,0,304,47304
5/14/22,Gabon,-0.8037,11.6094,47608,0,304,47304
5/15/22,Gabon,-0.8037,11.6094,47608,0,304,47304
5/16/22,Gabon,-0.8037,11.6094,47608,0,304,47304
5/17/22,Gabon,-0.8037,11.6094,47608,0,304,47304
5/18/22,Gabon,-0.8037,11.6094,47608,0,304,47304
5/19/22,Gabon,-0.8037,11.6094,47608,0,304,47304
5/20/22,Gabon,-0.8037,11.6094,47608,0,304,47304
5/21/22,Gabon,-0.8037,11.6094,47622,0,304,47318
5/22/22,Gabon,-0.8037,11.6094,47622,0,304,47318
5/23/22,Gabon,-0.8037,11.6094,47622,0,304,47318
5/24/22,Gabon,-0.8037,11.6094,47622,0,304,47318
5/25/22,Gabon,-0.8037,11.6094,47622,0,304,47318
5/26/22,Gabon,-0.8037,11.6094,47622,0,304,47318
5/27/22,Gabon,-0.8037,11.6094,47622,0,304,47318
5/28/22,Gabon,-0.8037,11.6094,47622,0,304,47318
5/29/22,Gabon,-0.8037,11.6094,47622,0,304,47318
5/30/22,Gabon,-0.8037,11.6094,47650,0,304,47346
5/31/22,Gabon,-0.8037,11.6094,47650,0,304,47346
6/1/22,Gabon,-0.8037,11.6094,47677,0,304,47373
6/2/22,Gabon,-0.8037,11.6094,47677,0,304,47373
6/3/22,Gabon,-0.8037,11.6094,47677,0,304,47373
6/4/22,Gabon,-0.8037,11.6094,47677,0,304,47373
6/5/22,Gabon,-0.8037,11.6094,47677,0,304,47373
6/6/22,Gabon,-0.8037,11.6094,47677,0,304,47373
6/7/22,Gabon,-0.8037,11.6094,47677,0,304,47373
6/8/22,Gabon,-0.8037,11.6094,47677,0,304,47373
6/9/22,Gabon,-0.8037,11.6094,47711,0,304,47407
6/10/22,Gabon,-0.8037,11.6094,47711,0,304,47407
6/11/22,Gabon,-0.8037,11.6094,47711,0,304,47407
6/12/22,Gabon,-0.8037,11.6094,47711,0,304,47407
6/13/22,Gabon,-0.8037,11.6094,47711,0,304,47407
6/14/22,Gabon,-0.8037,11.6094,47711,0,304,47407
6/15/22,Gabon,-0.8037,11.6094,47711,0,304,47407
6/16/22,Gabon,-0.8037,11.6094,47711,0,304,47407
6/17/22,Gabon,-0.8037,11.6094,47742,0,304,47438
6/18/22,Gabon,-0.8037,11.6094,47742,0,304,47438
6/19/22,Gabon,-0.8037,11.6094,47742,0,304,47438
6/20/22,Gabon,-0.8037,11.6094,47742,0,304,47438
6/21/22,Gabon,-0.8037,11.6094,47742,0,304,47438
6/22/22,Gabon,-0.8037,11.6094,47742,0,304,47438
6/23/22,Gabon,-0.8037,11.6094,47824,0,305,47519
6/24/22,Gabon,-0.8037,11.6094,47824,0,305,47519
6/25/22,Gabon,-0.8037,11.6094,47824,0,305,47519
6/26/22,Gabon,-0.8037,11.6094,47824,0,305,47519
6/27/22,Gabon,-0.8037,11.6094,47824,0,305,47519
6/28/22,Gabon,-0.8037,11.6094,47824,0,305,47519
6/29/22,Gabon,-0.8037,11.6094,47824,0,305,47519
6/30/22,Gabon,-0.8037,11.6094,47939,0,305,47634
7/1/22,Gabon,-0.8037,11.6094,47939,0,305,47634
7/2/22,Gabon,-0.8037,11.6094,47939,0,305,47634
7/3/22,Gabon,-0.8037,11.6094,47939,0,305,47634
7/4/22,Gabon,-0.8037,11.6094,47939,0,305,47634
7/5/22,Gabon,-0.8037,11.6094,47939,0,305,47634
7/6/22,Gabon,-0.8037,11.6094,47939,0,305,47634
7/7/22,Gabon,-0.8037,11.6094,47939,0,305,47634
7/8/22,Gabon,-0.8037,11.6094,47939,0,305,47634
7/9/22,Gabon,-0.8037,11.6094,48157,0,305,47852
7/10/22,Gabon,-0.8037,11.6094,48157,0,305,47852
7/11/22,Gabon,-0.8037,11.6094,48157,0,305,47852
7/12/22,Gabon,-0.8037,11.6094,48157,0,305,47852
7/13/22,Gabon,-0.8037,11.6094,48157,0,305,47852
7/14/22,Gabon,-0.8037,11.6094,48157,0,305,47852
7/15/22,Gabon,-0.8037,11.6094,48289,0,306,47983
7/16/22,Gabon,-0.8037,11.6094,48289,0,306,47983
7/17/22,Gabon,-0.8037,11.6094,48289,0,306,47983
7/18/22,Gabon,-0.8037,11.6094,48289,0,306,47983
7/19/22,Gabon,-0.8037,11.6094,48289,0,306,47983
7/20/22,Gabon,-0.8037,11.6094,48289,0,306,47983
7/21/22,Gabon,-0.8037,11.6094,48289,0,306,47983
7/22/22,Gabon,-0.8037,11.6094,48289,0,306,47983
7/23/22,Gabon,-0.8037,11.6094,48417,0,306,48111
7/24/22,Gabon,-0.8037,11.6094,48417,0,306,48111
7/25/22,Gabon,-0.8037,11.6094,48417,0,306,48111
7/26/22,Gabon,-0.8037,11.6094,48417,0,306,48111
7/27/22,Gabon,-0.8037,11.6094,48417,0,306,48111
7/28/22,Gabon,-0.8037,11.6094,48511,0,306,48205
7/29/22,Gabon,-0.8037,11.6094,48511,0,306,48205
7/30/22,Gabon,-0.8037,11.6094,48511,0,306,48205
7/31/22,Gabon,-0.8037,11.6094,48511,0,306,48205
8/1/22,Gabon,-0.8037,11.6094,48511,0,306,48205
8/2/22,Gabon,-0.8037,11.6094,48511,0,306,48205
8/3/22,Gabon,-0.8037,11.6094,48511,0,306,48205
8/4/22,Gabon,-0.8037,11.6094,48511,0,306,48205
8/5/22,Gabon,-0.8037,11.6094,48511,0,306,48205
8/6/22,Gabon,-0.8037,11.6094,48511,0,306,48205
8/7/22,Gabon,-0.8037,11.6094,48511,0,306,48205
8/8/22,Gabon,-0.8037,11.6094,48511,0,306,48205
8/9/22,Gabon,-0.8037,11.6094,48592,0,306,48286
8/10/22,Gabon,-0.8037,11.6094,48592,0,306,48286
8/11/22,Gabon,-0.8037,11.6094,48592,0,306,48286
8/12/22,Gabon,-0.8037,11.6094,48592,0,306,48286
8/13/22,Gabon,-0.8037,11.6094,48592,0,306,48286
8/14/22,Gabon,-0.8037,11.6094,48592,0,306,48286
8/15/22,Gabon,-0.8037,11.6094,48592,0,306,48286
8/16/22,Gabon,-0.8037,11.6094,48592,0,306,48286
8/17/22,Gabon,-0.8037,11.6094,48592,0,306,48286
8/18/22,Gabon,-0.8037,11.6094,48592,0,306,48286
8/19/22,Gabon,-0.8037,11.6094,48635,0,306,48329
8/20/22,Gabon,-0.8037,11.6094,48635,0,306,48329
8/21/22,Gabon,-0.8037,11.6094,48635,0,306,48329
8/22/22,Gabon,-0.8037,11.6094,48635,0,306,48329
8/23/22,Gabon,-0.8037,11.6094,48635,0,306,48329
8/24/22,Gabon,-0.8037,11.6094,48635,0,306,48329
8/25/22,Gabon,-0.8037,11.6094,48635,0,306,48329
8/26/22,Gabon,-0.8037,11.6094,48635,0,306,48329
8/27/22,Gabon,-0.8037,11.6094,48635,0,306,48329
8/28/22,Gabon,-0.8037,11.6094,48635,0,306,48329
8/29/22,Gabon,-0.8037,11.6094,48635,0,306,48329
8/30/22,Gabon,-0.8037,11.6094,48649,0,306,48343
8/31/22,Gabon,-0.8037,11.6094,48649,0,306,48343
9/1/22,Gabon,-0.8037,11.6094,48649,0,306,48343
9/2/22,Gabon,-0.8037,11.6094,48649,0,306,48343
9/3/22,Gabon,-0.8037,11.6094,48649,0,306,48343
9/4/22,Gabon,-0.8037,11.6094,48649,0,306,48343
9/5/22,Gabon,-0.8037,11.6094,48649,0,306,48343
9/6/22,Gabon,-0.8037,11.6094,48655,0,306,48349
9/7/22,Gabon,-0.8037,11.6094,48655,0,306,48349
9/8/22,Gabon,-0.8037,11.6094,48655,0,306,48349
9/9/22,Gabon,-0.8037,11.6094,48668,0,306,48362
9/10/22,Gabon,-0.8037,11.6094,48668,0,306,48362
9/11/22,Gabon,-0.8037,11.6094,48668,0,306,48362
9/12/22,Gabon,-0.8037,11.6094,48668,0,306,48362
9/13/22,Gabon,-0.8037,11.6094,48668,0,306,48362
9/14/22,Gabon,-0.8037,11.6094,48668,0,306,48362
9/15/22,Gabon,-0.8037,11.6094,48668,0,306,48362
9/16/22,Gabon,-0.8037,11.6094,48668,0,306,48362
9/17/22,Gabon,-0.8037,11.6094,48668,0,306,48362
9/18/22,Gabon,-0.8037,11.6094,48682,0,306,48376
9/19/22,Gabon,-0.8037,11.6094,48682,0,306,48376
9/20/22,Gabon,-0.8037,11.6094,48682,0,306,48376
9/21/22,Gabon,-0.8037,11.6094,48682,0,306,48376
9/22/22,Gabon,-0.8037,11.6094,48682,0,306,48376
9/23/22,Gabon,-0.8037,11.6094,48691,0,306,48385
9/24/22,Gabon,-0.8037,11.6094,48691,0,306,48385
9/25/22,Gabon,-0.8037,11.6094,48691,0,306,48385
9/26/22,Gabon,-0.8037,11.6094,48691,0,306,48385
9/27/22,Gabon,-0.8037,11.6094,48691,0,306,48385
9/28/22,Gabon,-0.8037,11.6094,48691,0,306,48385
9/29/22,Gabon,-0.8037,11.6094,48691,0,306,48385
9/30/22,Gabon,-0.8037,11.6094,48691,0,306,48385
10/1/22,Gabon,-0.8037,11.6094,48691,0,306,48385
10/2/22,Gabon,-0.8037,11.6094,48713,0,306,48407
10/3/22,Gabon,-0.8037,11.6094,48713,0,306,48407
10/4/22,Gabon,-0.8037,11.6094,48713,0,306,48407
10/5/22,Gabon,-0.8037,11.6094,48713,0,306,48407
10/6/22,Gabon,-0.8037,11.6094,48713,0,306,48407
10/7/22,Gabon,-0.8037,11.6094,48713,0,306,48407
10/8/22,Gabon,-0.8037,11.6094,48713,0,306,48407
10/9/22,Gabon,-0.8037,11.6094,48713,0,306,48407
10/10/22,Gabon,-0.8037,11.6094,48713,0,306,48407
10/11/22,Gabon,-0.8037,11.6094,48772,0,306,48466
10/12/22,Gabon,-0.8037,11.6094,48772,0,306,48466
10/13/22,Gabon,-0.8037,11.6094,48810,0,306,48504
10/14/22,Gabon,-0.8037,11.6094,48810,0,306,48504
10/15/22,Gabon,-0.8037,11.6094,48810,0,306,48504
10/16/22,Gabon,-0.8037,11.6094,48810,0,306,48504
10/17/22,Gabon,-0.8037,11.6094,48810,0,306,48504
10/18/22,Gabon,-0.8037,11.6094,48810,0,306,48504
10/19/22,Gabon,-0.8037,11.6094,48810,0,306,48504
10/20/22,Gabon,-0.8037,11.6094,48810,0,306,48504
10/21/22,Gabon,-0.8037,11.6094,48810,0,306,48504
10/22/22,Gabon,-0.8037,11.6094,48810,0,306,48504
10/23/22,Gabon,-0.8037,11.6094,48810,0,306,48504
10/24/22,Gabon,-0.8037,11.6094,48914,0,306,48608
10/25/22,Gabon,-0.8037,11.6094,48914,0,306,48608
10/26/22,Gabon,-0.8037,11.6094,48914,0,306,48608
10/27/22,Gabon,-0.8037,11.6094,48914,0,306,48608
10/28/22,Gabon,-0.8037,11.6094,48945,0,306,48639
10/29/22,Gabon,-0.8037,11.6094,48945,0,306,48639
10/30/22,Gabon,-0.8037,11.6094,48945,0,306,48639
10/31/22,Gabon,-0.8037,11.6094,48945,0,306,48639
11/1/22,Gabon,-0.8037,11.6094,48945,0,306,48639
11/2/22,Gabon,-0.8037,11.6094,48945,0,306,48639
11/3/22,Gabon,-0.8037,11.6094,48945,0,306,48639
11/4/22,Gabon,-0.8037,11.6094,48945,0,306,48639
11/5/22,Gabon,-0.8037,11.6094,48945,0,306,48639
11/6/22,Gabon,-0.8037,11.6094,48945,0,306,48639
11/7/22,Gabon,-0.8037,11.6094,48945,0,306,48639
11/8/22,Gabon,-0.8037,11.6094,48945,0,306,48639
11/9/22,Gabon,-0.8037,11.6094,48945,0,306,48639
11/10/22,Gabon,-0.8037,11.6094,48945,0,306,48639
11/11/22,Gabon,-0.8037,11.6094,48945,0,306,48639
11/12/22,Gabon,-0.8037,11.6094,48945,0,306,48639
11/13/22,Gabon,-0.8037,11.6094,48945,0,306,48639
11/14/22,Gabon,-0.8037,11.6094,48945,0,306,48639
11/15/22,Gabon,-0.8037,11.6094,48945,0,306,48639
11/16/22,Gabon,-0.8037,11.6094,48959,0,306,48653
11/17/22,Gabon,-0.8037,11.6094,48959,0,306,48653
11/18/22,Gabon,-0.8037,11.6094,48972,0,306,48666
11/19/22,Gabon,-0.8037,11.6094,48972,0,306,48666
11/20/22,Gabon,-0.8037,11.6094,48972,0,306,48666
11/21/22,Gabon,-0.8037,11.6094,48972,0,306,48666
11/22/22,Gabon,-0.8037,11.6094,48972,0,306,48666
11/23/22,Gabon,-0.8037,11.6094,48972,0,306,48666
11/24/22,Gabon,-0.8037,11.6094,48972,0,306,48666
11/25/22,Gabon,-0.8037,11.6094,48972,0,306,48666
11/26/22,Gabon,-0.8037,11.6094,48972,0,306,48666
11/27/22,Gabon,-0.8037,11.6094,48972,0,306,48666
11/28/22,Gabon,-0.8037,11.6094,48972,0,306,48666
11/29/22,Gabon,-0.8037,11.6094,48973,0,306,48667
11/30/22,Gabon,-0.8037,11.6094,48973,0,306,48667
12/1/22,Gabon,-0.8037,11.6094,48973,0,306,48667
12/2/22,Gabon,-0.8037,11.6094,48973,0,306,48667
12/3/22,Gabon,-0.8037,11.6094,48973,0,306,48667
12/4/22,Gabon,-0.8037,11.6094,48973,0,306,48667
12/5/22,Gabon,-0.8037,11.6094,48973,0,306,48667
12/6/22,Gabon,-0.8037,11.6094,48973,0,306,48667
12/7/22,Gabon,-0.8037,11.6094,48973,0,306,48667
12/8/22,Gabon,-0.8037,11.6094,48973,0,306,48667
12/9/22,Gabon,-0.8037,11.6094,48973,0,306,48667
12/10/22,Gabon,-0.8037,11.6094,48973,0,306,48667
12/11/22,Gabon,-0.8037,11.6094,48973,0,306,48667
12/12/22,Gabon,-0.8037,11.6094,48973,0,306,48667
12/13/22,Gabon,-0.8037,11.6094,48973,0,306,48667
12/14/22,Gabon,-0.8037,11.6094,48973,0,306,48667
12/15/22,Gabon,-0.8037,11.6094,48973,0,306,48667
12/16/22,Gabon,-0.8037,11.6094,48973,0,306,48667
12/17/22,Gabon,-0.8037,11.6094,48973,0,306,48667
1/1/22,Gambia,13.4432,-15.3101,10170,0,343,9827
1/2/22,Gambia,13.4432,-15.3101,10170,0,343,9827
1/3/22,Gambia,13.4432,-15.3101,10170,0,343,9827
1/4/22,Gambia,13.4432,-15.3101,10376,0,343,10033
1/5/22,Gambia,13.4432,-15.3101,10376,0,343,10033
1/6/22,Gambia,13.4432,-15.3101,10792,0,343,10449
1/7/22,Gambia,13.4432,-15.3101,10792,0,343,10449
1/8/22,Gambia,13.4432,-15.3101,10792,0,343,10449
1/9/22,Gambia,13.4432,-15.3101,10792,0,343,10449
1/10/22,Gambia,13.4432,-15.3101,10792,0,343,10449
1/11/22,Gambia,13.4432,-15.3101,11122,0,344,10778
1/12/22,Gambia,13.4432,-15.3101,11122,0,344,10778
1/13/22,Gambia,13.4432,-15.3101,11122,0,344,10778
1/14/22,Gambia,13.4432,-15.3101,11122,0,344,10778
1/15/22,Gambia,13.4432,-15.3101,11122,0,344,10778
1/16/22,Gambia,13.4432,-15.3101,11122,0,344,10778
1/17/22,Gambia,13.4432,-15.3101,11572,0,347,11225
1/18/22,Gambia,13.4432,-15.3101,11572,0,347,11225
1/19/22,Gambia,13.4432,-15.3101,11572,0,347,11225
1/20/22,Gambia,13.4432,-15.3101,11572,0,347,11225
1/21/22,Gambia,13.4432,-15.3101,11572,0,347,11225
1/22/22,Gambia,13.4432,-15.3101,11572,0,347,11225
1/23/22,Gambia,13.4432,-15.3101,11572,0,347,11225
1/24/22,Gambia,13.4432,-15.3101,11572,0,347,11225
1/25/22,Gambia,13.4432,-15.3101,11572,0,347,11225
1/26/22,Gambia,13.4432,-15.3101,11572,0,347,11225
1/27/22,Gambia,13.4432,-15.3101,11572,0,347,11225
1/28/22,Gambia,13.4432,-15.3101,11572,0,347,11225
1/29/22,Gambia,13.4432,-15.3101,11842,0,347,11495
1/30/22,Gambia,13.4432,-15.3101,11842,0,347,11495
1/31/22,Gambia,13.4432,-15.3101,11842,0,362,11480
2/1/22,Gambia,13.4432,-15.3101,11863,0,364,11499
2/2/22,Gambia,13.4432,-15.3101,11863,0,364,11499
2/3/22,Gambia,13.4432,-15.3101,11863,0,364,11499
2/4/22,Gambia,13.4432,-15.3101,11880,0,364,11516
2/5/22,Gambia,13.4432,-15.3101,11880,0,364,11516
2/6/22,Gambia,13.4432,-15.3101,11880,0,364,11516
2/7/22,Gambia,13.4432,-15.3101,11880,0,364,11516
2/8/22,Gambia,13.4432,-15.3101,11880,0,364,11516
2/9/22,Gambia,13.4432,-15.3101,11911,0,365,11546
2/10/22,Gambia,13.4432,-15.3101,11911,0,365,11546
2/11/22,Gambia,13.4432,-15.3101,11911,0,365,11546
2/12/22,Gambia,13.4432,-15.3101,11911,0,365,11546
2/13/22,Gambia,13.4432,-15.3101,11911,0,365,11546
2/14/22,Gambia,13.4432,-15.3101,11911,0,365,11546
2/15/22,Gambia,13.4432,-15.3101,11911,0,365,11546
2/16/22,Gambia,13.4432,-15.3101,11924,0,365,11559
2/17/22,Gambia,13.4432,-15.3101,11924,0,365,11559
2/18/22,Gambia,13.4432,-15.3101,11924,0,365,11559
2/19/22,Gambia,13.4432,-15.3101,11924,0,365,11559
2/20/22,Gambia,13.4432,-15.3101,11924,0,365,11559
2/21/22,Gambia,13.4432,-15.3101,11924,0,365,11559
2/22/22,Gambia,13.4432,-15.3101,11924,0,365,11559
2/23/22,Gambia,13.4432,-15.3101,11924,0,365,11559
2/24/22,Gambia,13.4432,-15.3101,11924,0,365,11559
2/25/22,Gambia,13.4432,-15.3101,11924,0,365,11559
2/26/22,Gambia,13.4432,-15.3101,11924,0,365,11559
2/27/22,Gambia,13.4432,-15.3101,11924,0,365,11559
2/28/22,Gambia,13.4432,-15.3101,11939,0,365,11574
3/1/22,Gambia,13.4432,-15.3101,11939,0,365,11574
3/2/22,Gambia,13.4432,-15.3101,11939,0,365,11574
3/3/22,Gambia,13.4432,-15.3101,11948,0,365,11583
3/4/22,Gambia,13.4432,-15.3101,11948,0,365,11583
3/5/22,Gambia,13.4432,-15.3101,11948,0,365,11583
3/6/22,Gambia,13.4432,-15.3101,11948,0,365,11583
3/7/22,Gambia,13.4432,-15.3101,11948,0,365,11583
3/8/22,Gambia,13.4432,-15.3101,11963,0,365,11598
3/9/22,Gambia,13.4432,-15.3101,11963,0,365,11598
3/10/22,Gambia,13.4432,-15.3101,11963,0,365,11598
3/11/22,Gambia,13.4432,-15.3101,11963,0,365,11598
3/12/22,Gambia,13.4432,-15.3101,11963,0,365,11598
3/13/22,Gambia,13.4432,-15.3101,11963,0,365,11598
3/14/22,Gambia,13.4432,-15.3101,11973,0,365,11608
3/15/22,Gambia,13.4432,-15.3101,11973,0,365,11608
3/16/22,Gambia,13.4432,-15.3101,11973,0,365,11608
3/17/22,Gambia,13.4432,-15.3101,11973,0,365,11608
3/18/22,Gambia,13.4432,-15.3101,11978,0,365,11613
3/19/22,Gambia,13.4432,-15.3101,11978,0,365,11613
3/20/22,Gambia,13.4432,-15.3101,11978,0,365,11613
3/21/22,Gambia,13.4432,-15.3101,11978,0,365,11613
3/22/22,Gambia,13.4432,-15.3101,11978,0,365,11613
3/23/22,Gambia,13.4432,-15.3101,11978,0,365,11613
3/24/22,Gambia,13.4432,-15.3101,11978,0,365,11613
3/25/22,Gambia,13.4432,-15.3101,11986,0,365,11621
3/26/22,Gambia,13.4432,-15.3101,11986,0,365,11621
3/27/22,Gambia,13.4432,-15.3101,11986,0,365,11621
3/28/22,Gambia,13.4432,-15.3101,11986,0,365,11621
3/29/22,Gambia,13.4432,-15.3101,11988,0,365,11623
3/30/22,Gambia,13.4432,-15.3101,11988,0,365,11623
3/31/22,Gambia,13.4432,-15.3101,11988,0,365,11623
4/1/22,Gambia,13.4432,-15.3101,11988,0,365,11623
4/2/22,Gambia,13.4432,-15.3101,11988,0,365,11623
4/3/22,Gambia,13.4432,-15.3101,11988,0,365,11623
4/4/22,Gambia,13.4432,-15.3101,11989,0,365,11624
4/5/22,Gambia,13.4432,-15.3101,11990,0,365,11625
4/6/22,Gambia,13.4432,-15.3101,11990,0,365,11625
4/7/22,Gambia,13.4432,-15.3101,11990,0,365,11625
4/8/22,Gambia,13.4432,-15.3101,11990,0,365,11625
4/9/22,Gambia,13.4432,-15.3101,11990,0,365,11625
4/10/22,Gambia,13.4432,-15.3101,11990,0,365,11625
4/11/22,Gambia,13.4432,-15.3101,11990,0,365,11625
4/12/22,Gambia,13.4432,-15.3101,11990,0,365,11625
4/13/22,Gambia,13.4432,-15.3101,11990,0,365,11625
4/14/22,Gambia,13.4432,-15.3101,11994,0,365,11629
4/15/22,Gambia,13.4432,-15.3101,11994,0,365,11629
4/16/22,Gambia,13.4432,-15.3101,11994,0,365,11629
4/17/22,Gambia,13.4432,-15.3101,11994,0,365,11629
4/18/22,Gambia,13.4432,-15.3101,11994,0,365,11629
4/19/22,Gambia,13.4432,-15.3101,11994,0,365,11629
4/20/22,Gambia,13.4432,-15.3101,11995,0,365,11630
4/21/22,Gambia,13.4432,-15.3101,11995,0,365,11630
4/22/22,Gambia,13.4432,-15.3101,11995,0,365,11630
4/23/22,Gambia,13.4432,-15.3101,11995,0,365,11630
4/24/22,Gambia,13.4432,-15.3101,11995,0,365,11630
4/25/22,Gambia,13.4432,-15.3101,11995,0,365,11630
4/26/22,Gambia,13.4432,-15.3101,11995,0,365,11630
4/27/22,Gambia,13.4432,-15.3101,11995,0,365,11630
4/28/22,Gambia,13.4432,-15.3101,11995,0,365,11630
4/29/22,Gambia,13.4432,-15.3101,11995,0,365,11630
4/30/22,Gambia,13.4432,-15.3101,11995,0,365,11630
5/1/22,Gambia,13.4432,-15.3101,11995,0,365,11630
5/2/22,Gambia,13.4432,-15.3101,11995,0,365,11630
5/3/22,Gambia,13.4432,-15.3101,11995,0,365,11630
5/4/22,Gambia,13.4432,-15.3101,11995,0,365,11630
5/5/22,Gambia,13.4432,-15.3101,11995,0,365,11630
5/6/22,Gambia,13.4432,-15.3101,11995,0,365,11630
5/7/22,Gambia,13.4432,-15.3101,11995,0,365,11630
5/8/22,Gambia,13.4432,-15.3101,11995,0,365,11630
5/9/22,Gambia,13.4432,-15.3101,11996,0,365,11631
5/10/22,Gambia,13.4432,-15.3101,11996,0,365,11631
5/11/22,Gambia,13.4432,-15.3101,11996,0,365,11631
5/12/22,Gambia,13.4432,-15.3101,11996,0,365,11631
5/13/22,Gambia,13.4432,-15.3101,11999,0,365,11634
5/14/22,Gambia,13.4432,-15.3101,11999,0,365,11634
5/15/22,Gambia,13.4432,-15.3101,11999,0,365,11634
5/16/22,Gambia,13.4432,-15.3101,11999,0,365,11634
5/17/22,Gambia,13.4432,-15.3101,11999,0,365,11634
5/18/22,Gambia,13.4432,-15.3101,11999,0,365,11634
5/19/22,Gambia,13.4432,-15.3101,11999,0,365,11634
5/20/22,Gambia,13.4432,-15.3101,11999,0,365,11634
5/21/22,Gambia,13.4432,-15.3101,11999,0,365,11634
5/22/22,Gambia,13.4432,-15.3101,11999,0,365,11634
5/23/22,Gambia,13.4432,-15.3101,11999,0,365,11634
5/24/22,Gambia,13.4432,-15.3101,12002,0,365,11637
5/25/22,Gambia,13.4432,-15.3101,12002,0,365,11637
5/26/22,Gambia,13.4432,-15.3101,12002,0,365,11637
5/27/22,Gambia,13.4432,-15.3101,12002,0,365,11637
5/28/22,Gambia,13.4432,-15.3101,12002,0,365,11637
5/29/22,Gambia,13.4432,-15.3101,12002,0,365,11637
5/30/22,Gambia,13.4432,-15.3101,12002,0,365,11637
5/31/22,Gambia,13.4432,-15.3101,12002,0,365,11637
6/1/22,Gambia,13.4432,-15.3101,12002,0,365,11637
6/2/22,Gambia,13.4432,-15.3101,12002,0,365,11637
6/3/22,Gambia,13.4432,-15.3101,12002,0,365,11637
6/4/22,Gambia,13.4432,-15.3101,12002,0,365,11637
6/5/22,Gambia,13.4432,-15.3101,12002,0,365,11637
6/6/22,Gambia,13.4432,-15.3101,12002,0,365,11637
6/7/22,Gambia,13.4432,-15.3101,12002,0,365,11637
6/8/22,Gambia,13.4432,-15.3101,12002,0,365,11637
6/9/22,Gambia,13.4432,-15.3101,12002,0,365,11637
6/10/22,Gambia,13.4432,-15.3101,12002,0,365,11637
6/11/22,Gambia,13.4432,-15.3101,12002,0,365,11637
6/12/22,Gambia,13.4432,-15.3101,12002,0,365,11637
6/13/22,Gambia,13.4432,-15.3101,12002,0,365,11637
6/14/22,Gambia,13.4432,-15.3101,12002,0,365,11637
6/15/22,Gambia,13.4432,-15.3101,12002,0,365,11637
6/16/22,Gambia,13.4432,-15.3101,12002,0,365,11637
6/17/22,Gambia,13.4432,-15.3101,12002,0,365,11637
6/18/22,Gambia,13.4432,-15.3101,12002,0,365,11637
6/19/22,Gambia,13.4432,-15.3101,12002,0,365,11637
6/20/22,Gambia,13.4432,-15.3101,12002,0,365,11637
6/21/22,Gambia,13.4432,-15.3101,12002,0,365,11637
6/22/22,Gambia,13.4432,-15.3101,12002,0,365,11637
6/23/22,Gambia,13.4432,-15.3101,12002,0,365,11637
6/24/22,Gambia,13.4432,-15.3101,12002,0,365,11637
6/25/22,Gambia,13.4432,-15.3101,12002,0,365,11637
6/26/22,Gambia,13.4432,-15.3101,12002,0,365,11637
6/27/22,Gambia,13.4432,-15.3101,12002,0,365,11637
6/28/22,Gambia,13.4432,-15.3101,12002,0,365,11637
6/29/22,Gambia,13.4432,-15.3101,12002,0,365,11637
6/30/22,Gambia,13.4432,-15.3101,12002,0,365,11637
7/1/22,Gambia,13.4432,-15.3101,12002,0,365,11637
7/2/22,Gambia,13.4432,-15.3101,12002,0,365,11637
7/3/22,Gambia,13.4432,-15.3101,12002,0,365,11637
7/4/22,Gambia,13.4432,-15.3101,12002,0,365,11637
7/5/22,Gambia,13.4432,-15.3101,12002,0,365,11637
7/6/22,Gambia,13.4432,-15.3101,12009,0,365,11644
7/7/22,Gambia,13.4432,-15.3101,12009,0,365,11644
7/8/22,Gambia,13.4432,-15.3101,12009,0,365,11644
7/9/22,Gambia,13.4432,-15.3101,12009,0,365,11644
7/10/22,Gambia,13.4432,-15.3101,12009,0,365,11644
7/11/22,Gambia,13.4432,-15.3101,12009,0,365,11644
7/12/22,Gambia,13.4432,-15.3101,12009,0,365,11644
7/13/22,Gambia,13.4432,-15.3101,12009,0,365,11644
7/14/22,Gambia,13.4432,-15.3101,12009,0,365,11644
7/15/22,Gambia,13.4432,-15.3101,12009,0,365,11644
7/16/22,Gambia,13.4432,-15.3101,12009,0,365,11644
7/17/22,Gambia,13.4432,-15.3101,12009,0,365,11644
7/18/22,Gambia,13.4432,-15.3101,12009,0,365,11644
7/19/22,Gambia,13.4432,-15.3101,12028,0,368,11660
7/20/22,Gambia,13.4432,-15.3101,12028,0,368,11660
7/21/22,Gambia,13.4432,-15.3101,12028,0,368,11660
7/22/22,Gambia,13.4432,-15.3101,12028,0,368,11660
7/23/22,Gambia,13.4432,-15.3101,12028,0,368,11660
7/24/22,Gambia,13.4432,-15.3101,12028,0,368,11660
7/25/22,Gambia,13.4432,-15.3101,12028,0,368,11660
7/26/22,Gambia,13.4432,-15.3101,12078,0,368,11710
7/27/22,Gambia,13.4432,-15.3101,12078,0,368,11710
7/28/22,Gambia,13.4432,-15.3101,12078,0,368,11710
7/29/22,Gambia,13.4432,-15.3101,12078,0,368,11710
7/30/22,Gambia,13.4432,-15.3101,12078,0,368,11710
7/31/22,Gambia,13.4432,-15.3101,12078,0,368,11710
8/1/22,Gambia,13.4432,-15.3101,12078,0,368,11710
8/2/22,Gambia,13.4432,-15.3101,12115,0,368,11747
8/3/22,Gambia,13.4432,-15.3101,12149,0,368,11781
8/4/22,Gambia,13.4432,-15.3101,12149,0,368,11781
8/5/22,Gambia,13.4432,-15.3101,12149,0,368,11781
8/6/22,Gambia,13.4432,-15.3101,12149,0,368,11781
8/7/22,Gambia,13.4432,-15.3101,12149,0,368,11781
8/8/22,Gambia,13.4432,-15.3101,12197,0,368,11829
8/9/22,Gambia,13.4432,-15.3101,12197,0,368,11829
8/10/22,Gambia,13.4432,-15.3101,12238,0,368,11870
8/11/22,Gambia,13.4432,-15.3101,12238,0,368,11870
8/12/22,Gambia,13.4432,-15.3101,12238,0,368,11870
8/13/22,Gambia,13.4432,-15.3101,12238,0,368,11870
8/14/22,Gambia,13.4432,-15.3101,12238,0,368,11870
8/15/22,Gambia,13.4432,-15.3101,12238,0,368,11870
8/16/22,Gambia,13.4432,-15.3101,12238,0,368,11870
8/17/22,Gambia,13.4432,-15.3101,12238,0,368,11870
8/18/22,Gambia,13.4432,-15.3101,12238,0,368,11870
8/19/22,Gambia,13.4432,-15.3101,12238,0,368,11870
8/20/22,Gambia,13.4432,-15.3101,12238,0,368,11870
8/21/22,Gambia,13.4432,-15.3101,12238,0,368,11870
8/22/22,Gambia,13.4432,-15.3101,12311,0,371,11940
8/23/22,Gambia,13.4432,-15.3101,12311,0,371,11940
8/24/22,Gambia,13.4432,-15.3101,12311,0,371,11940
8/25/22,Gambia,13.4432,-15.3101,12311,0,371,11940
8/26/22,Gambia,13.4432,-15.3101,12311,0,371,11940
8/27/22,Gambia,13.4432,-15.3101,12311,0,371,11940
8/28/22,Gambia,13.4432,-15.3101,12311,0,371,11940
8/29/22,Gambia,13.4432,-15.3101,12311,0,371,11940
8/30/22,Gambia,13.4432,-15.3101,12311,0,371,11940
8/31/22,Gambia,13.4432,-15.3101,12311,0,371,11940
9/1/22,Gambia,13.4432,-15.3101,12311,0,371,11940
9/2/22,Gambia,13.4432,-15.3101,12311,0,371,11940
9/3/22,Gambia,13.4432,-15.3101,12311,0,371,11940
9/4/22,Gambia,13.4432,-15.3101,12311,0,371,11940
9/5/22,Gambia,13.4432,-15.3101,12311,0,371,11940
9/6/22,Gambia,13.4432,-15.3101,12311,0,371,11940
9/7/22,Gambia,13.4432,-15.3101,12311,0,371,11940
9/8/22,Gambia,13.4432,-15.3101,12311,0,371,11940
9/9/22,Gambia,13.4432,-15.3101,12311,0,371,11940
9/10/22,Gambia,13.4432,-15.3101,12311,0,371,11940
9/11/22,Gambia,13.4432,-15.3101,12311,0,371,11940
9/12/22,Gambia,13.4432,-15.3101,12311,0,371,11940
9/13/22,Gambia,13.4432,-15.3101,12508,0,372,12136
9/14/22,Gambia,13.4432,-15.3101,12508,0,372,12136
9/15/22,Gambia,13.4432,-15.3101,12508,0,372,12136
9/16/22,Gambia,13.4432,-15.3101,12508,0,372,12136
9/17/22,Gambia,13.4432,-15.3101,12508,0,372,12136
9/18/22,Gambia,13.4432,-15.3101,12508,0,372,12136
9/19/22,Gambia,13.4432,-15.3101,12508,0,372,12136
9/20/22,Gambia,13.4432,-15.3101,12508,0,372,12136
9/21/22,Gambia,13.4432,-15.3101,12508,0,372,12136
9/22/22,Gambia,13.4432,-15.3101,12508,0,372,12136
9/23/22,Gambia,13.4432,-15.3101,12508,0,372,12136
9/24/22,Gambia,13.4432,-15.3101,12508,0,372,12136
9/25/22,Gambia,13.4432,-15.3101,12508,0,372,12136
9/26/22,Gambia,13.4432,-15.3101,12508,0,372,12136
9/27/22,Gambia,13.4432,-15.3101,12508,0,372,12136
9/28/22,Gambia,13.4432,-15.3101,12508,0,372,12136
9/29/22,Gambia,13.4432,-15.3101,12508,0,372,12136
9/30/22,Gambia,13.4432,-15.3101,12508,0,372,12136
10/1/22,Gambia,13.4432,-15.3101,12508,0,372,12136
10/2/22,Gambia,13.4432,-15.3101,12508,0,372,12136
10/3/22,Gambia,13.4432,-15.3101,12508,0,372,12136
10/4/22,Gambia,13.4432,-15.3101,12508,0,372,12136
10/5/22,Gambia,13.4432,-15.3101,12508,0,372,12136
10/6/22,Gambia,13.4432,-15.3101,12508,0,372,12136
10/7/22,Gambia,13.4432,-15.3101,12508,0,372,12136
10/8/22,Gambia,13.4432,-15.3101,12508,0,372,12136
10/9/22,Gambia,13.4432,-15.3101,12508,0,372,12136
10/10/22,Gambia,13.4432,-15.3101,12508,0,372,12136
10/11/22,Gambia,13.4432,-15.3101,12508,0,372,12136
10/12/22,Gambia,13.4432,-15.3101,12508,0,372,12136
10/13/22,Gambia,13.4432,-15.3101,12508,0,372,12136
10/14/22,Gambia,13.4432,-15.3101,12508,0,372,12136
10/15/22,Gambia,13.4432,-15.3101,12508,0,372,12136
10/16/22,Gambia,13.4432,-15.3101,12508,0,372,12136
10/17/22,Gambia,13.4432,-15.3101,12508,0,372,12136
10/18/22,Gambia,13.4432,-15.3101,12508,0,372,12136
10/19/22,Gambia,13.4432,-15.3101,12508,0,372,12136
10/20/22,Gambia,13.4432,-15.3101,12508,0,372,12136
10/21/22,Gambia,13.4432,-15.3101,12508,0,372,12136
10/22/22,Gambia,13.4432,-15.3101,12508,0,372,12136
10/23/22,Gambia,13.4432,-15.3101,12508,0,372,12136
10/24/22,Gambia,13.4432,-15.3101,12508,0,372,12136
10/25/22,Gambia,13.4432,-15.3101,12508,0,372,12136
10/26/22,Gambia,13.4432,-15.3101,12508,0,372,12136
10/27/22,Gambia,13.4432,-15.3101,12508,0,372,12136
10/28/22,Gambia,13.4432,-15.3101,12508,0,372,12136
10/29/22,Gambia,13.4432,-15.3101,12508,0,372,12136
10/30/22,Gambia,13.4432,-15.3101,12508,0,372,12136
10/31/22,Gambia,13.4432,-15.3101,12580,0,372,12208
11/1/22,Gambia,13.4432,-15.3101,12580,0,372,12208
11/2/22,Gambia,13.4432,-15.3101,12580,0,372,12208
11/3/22,Gambia,13.4432,-15.3101,12580,0,372,12208
11/4/22,Gambia,13.4432,-15.3101,12580,0,372,12208
11/5/22,Gambia,13.4432,-15.3101,12580,0,372,12208
11/6/22,Gambia,13.4432,-15.3101,12580,0,372,12208
11/7/22,Gambia,13.4432,-15.3101,12580,0,372,12208
11/8/22,Gambia,13.4432,-15.3101,12580,0,372,12208
11/9/22,Gambia,13.4432,-15.3101,12580,0,372,12208
11/10/22,Gambia,13.4432,-15.3101,12580,0,372,12208
11/11/22,Gambia,13.4432,-15.3101,12580,0,372,12208
11/12/22,Gambia,13.4432,-15.3101,12580,0,372,12208
11/13/22,Gambia,13.4432,-15.3101,12580,0,372,12208
11/14/22,Gambia,13.4432,-15.3101,12580,0,372,12208
11/15/22,Gambia,13.4432,-15.3101,12580,0,372,12208
11/16/22,Gambia,13.4432,-15.3101,12580,0,372,12208
11/17/22,Gambia,13.4432,-15.3101,12580,0,372,12208
11/18/22,Gambia,13.4432,-15.3101,12580,0,372,12208
11/19/22,Gambia,13.4432,-15.3101,12580,0,372,12208
11/20/22,Gambia,13.4432,-15.3101,12580,0,372,12208
11/21/22,Gambia,13.4432,-15.3101,12580,0,372,12208
11/22/22,Gambia,13.4432,-15.3101,12586,0,372,12214
11/23/22,Gambia,13.4432,-15.3101,12586,0,372,12214
11/24/22,Gambia,13.4432,-15.3101,12586,0,372,12214
11/25/22,Gambia,13.4432,-15.3101,12586,0,372,12214
11/26/22,Gambia,13.4432,-15.3101,12586,0,372,12214
11/27/22,Gambia,13.4432,-15.3101,12586,0,372,12214
11/28/22,Gambia,13.4432,-15.3101,12586,0,372,12214
11/29/22,Gambia,13.4432,-15.3101,12586,0,372,12214
11/30/22,Gambia,13.4432,-15.3101,12586,0,372,12214
12/1/22,Gambia,13.4432,-15.3101,12586,0,372,12214
12/2/22,Gambia,13.4432,-15.3101,12586,0,372,12214
12/3/22,Gambia,13.4432,-15.3101,12586,0,372,12214
12/4/22,Gambia,13.4432,-15.3101,12586,0,372,12214
12/5/22,Gambia,13.4432,-15.3101,12586,0,372,12214
12/6/22,Gambia,13.4432,-15.3101,12586,0,372,12214
12/7/22,Gambia,13.4432,-15.3101,12586,0,372,12214
12/8/22,Gambia,13.4432,-15.3101,12586,0,372,12214
12/9/22,Gambia,13.4432,-15.3101,12586,0,372,12214
12/10/22,Gambia,13.4432,-15.3101,12586,0,372,12214
12/11/22,Gambia,13.4432,-15.3101,12586,0,372,12214
12/12/22,Gambia,13.4432,-15.3101,12586,0,372,12214
12/13/22,Gambia,13.4432,-15.3101,12586,0,372,12214
12/14/22,Gambia,13.4432,-15.3101,12586,0,372,12214
12/15/22,Gambia,13.4432,-15.3101,12586,0,372,12214
12/16/22,Gambia,13.4432,-15.3101,12586,0,372,12214
12/17/22,Gambia,13.4432,-15.3101,12586,0,372,12214
1/1/22,Georgia,42.3154,43.3569,936844,0,13850,922994
1/2/22,Georgia,42.3154,43.3569,937640,0,13885,923755
1/3/22,Georgia,42.3154,43.3569,938583,0,13922,924661
1/4/22,Georgia,42.3154,43.3569,942173,0,13979,928194
1/5/22,Georgia,42.3154,43.3569,945609,0,14011,931598
1/6/22,Georgia,42.3154,43.3569,949176,0,14042,935134
1/7/22,Georgia,42.3154,43.3569,953410,0,14078,939332
1/8/22,Georgia,42.3154,43.3569,956032,0,14106,941926
1/9/22,Georgia,42.3154,43.3569,959874,0,14137,945737
1/10/22,Georgia,42.3154,43.3569,962827,0,14168,948659
1/11/22,Georgia,42.3154,43.3569,968313,0,14214,954099
1/12/22,Georgia,42.3154,43.3569,973909,0,14261,959648
1/13/22,Georgia,42.3154,43.3569,979235,0,14309,964926
1/14/22,Georgia,42.3154,43.3569,984802,0,14345,970457
1/15/22,Georgia,42.3154,43.3569,990183,0,14375,975808
1/16/22,Georgia,42.3154,43.3569,995687,0,14399,981288
1/17/22,Georgia,42.3154,43.3569,999343,0,14431,984912
1/18/22,Georgia,42.3154,43.3569,1006864,0,14462,992402
1/19/22,Georgia,42.3154,43.3569,1015592,0,14505,1001087
1/20/22,Georgia,42.3154,43.3569,1021943,0,14532,1007411
1/21/22,Georgia,42.3154,43.3569,1030710,0,14581,1016129
1/22/22,Georgia,42.3154,43.3569,1041749,0,14623,1027126
1/23/22,Georgia,42.3154,43.3569,1051445,0,14651,1036794
1/24/22,Georgia,42.3154,43.3569,1059392,0,14682,1044710
1/25/22,Georgia,42.3154,43.3569,1075154,0,14724,1060430
1/26/22,Georgia,42.3154,43.3569,1092684,0,14763,1077921
1/27/22,Georgia,42.3154,43.3569,1110168,0,14790,1095378
1/28/22,Georgia,42.3154,43.3569,1127234,0,14820,1112414
1/29/22,Georgia,42.3154,43.3569,1145508,0,14861,1130647
1/30/22,Georgia,42.3154,43.3569,1162773,0,14895,1147878
1/31/22,Georgia,42.3154,43.3569,1175923,0,14930,1160993
2/1/22,Georgia,42.3154,43.3569,1200124,0,14966,1185158
2/2/22,Georgia,42.3154,43.3569,1226444,0,15010,1211434
2/3/22,Georgia,42.3154,43.3569,1250108,0,15052,1235056
2/4/22,Georgia,42.3154,43.3569,1272371,0,15091,1257280
2/5/22,Georgia,42.3154,43.3569,1295505,0,15124,1280381
2/6/22,Georgia,42.3154,43.3569,1314603,0,15162,1299441
2/7/22,Georgia,42.3154,43.3569,1325838,0,15196,1310642
2/8/22,Georgia,42.3154,43.3569,1350454,0,15250,1335204
2/9/22,Georgia,42.3154,43.3569,1375615,0,15301,1360314
2/10/22,Georgia,42.3154,43.3569,1398059,0,15354,1382705
2/11/22,Georgia,42.3154,43.3569,1418027,0,15409,1402618
2/12/22,Georgia,42.3154,43.3569,1438353,0,15466,1422887
2/13/22,Georgia,42.3154,43.3569,1454065,0,15506,1438559
2/14/22,Georgia,42.3154,43.3569,1458093,0,15527,1442566
2/15/22,Georgia,42.3154,43.3569,1480841,0,15578,1465263
2/16/22,Georgia,42.3154,43.3569,1496156,0,15633,1480523
2/17/22,Georgia,42.3154,43.3569,1511800,0,15679,1496121
2/18/22,Georgia,42.3154,43.3569,1526205,0,15721,1510484
2/19/22,Georgia,42.3154,43.3569,1539493,0,15772,1523721
2/20/22,Georgia,42.3154,43.3569,1548893,0,15806,1533087
2/21/22,Georgia,42.3154,43.3569,1553668,0,15838,1537830
2/22/22,Georgia,42.3154,43.3569,1565769,0,15883,1549886
2/23/22,Georgia,42.3154,43.3569,1575999,0,15931,1560068
2/24/22,Georgia,42.3154,43.3569,1584454,0,15972,1568482
2/25/22,Georgia,42.3154,43.3569,1591936,0,16004,1575932
2/26/22,Georgia,42.3154,43.3569,1598172,0,16047,1582125
2/27/22,Georgia,42.3154,43.3569,1603007,0,16088,1586919
2/28/22,Georgia,42.3154,43.3569,1605472,0,16113,1589359
3/1/22,Georgia,42.3154,43.3569,1612319,0,16149,1596170
3/2/22,Georgia,42.3154,43.3569,1616159,0,16181,1599978
3/3/22,Georgia,42.3154,43.3569,1619274,0,16224,1603050
3/4/22,Georgia,42.3154,43.3569,1620639,0,16256,1604383
3/5/22,Georgia,42.3154,43.3569,1623672,0,16288,1607384
3/6/22,Georgia,42.3154,43.3569,1625372,0,16316,1609056
3/7/22,Georgia,42.3154,43.3569,1626282,0,16348,1609934
3/8/22,Georgia,42.3154,43.3569,1629065,0,16380,1612685
3/9/22,Georgia,42.3154,43.3569,1629930,0,16406,1613524
3/10/22,Georgia,42.3154,43.3569,1631900,0,16435,1615465
3/11/22,Georgia,42.3154,43.3569,1633443,0,16455,1616988
3/12/22,Georgia,42.3154,43.3569,1634686,0,16480,1618206
3/13/22,Georgia,42.3154,43.3569,1635509,0,16504,1619005
3/14/22,Georgia,42.3154,43.3569,1635975,0,16519,1619456
3/15/22,Georgia,42.3154,43.3569,1637691,0,16535,1621156
3/16/22,Georgia,42.3154,43.3569,1638790,0,16545,1622245
3/17/22,Georgia,42.3154,43.3569,1639678,0,16562,1623116
3/18/22,Georgia,42.3154,43.3569,1640550,0,16580,1623970
3/19/22,Georgia,42.3154,43.3569,1641399,0,16593,1624806
3/20/22,Georgia,42.3154,43.3569,1641874,0,16613,1625261
3/21/22,Georgia,42.3154,43.3569,1642242,0,16621,1625621
3/22/22,Georgia,42.3154,43.3569,1643295,0,16628,1626667
3/23/22,Georgia,42.3154,43.3569,1644112,0,16631,1627481
3/24/22,Georgia,42.3154,43.3569,1644711,0,16638,1628073
3/25/22,Georgia,42.3154,43.3569,1645301,0,16648,1628653
3/26/22,Georgia,42.3154,43.3569,1645959,0,16654,1629305
3/27/22,Georgia,42.3154,43.3569,1646316,0,16658,1629658
3/28/22,Georgia,42.3154,43.3569,1646545,0,16670,1629875
3/29/22,Georgia,42.3154,43.3569,1647243,0,16680,1630563
3/30/22,Georgia,42.3154,43.3569,1647796,0,16689,1631107
3/31/22,Georgia,42.3154,43.3569,1648264,0,16695,1631569
4/1/22,Georgia,42.3154,43.3569,1648653,0,16698,1631955
4/2/22,Georgia,42.3154,43.3569,1649005,0,16701,1632304
4/3/22,Georgia,42.3154,43.3569,1649222,0,16706,1632516
4/4/22,Georgia,42.3154,43.3569,1649430,0,16708,1632722
4/5/22,Georgia,42.3154,43.3569,1650008,0,16711,1633297
4/6/22,Georgia,42.3154,43.3569,1650384,0,16715,1633669
4/7/22,Georgia,42.3154,43.3569,1650708,0,16715,1633993
4/8/22,Georgia,42.3154,43.3569,1650981,0,16716,1634265
4/9/22,Georgia,42.3154,43.3569,1651322,0,16720,1634602
4/10/22,Georgia,42.3154,43.3569,1651470,0,16721,1634749
4/11/22,Georgia,42.3154,43.3569,1651577,0,16727,1634850
4/12/22,Georgia,42.3154,43.3569,1651969,0,16729,1635240
4/13/22,Georgia,42.3154,43.3569,1652235,0,16731,1635504
4/14/22,Georgia,42.3154,43.3569,1652472,0,16733,1635739
4/15/22,Georgia,42.3154,43.3569,1652707,0,16738,1635969
4/16/22,Georgia,42.3154,43.3569,1652929,0,16739,1636190
4/17/22,Georgia,42.3154,43.3569,1653044,0,16742,1636302
4/18/22,Georgia,42.3154,43.3569,1653118,0,16743,1636375
4/19/22,Georgia,42.3154,43.3569,1653460,0,16744,1636716
4/20/22,Georgia,42.3154,43.3569,1653692,0,16744,1636948
4/21/22,Georgia,42.3154,43.3569,1653915,0,16744,1637171
4/22/22,Georgia,42.3154,43.3569,1654076,0,16745,1637331
4/23/22,Georgia,42.3154,43.3569,1654163,0,16747,1637416
4/24/22,Georgia,42.3154,43.3569,1654255,0,16750,1637505
4/25/22,Georgia,42.3154,43.3569,1654313,0,16750,1637563
4/26/22,Georgia,42.3154,43.3569,1654375,0,16750,1637625
4/27/22,Georgia,42.3154,43.3569,1654665,0,16752,1637913
4/28/22,Georgia,42.3154,43.3569,1654797,0,16755,1638042
4/29/22,Georgia,42.3154,43.3569,1654945,0,16757,1638188
4/30/22,Georgia,42.3154,43.3569,1655098,0,16757,1638341
5/1/22,Georgia,42.3154,43.3569,1655170,0,16760,1638410
5/2/22,Georgia,42.3154,43.3569,1655221,0,16761,1638460
5/3/22,Georgia,42.3154,43.3569,1655221,0,16761,1638460
5/4/22,Georgia,42.3154,43.3569,1655221,0,16761,1638460
5/5/22,Georgia,42.3154,43.3569,1655221,0,16761,1638460
5/6/22,Georgia,42.3154,43.3569,1655221,0,16761,1638460
5/7/22,Georgia,42.3154,43.3569,1655221,0,16761,1638460
5/8/22,Georgia,42.3154,43.3569,1655221,0,16761,1638460
5/9/22,Georgia,42.3154,43.3569,1655221,0,16761,1638460
5/10/22,Georgia,42.3154,43.3569,1655221,0,16761,1638460
5/11/22,Georgia,42.3154,43.3569,1655966,0,16769,1639197
5/12/22,Georgia,42.3154,43.3569,1655966,0,16769,1639197
5/13/22,Georgia,42.3154,43.3569,1655966,0,16769,1639197
5/14/22,Georgia,42.3154,43.3569,1655966,0,16769,1639197
5/15/22,Georgia,42.3154,43.3569,1655966,0,16769,1639197
5/16/22,Georgia,42.3154,43.3569,1655966,0,16769,1639197
5/17/22,Georgia,42.3154,43.3569,1655966,0,16769,1639197
5/18/22,Georgia,42.3154,43.3569,1656568,0,16772,1639796
5/19/22,Georgia,42.3154,43.3569,1656568,0,16772,1639796
5/20/22,Georgia,42.3154,43.3569,1656568,0,16772,1639796
5/21/22,Georgia,42.3154,43.3569,1656568,0,16772,1639796
5/22/22,Georgia,42.3154,43.3569,1656568,0,16772,1639796
5/23/22,Georgia,42.3154,43.3569,1656568,0,16772,1639796
5/24/22,Georgia,42.3154,43.3569,1656568,0,16772,1639796
5/25/22,Georgia,42.3154,43.3569,1657154,0,16777,1640377
5/26/22,Georgia,42.3154,43.3569,1657154,0,16777,1640377
5/27/22,Georgia,42.3154,43.3569,1657154,0,16777,1640377
5/28/22,Georgia,42.3154,43.3569,1657154,0,16777,1640377
5/29/22,Georgia,42.3154,43.3569,1657154,0,16777,1640377
5/30/22,Georgia,42.3154,43.3569,1657154,0,16777,1640377
5/31/22,Georgia,42.3154,43.3569,1657154,0,16777,1640377
6/1/22,Georgia,42.3154,43.3569,1657729,0,16778,1640951
6/2/22,Georgia,42.3154,43.3569,1657729,0,16778,1640951
6/3/22,Georgia,42.3154,43.3569,1657729,0,16778,1640951
6/4/22,Georgia,42.3154,43.3569,1657729,0,16778,1640951
6/5/22,Georgia,42.3154,43.3569,1657729,0,16778,1640951
6/6/22,Georgia,42.3154,43.3569,1657729,0,16778,1640951
6/7/22,Georgia,42.3154,43.3569,1658240,0,16785,1641455
6/8/22,Georgia,42.3154,43.3569,1658240,0,16785,1641455
6/9/22,Georgia,42.3154,43.3569,1658240,0,16785,1641455
6/10/22,Georgia,42.3154,43.3569,1658240,0,16785,1641455
6/11/22,Georgia,42.3154,43.3569,1658240,0,16785,1641455
6/12/22,Georgia,42.3154,43.3569,1658240,0,16788,1641452
6/13/22,Georgia,42.3154,43.3569,1658240,0,16788,1641452
6/14/22,Georgia,42.3154,43.3569,1658240,0,16788,1641452
6/15/22,Georgia,42.3154,43.3569,1658755,0,16788,1641967
6/16/22,Georgia,42.3154,43.3569,1658755,0,16788,1641967
6/17/22,Georgia,42.3154,43.3569,1658755,0,16788,1641967
6/18/22,Georgia,42.3154,43.3569,1658755,0,16788,1641967
6/19/22,Georgia,42.3154,43.3569,1658755,0,16788,1641967
6/20/22,Georgia,42.3154,43.3569,1658755,0,16788,1641967
6/21/22,Georgia,42.3154,43.3569,1658755,0,16788,1641967
6/22/22,Georgia,42.3154,43.3569,1659371,0,16789,1642582
6/23/22,Georgia,42.3154,43.3569,1659371,0,16789,1642582
6/24/22,Georgia,42.3154,43.3569,1659371,0,16789,1642582
6/25/22,Georgia,42.3154,43.3569,1659371,0,16789,1642582
6/26/22,Georgia,42.3154,43.3569,1659371,0,16791,1642580
6/27/22,Georgia,42.3154,43.3569,1659371,0,16791,1642580
6/28/22,Georgia,42.3154,43.3569,1659371,0,16791,1642580
6/29/22,Georgia,42.3154,43.3569,1660429,0,16791,1643638
6/30/22,Georgia,42.3154,43.3569,1660429,0,16791,1643638
7/1/22,Georgia,42.3154,43.3569,1660429,0,16791,1643638
7/2/22,Georgia,42.3154,43.3569,1660429,0,16791,1643638
7/3/22,Georgia,42.3154,43.3569,1660429,0,16791,1643638
7/4/22,Georgia,42.3154,43.3569,1660429,0,16791,1643638
7/5/22,Georgia,42.3154,43.3569,1662299,0,16794,1645505
7/6/22,Georgia,42.3154,43.3569,1662299,0,16794,1645505
7/7/22,Georgia,42.3154,43.3569,1662299,0,16794,1645505
7/8/22,Georgia,42.3154,43.3569,1662299,0,16794,1645505
7/9/22,Georgia,42.3154,43.3569,1662299,0,16794,1645505
7/10/22,Georgia,42.3154,43.3569,1662299,0,16794,1645505
7/11/22,Georgia,42.3154,43.3569,1662299,0,16794,1645505
7/12/22,Georgia,42.3154,43.3569,1662299,0,16794,1645505
7/13/22,Georgia,42.3154,43.3569,1662299,0,16797,1645502
7/14/22,Georgia,42.3154,43.3569,1667453,0,16797,1650656
7/15/22,Georgia,42.3154,43.3569,1667453,0,16797,1650656
7/16/22,Georgia,42.3154,43.3569,1667453,0,16797,1650656
7/17/22,Georgia,42.3154,43.3569,1667453,0,16797,1650656
7/18/22,Georgia,42.3154,43.3569,1667453,0,16797,1650656
7/19/22,Georgia,42.3154,43.3569,1667453,0,16797,1650656
7/20/22,Georgia,42.3154,43.3569,1667453,0,16804,1650649
7/21/22,Georgia,42.3154,43.3569,1675265,0,16804,1658461
7/22/22,Georgia,42.3154,43.3569,1675265,0,16804,1658461
7/23/22,Georgia,42.3154,43.3569,1675265,0,16804,1658461
7/24/22,Georgia,42.3154,43.3569,1675265,0,16804,1658461
7/25/22,Georgia,42.3154,43.3569,1675265,0,16804,1658461
7/26/22,Georgia,42.3154,43.3569,1675265,0,16804,1658461
7/27/22,Georgia,42.3154,43.3569,1686218,0,16809,1669409
7/28/22,Georgia,42.3154,43.3569,1686218,0,16809,1669409
7/29/22,Georgia,42.3154,43.3569,1686218,0,16809,1669409
7/30/22,Georgia,42.3154,43.3569,1686218,0,16809,1669409
7/31/22,Georgia,42.3154,43.3569,1686218,0,16809,1669409
8/1/22,Georgia,42.3154,43.3569,1686218,0,16809,1669409
8/2/22,Georgia,42.3154,43.3569,1686218,0,16809,1669409
8/3/22,Georgia,42.3154,43.3569,1698020,0,16819,1681201
8/4/22,Georgia,42.3154,43.3569,1698020,0,16819,1681201
8/5/22,Georgia,42.3154,43.3569,1698020,0,16819,1681201
8/6/22,Georgia,42.3154,43.3569,1698020,0,16819,1681201
8/7/22,Georgia,42.3154,43.3569,1698020,0,16819,1681201
8/8/22,Georgia,42.3154,43.3569,1698020,0,16819,1681201
8/9/22,Georgia,42.3154,43.3569,1698020,0,16819,1681201
8/10/22,Georgia,42.3154,43.3569,1698020,0,16827,1681193
8/11/22,Georgia,42.3154,43.3569,1710749,0,16827,1693922
8/12/22,Georgia,42.3154,43.3569,1710749,0,16827,1693922
8/13/22,Georgia,42.3154,43.3569,1710749,0,16827,1693922
8/14/22,Georgia,42.3154,43.3569,1710749,0,16827,1693922
8/15/22,Georgia,42.3154,43.3569,1710749,0,16827,1693922
8/16/22,Georgia,42.3154,43.3569,1710749,0,16827,1693922
8/17/22,Georgia,42.3154,43.3569,1710749,0,16833,1693916
8/18/22,Georgia,42.3154,43.3569,1723087,0,16833,1706254
8/19/22,Georgia,42.3154,43.3569,1723087,0,16833,1706254
8/20/22,Georgia,42.3154,43.3569,1723087,0,16833,1706254
8/21/22,Georgia,42.3154,43.3569,1723087,0,16833,1706254
8/22/22,Georgia,42.3154,43.3569,1723087,0,16833,1706254
8/23/22,Georgia,42.3154,43.3569,1723087,0,16833,1706254
8/24/22,Georgia,42.3154,43.3569,1723087,0,16833,1706254
8/25/22,Georgia,42.3154,43.3569,1735682,0,16839,1718843
8/26/22,Georgia,42.3154,43.3569,1735682,0,16839,1718843
8/27/22,Georgia,42.3154,43.3569,1735682,0,16839,1718843
8/28/22,Georgia,42.3154,43.3569,1735682,0,16839,1718843
8/29/22,Georgia,42.3154,43.3569,1735682,0,16839,1718843
8/30/22,Georgia,42.3154,43.3569,1735682,0,16839,1718843
8/31/22,Georgia,42.3154,43.3569,1735682,0,16839,1718843
9/1/22,Georgia,42.3154,43.3569,1735682,0,16842,1718840
9/2/22,Georgia,42.3154,43.3569,1735682,0,16842,1718840
9/3/22,Georgia,42.3154,43.3569,1735682,0,16843,1718839
9/4/22,Georgia,42.3154,43.3569,1735682,0,16843,1718839
9/5/22,Georgia,42.3154,43.3569,1735682,0,16844,1718838
9/6/22,Georgia,42.3154,43.3569,1735682,0,16844,1718838
9/7/22,Georgia,42.3154,43.3569,1735682,0,16845,1718837
9/8/22,Georgia,42.3154,43.3569,1735682,0,16847,1718835
9/9/22,Georgia,42.3154,43.3569,1735682,0,16848,1718834
9/10/22,Georgia,42.3154,43.3569,1735682,0,16849,1718833
9/11/22,Georgia,42.3154,43.3569,1735682,0,16849,1718833
9/12/22,Georgia,42.3154,43.3569,1762206,0,16850,1745356
9/13/22,Georgia,42.3154,43.3569,1762206,0,16851,1745355
9/14/22,Georgia,42.3154,43.3569,1762206,0,16851,1745355
9/15/22,Georgia,42.3154,43.3569,1762206,0,16852,1745354
9/16/22,Georgia,42.3154,43.3569,1762206,0,16852,1745354
9/17/22,Georgia,42.3154,43.3569,1762206,0,16854,1745352
9/18/22,Georgia,42.3154,43.3569,1762206,0,16854,1745352
9/19/22,Georgia,42.3154,43.3569,1762206,0,16855,1745351
9/20/22,Georgia,42.3154,43.3569,1762206,0,16855,1745351
9/21/22,Georgia,42.3154,43.3569,1762206,0,16856,1745350
9/22/22,Georgia,42.3154,43.3569,1780691,0,16856,1763835
9/23/22,Georgia,42.3154,43.3569,1780691,0,16857,1763834
9/24/22,Georgia,42.3154,43.3569,1780691,0,16858,1763833
9/25/22,Georgia,42.3154,43.3569,1780691,0,16858,1763833
9/26/22,Georgia,42.3154,43.3569,1780691,0,16858,1763833
9/27/22,Georgia,42.3154,43.3569,1780691,0,16859,1763832
9/28/22,Georgia,42.3154,43.3569,1780691,0,16860,1763831
9/29/22,Georgia,42.3154,43.3569,1780691,0,16860,1763831
9/30/22,Georgia,42.3154,43.3569,1780691,0,16861,1763830
10/1/22,Georgia,42.3154,43.3569,1780691,0,16862,1763829
10/2/22,Georgia,42.3154,43.3569,1780691,0,16862,1763829
10/3/22,Georgia,42.3154,43.3569,1780691,0,16862,1763829
10/4/22,Georgia,42.3154,43.3569,1780691,0,16863,1763828
10/5/22,Georgia,42.3154,43.3569,1780691,0,16863,1763828
10/6/22,Georgia,42.3154,43.3569,1780691,0,16865,1763826
10/7/22,Georgia,42.3154,43.3569,1780691,0,16866,1763825
10/8/22,Georgia,42.3154,43.3569,1780691,0,16867,1763824
10/9/22,Georgia,42.3154,43.3569,1780691,0,16867,1763824
10/10/22,Georgia,42.3154,43.3569,1780691,0,16868,1763823
10/11/22,Georgia,42.3154,43.3569,1780691,0,16868,1763823
10/12/22,Georgia,42.3154,43.3569,1780691,0,16868,1763823
10/13/22,Georgia,42.3154,43.3569,1780691,0,16868,1763823
10/14/22,Georgia,42.3154,43.3569,1780691,0,16870,1763821
10/15/22,Georgia,42.3154,43.3569,1780691,0,16870,1763821
10/16/22,Georgia,42.3154,43.3569,1780691,0,16870,1763821
10/17/22,Georgia,42.3154,43.3569,1780691,0,16870,1763821
10/18/22,Georgia,42.3154,43.3569,1780691,0,16871,1763820
10/19/22,Georgia,42.3154,43.3569,1780691,0,16871,1763820
10/20/22,Georgia,42.3154,43.3569,1780691,0,16871,1763820
10/21/22,Georgia,42.3154,43.3569,1780691,0,16871,1763820
10/22/22,Georgia,42.3154,43.3569,1780691,0,16871,1763820
10/23/22,Georgia,42.3154,43.3569,1780691,0,16871,1763820
10/24/22,Georgia,42.3154,43.3569,1780691,0,16872,1763819
10/25/22,Georgia,42.3154,43.3569,1780691,0,16873,1763818
10/26/22,Georgia,42.3154,43.3569,1780691,0,16873,1763818
10/27/22,Georgia,42.3154,43.3569,1780691,0,16873,1763818
10/28/22,Georgia,42.3154,43.3569,1780691,0,16873,1763818
10/29/22,Georgia,42.3154,43.3569,1780691,0,16873,1763818
10/30/22,Georgia,42.3154,43.3569,1780691,0,16873,1763818
10/31/22,Georgia,42.3154,43.3569,1780691,0,16873,1763818
11/1/22,Georgia,42.3154,43.3569,1780691,0,16875,1763816
11/2/22,Georgia,42.3154,43.3569,1780691,0,16877,1763814
11/3/22,Georgia,42.3154,43.3569,1780691,0,16877,1763814
11/4/22,Georgia,42.3154,43.3569,1785138,0,16878,1768260
11/5/22,Georgia,42.3154,43.3569,1785138,0,16878,1768260
11/6/22,Georgia,42.3154,43.3569,1785138,0,16878,1768260
11/7/22,Georgia,42.3154,43.3569,1785138,0,16878,1768260
11/8/22,Georgia,42.3154,43.3569,1785138,0,16878,1768260
11/9/22,Georgia,42.3154,43.3569,1785138,0,16878,1768260
11/10/22,Georgia,42.3154,43.3569,1785138,0,16878,1768260
11/11/22,Georgia,42.3154,43.3569,1785138,0,16878,1768260
11/12/22,Georgia,42.3154,43.3569,1785138,0,16878,1768260
11/13/22,Georgia,42.3154,43.3569,1785138,0,16878,1768260
11/14/22,Georgia,42.3154,43.3569,1785138,0,16878,1768260
11/15/22,Georgia,42.3154,43.3569,1785138,0,16878,1768260
11/16/22,Georgia,42.3154,43.3569,1785138,0,16878,1768260
11/17/22,Georgia,42.3154,43.3569,1785138,0,16878,1768260
11/18/22,Georgia,42.3154,43.3569,1785138,0,16878,1768260
11/19/22,Georgia,42.3154,43.3569,1785138,0,16881,1768257
11/20/22,Georgia,42.3154,43.3569,1785138,0,16881,1768257
11/21/22,Georgia,42.3154,43.3569,1785138,0,16881,1768257
11/22/22,Georgia,42.3154,43.3569,1785138,0,16882,1768256
11/23/22,Georgia,42.3154,43.3569,1805698,0,16883,1788815
11/24/22,Georgia,42.3154,43.3569,1805698,0,16885,1788813
11/25/22,Georgia,42.3154,43.3569,1805698,0,16886,1788812
11/26/22,Georgia,42.3154,43.3569,1805698,0,16886,1788812
11/27/22,Georgia,42.3154,43.3569,1805698,0,16887,1788811
11/28/22,Georgia,42.3154,43.3569,1805698,0,16888,1788810
11/29/22,Georgia,42.3154,43.3569,1805698,0,16888,1788810
11/30/22,Georgia,42.3154,43.3569,1805698,0,16888,1788810
12/1/22,Georgia,42.3154,43.3569,1806918,0,16888,1790030
12/2/22,Georgia,42.3154,43.3569,1806918,0,16888,1790030
12/3/22,Georgia,42.3154,43.3569,1806918,0,16888,1790030
12/4/22,Georgia,42.3154,43.3569,1806918,0,16888,1790030
12/5/22,Georgia,42.3154,43.3569,1806918,0,16888,1790030
12/6/22,Georgia,42.3154,43.3569,1806918,0,16888,1790030
12/7/22,Georgia,42.3154,43.3569,1806918,0,16888,1790030
12/8/22,Georgia,42.3154,43.3569,1807654,0,16888,1790766
12/9/22,Georgia,42.3154,43.3569,1807654,0,16888,1790766
12/10/22,Georgia,42.3154,43.3569,1807654,0,16888,1790766
12/11/22,Georgia,42.3154,43.3569,1807654,0,16888,1790766
12/12/22,Georgia,42.3154,43.3569,1807654,0,16888,1790766
12/13/22,Georgia,42.3154,43.3569,1807654,0,16888,1790766
12/14/22,Georgia,42.3154,43.3569,1808085,0,16895,1791190
12/15/22,Georgia,42.3154,43.3569,1808085,0,16895,1791190
12/16/22,Georgia,42.3154,43.3569,1808085,0,16895,1791190
12/17/22,Georgia,42.3154,43.3569,1808085,0,16895,1791190
1/1/22,Germany,51.165691,10.451526,7176814,0,112109,7064705
1/2/22,Germany,51.165691,10.451526,7189329,0,112155,7077174
1/3/22,Germany,51.165691,10.451526,7207847,0,112223,7095624
1/4/22,Germany,51.165691,10.451526,7238408,0,112579,7125829
1/5/22,Germany,51.165691,10.451526,7297320,0,112925,7184395
1/6/22,Germany,51.165691,10.451526,7361660,0,113368,7248292
1/7/22,Germany,51.165691,10.451526,7417995,0,113632,7304363
1/8/22,Germany,51.165691,10.451526,7473884,0,113900,7359984
1/9/22,Germany,51.165691,10.451526,7510436,0,113977,7396459
1/10/22,Germany,51.165691,10.451526,7535691,0,114029,7421662
1/11/22,Germany,51.165691,10.451526,7581381,0,114351,7467030
1/12/22,Germany,51.165691,10.451526,7661811,0,114735,7547076
1/13/22,Germany,51.165691,10.451526,7743228,0,115051,7628177
1/14/22,Germany,51.165691,10.451526,7835451,0,115337,7720114
1/15/22,Germany,51.165691,10.451526,7913473,0,115572,7797901
1/16/22,Germany,51.165691,10.451526,7965977,0,115619,7850358
1/17/22,Germany,51.165691,10.451526,8000122,0,115649,7884473
1/18/22,Germany,51.165691,10.451526,8074527,0,115842,7958685
1/19/22,Germany,51.165691,10.451526,8186850,0,116081,8070769
1/20/22,Germany,51.165691,10.451526,8320386,0,116315,8204071
1/21/22,Germany,51.165691,10.451526,8460546,0,116485,8344061
1/22/22,Germany,51.165691,10.451526,8596007,0,116664,8479343
1/23/22,Germany,51.165691,10.451526,8681447,0,116718,8564729
1/24/22,Germany,51.165691,10.451526,8744840,0,116746,8628094
1/25/22,Germany,51.165691,10.451526,8871795,0,116960,8754835
1/26/22,Germany,51.165691,10.451526,9035795,0,117126,8918669
1/27/22,Germany,51.165691,10.451526,9238931,0,117314,9121617
1/28/22,Germany,51.165691,10.451526,9429079,0,117484,9311595
1/29/22,Germany,51.165691,10.451526,9618245,0,117666,9500579
1/30/22,Germany,51.165691,10.451526,9737215,0,117725,9619490
1/31/22,Germany,51.165691,10.451526,9815533,0,117786,9697747
2/1/22,Germany,51.165691,10.451526,9978146,0,117974,9860172
2/2/22,Germany,51.165691,10.451526,10186644,0,118170,10068474
2/3/22,Germany,51.165691,10.451526,10422764,0,118334,10304430
2/4/22,Germany,51.165691,10.451526,10671602,0,118504,10553098
2/5/22,Germany,51.165691,10.451526,10889417,0,118676,10770741
2/6/22,Germany,51.165691,10.451526,11022590,0,118717,10903873
2/7/22,Germany,51.165691,10.451526,11117857,0,118766,10999091
2/8/22,Germany,51.165691,10.451526,11287428,0,118943,11168485
2/9/22,Germany,51.165691,10.451526,11521678,0,119215,11402463
2/10/22,Germany,51.165691,10.451526,11769540,0,119453,11650087
2/11/22,Germany,51.165691,10.451526,12009712,0,119679,11890033
2/12/22,Germany,51.165691,10.451526,12219501,0,119877,12099624
2/13/22,Germany,51.165691,10.451526,12344661,0,119935,12224726
2/14/22,Germany,51.165691,10.451526,12421126,0,119977,12301149
2/15/22,Germany,51.165691,10.451526,12580343,0,120220,12460123
2/16/22,Germany,51.165691,10.451526,12800315,0,120467,12679848
2/17/22,Germany,51.165691,10.451526,13035941,0,120728,12915213
2/18/22,Germany,51.165691,10.451526,13255989,0,120992,13134997
2/19/22,Germany,51.165691,10.451526,13445094,0,121202,13323892
2/20/22,Germany,51.165691,10.451526,13563126,0,121275,13441851
2/21/22,Germany,51.165691,10.451526,13636993,0,121297,13515696
2/22/22,Germany,51.165691,10.451526,13762895,0,121603,13641292
2/23/22,Germany,51.165691,10.451526,13971947,0,121902,13850045
2/24/22,Germany,51.165691,10.451526,14188269,0,122145,14066124
2/25/22,Germany,51.165691,10.451526,14399012,0,122371,14276641
2/26/22,Germany,51.165691,10.451526,14574845,0,122621,14452224
2/27/22,Germany,51.165691,10.451526,14682758,0,122678,14560080
2/28/22,Germany,51.165691,10.451526,14745107,0,122702,14622405
3/1/22,Germany,51.165691,10.451526,14867218,0,122937,14744281
3/2/22,Germany,51.165691,10.451526,15053624,0,123238,14930386
3/3/22,Germany,51.165691,10.451526,15264297,0,123505,15140792
3/4/22,Germany,51.165691,10.451526,15481890,0,123796,15358094
3/5/22,Germany,51.165691,10.451526,15674100,0,124051,15550049
3/6/22,Germany,51.165691,10.451526,15790989,0,124102,15666887
3/7/22,Germany,51.165691,10.451526,15869417,0,124126,15745291
3/8/22,Germany,51.165691,10.451526,16026216,0,124450,15901766
3/9/22,Germany,51.165691,10.451526,16242070,0,124764,16117306
3/10/22,Germany,51.165691,10.451526,16504822,0,125023,16379799
3/11/22,Germany,51.165691,10.451526,16757658,0,125272,16632386
3/12/22,Germany,51.165691,10.451526,16994744,0,125521,16869223
3/13/22,Germany,51.165691,10.451526,17141351,0,125571,17015780
3/14/22,Germany,51.165691,10.451526,17233729,0,125590,17108139
3/15/22,Germany,51.165691,10.451526,17432617,0,125873,17306744
3/16/22,Germany,51.165691,10.451526,17695210,0,126142,17569068
3/17/22,Germany,51.165691,10.451526,17990141,0,126420,17863721
3/18/22,Germany,51.165691,10.451526,18287986,0,126646,18161340
3/19/22,Germany,51.165691,10.451526,18548225,0,126867,18421358
3/20/22,Germany,51.165691,10.451526,18680017,0,126916,18553101
3/21/22,Germany,51.165691,10.451526,18772331,0,126929,18645402
3/22/22,Germany,51.165691,10.451526,18994411,0,127193,18867218
3/23/22,Germany,51.165691,10.451526,19278143,0,127522,19150621
3/24/22,Germany,51.165691,10.451526,19596530,0,127822,19468708
3/25/22,Germany,51.165691,10.451526,19893028,0,128110,19764918
3/26/22,Germany,51.165691,10.451526,20145054,0,128388,20016666
3/27/22,Germany,51.165691,10.451526,20256278,0,128437,20127841
3/28/22,Germany,51.165691,10.451526,20323779,0,128457,20195322
3/29/22,Germany,51.165691,10.451526,20561131,0,128764,20432367
3/30/22,Germany,51.165691,10.451526,20829608,0,129112,20700496
3/31/22,Germany,51.165691,10.451526,21357095,0,129708,21227387
4/1/22,Germany,51.165691,10.451526,21357039,0,129695,21227344
4/2/22,Germany,51.165691,10.451526,21553495,0,129987,21423508
4/3/22,Germany,51.165691,10.451526,21668677,0,130052,21538625
4/4/22,Germany,51.165691,10.451526,21668677,0,130052,21538625
4/5/22,Germany,51.165691,10.451526,21849074,0,130368,21718706
4/6/22,Germany,51.165691,10.451526,22265788,0,131036,22134752
4/7/22,Germany,51.165691,10.451526,22441051,0,131370,22309681
4/8/22,Germany,51.165691,10.451526,22591726,0,131679,22460047
4/9/22,Germany,51.165691,10.451526,22647197,0,131715,22515482
4/10/22,Germany,51.165691,10.451526,22677986,0,131728,22546258
4/11/22,Germany,51.165691,10.451526,22878428,0,132017,22746411
4/12/22,Germany,51.165691,10.451526,23017079,0,132378,22884701
4/13/22,Germany,51.165691,10.451526,23182447,0,132688,23049759
4/14/22,Germany,51.165691,10.451526,23339311,0,132900,23206411
4/15/22,Germany,51.165691,10.451526,23376879,0,132929,23243950
4/16/22,Germany,51.165691,10.451526,23416663,0,132942,23283721
4/17/22,Germany,51.165691,10.451526,23437145,0,132953,23304192
4/18/22,Germany,51.165691,10.451526,23459628,0,132960,23326668
4/19/22,Germany,51.165691,10.451526,23658211,0,133308,23524903
4/20/22,Germany,51.165691,10.451526,23844536,0,133632,23710904
4/21/22,Germany,51.165691,10.451526,24006254,0,133921,23872333
4/22/22,Germany,51.165691,10.451526,24141333,0,134155,24007178
4/23/22,Germany,51.165691,10.451526,24180512,0,134179,24046333
4/24/22,Germany,51.165691,10.451526,24200596,0,134185,24066411
4/25/22,Germany,51.165691,10.451526,24337394,0,134489,24202905
4/26/22,Germany,51.165691,10.451526,24337394,0,134489,24202905
4/27/22,Germany,51.165691,10.451526,24609159,0,135078,24474081
4/28/22,Germany,51.165691,10.451526,24710769,0,135292,24575477
4/29/22,Germany,51.165691,10.451526,24798067,0,135451,24662616
4/30/22,Germany,51.165691,10.451526,24809785,0,135461,24674324
5/1/22,Germany,51.165691,10.451526,24813817,0,135461,24678356
5/2/22,Germany,51.165691,10.451526,24927339,0,135701,24791638
5/3/22,Germany,51.165691,10.451526,25033970,0,135942,24898028
5/4/22,Germany,51.165691,10.451526,25130137,0,136125,24994012
5/5/22,Germany,51.165691,10.451526,25215210,0,136339,25078871
5/6/22,Germany,51.165691,10.451526,25287462,0,136523,25150939
5/7/22,Germany,51.165691,10.451526,25295950,0,136533,25159417
5/8/22,Germany,51.165691,10.451526,25299300,0,136538,25162762
5/9/22,Germany,51.165691,10.451526,25406868,0,136756,25270112
5/10/22,Germany,51.165691,10.451526,25503878,0,136987,25366891
5/11/22,Germany,51.165691,10.451526,25592839,0,137184,25455655
5/12/22,Germany,51.165691,10.451526,25661838,0,137348,25524490
5/13/22,Germany,51.165691,10.451526,25723697,0,137492,25586205
5/14/22,Germany,51.165691,10.451526,25729848,0,137499,25592349
5/15/22,Germany,51.165691,10.451526,25732153,0,137499,25594654
5/16/22,Germany,51.165691,10.451526,25818405,0,137714,25680691
5/17/22,Germany,51.165691,10.451526,25890456,0,137888,25752568
5/18/22,Germany,51.165691,10.451526,25949175,0,138053,25811122
5/19/22,Germany,51.165691,10.451526,25998085,0,138204,25859881
5/20/22,Germany,51.165691,10.451526,26040460,0,138324,25902136
5/21/22,Germany,51.165691,10.451526,26044283,0,138325,25905958
5/22/22,Germany,51.165691,10.451526,26045528,0,138326,25907202
5/23/22,Germany,51.165691,10.451526,26109965,0,138485,25971480
5/24/22,Germany,51.165691,10.451526,26159106,0,138643,26020463
5/25/22,Germany,51.165691,10.451526,26198811,0,138779,26060032
5/26/22,Germany,51.165691,10.451526,26200663,0,138781,26061882
5/27/22,Germany,51.165691,10.451526,26240639,0,138854,26101785
5/28/22,Germany,51.165691,10.451526,26243352,0,138862,26104490
5/29/22,Germany,51.165691,10.451526,26244107,0,138864,26105243
5/30/22,Germany,51.165691,10.451526,26305996,0,139000,26166996
5/31/22,Germany,51.165691,10.451526,26360953,0,139091,26221862
6/1/22,Germany,51.165691,10.451526,26409455,0,139222,26270233
6/2/22,Germany,51.165691,10.451526,26452148,0,139313,26312835
6/3/22,Germany,51.165691,10.451526,26493235,0,139386,26353849
6/4/22,Germany,51.165691,10.451526,26493235,0,139386,26353849
6/5/22,Germany,51.165691,10.451526,26496611,0,139386,26357225
6/6/22,Germany,51.165691,10.451526,26498361,0,139388,26358973
6/7/22,Germany,51.165691,10.451526,26583016,0,139533,26443483
6/8/22,Germany,51.165691,10.451526,26660652,0,139623,26521029
6/9/22,Germany,51.165691,10.451526,26738530,0,139729,26598801
6/10/22,Germany,51.165691,10.451526,26803867,0,139806,26664061
6/11/22,Germany,51.165691,10.451526,26803867,0,139806,26664061
6/12/22,Germany,51.165691,10.451526,26809245,0,139807,26669438
6/13/22,Germany,51.165691,10.451526,26915085,0,139914,26775171
6/14/22,Germany,51.165691,10.451526,27007429,0,140026,26867403
6/15/22,Germany,51.165691,10.451526,27096571,0,140099,26956472
6/16/22,Germany,51.165691,10.451526,27124689,0,140118,26984571
6/17/22,Germany,51.165691,10.451526,27204953,0,140176,27064777
6/18/22,Germany,51.165691,10.451526,27204955,0,140176,27064779
6/19/22,Germany,51.165691,10.451526,27211896,0,140176,27071720
6/20/22,Germany,51.165691,10.451526,27334993,0,140358,27194635
6/21/22,Germany,51.165691,10.451526,27454225,0,140462,27313763
6/22/22,Germany,51.165691,10.451526,27573585,0,140560,27433025
6/23/22,Germany,51.165691,10.451526,27681775,0,140650,27541125
6/24/22,Germany,51.165691,10.451526,27771111,0,140734,27630377
6/25/22,Germany,51.165691,10.451526,27771112,0,140734,27630378
6/26/22,Germany,51.165691,10.451526,27771911,0,140734,27631177
6/27/22,Germany,51.165691,10.451526,27914240,0,140847,27773393
6/28/22,Germany,51.165691,10.451526,28048190,0,141022,27907168
6/29/22,Germany,51.165691,10.451526,28180861,0,141105,28039756
6/30/22,Germany,51.165691,10.451526,28293960,0,141189,28152771
7/1/22,Germany,51.165691,10.451526,28392629,0,141292,28251337
7/2/22,Germany,51.165691,10.451526,28392630,0,141292,28251338
7/3/22,Germany,51.165691,10.451526,28394995,0,141295,28253700
7/4/22,Germany,51.165691,10.451526,28542484,0,141397,28401087
7/5/22,Germany,51.165691,10.451526,28673212,0,141519,28531693
7/6/22,Germany,51.165691,10.451526,28808614,0,141627,28666987
7/7/22,Germany,51.165691,10.451526,28926346,0,141758,28784588
7/8/22,Germany,51.165691,10.451526,29022265,0,141862,28880403
7/9/22,Germany,51.165691,10.451526,29022265,0,141862,28880403
7/10/22,Germany,51.165691,10.451526,29025760,0,141870,28883890
7/11/22,Germany,51.165691,10.451526,29180489,0,142035,29038454
7/12/22,Germany,51.165691,10.451526,29308100,0,142139,29165961
7/13/22,Germany,51.165691,10.451526,29460249,0,142284,29317965
7/14/22,Germany,51.165691,10.451526,29569943,0,142399,29427544
7/15/22,Germany,51.165691,10.451526,29692989,0,142533,29550456
7/16/22,Germany,51.165691,10.451526,29692989,0,142533,29550456
7/17/22,Germany,51.165691,10.451526,29692989,0,142533,29550456
7/18/22,Germany,51.165691,10.451526,29853680,0,142635,29711045
7/19/22,Germany,51.165691,10.451526,29994679,0,142771,29851908
7/20/22,Germany,51.165691,10.451526,30131303,0,142948,29988355
7/21/22,Germany,51.165691,10.451526,30239122,0,143061,30096061
7/22/22,Germany,51.165691,10.451526,30331131,0,143177,30187954
7/23/22,Germany,51.165691,10.451526,30331133,0,143177,30187956
7/24/22,Germany,51.165691,10.451526,30331133,0,143177,30187956
7/25/22,Germany,51.165691,10.451526,30476605,0,143364,30333241
7/26/22,Germany,51.165691,10.451526,30598385,0,143545,30454840
7/27/22,Germany,51.165691,10.451526,30702511,0,143702,30558809
7/28/22,Germany,51.165691,10.451526,30787309,0,143855,30643454
7/29/22,Germany,51.165691,10.451526,30853312,0,143972,30709340
7/30/22,Germany,51.165691,10.451526,30853314,0,143972,30709342
7/31/22,Germany,51.165691,10.451526,30854175,0,143979,30710196
8/1/22,Germany,51.165691,10.451526,30956873,0,144150,30812723
8/2/22,Germany,51.165691,10.451526,31044554,0,144360,30900194
8/3/22,Germany,51.165691,10.451526,31119199,0,144552,30974647
8/4/22,Germany,51.165691,10.451526,31178705,0,144717,31033988
8/5/22,Germany,51.165691,10.451526,31228314,0,144858,31083456
8/6/22,Germany,51.165691,10.451526,31228314,0,144858,31083456
8/7/22,Germany,51.165691,10.451526,31228322,0,144858,31083464
8/8/22,Germany,51.165691,10.451526,31307020,0,145028,31161992
8/9/22,Germany,51.165691,10.451526,31379757,0,145241,31234516
8/10/22,Germany,51.165691,10.451526,31439645,0,145394,31294251
8/11/22,Germany,51.165691,10.451526,31489484,0,145561,31343923
8/12/22,Germany,51.165691,10.451526,31535343,0,145698,31389645
8/13/22,Germany,51.165691,10.451526,31535343,0,145698,31389645
8/14/22,Germany,51.165691,10.451526,31535340,0,145698,31389642
8/15/22,Germany,51.165691,10.451526,31599085,0,145838,31453247
8/16/22,Germany,51.165691,10.451526,31666475,0,146030,31520445
8/17/22,Germany,51.165691,10.451526,31725160,0,146214,31578946
8/18/22,Germany,51.165691,10.451526,31771884,0,146383,31625501
8/19/22,Germany,51.165691,10.451526,31808179,0,146504,31661675
8/20/22,Germany,51.165691,10.451526,31808179,0,146504,31661675
8/21/22,Germany,51.165691,10.451526,31808228,0,146504,31661724
8/22/22,Germany,51.165691,10.451526,31868639,0,146650,31721989
8/23/22,Germany,51.165691,10.451526,31921578,0,146797,31774781
8/24/22,Germany,51.165691,10.451526,31921578,0,146797,31774781
8/25/22,Germany,51.165691,10.451526,32008122,0,147003,31861119
8/26/22,Germany,51.165691,10.451526,32041348,0,147104,31894244
8/27/22,Germany,51.165691,10.451526,32041349,0,147104,31894245
8/28/22,Germany,51.165691,10.451526,32041350,0,147104,31894246
8/29/22,Germany,51.165691,10.451526,32095854,0,147223,31948631
8/30/22,Germany,51.165691,10.451526,32095854,0,147223,31948631
8/31/22,Germany,51.165691,10.451526,32184553,0,147494,32037059
9/1/22,Germany,51.165691,10.451526,32218483,0,147642,32070841
9/2/22,Germany,51.165691,10.451526,32247828,0,147762,32100066
9/3/22,Germany,51.165691,10.451526,32247828,0,147762,32100066
9/4/22,Germany,51.165691,10.451526,32247828,0,147762,32100066
9/5/22,Germany,51.165691,10.451526,32297537,0,147861,32149676
9/6/22,Germany,51.165691,10.451526,32344032,0,147981,32196051
9/7/22,Germany,51.165691,10.451526,32386089,0,148098,32237991
9/8/22,Germany,51.165691,10.451526,32422084,0,148217,32273867
9/9/22,Germany,51.165691,10.451526,32452250,0,148299,32303951
9/10/22,Germany,51.165691,10.451526,32452250,0,148299,32303951
9/11/22,Germany,51.165691,10.451526,32452250,0,148299,32303951
9/12/22,Germany,51.165691,10.451526,32507180,0,148389,32358791
9/13/22,Germany,51.165691,10.451526,32558479,0,148498,32409981
9/14/22,Germany,51.165691,10.451526,32604993,0,148728,32456265
9/15/22,Germany,51.165691,10.451526,32643742,0,148845,32494897
9/16/22,Germany,51.165691,10.451526,32680355,0,148933,32531422
9/17/22,Germany,51.165691,10.451526,32680356,0,148933,32531423
9/18/22,Germany,51.165691,10.451526,32680356,0,148933,32531423
9/19/22,Germany,51.165691,10.451526,32740593,0,149079,32591514
9/20/22,Germany,51.165691,10.451526,32797308,0,149169,32648139
9/21/22,Germany,51.165691,10.451526,32854286,0,149275,32705011
9/22/22,Germany,51.165691,10.451526,32905086,0,149368,32755718
9/23/22,Germany,51.165691,10.451526,32952050,0,149458,32802592
9/24/22,Germany,51.165691,10.451526,32952050,0,149458,32802592
9/25/22,Germany,51.165691,10.451526,32952050,0,149458,32802592
9/26/22,Germany,51.165691,10.451526,33041332,0,149576,32891756
9/27/22,Germany,51.165691,10.451526,33137143,0,149714,32987429
9/28/22,Germany,51.165691,10.451526,33216006,0,149808,33066198
9/29/22,Germany,51.165691,10.451526,33312373,0,149948,33162425
9/30/22,Germany,51.165691,10.451526,33386229,0,150064,33236165
10/1/22,Germany,51.165691,10.451526,33386229,0,150064,33236165
10/2/22,Germany,51.165691,10.451526,33386229,0,150064,33236165
10/3/22,Germany,51.165691,10.451526,33386229,0,150064,33236165
10/4/22,Germany,51.165691,10.451526,33519761,0,150192,33369569
10/5/22,Germany,51.165691,10.451526,33652255,0,150289,33501966
10/6/22,Germany,51.165691,10.451526,33826367,0,150406,33675961
10/7/22,Germany,51.165691,10.451526,33948632,0,150535,33798097
10/8/22,Germany,51.165691,10.451526,33948632,0,150535,33798097
10/9/22,Germany,51.165691,10.451526,33948632,0,150535,33798097
10/10/22,Germany,51.165691,10.451526,34121168,0,150720,33970448
10/11/22,Germany,51.165691,10.451526,34257916,0,150919,34106997
10/12/22,Germany,51.165691,10.451526,34403129,0,151095,34252034
10/13/22,Germany,51.165691,10.451526,34517327,0,151260,34366067
10/14/22,Germany,51.165691,10.451526,34608835,0,151420,34457415
10/15/22,Germany,51.165691,10.451526,34608837,0,151420,34457417
10/16/22,Germany,51.165691,10.451526,34608837,0,151420,34457417
10/17/22,Germany,51.165691,10.451526,34758889,0,151629,34607260
10/18/22,Germany,51.165691,10.451526,34888963,0,151877,34737086
10/19/22,Germany,51.165691,10.451526,35005769,0,152100,34853669
10/20/22,Germany,51.165691,10.451526,35098062,0,152278,34945784
10/21/22,Germany,51.165691,10.451526,35172693,0,152482,35020211
10/22/22,Germany,51.165691,10.451526,35172694,0,152482,35020212
10/23/22,Germany,51.165691,10.451526,35172694,0,152482,35020212
10/24/22,Germany,51.165691,10.451526,35288228,0,152755,35135473
10/25/22,Germany,51.165691,10.451526,35383015,0,152997,35230018
10/26/22,Germany,51.165691,10.451526,35461920,0,153193,35308727
10/27/22,Germany,51.165691,10.451526,35523412,0,153377,35370035
10/28/22,Germany,51.165691,10.451526,35571130,0,153544,35417586
10/29/22,Germany,51.165691,10.451526,35571130,0,153544,35417586
10/30/22,Germany,51.165691,10.451526,35571131,0,153544,35417587
10/31/22,Germany,51.165691,10.451526,35619687,0,153694,35465993
11/1/22,Germany,51.165691,10.451526,35649648,0,153814,35495834
11/2/22,Germany,51.165691,10.451526,35728277,0,154095,35574182
11/3/22,Germany,51.165691,10.451526,35784912,0,154328,35630584
11/4/22,Germany,51.165691,10.451526,35823771,0,154535,35669236
11/5/22,Germany,51.165691,10.451526,35823771,0,154535,35669236
11/6/22,Germany,51.165691,10.451526,35823771,0,154535,35669236
11/7/22,Germany,51.165691,10.451526,35884834,0,154785,35730049
11/8/22,Germany,51.165691,10.451526,35932654,0,155012,35777642
11/9/22,Germany,51.165691,10.451526,35971322,0,155187,35816135
11/10/22,Germany,51.165691,10.451526,36005025,0,155403,35849622
11/11/22,Germany,51.165691,10.451526,36033394,0,155588,35877806
11/12/22,Germany,51.165691,10.451526,36033395,0,155588,35877807
11/13/22,Germany,51.165691,10.451526,36033395,0,155588,35877807
11/14/22,Germany,51.165691,10.451526,36080574,0,155807,35924767
11/15/22,Germany,51.165691,10.451526,36119184,0,156030,35963154
11/16/22,Germany,51.165691,10.451526,36152490,0,156192,35996298
11/17/22,Germany,51.165691,10.451526,36180077,0,156410,36023667
11/18/22,Germany,51.165691,10.451526,36205405,0,156613,36048792
11/19/22,Germany,51.165691,10.451526,36205405,0,156613,36048792
11/20/22,Germany,51.165691,10.451526,36205405,0,156613,36048792
11/21/22,Germany,51.165691,10.451526,36247081,0,156812,36090269
11/22/22,Germany,51.165691,10.451526,36280371,0,156951,36123420
11/23/22,Germany,51.165691,10.451526,36318461,0,157114,36161347
11/24/22,Germany,51.165691,10.451526,36348477,0,157388,36191089
11/25/22,Germany,51.165691,10.451526,36373164,0,157495,36215669
11/26/22,Germany,51.165691,10.451526,36373164,0,157495,36215669
11/27/22,Germany,51.165691,10.451526,36373165,0,157495,36215670
11/28/22,Germany,51.165691,10.451526,36419717,0,157657,36262060
11/29/22,Germany,51.165691,10.451526,36463485,0,157791,36305694
11/30/22,Germany,51.165691,10.451526,36499600,0,157943,36341657
12/1/22,Germany,51.165691,10.451526,36530020,0,158109,36371911
12/2/22,Germany,51.165691,10.451526,36557861,0,158198,36399663
12/3/22,Germany,51.165691,10.451526,36557861,0,158198,36399663
12/4/22,Germany,51.165691,10.451526,36557861,0,158198,36399663
12/5/22,Germany,51.165691,10.451526,36604648,0,158386,36446262
12/6/22,Germany,51.165691,10.451526,36649979,0,158559,36491420
12/7/22,Germany,51.165691,10.451526,36690235,0,158684,36531551
12/8/22,Germany,51.165691,10.451526,36726061,0,158851,36567210
12/9/22,Germany,51.165691,10.451526,36755666,0,158971,36596695
12/10/22,Germany,51.165691,10.451526,36755666,0,158971,36596695
12/11/22,Germany,51.165691,10.451526,36755666,0,158971,36596695
12/12/22,Germany,51.165691,10.451526,36812671,0,159177,36653494
12/13/22,Germany,51.165691,10.451526,36859058,0,159367,36699691
12/14/22,Germany,51.165691,10.451526,36905873,0,159594,36746279
12/15/22,Germany,51.165691,10.451526,36946574,0,159737,36786837
12/16/22,Germany,51.165691,10.451526,36980882,0,159884,36820998
12/17/22,Germany,51.165691,10.451526,36980882,0,159884,36820998
1/1/22,Ghana,7.9465,-1.0232,143997,0,1298,142699
1/2/22,Ghana,7.9465,-1.0232,145052,0,1303,143749
1/3/22,Ghana,7.9465,-1.0232,146119,0,1306,144813
1/4/22,Ghana,7.9465,-1.0232,147203,0,1309,145894
1/5/22,Ghana,7.9465,-1.0232,148079,0,1313,146766
1/6/22,Ghana,7.9465,-1.0232,148079,0,1313,146766
1/7/22,Ghana,7.9465,-1.0232,148079,0,1313,146766
1/8/22,Ghana,7.9465,-1.0232,149367,0,1319,148048
1/9/22,Ghana,7.9465,-1.0232,150874,0,1325,149549
1/10/22,Ghana,7.9465,-1.0232,152243,0,1332,150911
1/11/22,Ghana,7.9465,-1.0232,152243,0,1332,150911
1/12/22,Ghana,7.9465,-1.0232,152729,0,1336,151393
1/13/22,Ghana,7.9465,-1.0232,152729,0,1336,151393
1/14/22,Ghana,7.9465,-1.0232,152729,0,1336,151393
1/15/22,Ghana,7.9465,-1.0232,153514,0,1343,152171
1/16/22,Ghana,7.9465,-1.0232,153514,0,1343,152171
1/17/22,Ghana,7.9465,-1.0232,153514,0,1343,152171
1/18/22,Ghana,7.9465,-1.0232,154190,0,1350,152840
1/19/22,Ghana,7.9465,-1.0232,154190,0,1350,152840
1/20/22,Ghana,7.9465,-1.0232,154891,0,1357,153534
1/21/22,Ghana,7.9465,-1.0232,154891,0,1357,153534
1/22/22,Ghana,7.9465,-1.0232,154891,0,1357,153534
1/23/22,Ghana,7.9465,-1.0232,155496,0,1367,154129
1/24/22,Ghana,7.9465,-1.0232,155665,0,1370,154295
1/25/22,Ghana,7.9465,-1.0232,155665,0,1370,154295
1/26/22,Ghana,7.9465,-1.0232,156272,0,1382,154890
1/27/22,Ghana,7.9465,-1.0232,156392,0,1384,155008
1/28/22,Ghana,7.9465,-1.0232,156515,0,1388,155127
1/29/22,Ghana,7.9465,-1.0232,156690,0,1391,155299
1/30/22,Ghana,7.9465,-1.0232,156805,0,1393,155412
1/31/22,Ghana,7.9465,-1.0232,156920,0,1395,155525
2/1/22,Ghana,7.9465,-1.0232,156920,0,1395,155525
2/2/22,Ghana,7.9465,-1.0232,156920,0,1395,155525
2/3/22,Ghana,7.9465,-1.0232,157220,0,1404,155816
2/4/22,Ghana,7.9465,-1.0232,157220,0,1404,155816
2/5/22,Ghana,7.9465,-1.0232,157541,0,1412,156129
2/6/22,Ghana,7.9465,-1.0232,157541,0,1412,156129
2/7/22,Ghana,7.9465,-1.0232,157751,0,1419,156332
2/8/22,Ghana,7.9465,-1.0232,157751,0,1419,156332
2/9/22,Ghana,7.9465,-1.0232,157751,0,1419,156332
2/10/22,Ghana,7.9465,-1.0232,157751,0,1419,156332
2/11/22,Ghana,7.9465,-1.0232,157751,0,1419,156332
2/12/22,Ghana,7.9465,-1.0232,157751,0,1419,156332
2/13/22,Ghana,7.9465,-1.0232,157751,0,1419,156332
2/14/22,Ghana,7.9465,-1.0232,157917,0,1426,156491
2/15/22,Ghana,7.9465,-1.0232,157992,0,1429,156563
2/16/22,Ghana,7.9465,-1.0232,158159,0,1431,156728
2/17/22,Ghana,7.9465,-1.0232,158220,0,1433,156787
2/18/22,Ghana,7.9465,-1.0232,158220,0,1433,156787
2/19/22,Ghana,7.9465,-1.0232,158220,0,1433,156787
2/20/22,Ghana,7.9465,-1.0232,158220,0,1433,156787
2/21/22,Ghana,7.9465,-1.0232,158434,0,1438,156996
2/22/22,Ghana,7.9465,-1.0232,158894,0,1441,157453
2/23/22,Ghana,7.9465,-1.0232,159124,0,1442,157682
2/24/22,Ghana,7.9465,-1.0232,159124,0,1442,157682
2/25/22,Ghana,7.9465,-1.0232,159124,0,1442,157682
2/26/22,Ghana,7.9465,-1.0232,159124,0,1442,157682
2/27/22,Ghana,7.9465,-1.0232,159124,0,1442,157682
2/28/22,Ghana,7.9465,-1.0232,159674,0,1442,158232
3/1/22,Ghana,7.9465,-1.0232,159891,0,1442,158449
3/2/22,Ghana,7.9465,-1.0232,159891,0,1442,158449
3/3/22,Ghana,7.9465,-1.0232,160028,0,1442,158586
3/4/22,Ghana,7.9465,-1.0232,160028,0,1442,158586
3/5/22,Ghana,7.9465,-1.0232,160028,0,1442,158586
3/6/22,Ghana,7.9465,-1.0232,160028,0,1442,158586
3/7/22,Ghana,7.9465,-1.0232,160028,0,1442,158586
3/8/22,Ghana,7.9465,-1.0232,160640,0,1442,159198
3/9/22,Ghana,7.9465,-1.0232,160667,0,1444,159223
3/10/22,Ghana,7.9465,-1.0232,160681,0,1445,159236
3/11/22,Ghana,7.9465,-1.0232,160693,0,1445,159248
3/12/22,Ghana,7.9465,-1.0232,160693,0,1445,159248
3/13/22,Ghana,7.9465,-1.0232,160716,0,1445,159271
3/14/22,Ghana,7.9465,-1.0232,160716,0,1445,159271
3/15/22,Ghana,7.9465,-1.0232,160761,0,1445,159316
3/16/22,Ghana,7.9465,-1.0232,160761,0,1445,159316
3/17/22,Ghana,7.9465,-1.0232,160775,0,1445,159330
3/18/22,Ghana,7.9465,-1.0232,160791,0,1445,159346
3/19/22,Ghana,7.9465,-1.0232,160791,0,1445,159346
3/20/22,Ghana,7.9465,-1.0232,160819,0,1445,159374
3/21/22,Ghana,7.9465,-1.0232,160863,0,1445,159418
3/22/22,Ghana,7.9465,-1.0232,160870,0,1445,159425
3/23/22,Ghana,7.9465,-1.0232,160870,0,1445,159425
3/24/22,Ghana,7.9465,-1.0232,160894,0,1445,159449
3/25/22,Ghana,7.9465,-1.0232,160894,0,1445,159449
3/26/22,Ghana,7.9465,-1.0232,160925,0,1445,159480
3/27/22,Ghana,7.9465,-1.0232,160925,0,1445,159480
3/28/22,Ghana,7.9465,-1.0232,160925,0,1445,159480
3/29/22,Ghana,7.9465,-1.0232,160925,0,1445,159480
3/30/22,Ghana,7.9465,-1.0232,160925,0,1445,159480
3/31/22,Ghana,7.9465,-1.0232,160971,0,1445,159526
4/1/22,Ghana,7.9465,-1.0232,160971,0,1445,159526
4/2/22,Ghana,7.9465,-1.0232,160971,0,1445,159526
4/3/22,Ghana,7.9465,-1.0232,160971,0,1445,159526
4/4/22,Ghana,7.9465,-1.0232,160971,0,1445,159526
4/5/22,Ghana,7.9465,-1.0232,161014,0,1445,159569
4/6/22,Ghana,7.9465,-1.0232,161034,0,1445,159589
4/7/22,Ghana,7.9465,-1.0232,161034,0,1445,159589
4/8/22,Ghana,7.9465,-1.0232,161048,0,1445,159603
4/9/22,Ghana,7.9465,-1.0232,161048,0,1445,159603
4/10/22,Ghana,7.9465,-1.0232,161048,0,1445,159603
4/11/22,Ghana,7.9465,-1.0232,161071,0,1445,159626
4/12/22,Ghana,7.9465,-1.0232,161071,0,1445,159626
4/13/22,Ghana,7.9465,-1.0232,161086,0,1445,159641
4/14/22,Ghana,7.9465,-1.0232,161086,0,1445,159641
4/15/22,Ghana,7.9465,-1.0232,161101,0,1445,159656
4/16/22,Ghana,7.9465,-1.0232,161101,0,1445,159656
4/17/22,Ghana,7.9465,-1.0232,161101,0,1445,159656
4/18/22,Ghana,7.9465,-1.0232,161101,0,1445,159656
4/19/22,Ghana,7.9465,-1.0232,161114,0,1445,159669
4/20/22,Ghana,7.9465,-1.0232,161117,0,1445,159672
4/21/22,Ghana,7.9465,-1.0232,161124,0,1445,159679
4/22/22,Ghana,7.9465,-1.0232,161124,0,1445,159679
4/23/22,Ghana,7.9465,-1.0232,161124,0,1445,159679
4/24/22,Ghana,7.9465,-1.0232,161124,0,1445,159679
4/25/22,Ghana,7.9465,-1.0232,161157,0,1445,159712
4/26/22,Ghana,7.9465,-1.0232,161157,0,1445,159712
4/27/22,Ghana,7.9465,-1.0232,161170,0,1445,159725
4/28/22,Ghana,7.9465,-1.0232,161170,0,1445,159725
4/29/22,Ghana,7.9465,-1.0232,161173,0,1445,159728
4/30/22,Ghana,7.9465,-1.0232,161173,0,1445,159728
5/1/22,Ghana,7.9465,-1.0232,161204,0,1445,159759
5/2/22,Ghana,7.9465,-1.0232,161204,0,1445,159759
5/3/22,Ghana,7.9465,-1.0232,161216,0,1445,159771
5/4/22,Ghana,7.9465,-1.0232,161216,0,1445,159771
5/5/22,Ghana,7.9465,-1.0232,161222,0,1445,159777
5/6/22,Ghana,7.9465,-1.0232,161222,0,1445,159777
5/7/22,Ghana,7.9465,-1.0232,161222,0,1445,159777
5/8/22,Ghana,7.9465,-1.0232,161222,0,1445,159777
5/9/22,Ghana,7.9465,-1.0232,161269,0,1445,159824
5/10/22,Ghana,7.9465,-1.0232,161271,0,1445,159826
5/11/22,Ghana,7.9465,-1.0232,161271,0,1445,159826
5/12/22,Ghana,7.9465,-1.0232,161280,0,1445,159835
5/13/22,Ghana,7.9465,-1.0232,161280,0,1445,159835
5/14/22,Ghana,7.9465,-1.0232,161280,0,1445,159835
5/15/22,Ghana,7.9465,-1.0232,161280,0,1445,159835
5/16/22,Ghana,7.9465,-1.0232,161310,0,1445,159865
5/17/22,Ghana,7.9465,-1.0232,161325,0,1445,159880
5/18/22,Ghana,7.9465,-1.0232,161325,0,1445,159880
5/19/22,Ghana,7.9465,-1.0232,161325,0,1445,159880
5/20/22,Ghana,7.9465,-1.0232,161325,0,1445,159880
5/21/22,Ghana,7.9465,-1.0232,161325,0,1445,159880
5/22/22,Ghana,7.9465,-1.0232,161351,0,1445,159906
5/23/22,Ghana,7.9465,-1.0232,161351,0,1445,159906
5/24/22,Ghana,7.9465,-1.0232,161370,0,1445,159925
5/25/22,Ghana,7.9465,-1.0232,161370,0,1445,159925
5/26/22,Ghana,7.9465,-1.0232,161370,0,1445,159925
5/27/22,Ghana,7.9465,-1.0232,161370,0,1445,159925
5/28/22,Ghana,7.9465,-1.0232,161370,0,1445,159925
5/29/22,Ghana,7.9465,-1.0232,161370,0,1445,159925
5/30/22,Ghana,7.9465,-1.0232,161370,0,1445,159925
5/31/22,Ghana,7.9465,-1.0232,161370,0,1445,159925
6/1/22,Ghana,7.9465,-1.0232,161443,0,1445,159998
6/2/22,Ghana,7.9465,-1.0232,161481,0,1445,160036
6/3/22,Ghana,7.9465,-1.0232,161481,0,1445,160036
6/4/22,Ghana,7.9465,-1.0232,161481,0,1445,160036
6/5/22,Ghana,7.9465,-1.0232,161795,0,1445,160350
6/6/22,Ghana,7.9465,-1.0232,161795,0,1445,160350
6/7/22,Ghana,7.9465,-1.0232,161841,0,1445,160396
6/8/22,Ghana,7.9465,-1.0232,161841,0,1445,160396
6/9/22,Ghana,7.9465,-1.0232,161841,0,1445,160396
6/10/22,Ghana,7.9465,-1.0232,161841,0,1445,160396
6/11/22,Ghana,7.9465,-1.0232,161841,0,1445,160396
6/12/22,Ghana,7.9465,-1.0232,161935,0,1445,160490
6/13/22,Ghana,7.9465,-1.0232,161935,0,1445,160490
6/14/22,Ghana,7.9465,-1.0232,162646,0,1445,161201
6/15/22,Ghana,7.9465,-1.0232,163191,0,1445,161746
6/16/22,Ghana,7.9465,-1.0232,163332,0,1445,161887
6/17/22,Ghana,7.9465,-1.0232,163332,0,1445,161887
6/18/22,Ghana,7.9465,-1.0232,163332,0,1445,161887
6/19/22,Ghana,7.9465,-1.0232,163666,0,1446,162220
6/20/22,Ghana,7.9465,-1.0232,164164,0,1448,162716
6/21/22,Ghana,7.9465,-1.0232,164164,0,1448,162716
6/22/22,Ghana,7.9465,-1.0232,164541,0,1448,163093
6/23/22,Ghana,7.9465,-1.0232,164612,0,1448,163164
6/24/22,Ghana,7.9465,-1.0232,164843,0,1448,163395
6/25/22,Ghana,7.9465,-1.0232,164843,0,1448,163395
6/26/22,Ghana,7.9465,-1.0232,164843,0,1448,163395
6/27/22,Ghana,7.9465,-1.0232,165749,0,1449,164300
6/28/22,Ghana,7.9465,-1.0232,165749,0,1449,164300
6/29/22,Ghana,7.9465,-1.0232,166133,0,1450,164683
6/30/22,Ghana,7.9465,-1.0232,166133,0,1450,164683
7/1/22,Ghana,7.9465,-1.0232,166133,0,1450,164683
7/2/22,Ghana,7.9465,-1.0232,166133,0,1450,164683
7/3/22,Ghana,7.9465,-1.0232,166397,0,1451,164946
7/4/22,Ghana,7.9465,-1.0232,166546,0,1452,165094
7/5/22,Ghana,7.9465,-1.0232,166546,0,1452,165094
7/6/22,Ghana,7.9465,-1.0232,166546,0,1452,165094
7/7/22,Ghana,7.9465,-1.0232,166816,0,1453,165363
7/8/22,Ghana,7.9465,-1.0232,166816,0,1453,165363
7/9/22,Ghana,7.9465,-1.0232,166816,0,1453,165363
7/10/22,Ghana,7.9465,-1.0232,166816,0,1453,165363
7/11/22,Ghana,7.9465,-1.0232,166816,0,1453,165363
7/12/22,Ghana,7.9465,-1.0232,167215,0,1456,165759
7/13/22,Ghana,7.9465,-1.0232,167215,0,1456,165759
7/14/22,Ghana,7.9465,-1.0232,167215,0,1456,165759
7/15/22,Ghana,7.9465,-1.0232,167215,0,1456,165759
7/16/22,Ghana,7.9465,-1.0232,167215,0,1456,165759
7/17/22,Ghana,7.9465,-1.0232,167215,0,1456,165759
7/18/22,Ghana,7.9465,-1.0232,167215,0,1456,165759
7/19/22,Ghana,7.9465,-1.0232,167215,0,1456,165759
7/20/22,Ghana,7.9465,-1.0232,167215,0,1456,165759
7/21/22,Ghana,7.9465,-1.0232,167215,0,1456,165759
7/22/22,Ghana,7.9465,-1.0232,167215,0,1456,165759
7/23/22,Ghana,7.9465,-1.0232,167215,0,1456,165759
7/24/22,Ghana,7.9465,-1.0232,167215,0,1456,165759
7/25/22,Ghana,7.9465,-1.0232,167215,0,1456,165759
7/26/22,Ghana,7.9465,-1.0232,167215,0,1456,165759
7/27/22,Ghana,7.9465,-1.0232,167215,0,1456,165759
7/28/22,Ghana,7.9465,-1.0232,168007,0,1457,166550
7/29/22,Ghana,7.9465,-1.0232,168007,0,1457,166550
7/30/22,Ghana,7.9465,-1.0232,168007,0,1457,166550
7/31/22,Ghana,7.9465,-1.0232,168007,0,1457,166550
8/1/22,Ghana,7.9465,-1.0232,168127,0,1457,166670
8/2/22,Ghana,7.9465,-1.0232,168127,0,1457,166670
8/3/22,Ghana,7.9465,-1.0232,168127,0,1457,166670
8/4/22,Ghana,7.9465,-1.0232,168127,0,1457,166670
8/5/22,Ghana,7.9465,-1.0232,168306,0,1458,166848
8/6/22,Ghana,7.9465,-1.0232,168306,0,1458,166848
8/7/22,Ghana,7.9465,-1.0232,168306,0,1458,166848
8/8/22,Ghana,7.9465,-1.0232,168350,0,1458,166892
8/9/22,Ghana,7.9465,-1.0232,168350,0,1458,166892
8/10/22,Ghana,7.9465,-1.0232,168350,0,1458,166892
8/11/22,Ghana,7.9465,-1.0232,168350,0,1458,166892
8/12/22,Ghana,7.9465,-1.0232,168350,0,1458,166892
8/13/22,Ghana,7.9465,-1.0232,168350,0,1458,166892
8/14/22,Ghana,7.9465,-1.0232,168350,0,1458,166892
8/15/22,Ghana,7.9465,-1.0232,168457,0,1459,166998
8/16/22,Ghana,7.9465,-1.0232,168457,0,1459,166998
8/17/22,Ghana,7.9465,-1.0232,168457,0,1459,166998
8/18/22,Ghana,7.9465,-1.0232,168457,0,1459,166998
8/19/22,Ghana,7.9465,-1.0232,168457,0,1459,166998
8/20/22,Ghana,7.9465,-1.0232,168457,0,1459,166998
8/21/22,Ghana,7.9465,-1.0232,168457,0,1459,166998
8/22/22,Ghana,7.9465,-1.0232,168457,0,1459,166998
8/23/22,Ghana,7.9465,-1.0232,168457,0,1459,166998
8/24/22,Ghana,7.9465,-1.0232,168457,0,1459,166998
8/25/22,Ghana,7.9465,-1.0232,168457,0,1459,166998
8/26/22,Ghana,7.9465,-1.0232,168565,0,1459,167106
8/27/22,Ghana,7.9465,-1.0232,168565,0,1459,167106
8/28/22,Ghana,7.9465,-1.0232,168565,0,1459,167106
8/29/22,Ghana,7.9465,-1.0232,168580,0,1459,167121
8/30/22,Ghana,7.9465,-1.0232,168580,0,1459,167121
8/31/22,Ghana,7.9465,-1.0232,168580,0,1459,167121
9/1/22,Ghana,7.9465,-1.0232,168580,0,1459,167121
9/2/22,Ghana,7.9465,-1.0232,168580,0,1459,167121
9/3/22,Ghana,7.9465,-1.0232,168580,0,1459,167121
9/4/22,Ghana,7.9465,-1.0232,168580,0,1459,167121
9/5/22,Ghana,7.9465,-1.0232,168580,0,1459,167121
9/6/22,Ghana,7.9465,-1.0232,168580,0,1459,167121
9/7/22,Ghana,7.9465,-1.0232,168580,0,1459,167121
9/8/22,Ghana,7.9465,-1.0232,168580,0,1459,167121
9/9/22,Ghana,7.9465,-1.0232,168580,0,1459,167121
9/10/22,Ghana,7.9465,-1.0232,168616,0,1459,167157
9/11/22,Ghana,7.9465,-1.0232,168616,0,1459,167157
9/12/22,Ghana,7.9465,-1.0232,168616,0,1459,167157
9/13/22,Ghana,7.9465,-1.0232,168616,0,1459,167157
9/14/22,Ghana,7.9465,-1.0232,168616,0,1459,167157
9/15/22,Ghana,7.9465,-1.0232,168616,0,1459,167157
9/16/22,Ghana,7.9465,-1.0232,168616,0,1459,167157
9/17/22,Ghana,7.9465,-1.0232,168616,0,1459,167157
9/18/22,Ghana,7.9465,-1.0232,168616,0,1459,167157
9/19/22,Ghana,7.9465,-1.0232,168813,0,1459,167354
9/20/22,Ghana,7.9465,-1.0232,168813,0,1459,167354
9/21/22,Ghana,7.9465,-1.0232,168813,0,1459,167354
9/22/22,Ghana,7.9465,-1.0232,168813,0,1459,167354
9/23/22,Ghana,7.9465,-1.0232,168813,0,1459,167354
9/24/22,Ghana,7.9465,-1.0232,168813,0,1459,167354
9/25/22,Ghana,7.9465,-1.0232,168813,0,1459,167354
9/26/22,Ghana,7.9465,-1.0232,169100,0,1459,167641
9/27/22,Ghana,7.9465,-1.0232,169100,0,1459,167641
9/28/22,Ghana,7.9465,-1.0232,169100,0,1459,167641
9/29/22,Ghana,7.9465,-1.0232,169100,0,1459,167641
9/30/22,Ghana,7.9465,-1.0232,169100,0,1459,167641
10/1/22,Ghana,7.9465,-1.0232,169385,0,1459,167926
10/2/22,Ghana,7.9465,-1.0232,169385,0,1459,167926
10/3/22,Ghana,7.9465,-1.0232,169685,0,1459,168226
10/4/22,Ghana,7.9465,-1.0232,169685,0,1459,168226
10/5/22,Ghana,7.9465,-1.0232,169685,0,1459,168226
10/6/22,Ghana,7.9465,-1.0232,169685,0,1459,168226
10/7/22,Ghana,7.9465,-1.0232,169685,0,1459,168226
10/8/22,Ghana,7.9465,-1.0232,169685,0,1459,168226
10/9/22,Ghana,7.9465,-1.0232,169685,0,1459,168226
10/10/22,Ghana,7.9465,-1.0232,169685,0,1459,168226
10/11/22,Ghana,7.9465,-1.0232,170103,0,1459,168644
10/12/22,Ghana,7.9465,-1.0232,170103,0,1459,168644
10/13/22,Ghana,7.9465,-1.0232,170177,0,1460,168717
10/14/22,Ghana,7.9465,-1.0232,170177,0,1460,168717
10/15/22,Ghana,7.9465,-1.0232,170177,0,1460,168717
10/16/22,Ghana,7.9465,-1.0232,170321,0,1460,168861
10/17/22,Ghana,7.9465,-1.0232,170321,0,1460,168861
10/18/22,Ghana,7.9465,-1.0232,170321,0,1460,168861
10/19/22,Ghana,7.9465,-1.0232,170321,0,1460,168861
10/20/22,Ghana,7.9465,-1.0232,170421,0,1460,168961
10/21/22,Ghana,7.9465,-1.0232,170421,0,1460,168961
10/22/22,Ghana,7.9465,-1.0232,170421,0,1460,168961
10/23/22,Ghana,7.9465,-1.0232,170573,0,1460,169113
10/24/22,Ghana,7.9465,-1.0232,170573,0,1460,169113
10/25/22,Ghana,7.9465,-1.0232,170573,0,1460,169113
10/26/22,Ghana,7.9465,-1.0232,170573,0,1460,169113
10/27/22,Ghana,7.9465,-1.0232,170573,0,1460,169113
10/28/22,Ghana,7.9465,-1.0232,170707,0,1460,169247
10/29/22,Ghana,7.9465,-1.0232,170707,0,1460,169247
10/30/22,Ghana,7.9465,-1.0232,170707,0,1460,169247
10/31/22,Ghana,7.9465,-1.0232,170707,0,1460,169247
11/1/22,Ghana,7.9465,-1.0232,170707,0,1460,169247
11/2/22,Ghana,7.9465,-1.0232,170707,0,1460,169247
11/3/22,Ghana,7.9465,-1.0232,170894,0,1460,169434
11/4/22,Ghana,7.9465,-1.0232,170894,0,1460,169434
11/5/22,Ghana,7.9465,-1.0232,170894,0,1460,169434
11/6/22,Ghana,7.9465,-1.0232,170894,0,1460,169434
11/7/22,Ghana,7.9465,-1.0232,170894,0,1460,169434
11/8/22,Ghana,7.9465,-1.0232,170894,0,1460,169434
11/9/22,Ghana,7.9465,-1.0232,170894,0,1460,169434
11/10/22,Ghana,7.9465,-1.0232,170894,0,1460,169434
11/11/22,Ghana,7.9465,-1.0232,170894,0,1460,169434
11/12/22,Ghana,7.9465,-1.0232,170894,0,1460,169434
11/13/22,Ghana,7.9465,-1.0232,170894,0,1460,169434
11/14/22,Ghana,7.9465,-1.0232,170972,0,1461,169511
11/15/22,Ghana,7.9465,-1.0232,170972,0,1461,169511
11/16/22,Ghana,7.9465,-1.0232,170972,0,1461,169511
11/17/22,Ghana,7.9465,-1.0232,170972,0,1461,169511
11/18/22,Ghana,7.9465,-1.0232,170972,0,1461,169511
11/19/22,Ghana,7.9465,-1.0232,170972,0,1461,169511
11/20/22,Ghana,7.9465,-1.0232,170996,0,1461,169535
11/21/22,Ghana,7.9465,-1.0232,170996,0,1461,169535
11/22/22,Ghana,7.9465,-1.0232,170996,0,1461,169535
11/23/22,Ghana,7.9465,-1.0232,170996,0,1461,169535
11/24/22,Ghana,7.9465,-1.0232,171009,0,1461,169548
11/25/22,Ghana,7.9465,-1.0232,171009,0,1461,169548
11/26/22,Ghana,7.9465,-1.0232,171009,0,1461,169548
11/27/22,Ghana,7.9465,-1.0232,171009,0,1461,169548
11/28/22,Ghana,7.9465,-1.0232,171009,0,1461,169548
11/29/22,Ghana,7.9465,-1.0232,171009,0,1461,169548
11/30/22,Ghana,7.9465,-1.0232,171009,0,1461,169548
12/1/22,Ghana,7.9465,-1.0232,171009,0,1461,169548
12/2/22,Ghana,7.9465,-1.0232,171018,0,1461,169557
12/3/22,Ghana,7.9465,-1.0232,171018,0,1461,169557
12/4/22,Ghana,7.9465,-1.0232,171023,0,1461,169562
12/5/22,Ghana,7.9465,-1.0232,171023,0,1461,169562
12/6/22,Ghana,7.9465,-1.0232,171023,0,1461,169562
12/7/22,Ghana,7.9465,-1.0232,171023,0,1461,169562
12/8/22,Ghana,7.9465,-1.0232,171023,0,1461,169562
12/9/22,Ghana,7.9465,-1.0232,171023,0,1461,169562
12/10/22,Ghana,7.9465,-1.0232,171023,0,1461,169562
12/11/22,Ghana,7.9465,-1.0232,171023,0,1461,169562
12/12/22,Ghana,7.9465,-1.0232,171023,0,1461,169562
12/13/22,Ghana,7.9465,-1.0232,171023,0,1461,169562
12/14/22,Ghana,7.9465,-1.0232,171023,0,1461,169562
12/15/22,Ghana,7.9465,-1.0232,171023,0,1461,169562
12/16/22,Ghana,7.9465,-1.0232,171023,0,1461,169562
12/17/22,Ghana,7.9465,-1.0232,171023,0,1461,169562
1/1/22,Greece,39.0742,21.8243,1240862,0,20849,1220013
1/2/22,Greece,39.0742,21.8243,1258495,0,20910,1237585
1/3/22,Greece,39.0742,21.8243,1294741,0,20990,1273751
1/4/22,Greece,39.0742,21.8243,1344923,0,21053,1323870
1/5/22,Greece,39.0742,21.8243,1388309,0,21115,1367194
1/6/22,Greece,39.0742,21.8243,1422020,0,21185,1400835
1/7/22,Greece,39.0742,21.8243,1451354,0,21263,1430091
1/8/22,Greece,39.0742,21.8243,1489024,0,21328,1467696
1/9/22,Greece,39.0742,21.8243,1507616,0,21394,1486222
1/10/22,Greece,39.0742,21.8243,1535382,0,21479,1513903
1/11/22,Greece,39.0742,21.8243,1568215,0,21559,1546656
1/12/22,Greece,39.0742,21.8243,1592460,0,21637,1570823
1/13/22,Greece,39.0742,21.8243,1612869,0,21732,1591137
1/14/22,Greece,39.0742,21.8243,1632641,0,21809,1610832
1/15/22,Greece,39.0742,21.8243,1650088,0,21888,1628200
1/16/22,Greece,39.0742,21.8243,1660871,0,21984,1638887
1/17/22,Greece,39.0742,21.8243,1679705,0,22087,1657618
1/18/22,Greece,39.0742,21.8243,1703396,0,22197,1681199
1/19/22,Greece,39.0742,21.8243,1723496,0,22285,1701211
1/20/22,Greece,39.0742,21.8243,1742363,0,22366,1719997
1/21/22,Greece,39.0742,21.8243,1762870,0,22476,1740394
1/22/22,Greece,39.0742,21.8243,1781203,0,22549,1758654
1/23/22,Greece,39.0742,21.8243,1793311,0,22635,1770676
1/24/22,Greece,39.0742,21.8243,1812384,0,22748,1789636
1/25/22,Greece,39.0742,21.8243,1830263,0,22852,1807411
1/26/22,Greece,39.0742,21.8243,1848223,0,22970,1825253
1/27/22,Greece,39.0742,21.8243,1867935,0,23083,1844852
1/28/22,Greece,39.0742,21.8243,1890296,0,23195,1867101
1/29/22,Greece,39.0742,21.8243,1909880,0,23275,1886605
1/30/22,Greece,39.0742,21.8243,1920992,0,23372,1897620
1/31/22,Greece,39.0742,21.8243,1940723,0,23500,1917223
2/1/22,Greece,39.0742,21.8243,1965719,0,23608,1942111
2/2/22,Greece,39.0742,21.8243,1984544,0,23721,1960823
2/3/22,Greece,39.0742,21.8243,2002206,0,23833,1978373
2/4/22,Greece,39.0742,21.8243,2020846,0,23927,1996919
2/5/22,Greece,39.0742,21.8243,2036869,0,23999,2012870
2/6/22,Greece,39.0742,21.8243,2047849,0,24094,2023755
2/7/22,Greece,39.0742,21.8243,2066696,0,24210,2042486
2/8/22,Greece,39.0742,21.8243,2090383,0,24322,2066061
2/9/22,Greece,39.0742,21.8243,2109999,0,24410,2085589
2/10/22,Greece,39.0742,21.8243,2129153,0,24507,2104646
2/11/22,Greece,39.0742,21.8243,2146798,0,24609,2122189
2/12/22,Greece,39.0742,21.8243,2163240,0,24679,2138561
2/13/22,Greece,39.0742,21.8243,2174093,0,24754,2149339
2/14/22,Greece,39.0742,21.8243,2194453,0,24836,2169617
2/15/22,Greece,39.0742,21.8243,2216411,0,24917,2191494
2/16/22,Greece,39.0742,21.8243,2235920,0,25001,2210919
2/17/22,Greece,39.0742,21.8243,2255421,0,25095,2230326
2/18/22,Greece,39.0742,21.8243,2274025,0,25183,2248842
2/19/22,Greece,39.0742,21.8243,2289330,0,25260,2264070
2/20/22,Greece,39.0742,21.8243,2298926,0,25327,2273599
2/21/22,Greece,39.0742,21.8243,2317014,0,25417,2291597
2/22/22,Greece,39.0742,21.8243,2336615,0,25485,2311130
2/23/22,Greece,39.0742,21.8243,2353577,0,25538,2328039
2/24/22,Greece,39.0742,21.8243,2369396,0,25603,2343793
2/25/22,Greece,39.0742,21.8243,2385304,0,25668,2359636
2/26/22,Greece,39.0742,21.8243,2397187,0,25719,2371468
2/27/22,Greece,39.0742,21.8243,2405401,0,25785,2379616
2/28/22,Greece,39.0742,21.8243,2421664,0,25860,2395804
3/1/22,Greece,39.0742,21.8243,2438872,0,25914,2412958
3/2/22,Greece,39.0742,21.8243,2454429,0,25972,2428457
3/3/22,Greece,39.0742,21.8243,2470212,0,26036,2444176
3/4/22,Greece,39.0742,21.8243,2486262,0,26092,2460170
3/5/22,Greece,39.0742,21.8243,2499259,0,26143,2473116
3/6/22,Greece,39.0742,21.8243,2508472,0,26194,2482278
3/7/22,Greece,39.0742,21.8243,2517111,0,26246,2490865
3/8/22,Greece,39.0742,21.8243,2538168,0,26303,2511865
3/9/22,Greece,39.0742,21.8243,2561503,0,26366,2535137
3/10/22,Greece,39.0742,21.8243,2583366,0,26424,2556942
3/11/22,Greece,39.0742,21.8243,2604626,0,26473,2578153
3/12/22,Greece,39.0742,21.8243,2623628,0,26513,2597115
3/13/22,Greece,39.0742,21.8243,2635614,0,26562,2609052
3/14/22,Greece,39.0742,21.8243,2658296,0,26635,2631661
3/15/22,Greece,39.0742,21.8243,2684916,0,26686,2658230
3/16/22,Greece,39.0742,21.8243,2708610,0,26730,2681880
3/17/22,Greece,39.0742,21.8243,2732866,0,26792,2706074
3/18/22,Greece,39.0742,21.8243,2756487,0,26847,2729640
3/19/22,Greece,39.0742,21.8243,2776192,0,26893,2749299
3/20/22,Greece,39.0742,21.8243,2788654,0,26937,2761717
3/21/22,Greece,39.0742,21.8243,2812182,0,26995,2785187
3/22/22,Greece,39.0742,21.8243,2838891,0,27029,2811862
3/23/22,Greece,39.0742,21.8243,2861993,0,27083,2834910
3/24/22,Greece,39.0742,21.8243,2884100,0,27125,2856975
3/25/22,Greece,39.0742,21.8243,2900334,0,27160,2873174
3/26/22,Greece,39.0742,21.8243,2916892,0,27216,2889676
3/27/22,Greece,39.0742,21.8243,2930321,0,27268,2903053
3/28/22,Greece,39.0742,21.8243,2957810,0,27341,2930469
3/29/22,Greece,39.0742,21.8243,2986882,0,27392,2959490
3/30/22,Greece,39.0742,21.8243,3009333,0,27454,2981879
3/31/22,Greece,39.0742,21.8243,3030429,0,27510,3002919
4/1/22,Greece,39.0742,21.8243,3051531,0,27571,3023960
4/2/22,Greece,39.0742,21.8243,3067354,0,27623,3039731
4/3/22,Greece,39.0742,21.8243,3077711,0,27684,3050027
4/4/22,Greece,39.0742,21.8243,3096135,0,27746,3068389
4/5/22,Greece,39.0742,21.8243,3114591,0,27816,3086775
4/6/22,Greece,39.0742,21.8243,3126856,0,27892,3098964
4/7/22,Greece,39.0742,21.8243,3137714,0,27968,3109746
4/8/22,Greece,39.0742,21.8243,3152477,0,28025,3124452
4/9/22,Greece,39.0742,21.8243,3164995,0,28076,3136919
4/10/22,Greece,39.0742,21.8243,3173630,0,28130,3145500
4/11/22,Greece,39.0742,21.8243,3180556,0,28205,3152351
4/12/22,Greece,39.0742,21.8243,3195887,0,28274,3167613
4/13/22,Greece,39.0742,21.8243,3206948,0,28344,3178604
4/14/22,Greece,39.0742,21.8243,3216256,0,28406,3187850
4/15/22,Greece,39.0742,21.8243,3224479,0,28488,3195991
4/16/22,Greece,39.0742,21.8243,3232496,0,28537,3203959
4/17/22,Greece,39.0742,21.8243,3238169,0,28588,3209581
4/18/22,Greece,39.0742,21.8243,3242037,0,28652,3213385
4/19/22,Greece,39.0742,21.8243,3252248,0,28701,3223547
4/20/22,Greece,39.0742,21.8243,3259613,0,28765,3230848
4/21/22,Greece,39.0742,21.8243,3266368,0,28808,3237560
4/22/22,Greece,39.0742,21.8243,3273382,0,28839,3244543
4/23/22,Greece,39.0742,21.8243,3277557,0,28867,3248690
4/24/22,Greece,39.0742,21.8243,3277557,0,28867,3248690
4/25/22,Greece,39.0742,21.8243,3285970,0,28933,3257037
4/26/22,Greece,39.0742,21.8243,3290895,0,28976,3261919
4/27/22,Greece,39.0742,21.8243,3302382,0,29022,3273360
4/28/22,Greece,39.0742,21.8243,3309962,0,29073,3280889
4/29/22,Greece,39.0742,21.8243,3317425,0,29114,3288311
4/30/22,Greece,39.0742,21.8243,3323922,0,29153,3294769
5/1/22,Greece,39.0742,21.8243,3328623,0,29175,3299448
5/2/22,Greece,39.0742,21.8243,3331288,0,29205,3302083
5/3/22,Greece,39.0742,21.8243,3335550,0,29249,3306301
5/4/22,Greece,39.0742,21.8243,3343565,0,29284,3314281
5/5/22,Greece,39.0742,21.8243,3348756,0,29315,3319441
5/6/22,Greece,39.0742,21.8243,3353886,0,29349,3324537
5/7/22,Greece,39.0742,21.8243,3358584,0,29369,3329215
5/8/22,Greece,39.0742,21.8243,3361779,0,29392,3332387
5/9/22,Greece,39.0742,21.8243,3364598,0,29417,3335181
5/10/22,Greece,39.0742,21.8243,3371051,0,29444,3341607
5/11/22,Greece,39.0742,21.8243,3375812,0,29471,3346341
5/12/22,Greece,39.0742,21.8243,3380594,0,29491,3351103
5/13/22,Greece,39.0742,21.8243,3384982,0,29521,3355461
5/14/22,Greece,39.0742,21.8243,3389306,0,29536,3359770
5/15/22,Greece,39.0742,21.8243,3392575,0,29547,3363028
5/16/22,Greece,39.0742,21.8243,3395641,0,29576,3366065
5/17/22,Greece,39.0742,21.8243,3401927,0,29599,3372328
5/18/22,Greece,39.0742,21.8243,3406553,0,29619,3376934
5/19/22,Greece,39.0742,21.8243,3410481,0,29642,3380839
5/20/22,Greece,39.0742,21.8243,3414189,0,29658,3384531
5/21/22,Greece,39.0742,21.8243,3417613,0,29679,3387934
5/22/22,Greece,39.0742,21.8243,3419998,0,29690,3390308
5/23/22,Greece,39.0742,21.8243,3422233,0,29711,3392522
5/24/22,Greece,39.0742,21.8243,3427857,0,29725,3398132
5/25/22,Greece,39.0742,21.8243,3431998,0,29743,3402255
5/26/22,Greece,39.0742,21.8243,3436046,0,29756,3406290
5/27/22,Greece,39.0742,21.8243,3439773,0,29771,3410002
5/28/22,Greece,39.0742,21.8243,3442963,0,29784,3413179
5/29/22,Greece,39.0742,21.8243,3445538,0,29803,3415735
5/30/22,Greece,39.0742,21.8243,3447938,0,29828,3418110
5/31/22,Greece,39.0742,21.8243,3453229,0,29845,3423384
6/1/22,Greece,39.0742,21.8243,3457256,0,29857,3427399
6/2/22,Greece,39.0742,21.8243,3461025,0,29869,3431156
6/3/22,Greece,39.0742,21.8243,3464666,0,29886,3434780
6/4/22,Greece,39.0742,21.8243,3467979,0,29901,3438078
6/5/22,Greece,39.0742,21.8243,3470640,0,29913,3440727
6/6/22,Greece,39.0742,21.8243,3473141,0,29927,3443214
6/7/22,Greece,39.0742,21.8243,3478779,0,29951,3448828
6/8/22,Greece,39.0742,21.8243,3483275,0,29966,3453309
6/9/22,Greece,39.0742,21.8243,3487775,0,29976,3457799
6/10/22,Greece,39.0742,21.8243,3492268,0,29997,3462271
6/11/22,Greece,39.0742,21.8243,3496807,0,30012,3466795
6/12/22,Greece,39.0742,21.8243,3500489,0,30020,3470469
6/13/22,Greece,39.0742,21.8243,3500489,0,30020,3470469
6/14/22,Greece,39.0742,21.8243,3508610,0,30033,3478577
6/15/22,Greece,39.0742,21.8243,3517898,0,30049,3487849
6/16/22,Greece,39.0742,21.8243,3525056,0,30057,3494999
6/17/22,Greece,39.0742,21.8243,3532260,0,30070,3502190
6/18/22,Greece,39.0742,21.8243,3539423,0,30079,3509344
6/19/22,Greece,39.0742,21.8243,3545112,0,30087,3515025
6/20/22,Greece,39.0742,21.8243,3549944,0,30099,3519845
6/21/22,Greece,39.0742,21.8243,3562524,0,30115,3532409
6/22/22,Greece,39.0742,21.8243,3573052,0,30124,3542928
6/23/22,Greece,39.0742,21.8243,3583526,0,30141,3553385
6/24/22,Greece,39.0742,21.8243,3595498,0,30154,3565344
6/25/22,Greece,39.0742,21.8243,3607580,0,30162,3577418
6/26/22,Greece,39.0742,21.8243,3616874,0,30178,3586696
6/27/22,Greece,39.0742,21.8243,3624556,0,30190,3594366
6/28/22,Greece,39.0742,21.8243,3644889,0,30206,3614683
6/29/22,Greece,39.0742,21.8243,3661004,0,30218,3630786
6/30/22,Greece,39.0742,21.8243,3676502,0,30232,3646270
7/1/22,Greece,39.0742,21.8243,3692371,0,30250,3662121
7/2/22,Greece,39.0742,21.8243,3708210,0,30276,3677934
7/3/22,Greece,39.0742,21.8243,3719839,0,30302,3689537
7/4/22,Greece,39.0742,21.8243,3729199,0,30327,3698872
7/5/22,Greece,39.0742,21.8243,3755074,0,30349,3724725
7/6/22,Greece,39.0742,21.8243,3774377,0,30371,3744006
7/7/22,Greece,39.0742,21.8243,3792674,0,30400,3762274
7/8/22,Greece,39.0742,21.8243,3811622,0,30422,3781200
7/9/22,Greece,39.0742,21.8243,3829836,0,30448,3799388
7/10/22,Greece,39.0742,21.8243,3843142,0,30476,3812666
7/11/22,Greece,39.0742,21.8243,3843142,0,30476,3812666
7/12/22,Greece,39.0742,21.8243,3843142,0,30476,3812666
7/13/22,Greece,39.0742,21.8243,3843142,0,30476,3812666
7/14/22,Greece,39.0742,21.8243,3843142,0,30476,3812666
7/15/22,Greece,39.0742,21.8243,3843142,0,30476,3812666
7/16/22,Greece,39.0742,21.8243,3843142,0,30476,3812666
7/17/22,Greece,39.0742,21.8243,3843142,0,30476,3812666
7/18/22,Greece,39.0742,21.8243,3843142,0,30476,3812666
7/19/22,Greece,39.0742,21.8243,4210771,0,30707,4180064
7/20/22,Greece,39.0742,21.8243,4210771,0,30707,4180064
7/21/22,Greece,39.0742,21.8243,4210771,0,30707,4180064
7/22/22,Greece,39.0742,21.8243,4210771,0,30707,4180064
7/23/22,Greece,39.0742,21.8243,4210771,0,30707,4180064
7/24/22,Greece,39.0742,21.8243,4210771,0,30707,4180064
7/25/22,Greece,39.0742,21.8243,4210771,0,30707,4180064
7/26/22,Greece,39.0742,21.8243,4210771,0,30707,4180064
7/27/22,Greece,39.0742,21.8243,4349423,0,30999,4318424
7/28/22,Greece,39.0742,21.8243,4349423,0,30999,4318424
7/29/22,Greece,39.0742,21.8243,4349423,0,30999,4318424
7/30/22,Greece,39.0742,21.8243,4349423,0,30999,4318424
7/31/22,Greece,39.0742,21.8243,4349423,0,30999,4318424
8/1/22,Greece,39.0742,21.8243,4349423,0,30999,4318424
8/2/22,Greece,39.0742,21.8243,4474616,0,31377,4443239
8/3/22,Greece,39.0742,21.8243,4474616,0,31377,4443239
8/4/22,Greece,39.0742,21.8243,4474616,0,31377,4443239
8/5/22,Greece,39.0742,21.8243,4474616,0,31377,4443239
8/6/22,Greece,39.0742,21.8243,4474616,0,31377,4443239
8/7/22,Greece,39.0742,21.8243,4474616,0,31377,4443239
8/8/22,Greece,39.0742,21.8243,4474616,0,31377,4443239
8/9/22,Greece,39.0742,21.8243,4577675,0,31722,4545953
8/10/22,Greece,39.0742,21.8243,4577675,0,31722,4545953
8/11/22,Greece,39.0742,21.8243,4577675,0,31722,4545953
8/12/22,Greece,39.0742,21.8243,4577675,0,31722,4545953
8/13/22,Greece,39.0742,21.8243,4577675,0,31722,4545953
8/14/22,Greece,39.0742,21.8243,4577675,0,31722,4545953
8/15/22,Greece,39.0742,21.8243,4577675,0,31722,4545953
8/16/22,Greece,39.0742,21.8243,4654737,0,32028,4622709
8/17/22,Greece,39.0742,21.8243,4654737,0,32028,4622709
8/18/22,Greece,39.0742,21.8243,4654737,0,32028,4622709
8/19/22,Greece,39.0742,21.8243,4654737,0,32028,4622709
8/20/22,Greece,39.0742,21.8243,4654737,0,32028,4622709
8/21/22,Greece,39.0742,21.8243,4654737,0,32028,4622709
8/22/22,Greece,39.0742,21.8243,4654737,0,32028,4622709
8/23/22,Greece,39.0742,21.8243,4712025,0,32335,4679690
8/24/22,Greece,39.0742,21.8243,4712025,0,32335,4679690
8/25/22,Greece,39.0742,21.8243,4712025,0,32335,4679690
8/26/22,Greece,39.0742,21.8243,4712025,0,32335,4679690
8/27/22,Greece,39.0742,21.8243,4712025,0,32335,4679690
8/28/22,Greece,39.0742,21.8243,4712025,0,32335,4679690
8/29/22,Greece,39.0742,21.8243,4712025,0,32335,4679690
8/30/22,Greece,39.0742,21.8243,4762827,0,32552,4730275
8/31/22,Greece,39.0742,21.8243,4762827,0,32552,4730275
9/1/22,Greece,39.0742,21.8243,4762827,0,32552,4730275
9/2/22,Greece,39.0742,21.8243,4762827,0,32552,4730275
9/3/22,Greece,39.0742,21.8243,4762827,0,32552,4730275
9/4/22,Greece,39.0742,21.8243,4762827,0,32552,4730275
9/5/22,Greece,39.0742,21.8243,4762827,0,32552,4730275
9/6/22,Greece,39.0742,21.8243,4804982,0,32757,4772225
9/7/22,Greece,39.0742,21.8243,4804982,0,32757,4772225
9/8/22,Greece,39.0742,21.8243,4804982,0,32757,4772225
9/9/22,Greece,39.0742,21.8243,4804982,0,32757,4772225
9/10/22,Greece,39.0742,21.8243,4804982,0,32757,4772225
9/11/22,Greece,39.0742,21.8243,4804982,0,32757,4772225
9/12/22,Greece,39.0742,21.8243,4804982,0,32757,4772225
9/13/22,Greece,39.0742,21.8243,4838811,0,32894,4805917
9/14/22,Greece,39.0742,21.8243,4838811,0,32894,4805917
9/15/22,Greece,39.0742,21.8243,4838811,0,32894,4805917
9/16/22,Greece,39.0742,21.8243,4838811,0,32894,4805917
9/17/22,Greece,39.0742,21.8243,4838811,0,32894,4805917
9/18/22,Greece,39.0742,21.8243,4838811,0,32894,4805917
9/19/22,Greece,39.0742,21.8243,4838811,0,32894,4805917
9/20/22,Greece,39.0742,21.8243,4875215,0,33010,4842205
9/21/22,Greece,39.0742,21.8243,4875215,0,33010,4842205
9/22/22,Greece,39.0742,21.8243,4875215,0,33010,4842205
9/23/22,Greece,39.0742,21.8243,4875215,0,33010,4842205
9/24/22,Greece,39.0742,21.8243,4875215,0,33010,4842205
9/25/22,Greece,39.0742,21.8243,4875215,0,33010,4842205
9/26/22,Greece,39.0742,21.8243,4875215,0,33010,4842205
9/27/22,Greece,39.0742,21.8243,4920192,0,33111,4887081
9/28/22,Greece,39.0742,21.8243,4920192,0,33111,4887081
9/29/22,Greece,39.0742,21.8243,4920192,0,33111,4887081
9/30/22,Greece,39.0742,21.8243,4920192,0,33111,4887081
10/1/22,Greece,39.0742,21.8243,4920192,0,33111,4887081
10/2/22,Greece,39.0742,21.8243,4920192,0,33111,4887081
10/3/22,Greece,39.0742,21.8243,4920192,0,33111,4887081
10/4/22,Greece,39.0742,21.8243,4975067,0,33200,4941867
10/5/22,Greece,39.0742,21.8243,4975067,0,33200,4941867
10/6/22,Greece,39.0742,21.8243,4975067,0,33200,4941867
10/7/22,Greece,39.0742,21.8243,4975067,0,33200,4941867
10/8/22,Greece,39.0742,21.8243,4975067,0,33200,4941867
10/9/22,Greece,39.0742,21.8243,4975067,0,33200,4941867
10/10/22,Greece,39.0742,21.8243,4975067,0,33200,4941867
10/11/22,Greece,39.0742,21.8243,5026494,0,33313,4993181
10/12/22,Greece,39.0742,21.8243,5026494,0,33313,4993181
10/13/22,Greece,39.0742,21.8243,5026494,0,33313,4993181
10/14/22,Greece,39.0742,21.8243,5026494,0,33313,4993181
10/15/22,Greece,39.0742,21.8243,5026494,0,33313,4993181
10/16/22,Greece,39.0742,21.8243,5026494,0,33313,4993181
10/17/22,Greece,39.0742,21.8243,5026494,0,33313,4993181
10/18/22,Greece,39.0742,21.8243,5081981,0,33426,5048555
10/19/22,Greece,39.0742,21.8243,5081981,0,33426,5048555
10/20/22,Greece,39.0742,21.8243,5081981,0,33426,5048555
10/21/22,Greece,39.0742,21.8243,5081981,0,33426,5048555
10/22/22,Greece,39.0742,21.8243,5081981,0,33426,5048555
10/23/22,Greece,39.0742,21.8243,5081981,0,33426,5048555
10/24/22,Greece,39.0742,21.8243,5081981,0,33426,5048555
10/25/22,Greece,39.0742,21.8243,5135200,0,33574,5101626
10/26/22,Greece,39.0742,21.8243,5135200,0,33574,5101626
10/27/22,Greece,39.0742,21.8243,5135200,0,33574,5101626
10/28/22,Greece,39.0742,21.8243,5135200,0,33574,5101626
10/29/22,Greece,39.0742,21.8243,5135200,0,33574,5101626
10/30/22,Greece,39.0742,21.8243,5135200,0,33574,5101626
10/31/22,Greece,39.0742,21.8243,5135200,0,33574,5101626
11/1/22,Greece,39.0742,21.8243,5188890,0,33750,5155140
11/2/22,Greece,39.0742,21.8243,5188890,0,33750,5155140
11/3/22,Greece,39.0742,21.8243,5188890,0,33750,5155140
11/4/22,Greece,39.0742,21.8243,5188890,0,33750,5155140
11/5/22,Greece,39.0742,21.8243,5188890,0,33750,5155140
11/6/22,Greece,39.0742,21.8243,5188890,0,33750,5155140
11/7/22,Greece,39.0742,21.8243,5188890,0,33750,5155140
11/8/22,Greece,39.0742,21.8243,5250288,0,33888,5216400
11/9/22,Greece,39.0742,21.8243,5250288,0,33888,5216400
11/10/22,Greece,39.0742,21.8243,5250288,0,33888,5216400
11/11/22,Greece,39.0742,21.8243,5250288,0,33888,5216400
11/12/22,Greece,39.0742,21.8243,5250288,0,33888,5216400
11/13/22,Greece,39.0742,21.8243,5250288,0,33888,5216400
11/14/22,Greece,39.0742,21.8243,5250288,0,33888,5216400
11/15/22,Greece,39.0742,21.8243,5306482,0,34024,5272458
11/16/22,Greece,39.0742,21.8243,5306482,0,34024,5272458
11/17/22,Greece,39.0742,21.8243,5306482,0,34024,5272458
11/18/22,Greece,39.0742,21.8243,5306482,0,34024,5272458
11/19/22,Greece,39.0742,21.8243,5306482,0,34024,5272458
11/20/22,Greece,39.0742,21.8243,5306482,0,34024,5272458
11/21/22,Greece,39.0742,21.8243,5306482,0,34024,5272458
11/22/22,Greece,39.0742,21.8243,5360506,0,34178,5326328
11/23/22,Greece,39.0742,21.8243,5360506,0,34178,5326328
11/24/22,Greece,39.0742,21.8243,5360506,0,34178,5326328
11/25/22,Greece,39.0742,21.8243,5360506,0,34178,5326328
11/26/22,Greece,39.0742,21.8243,5360506,0,34178,5326328
11/27/22,Greece,39.0742,21.8243,5360506,0,34178,5326328
11/28/22,Greece,39.0742,21.8243,5360506,0,34178,5326328
11/29/22,Greece,39.0742,21.8243,5404690,0,34309,5370381
11/30/22,Greece,39.0742,21.8243,5404690,0,34309,5370381
12/1/22,Greece,39.0742,21.8243,5404690,0,34309,5370381
12/2/22,Greece,39.0742,21.8243,5404690,0,34309,5370381
12/3/22,Greece,39.0742,21.8243,5404690,0,34309,5370381
12/4/22,Greece,39.0742,21.8243,5404690,0,34309,5370381
12/5/22,Greece,39.0742,21.8243,5404690,0,34309,5370381
12/6/22,Greece,39.0742,21.8243,5448700,0,34482,5414218
12/7/22,Greece,39.0742,21.8243,5448700,0,34482,5414218
12/8/22,Greece,39.0742,21.8243,5448700,0,34482,5414218
12/9/22,Greece,39.0742,21.8243,5448700,0,34482,5414218
12/10/22,Greece,39.0742,21.8243,5448700,0,34482,5414218
12/11/22,Greece,39.0742,21.8243,5448700,0,34482,5414218
12/12/22,Greece,39.0742,21.8243,5448700,0,34482,5414218
12/13/22,Greece,39.0742,21.8243,5500737,0,34614,5466123
12/14/22,Greece,39.0742,21.8243,5500737,0,34614,5466123
12/15/22,Greece,39.0742,21.8243,5500737,0,34614,5466123
12/16/22,Greece,39.0742,21.8243,5500737,0,34614,5466123
12/17/22,Greece,39.0742,21.8243,5500737,0,34614,5466123
1/1/22,Grenada,12.1165,-61.679,6299,0,200,6099
1/2/22,Grenada,12.1165,-61.679,6306,0,200,6106
1/3/22,Grenada,12.1165,-61.679,6338,0,200,6138
1/4/22,Grenada,12.1165,-61.679,6787,0,200,6587
1/5/22,Grenada,12.1165,-61.679,7101,0,200,6901
1/6/22,Grenada,12.1165,-61.679,7377,0,200,7177
1/7/22,Grenada,12.1165,-61.679,7377,0,200,7177
1/8/22,Grenada,12.1165,-61.679,7669,0,200,7469
1/9/22,Grenada,12.1165,-61.679,7699,0,200,7499
1/10/22,Grenada,12.1165,-61.679,7699,0,200,7499
1/11/22,Grenada,12.1165,-61.679,8601,0,201,8400
1/12/22,Grenada,12.1165,-61.679,8601,0,201,8400
1/13/22,Grenada,12.1165,-61.679,8966,0,201,8765
1/14/22,Grenada,12.1165,-61.679,9259,0,202,9057
1/15/22,Grenada,12.1165,-61.679,9535,0,203,9332
1/16/22,Grenada,12.1165,-61.679,9701,0,203,9498
1/17/22,Grenada,12.1165,-61.679,9718,0,204,9514
1/18/22,Grenada,12.1165,-61.679,10427,0,204,10223
1/19/22,Grenada,12.1165,-61.679,10427,0,204,10223
1/20/22,Grenada,12.1165,-61.679,10960,0,205,10755
1/21/22,Grenada,12.1165,-61.679,10960,0,205,10755
1/22/22,Grenada,12.1165,-61.679,11190,0,205,10985
1/23/22,Grenada,12.1165,-61.679,11344,0,205,11139
1/24/22,Grenada,12.1165,-61.679,11344,0,205,11139
1/25/22,Grenada,12.1165,-61.679,11816,0,207,11609
1/26/22,Grenada,12.1165,-61.679,11816,0,207,11609
1/27/22,Grenada,12.1165,-61.679,12090,0,210,11880
1/28/22,Grenada,12.1165,-61.679,12246,0,210,12036
1/29/22,Grenada,12.1165,-61.679,12311,0,210,12101
1/30/22,Grenada,12.1165,-61.679,12311,0,210,12101
1/31/22,Grenada,12.1165,-61.679,12336,0,210,12126
2/1/22,Grenada,12.1165,-61.679,12498,0,210,12288
2/2/22,Grenada,12.1165,-61.679,12589,0,211,12378
2/3/22,Grenada,12.1165,-61.679,12698,0,211,12487
2/4/22,Grenada,12.1165,-61.679,12774,0,211,12563
2/5/22,Grenada,12.1165,-61.679,12834,0,211,12623
2/6/22,Grenada,12.1165,-61.679,12862,0,211,12651
2/7/22,Grenada,12.1165,-61.679,12872,0,211,12661
2/8/22,Grenada,12.1165,-61.679,12886,0,211,12675
2/9/22,Grenada,12.1165,-61.679,13041,0,212,12829
2/10/22,Grenada,12.1165,-61.679,13102,0,212,12890
2/11/22,Grenada,12.1165,-61.679,13172,0,213,12959
2/12/22,Grenada,12.1165,-61.679,13242,0,213,13029
2/13/22,Grenada,12.1165,-61.679,13255,0,213,13042
2/14/22,Grenada,12.1165,-61.679,13266,0,213,13053
2/15/22,Grenada,12.1165,-61.679,13373,0,214,13159
2/16/22,Grenada,12.1165,-61.679,13413,0,214,13199
2/17/22,Grenada,12.1165,-61.679,13452,0,214,13238
2/18/22,Grenada,12.1165,-61.679,13491,0,214,13277
2/19/22,Grenada,12.1165,-61.679,13525,0,214,13311
2/20/22,Grenada,12.1165,-61.679,13526,0,214,13312
2/21/22,Grenada,12.1165,-61.679,13532,0,214,13318
2/22/22,Grenada,12.1165,-61.679,13565,0,214,13351
2/23/22,Grenada,12.1165,-61.679,13565,0,214,13351
2/24/22,Grenada,12.1165,-61.679,13598,0,214,13384
2/25/22,Grenada,12.1165,-61.679,13661,0,214,13447
2/26/22,Grenada,12.1165,-61.679,13696,0,214,13482
2/27/22,Grenada,12.1165,-61.679,13679,0,216,13463
2/28/22,Grenada,12.1165,-61.679,13690,0,216,13474
3/1/22,Grenada,12.1165,-61.679,13690,0,216,13474
3/2/22,Grenada,12.1165,-61.679,13690,0,216,13474
3/3/22,Grenada,12.1165,-61.679,13690,0,216,13474
3/4/22,Grenada,12.1165,-61.679,13690,0,216,13474
3/5/22,Grenada,12.1165,-61.679,13690,0,216,13474
3/6/22,Grenada,12.1165,-61.679,13690,0,216,13474
3/7/22,Grenada,12.1165,-61.679,13690,0,216,13474
3/8/22,Grenada,12.1165,-61.679,13690,0,216,13474
3/9/22,Grenada,12.1165,-61.679,13690,0,216,13474
3/10/22,Grenada,12.1165,-61.679,13690,0,216,13474
3/11/22,Grenada,12.1165,-61.679,13690,0,216,13474
3/12/22,Grenada,12.1165,-61.679,13690,0,216,13474
3/13/22,Grenada,12.1165,-61.679,13690,0,216,13474
3/14/22,Grenada,12.1165,-61.679,13690,0,216,13474
3/15/22,Grenada,12.1165,-61.679,13690,0,216,13474
3/16/22,Grenada,12.1165,-61.679,13921,0,217,13704
3/17/22,Grenada,12.1165,-61.679,13921,0,217,13704
3/18/22,Grenada,12.1165,-61.679,13936,0,217,13719
3/19/22,Grenada,12.1165,-61.679,13936,0,217,13719
3/20/22,Grenada,12.1165,-61.679,13936,0,217,13719
3/21/22,Grenada,12.1165,-61.679,13936,0,217,13719
3/22/22,Grenada,12.1165,-61.679,13954,0,218,13736
3/23/22,Grenada,12.1165,-61.679,13954,0,218,13736
3/24/22,Grenada,12.1165,-61.679,13967,0,218,13749
3/25/22,Grenada,12.1165,-61.679,13967,0,218,13749
3/26/22,Grenada,12.1165,-61.679,13982,0,218,13764
3/27/22,Grenada,12.1165,-61.679,13982,0,218,13764
3/28/22,Grenada,12.1165,-61.679,13982,0,218,13764
3/29/22,Grenada,12.1165,-61.679,13982,0,218,13764
3/30/22,Grenada,12.1165,-61.679,13998,0,218,13780
3/31/22,Grenada,12.1165,-61.679,14012,0,218,13794
4/1/22,Grenada,12.1165,-61.679,14012,0,218,13794
4/2/22,Grenada,12.1165,-61.679,14012,0,218,13794
4/3/22,Grenada,12.1165,-61.679,14024,0,218,13806
4/4/22,Grenada,12.1165,-61.679,14024,0,218,13806
4/5/22,Grenada,12.1165,-61.679,14024,0,218,13806
4/6/22,Grenada,12.1165,-61.679,14024,0,218,13806
4/7/22,Grenada,12.1165,-61.679,14024,0,218,13806
4/8/22,Grenada,12.1165,-61.679,14024,0,218,13806
4/9/22,Grenada,12.1165,-61.679,14024,0,218,13806
4/10/22,Grenada,12.1165,-61.679,14064,0,219,13845
4/11/22,Grenada,12.1165,-61.679,14064,0,219,13845
4/12/22,Grenada,12.1165,-61.679,14064,0,219,13845
4/13/22,Grenada,12.1165,-61.679,14092,0,219,13873
4/14/22,Grenada,12.1165,-61.679,14165,0,219,13946
4/15/22,Grenada,12.1165,-61.679,14165,0,219,13946
4/16/22,Grenada,12.1165,-61.679,14165,0,219,13946
4/17/22,Grenada,12.1165,-61.679,14165,0,219,13946
4/18/22,Grenada,12.1165,-61.679,14165,0,219,13946
4/19/22,Grenada,12.1165,-61.679,14165,0,219,13946
4/20/22,Grenada,12.1165,-61.679,14287,0,219,14068
4/21/22,Grenada,12.1165,-61.679,14332,0,220,14112
4/22/22,Grenada,12.1165,-61.679,14332,0,220,14112
4/23/22,Grenada,12.1165,-61.679,14428,0,220,14208
4/24/22,Grenada,12.1165,-61.679,14428,0,220,14208
4/25/22,Grenada,12.1165,-61.679,14428,0,220,14208
4/26/22,Grenada,12.1165,-61.679,14519,0,220,14299
4/27/22,Grenada,12.1165,-61.679,14519,0,220,14299
4/28/22,Grenada,12.1165,-61.679,14629,0,220,14409
4/29/22,Grenada,12.1165,-61.679,14629,0,220,14409
4/30/22,Grenada,12.1165,-61.679,14629,0,220,14409
5/1/22,Grenada,12.1165,-61.679,14743,0,220,14523
5/2/22,Grenada,12.1165,-61.679,14743,0,220,14523
5/3/22,Grenada,12.1165,-61.679,14743,0,220,14523
5/4/22,Grenada,12.1165,-61.679,14984,0,220,14764
5/5/22,Grenada,12.1165,-61.679,15138,0,220,14918
5/6/22,Grenada,12.1165,-61.679,15303,0,220,15083
5/7/22,Grenada,12.1165,-61.679,15483,0,220,15263
5/8/22,Grenada,12.1165,-61.679,15483,0,220,15263
5/9/22,Grenada,12.1165,-61.679,15483,0,220,15263
5/10/22,Grenada,12.1165,-61.679,15818,0,220,15598
5/11/22,Grenada,12.1165,-61.679,16014,0,221,15793
5/12/22,Grenada,12.1165,-61.679,16191,0,221,15970
5/13/22,Grenada,12.1165,-61.679,16344,0,221,16123
5/14/22,Grenada,12.1165,-61.679,16344,0,221,16123
5/15/22,Grenada,12.1165,-61.679,16512,0,221,16291
5/16/22,Grenada,12.1165,-61.679,16512,0,221,16291
5/17/22,Grenada,12.1165,-61.679,16784,0,221,16563
5/18/22,Grenada,12.1165,-61.679,16918,0,222,16696
5/19/22,Grenada,12.1165,-61.679,17061,0,223,16838
5/20/22,Grenada,12.1165,-61.679,17146,0,223,16923
5/21/22,Grenada,12.1165,-61.679,17146,0,223,16923
5/22/22,Grenada,12.1165,-61.679,17234,0,223,17011
5/23/22,Grenada,12.1165,-61.679,17234,0,223,17011
5/24/22,Grenada,12.1165,-61.679,17390,0,224,17166
5/25/22,Grenada,12.1165,-61.679,17482,0,225,17257
5/26/22,Grenada,12.1165,-61.679,17556,0,226,17330
5/27/22,Grenada,12.1165,-61.679,17612,0,226,17386
5/28/22,Grenada,12.1165,-61.679,17662,0,226,17436
5/29/22,Grenada,12.1165,-61.679,17662,0,226,17436
5/30/22,Grenada,12.1165,-61.679,17662,0,226,17436
5/31/22,Grenada,12.1165,-61.679,17750,0,226,17524
6/1/22,Grenada,12.1165,-61.679,17750,0,226,17524
6/2/22,Grenada,12.1165,-61.679,17833,0,228,17605
6/3/22,Grenada,12.1165,-61.679,17866,0,230,17636
6/4/22,Grenada,12.1165,-61.679,17866,0,230,17636
6/5/22,Grenada,12.1165,-61.679,17866,0,230,17636
6/6/22,Grenada,12.1165,-61.679,17866,0,230,17636
6/7/22,Grenada,12.1165,-61.679,17948,0,231,17717
6/8/22,Grenada,12.1165,-61.679,17948,0,231,17717
6/9/22,Grenada,12.1165,-61.679,18035,0,231,17804
6/10/22,Grenada,12.1165,-61.679,18035,0,231,17804
6/11/22,Grenada,12.1165,-61.679,18035,0,231,17804
6/12/22,Grenada,12.1165,-61.679,18035,0,231,17804
6/13/22,Grenada,12.1165,-61.679,18035,0,231,17804
6/14/22,Grenada,12.1165,-61.679,18115,0,231,17884
6/15/22,Grenada,12.1165,-61.679,18115,0,231,17884
6/16/22,Grenada,12.1165,-61.679,18115,0,231,17884
6/17/22,Grenada,12.1165,-61.679,18115,0,231,17884
6/18/22,Grenada,12.1165,-61.679,18115,0,231,17884
6/19/22,Grenada,12.1165,-61.679,18115,0,231,17884
6/20/22,Grenada,12.1165,-61.679,18115,0,231,17884
6/21/22,Grenada,12.1165,-61.679,18205,0,232,17973
6/22/22,Grenada,12.1165,-61.679,18205,0,232,17973
6/23/22,Grenada,12.1165,-61.679,18243,0,232,18011
6/24/22,Grenada,12.1165,-61.679,18243,0,232,18011
6/25/22,Grenada,12.1165,-61.679,18270,0,232,18038
6/26/22,Grenada,12.1165,-61.679,18270,0,232,18038
6/27/22,Grenada,12.1165,-61.679,18270,0,232,18038
6/28/22,Grenada,12.1165,-61.679,18270,0,232,18038
6/29/22,Grenada,12.1165,-61.679,18270,0,232,18038
6/30/22,Grenada,12.1165,-61.679,18357,0,232,18125
7/1/22,Grenada,12.1165,-61.679,18376,0,232,18144
7/2/22,Grenada,12.1165,-61.679,18376,0,232,18144
7/3/22,Grenada,12.1165,-61.679,18376,0,232,18144
7/4/22,Grenada,12.1165,-61.679,18376,0,232,18144
7/5/22,Grenada,12.1165,-61.679,18475,0,232,18243
7/6/22,Grenada,12.1165,-61.679,18475,0,232,18243
7/7/22,Grenada,12.1165,-61.679,18475,0,232,18243
7/8/22,Grenada,12.1165,-61.679,18531,0,233,18298
7/9/22,Grenada,12.1165,-61.679,18531,0,233,18298
7/10/22,Grenada,12.1165,-61.679,18560,0,233,18327
7/11/22,Grenada,12.1165,-61.679,18560,0,233,18327
7/12/22,Grenada,12.1165,-61.679,18560,0,233,18327
7/13/22,Grenada,12.1165,-61.679,18592,0,233,18359
7/14/22,Grenada,12.1165,-61.679,18592,0,233,18359
7/15/22,Grenada,12.1165,-61.679,18640,0,233,18407
7/16/22,Grenada,12.1165,-61.679,18655,0,233,18422
7/17/22,Grenada,12.1165,-61.679,18655,0,233,18422
7/18/22,Grenada,12.1165,-61.679,18655,0,233,18422
7/19/22,Grenada,12.1165,-61.679,18694,0,233,18461
7/20/22,Grenada,12.1165,-61.679,18694,0,233,18461
7/21/22,Grenada,12.1165,-61.679,18720,0,233,18487
7/22/22,Grenada,12.1165,-61.679,18720,0,233,18487
7/23/22,Grenada,12.1165,-61.679,18720,0,233,18487
7/24/22,Grenada,12.1165,-61.679,18720,0,233,18487
7/25/22,Grenada,12.1165,-61.679,18720,0,233,18487
7/26/22,Grenada,12.1165,-61.679,18768,0,234,18534
7/27/22,Grenada,12.1165,-61.679,18768,0,234,18534
7/28/22,Grenada,12.1165,-61.679,18786,0,234,18552
7/29/22,Grenada,12.1165,-61.679,18786,0,234,18552
7/30/22,Grenada,12.1165,-61.679,18786,0,234,18552
7/31/22,Grenada,12.1165,-61.679,18786,0,234,18552
8/1/22,Grenada,12.1165,-61.679,18786,0,234,18552
8/2/22,Grenada,12.1165,-61.679,18786,0,234,18552
8/3/22,Grenada,12.1165,-61.679,18786,0,234,18552
8/4/22,Grenada,12.1165,-61.679,18822,0,234,18588
8/5/22,Grenada,12.1165,-61.679,18822,0,234,18588
8/6/22,Grenada,12.1165,-61.679,18822,0,234,18588
8/7/22,Grenada,12.1165,-61.679,18845,0,234,18611
8/8/22,Grenada,12.1165,-61.679,18845,0,234,18611
8/9/22,Grenada,12.1165,-61.679,18845,0,234,18611
8/10/22,Grenada,12.1165,-61.679,18845,0,234,18611
8/11/22,Grenada,12.1165,-61.679,18869,0,234,18635
8/12/22,Grenada,12.1165,-61.679,18869,0,234,18635
8/13/22,Grenada,12.1165,-61.679,18895,0,234,18661
8/14/22,Grenada,12.1165,-61.679,18895,0,234,18661
8/15/22,Grenada,12.1165,-61.679,18895,0,234,18661
8/16/22,Grenada,12.1165,-61.679,19006,0,234,18772
8/17/22,Grenada,12.1165,-61.679,19006,0,234,18772
8/18/22,Grenada,12.1165,-61.679,19113,0,234,18879
8/19/22,Grenada,12.1165,-61.679,19113,0,234,18879
8/20/22,Grenada,12.1165,-61.679,19161,0,234,18927
8/21/22,Grenada,12.1165,-61.679,19161,0,234,18927
8/22/22,Grenada,12.1165,-61.679,19161,0,234,18927
8/23/22,Grenada,12.1165,-61.679,19208,0,236,18972
8/24/22,Grenada,12.1165,-61.679,19208,0,236,18972
8/25/22,Grenada,12.1165,-61.679,19268,0,236,19032
8/26/22,Grenada,12.1165,-61.679,19268,0,236,19032
8/27/22,Grenada,12.1165,-61.679,19268,0,236,19032
8/28/22,Grenada,12.1165,-61.679,19289,0,236,19053
8/29/22,Grenada,12.1165,-61.679,19289,0,236,19053
8/30/22,Grenada,12.1165,-61.679,19289,0,236,19053
8/31/22,Grenada,12.1165,-61.679,19289,0,236,19053
9/1/22,Grenada,12.1165,-61.679,19346,0,236,19110
9/2/22,Grenada,12.1165,-61.679,19346,0,236,19110
9/3/22,Grenada,12.1165,-61.679,19346,0,236,19110
9/4/22,Grenada,12.1165,-61.679,19346,0,236,19110
9/5/22,Grenada,12.1165,-61.679,19346,0,236,19110
9/6/22,Grenada,12.1165,-61.679,19403,0,236,19167
9/7/22,Grenada,12.1165,-61.679,19403,0,236,19167
9/8/22,Grenada,12.1165,-61.679,19403,0,236,19167
9/9/22,Grenada,12.1165,-61.679,19403,0,236,19167
9/10/22,Grenada,12.1165,-61.679,19403,0,236,19167
9/11/22,Grenada,12.1165,-61.679,19403,0,236,19167
9/12/22,Grenada,12.1165,-61.679,19403,0,236,19167
9/13/22,Grenada,12.1165,-61.679,19473,0,236,19237
9/14/22,Grenada,12.1165,-61.679,19473,0,236,19237
9/15/22,Grenada,12.1165,-61.679,19473,0,236,19237
9/16/22,Grenada,12.1165,-61.679,19473,0,236,19237
9/17/22,Grenada,12.1165,-61.679,19473,0,236,19237
9/18/22,Grenada,12.1165,-61.679,19473,0,236,19237
9/19/22,Grenada,12.1165,-61.679,19473,0,236,19237
9/20/22,Grenada,12.1165,-61.679,19516,0,236,19280
9/21/22,Grenada,12.1165,-61.679,19516,0,236,19280
9/22/22,Grenada,12.1165,-61.679,19516,0,236,19280
9/23/22,Grenada,12.1165,-61.679,19516,0,236,19280
9/24/22,Grenada,12.1165,-61.679,19536,0,237,19299
9/25/22,Grenada,12.1165,-61.679,19536,0,237,19299
9/26/22,Grenada,12.1165,-61.679,19536,0,237,19299
9/27/22,Grenada,12.1165,-61.679,19536,0,237,19299
9/28/22,Grenada,12.1165,-61.679,19536,0,237,19299
9/29/22,Grenada,12.1165,-61.679,19536,0,237,19299
9/30/22,Grenada,12.1165,-61.679,19536,0,237,19299
10/1/22,Grenada,12.1165,-61.679,19536,0,237,19299
10/2/22,Grenada,12.1165,-61.679,19536,0,237,19299
10/3/22,Grenada,12.1165,-61.679,19536,0,237,19299
10/4/22,Grenada,12.1165,-61.679,19536,0,237,19299
10/5/22,Grenada,12.1165,-61.679,19536,0,237,19299
10/6/22,Grenada,12.1165,-61.679,19536,0,237,19299
10/7/22,Grenada,12.1165,-61.679,19536,0,237,19299
10/8/22,Grenada,12.1165,-61.679,19536,0,237,19299
10/9/22,Grenada,12.1165,-61.679,19536,0,237,19299
10/10/22,Grenada,12.1165,-61.679,19536,0,237,19299
10/11/22,Grenada,12.1165,-61.679,19536,0,237,19299
10/12/22,Grenada,12.1165,-61.679,19574,0,237,19337
10/13/22,Grenada,12.1165,-61.679,19574,0,237,19337
10/14/22,Grenada,12.1165,-61.679,19574,0,237,19337
10/15/22,Grenada,12.1165,-61.679,19574,0,237,19337
10/16/22,Grenada,12.1165,-61.679,19574,0,237,19337
10/17/22,Grenada,12.1165,-61.679,19574,0,237,19337
10/18/22,Grenada,12.1165,-61.679,19584,0,237,19347
10/19/22,Grenada,12.1165,-61.679,19584,0,237,19347
10/20/22,Grenada,12.1165,-61.679,19584,0,237,19347
10/21/22,Grenada,12.1165,-61.679,19584,0,237,19347
10/22/22,Grenada,12.1165,-61.679,19584,0,237,19347
10/23/22,Grenada,12.1165,-61.679,19584,0,237,19347
10/24/22,Grenada,12.1165,-61.679,19584,0,237,19347
10/25/22,Grenada,12.1165,-61.679,19591,0,237,19354
10/26/22,Grenada,12.1165,-61.679,19591,0,237,19354
10/27/22,Grenada,12.1165,-61.679,19591,0,237,19354
10/28/22,Grenada,12.1165,-61.679,19591,0,237,19354
10/29/22,Grenada,12.1165,-61.679,19591,0,237,19354
10/30/22,Grenada,12.1165,-61.679,19591,0,237,19354
10/31/22,Grenada,12.1165,-61.679,19591,0,237,19354
11/1/22,Grenada,12.1165,-61.679,19591,0,237,19354
11/2/22,Grenada,12.1165,-61.679,19591,0,237,19354
11/3/22,Grenada,12.1165,-61.679,19604,0,237,19367
11/4/22,Grenada,12.1165,-61.679,19604,0,237,19367
11/5/22,Grenada,12.1165,-61.679,19604,0,237,19367
11/6/22,Grenada,12.1165,-61.679,19604,0,237,19367
11/7/22,Grenada,12.1165,-61.679,19604,0,237,19367
11/8/22,Grenada,12.1165,-61.679,19604,0,237,19367
11/9/22,Grenada,12.1165,-61.679,19604,0,237,19367
11/10/22,Grenada,12.1165,-61.679,19604,0,237,19367
11/11/22,Grenada,12.1165,-61.679,19613,0,237,19376
11/12/22,Grenada,12.1165,-61.679,19613,0,237,19376
11/13/22,Grenada,12.1165,-61.679,19613,0,237,19376
11/14/22,Grenada,12.1165,-61.679,19613,0,237,19376
11/15/22,Grenada,12.1165,-61.679,19613,0,237,19376
11/16/22,Grenada,12.1165,-61.679,19613,0,237,19376
11/17/22,Grenada,12.1165,-61.679,19616,0,237,19379
11/18/22,Grenada,12.1165,-61.679,19616,0,237,19379
11/19/22,Grenada,12.1165,-61.679,19616,0,237,19379
11/20/22,Grenada,12.1165,-61.679,19616,0,237,19379
11/21/22,Grenada,12.1165,-61.679,19616,0,237,19379
11/22/22,Grenada,12.1165,-61.679,19616,0,237,19379
11/23/22,Grenada,12.1165,-61.679,19616,0,237,19379
11/24/22,Grenada,12.1165,-61.679,19616,0,237,19379
11/25/22,Grenada,12.1165,-61.679,19616,0,237,19379
11/26/22,Grenada,12.1165,-61.679,19616,0,237,19379
11/27/22,Grenada,12.1165,-61.679,19616,0,237,19379
11/28/22,Grenada,12.1165,-61.679,19616,0,237,19379
11/29/22,Grenada,12.1165,-61.679,19631,0,237,19394
11/30/22,Grenada,12.1165,-61.679,19631,0,237,19394
12/1/22,Grenada,12.1165,-61.679,19631,0,237,19394
12/2/22,Grenada,12.1165,-61.679,19631,0,237,19394
12/3/22,Grenada,12.1165,-61.679,19631,0,237,19394
12/4/22,Grenada,12.1165,-61.679,19631,0,237,19394
12/5/22,Grenada,12.1165,-61.679,19631,0,237,19394
12/6/22,Grenada,12.1165,-61.679,19636,0,237,19399
12/7/22,Grenada,12.1165,-61.679,19636,0,237,19399
12/8/22,Grenada,12.1165,-61.679,19636,0,237,19399
12/9/22,Grenada,12.1165,-61.679,19636,0,237,19399
12/10/22,Grenada,12.1165,-61.679,19636,0,237,19399
12/11/22,Grenada,12.1165,-61.679,19636,0,237,19399
12/12/22,Grenada,12.1165,-61.679,19636,0,237,19399
12/13/22,Grenada,12.1165,-61.679,19644,0,238,19406
12/14/22,Grenada,12.1165,-61.679,19644,0,238,19406
12/15/22,Grenada,12.1165,-61.679,19644,0,238,19406
12/16/22,Grenada,12.1165,-61.679,19644,0,238,19406
12/17/22,Grenada,12.1165,-61.679,19644,0,238,19406
1/1/22,Guatemala,15.7835,-90.2308,628589,0,16108,612481
1/2/22,Guatemala,15.7835,-90.2308,628695,0,16109,612586
1/3/22,Guatemala,15.7835,-90.2308,628804,0,16110,612694
1/4/22,Guatemala,15.7835,-90.2308,629811,0,16111,613700
1/5/22,Guatemala,15.7835,-90.2308,631730,0,16114,615616
1/6/22,Guatemala,15.7835,-90.2308,631730,0,16114,615616
1/7/22,Guatemala,15.7835,-90.2308,635613,0,16118,619495
1/8/22,Guatemala,15.7835,-90.2308,637663,0,16124,621539
1/9/22,Guatemala,15.7835,-90.2308,638705,0,16125,622580
1/10/22,Guatemala,15.7835,-90.2308,639048,0,16126,622922
1/11/22,Guatemala,15.7835,-90.2308,641164,0,16127,625037
1/12/22,Guatemala,15.7835,-90.2308,643447,0,16128,627319
1/13/22,Guatemala,15.7835,-90.2308,646319,0,16145,630174
1/14/22,Guatemala,15.7835,-90.2308,648947,0,16160,632787
1/15/22,Guatemala,15.7835,-90.2308,651774,0,16175,635599
1/16/22,Guatemala,15.7835,-90.2308,653171,0,16176,636995
1/17/22,Guatemala,15.7835,-90.2308,653555,0,16179,637376
1/18/22,Guatemala,15.7835,-90.2308,656456,0,16191,640265
1/19/22,Guatemala,15.7835,-90.2308,659655,0,16203,643452
1/20/22,Guatemala,15.7835,-90.2308,662828,0,16223,646605
1/21/22,Guatemala,15.7835,-90.2308,666017,0,16245,649772
1/22/22,Guatemala,15.7835,-90.2308,669012,0,16263,652749
1/23/22,Guatemala,15.7835,-90.2308,669830,0,16268,653562
1/24/22,Guatemala,15.7835,-90.2308,670489,0,16272,654217
1/25/22,Guatemala,15.7835,-90.2308,673559,0,16285,657274
1/26/22,Guatemala,15.7835,-90.2308,677214,0,16294,660920
1/27/22,Guatemala,15.7835,-90.2308,681308,0,16317,664991
1/28/22,Guatemala,15.7835,-90.2308,685542,0,16343,669199
1/29/22,Guatemala,15.7835,-90.2308,688326,0,16373,671953
1/30/22,Guatemala,15.7835,-90.2308,689609,0,16379,673230
1/31/22,Guatemala,15.7835,-90.2308,690290,0,16385,673905
2/1/22,Guatemala,15.7835,-90.2308,694513,0,16401,678112
2/2/22,Guatemala,15.7835,-90.2308,698385,0,16421,681964
2/3/22,Guatemala,15.7835,-90.2308,702310,0,16446,685864
2/4/22,Guatemala,15.7835,-90.2308,705614,0,16470,689144
2/5/22,Guatemala,15.7835,-90.2308,709910,0,16495,693415
2/6/22,Guatemala,15.7835,-90.2308,711076,0,16501,694575
2/7/22,Guatemala,15.7835,-90.2308,712057,0,16509,695548
2/8/22,Guatemala,15.7835,-90.2308,716082,0,16527,699555
2/9/22,Guatemala,15.7835,-90.2308,720802,0,16542,704260
2/10/22,Guatemala,15.7835,-90.2308,725701,0,16577,709124
2/11/22,Guatemala,15.7835,-90.2308,729977,0,16611,713366
2/12/22,Guatemala,15.7835,-90.2308,733960,0,16627,717333
2/13/22,Guatemala,15.7835,-90.2308,735099,0,16637,718462
2/14/22,Guatemala,15.7835,-90.2308,735957,0,16643,719314
2/15/22,Guatemala,15.7835,-90.2308,740011,0,16661,723350
2/16/22,Guatemala,15.7835,-90.2308,744754,0,16679,728075
2/17/22,Guatemala,15.7835,-90.2308,749257,0,16709,732548
2/18/22,Guatemala,15.7835,-90.2308,753281,0,16744,736537
2/19/22,Guatemala,15.7835,-90.2308,756600,0,16780,739820
2/20/22,Guatemala,15.7835,-90.2308,757588,0,16787,740801
2/21/22,Guatemala,15.7835,-90.2308,758303,0,16794,741509
2/22/22,Guatemala,15.7835,-90.2308,762096,0,16833,745263
2/23/22,Guatemala,15.7835,-90.2308,766475,0,16861,749614
2/24/22,Guatemala,15.7835,-90.2308,770135,0,16906,753229
2/25/22,Guatemala,15.7835,-90.2308,773575,0,16939,756636
2/26/22,Guatemala,15.7835,-90.2308,776262,0,16961,759301
2/27/22,Guatemala,15.7835,-90.2308,776991,0,16971,760020
2/28/22,Guatemala,15.7835,-90.2308,776991,0,16971,760020
3/1/22,Guatemala,15.7835,-90.2308,780815,0,17010,763805
3/2/22,Guatemala,15.7835,-90.2308,784024,0,17018,767006
3/3/22,Guatemala,15.7835,-90.2308,786869,0,17029,769840
3/4/22,Guatemala,15.7835,-90.2308,789354,0,17045,772309
3/5/22,Guatemala,15.7835,-90.2308,791944,0,17073,774871
3/6/22,Guatemala,15.7835,-90.2308,792503,0,17077,775426
3/7/22,Guatemala,15.7835,-90.2308,792961,0,17083,775878
3/8/22,Guatemala,15.7835,-90.2308,795808,0,17106,778702
3/9/22,Guatemala,15.7835,-90.2308,798400,0,17116,781284
3/10/22,Guatemala,15.7835,-90.2308,800403,0,17127,783276
3/11/22,Guatemala,15.7835,-90.2308,802744,0,17139,785605
3/12/22,Guatemala,15.7835,-90.2308,804709,0,17144,787565
3/13/22,Guatemala,15.7835,-90.2308,805030,0,17153,787877
3/14/22,Guatemala,15.7835,-90.2308,805393,0,17159,788234
3/15/22,Guatemala,15.7835,-90.2308,807453,0,17170,790283
3/16/22,Guatemala,15.7835,-90.2308,809586,0,17178,792408
3/17/22,Guatemala,15.7835,-90.2308,812125,0,17191,794934
3/18/22,Guatemala,15.7835,-90.2308,814111,0,17206,796905
3/19/22,Guatemala,15.7835,-90.2308,815776,0,17231,798545
3/20/22,Guatemala,15.7835,-90.2308,816136,0,17238,798898
3/21/22,Guatemala,15.7835,-90.2308,816653,0,17241,799412
3/22/22,Guatemala,15.7835,-90.2308,818454,0,17253,801201
3/23/22,Guatemala,15.7835,-90.2308,820477,0,17258,803219
3/24/22,Guatemala,15.7835,-90.2308,821834,0,17267,804567
3/25/22,Guatemala,15.7835,-90.2308,823145,0,17274,805871
3/26/22,Guatemala,15.7835,-90.2308,824159,0,17278,806881
3/27/22,Guatemala,15.7835,-90.2308,824502,0,17285,807217
3/28/22,Guatemala,15.7835,-90.2308,824644,0,17289,807355
3/29/22,Guatemala,15.7835,-90.2308,826061,0,17295,808766
3/30/22,Guatemala,15.7835,-90.2308,827596,0,17300,810296
3/31/22,Guatemala,15.7835,-90.2308,828874,0,17312,811562
4/1/22,Guatemala,15.7835,-90.2308,829881,0,17318,812563
4/2/22,Guatemala,15.7835,-90.2308,830745,0,17325,813420
4/3/22,Guatemala,15.7835,-90.2308,830933,0,17327,813606
4/4/22,Guatemala,15.7835,-90.2308,831149,0,17329,813820
4/5/22,Guatemala,15.7835,-90.2308,832159,0,17338,814821
4/6/22,Guatemala,15.7835,-90.2308,832956,0,17350,815606
4/7/22,Guatemala,15.7835,-90.2308,833723,0,17361,816362
4/8/22,Guatemala,15.7835,-90.2308,834481,0,17367,817114
4/9/22,Guatemala,15.7835,-90.2308,835213,0,17373,817840
4/10/22,Guatemala,15.7835,-90.2308,835338,0,17377,817961
4/11/22,Guatemala,15.7835,-90.2308,835425,0,17379,818046
4/12/22,Guatemala,15.7835,-90.2308,836234,0,17400,818834
4/13/22,Guatemala,15.7835,-90.2308,837087,0,17411,819676
4/14/22,Guatemala,15.7835,-90.2308,837326,0,17416,819910
4/15/22,Guatemala,15.7835,-90.2308,837377,0,17422,819955
4/16/22,Guatemala,15.7835,-90.2308,837492,0,17427,820065
4/17/22,Guatemala,15.7835,-90.2308,837558,0,17430,820128
4/18/22,Guatemala,15.7835,-90.2308,837608,0,17434,820174
4/19/22,Guatemala,15.7835,-90.2308,838518,0,17445,821073
4/20/22,Guatemala,15.7835,-90.2308,839416,0,17457,821959
4/21/22,Guatemala,15.7835,-90.2308,840477,0,17475,823002
4/22/22,Guatemala,15.7835,-90.2308,841341,0,17496,823845
4/23/22,Guatemala,15.7835,-90.2308,842369,0,17514,824855
4/24/22,Guatemala,15.7835,-90.2308,842572,0,17520,825052
4/25/22,Guatemala,15.7835,-90.2308,842653,0,17525,825128
4/26/22,Guatemala,15.7835,-90.2308,843269,0,17534,825735
4/27/22,Guatemala,15.7835,-90.2308,844059,0,17538,826521
4/28/22,Guatemala,15.7835,-90.2308,844989,0,17545,827444
4/29/22,Guatemala,15.7835,-90.2308,845868,0,17566,828302
4/30/22,Guatemala,15.7835,-90.2308,846546,0,17584,828962
5/1/22,Guatemala,15.7835,-90.2308,846611,0,17600,829011
5/2/22,Guatemala,15.7835,-90.2308,846632,0,17613,829019
5/3/22,Guatemala,15.7835,-90.2308,846785,0,17622,829163
5/4/22,Guatemala,15.7835,-90.2308,847491,0,17636,829855
5/5/22,Guatemala,15.7835,-90.2308,848098,0,17653,830445
5/6/22,Guatemala,15.7835,-90.2308,848807,0,17683,831124
5/7/22,Guatemala,15.7835,-90.2308,849417,0,17698,831719
5/8/22,Guatemala,15.7835,-90.2308,849495,0,17699,831796
5/9/22,Guatemala,15.7835,-90.2308,849552,0,17703,831849
5/10/22,Guatemala,15.7835,-90.2308,850255,0,17719,832536
5/11/22,Guatemala,15.7835,-90.2308,850255,0,17719,832536
5/12/22,Guatemala,15.7835,-90.2308,851215,0,17772,833443
5/13/22,Guatemala,15.7835,-90.2308,851877,0,17792,834085
5/14/22,Guatemala,15.7835,-90.2308,852432,0,17817,834615
5/15/22,Guatemala,15.7835,-90.2308,852503,0,17822,834681
5/16/22,Guatemala,15.7835,-90.2308,852591,0,17829,834762
5/17/22,Guatemala,15.7835,-90.2308,853280,0,17842,835438
5/18/22,Guatemala,15.7835,-90.2308,854074,0,17864,836210
5/19/22,Guatemala,15.7835,-90.2308,854891,0,17892,836999
5/20/22,Guatemala,15.7835,-90.2308,855802,0,17923,837879
5/21/22,Guatemala,15.7835,-90.2308,856376,0,17942,838434
5/22/22,Guatemala,15.7835,-90.2308,856496,0,17954,838542
5/23/22,Guatemala,15.7835,-90.2308,856576,0,17969,838607
5/24/22,Guatemala,15.7835,-90.2308,857197,0,17991,839206
5/25/22,Guatemala,15.7835,-90.2308,858015,0,18024,839991
5/26/22,Guatemala,15.7835,-90.2308,858629,0,18047,840582
5/27/22,Guatemala,15.7835,-90.2308,859311,0,18084,841227
5/28/22,Guatemala,15.7835,-90.2308,860006,0,18108,841898
5/29/22,Guatemala,15.7835,-90.2308,860098,0,18117,841981
5/30/22,Guatemala,15.7835,-90.2308,860169,0,18131,842038
5/31/22,Guatemala,15.7835,-90.2308,861002,0,18152,842850
6/1/22,Guatemala,15.7835,-90.2308,861916,0,18168,843748
6/2/22,Guatemala,15.7835,-90.2308,862756,0,18178,844578
6/3/22,Guatemala,15.7835,-90.2308,863595,0,18196,845399
6/4/22,Guatemala,15.7835,-90.2308,864560,0,18208,846352
6/5/22,Guatemala,15.7835,-90.2308,864662,0,18219,846443
6/6/22,Guatemala,15.7835,-90.2308,864768,0,18224,846544
6/7/22,Guatemala,15.7835,-90.2308,865900,0,18234,847666
6/8/22,Guatemala,15.7835,-90.2308,867301,0,18244,849057
6/9/22,Guatemala,15.7835,-90.2308,868360,0,18256,850104
6/10/22,Guatemala,15.7835,-90.2308,868360,0,18256,850104
6/11/22,Guatemala,15.7835,-90.2308,870897,0,18282,852615
6/12/22,Guatemala,15.7835,-90.2308,871112,0,18287,852825
6/13/22,Guatemala,15.7835,-90.2308,871263,0,18293,852970
6/14/22,Guatemala,15.7835,-90.2308,872788,0,18309,854479
6/15/22,Guatemala,15.7835,-90.2308,874926,0,18324,856602
6/16/22,Guatemala,15.7835,-90.2308,876499,0,18351,858148
6/17/22,Guatemala,15.7835,-90.2308,878401,0,18371,860030
6/18/22,Guatemala,15.7835,-90.2308,880169,0,18393,861776
6/19/22,Guatemala,15.7835,-90.2308,880467,0,18401,862066
6/20/22,Guatemala,15.7835,-90.2308,880715,0,18414,862301
6/21/22,Guatemala,15.7835,-90.2308,880715,0,18414,862301
6/22/22,Guatemala,15.7835,-90.2308,886747,0,18435,868312
6/23/22,Guatemala,15.7835,-90.2308,889913,0,18456,871457
6/24/22,Guatemala,15.7835,-90.2308,893071,0,18469,874602
6/25/22,Guatemala,15.7835,-90.2308,896133,0,18491,877642
6/26/22,Guatemala,15.7835,-90.2308,896850,0,18497,878353
6/27/22,Guatemala,15.7835,-90.2308,897462,0,18504,878958
6/28/22,Guatemala,15.7835,-90.2308,901300,0,18516,882784
6/29/22,Guatemala,15.7835,-90.2308,905642,0,18535,887107
6/30/22,Guatemala,15.7835,-90.2308,910714,0,18561,892153
7/1/22,Guatemala,15.7835,-90.2308,915321,0,18572,896749
7/2/22,Guatemala,15.7835,-90.2308,918797,0,18591,900206
7/3/22,Guatemala,15.7835,-90.2308,920294,0,18600,901694
7/4/22,Guatemala,15.7835,-90.2308,921146,0,18616,902530
7/5/22,Guatemala,15.7835,-90.2308,922340,0,18628,903712
7/6/22,Guatemala,15.7835,-90.2308,927473,0,18648,908825
7/7/22,Guatemala,15.7835,-90.2308,933259,0,18666,914593
7/8/22,Guatemala,15.7835,-90.2308,939300,0,18678,920622
7/9/22,Guatemala,15.7835,-90.2308,944993,0,18706,926287
7/10/22,Guatemala,15.7835,-90.2308,947472,0,18715,928757
7/11/22,Guatemala,15.7835,-90.2308,948749,0,18725,930024
7/12/22,Guatemala,15.7835,-90.2308,955370,0,18748,936622
7/13/22,Guatemala,15.7835,-90.2308,963117,0,18756,944361
7/14/22,Guatemala,15.7835,-90.2308,970621,0,18768,951853
7/15/22,Guatemala,15.7835,-90.2308,977539,0,18782,958757
7/16/22,Guatemala,15.7835,-90.2308,982808,0,18813,963995
7/17/22,Guatemala,15.7835,-90.2308,984477,0,18822,965655
7/18/22,Guatemala,15.7835,-90.2308,985245,0,18839,966406
7/19/22,Guatemala,15.7835,-90.2308,991257,0,18851,972406
7/20/22,Guatemala,15.7835,-90.2308,997980,0,18860,979120
7/21/22,Guatemala,15.7835,-90.2308,1004311,0,18881,985430
7/22/22,Guatemala,15.7835,-90.2308,1010612,0,18896,991716
7/23/22,Guatemala,15.7835,-90.2308,1015257,0,18925,996332
7/24/22,Guatemala,15.7835,-90.2308,1016666,0,18934,997732
7/25/22,Guatemala,15.7835,-90.2308,1017542,0,18940,998602
7/26/22,Guatemala,15.7835,-90.2308,1022891,0,18953,1003938
7/27/22,Guatemala,15.7835,-90.2308,1027805,0,18972,1008833
7/28/22,Guatemala,15.7835,-90.2308,1027805,0,18972,1008833
7/29/22,Guatemala,15.7835,-90.2308,1037751,0,19005,1018746
7/30/22,Guatemala,15.7835,-90.2308,1041274,0,19027,1022247
7/31/22,Guatemala,15.7835,-90.2308,1042376,0,19037,1023339
8/1/22,Guatemala,15.7835,-90.2308,1042592,0,19051,1023541
8/2/22,Guatemala,15.7835,-90.2308,1044915,0,19064,1025851
8/3/22,Guatemala,15.7835,-90.2308,1048193,0,19070,1029123
8/4/22,Guatemala,15.7835,-90.2308,1051398,0,19082,1032316
8/5/22,Guatemala,15.7835,-90.2308,1054127,0,19096,1035031
8/6/22,Guatemala,15.7835,-90.2308,1056618,0,19114,1037504
8/7/22,Guatemala,15.7835,-90.2308,1057289,0,19124,1038165
8/8/22,Guatemala,15.7835,-90.2308,1057694,0,19130,1038564
8/9/22,Guatemala,15.7835,-90.2308,1060714,0,19140,1041574
8/10/22,Guatemala,15.7835,-90.2308,1063908,0,19153,1044755
8/11/22,Guatemala,15.7835,-90.2308,1067606,0,19173,1048433
8/12/22,Guatemala,15.7835,-90.2308,1070326,0,19205,1051121
8/13/22,Guatemala,15.7835,-90.2308,1072241,0,19223,1053018
8/14/22,Guatemala,15.7835,-90.2308,1072590,0,19230,1053360
8/15/22,Guatemala,15.7835,-90.2308,1072733,0,19240,1053493
8/16/22,Guatemala,15.7835,-90.2308,1074514,0,19252,1055262
8/17/22,Guatemala,15.7835,-90.2308,1077836,0,19261,1058575
8/18/22,Guatemala,15.7835,-90.2308,1080712,0,19272,1061440
8/19/22,Guatemala,15.7835,-90.2308,1082925,0,19309,1063616
8/20/22,Guatemala,15.7835,-90.2308,1085118,0,19339,1065779
8/21/22,Guatemala,15.7835,-90.2308,1085327,0,19345,1065982
8/22/22,Guatemala,15.7835,-90.2308,1085456,0,19352,1066104
8/23/22,Guatemala,15.7835,-90.2308,1088280,0,19369,1068911
8/24/22,Guatemala,15.7835,-90.2308,1090506,0,19387,1071119
8/25/22,Guatemala,15.7835,-90.2308,1092545,0,19404,1073141
8/26/22,Guatemala,15.7835,-90.2308,1094572,0,19424,1075148
8/27/22,Guatemala,15.7835,-90.2308,1096530,0,19438,1077092
8/28/22,Guatemala,15.7835,-90.2308,1097563,0,19451,1078112
8/29/22,Guatemala,15.7835,-90.2308,1098327,0,19460,1078867
8/30/22,Guatemala,15.7835,-90.2308,1100437,0,19472,1080965
8/31/22,Guatemala,15.7835,-90.2308,1101954,0,19490,1082464
9/1/22,Guatemala,15.7835,-90.2308,1103606,0,19514,1084092
9/2/22,Guatemala,15.7835,-90.2308,1104536,0,19524,1085012
9/3/22,Guatemala,15.7835,-90.2308,1104842,0,19539,1085303
9/4/22,Guatemala,15.7835,-90.2308,1104909,0,19552,1085357
9/5/22,Guatemala,15.7835,-90.2308,1105036,0,19567,1085469
9/6/22,Guatemala,15.7835,-90.2308,1106153,0,19584,1086569
9/7/22,Guatemala,15.7835,-90.2308,1107533,0,19603,1087930
9/8/22,Guatemala,15.7835,-90.2308,1108779,0,19626,1089153
9/9/22,Guatemala,15.7835,-90.2308,1109940,0,19644,1090296
9/10/22,Guatemala,15.7835,-90.2308,1110973,0,19650,1091323
9/11/22,Guatemala,15.7835,-90.2308,1111043,0,19665,1091378
9/12/22,Guatemala,15.7835,-90.2308,1111191,0,19679,1091512
9/13/22,Guatemala,15.7835,-90.2308,1112550,0,19684,1092866
9/14/22,Guatemala,15.7835,-90.2308,1113871,0,19688,1094183
9/15/22,Guatemala,15.7835,-90.2308,1114758,0,19698,1095060
9/16/22,Guatemala,15.7835,-90.2308,1114803,0,19702,1095101
9/17/22,Guatemala,15.7835,-90.2308,1114913,0,19706,1095207
9/18/22,Guatemala,15.7835,-90.2308,1114951,0,19714,1095237
9/19/22,Guatemala,15.7835,-90.2308,1114991,0,19722,1095269
9/20/22,Guatemala,15.7835,-90.2308,1116046,0,19732,1096314
9/21/22,Guatemala,15.7835,-90.2308,1117364,0,19737,1097627
9/22/22,Guatemala,15.7835,-90.2308,1118292,0,19745,1098547
9/23/22,Guatemala,15.7835,-90.2308,1119277,0,19748,1099529
9/24/22,Guatemala,15.7835,-90.2308,1119984,0,19757,1100227
9/25/22,Guatemala,15.7835,-90.2308,1120141,0,19765,1100376
9/26/22,Guatemala,15.7835,-90.2308,1120199,0,19772,1100427
9/27/22,Guatemala,15.7835,-90.2308,1121231,0,19775,1101456
9/28/22,Guatemala,15.7835,-90.2308,1122517,0,19779,1102738
9/29/22,Guatemala,15.7835,-90.2308,1123465,0,19789,1103676
9/30/22,Guatemala,15.7835,-90.2308,1124467,0,19795,1104672
10/1/22,Guatemala,15.7835,-90.2308,1125164,0,19801,1105363
10/2/22,Guatemala,15.7835,-90.2308,1125205,0,19804,1105401
10/3/22,Guatemala,15.7835,-90.2308,1125287,0,19808,1105479
10/4/22,Guatemala,15.7835,-90.2308,1126214,0,19811,1106403
10/5/22,Guatemala,15.7835,-90.2308,1126990,0,19814,1107176
10/6/22,Guatemala,15.7835,-90.2308,1127942,0,19819,1108123
10/7/22,Guatemala,15.7835,-90.2308,1128715,0,19824,1108891
10/8/22,Guatemala,15.7835,-90.2308,1129099,0,19830,1109269
10/9/22,Guatemala,15.7835,-90.2308,1129448,0,19833,1109615
10/10/22,Guatemala,15.7835,-90.2308,1129542,0,19836,1109706
10/11/22,Guatemala,15.7835,-90.2308,1130102,0,19840,1110262
10/12/22,Guatemala,15.7835,-90.2308,1130829,0,19844,1110985
10/13/22,Guatemala,15.7835,-90.2308,1131666,0,19846,1111820
10/14/22,Guatemala,15.7835,-90.2308,1132692,0,19848,1112844
10/15/22,Guatemala,15.7835,-90.2308,1133367,0,19851,1113516
10/16/22,Guatemala,15.7835,-90.2308,1133421,0,19852,1113569
10/17/22,Guatemala,15.7835,-90.2308,1133517,0,19854,1113663
10/18/22,Guatemala,15.7835,-90.2308,1134249,0,19859,1114390
10/19/22,Guatemala,15.7835,-90.2308,1134947,0,19861,1115086
10/20/22,Guatemala,15.7835,-90.2308,1135690,0,19862,1115828
10/21/22,Guatemala,15.7835,-90.2308,1135840,0,19863,1115977
10/22/22,Guatemala,15.7835,-90.2308,1136527,0,19866,1116661
10/23/22,Guatemala,15.7835,-90.2308,1136676,0,19869,1116807
10/24/22,Guatemala,15.7835,-90.2308,1136861,0,19871,1116990
10/25/22,Guatemala,15.7835,-90.2308,1137512,0,19875,1117637
10/26/22,Guatemala,15.7835,-90.2308,1138242,0,19878,1118364
10/27/22,Guatemala,15.7835,-90.2308,1139274,0,19880,1119394
10/28/22,Guatemala,15.7835,-90.2308,1139845,0,19882,1119963
10/29/22,Guatemala,15.7835,-90.2308,1140382,0,19885,1120497
10/30/22,Guatemala,15.7835,-90.2308,1140447,0,19886,1120561
10/31/22,Guatemala,15.7835,-90.2308,1140499,0,19888,1120611
11/1/22,Guatemala,15.7835,-90.2308,1140602,0,19892,1120710
11/2/22,Guatemala,15.7835,-90.2308,1140672,0,19895,1120777
11/3/22,Guatemala,15.7835,-90.2308,1141290,0,19897,1121393
11/4/22,Guatemala,15.7835,-90.2308,1141938,0,19901,1122037
11/5/22,Guatemala,15.7835,-90.2308,1142470,0,19905,1122565
11/6/22,Guatemala,15.7835,-90.2308,1142521,0,19906,1122615
11/7/22,Guatemala,15.7835,-90.2308,1142589,0,19907,1122682
11/8/22,Guatemala,15.7835,-90.2308,1143218,0,19910,1123308
11/9/22,Guatemala,15.7835,-90.2308,1143697,0,19913,1123784
11/10/22,Guatemala,15.7835,-90.2308,1144358,0,19915,1124443
11/11/22,Guatemala,15.7835,-90.2308,1144771,0,19916,1124855
11/12/22,Guatemala,15.7835,-90.2308,1145216,0,19920,1125296
11/13/22,Guatemala,15.7835,-90.2308,1145374,0,19922,1125452
11/14/22,Guatemala,15.7835,-90.2308,1145496,0,19923,1125573
11/15/22,Guatemala,15.7835,-90.2308,1146055,0,19924,1126131
11/16/22,Guatemala,15.7835,-90.2308,1146536,0,19929,1126607
11/17/22,Guatemala,15.7835,-90.2308,1147070,0,19934,1127136
11/18/22,Guatemala,15.7835,-90.2308,1147699,0,19936,1127763
11/19/22,Guatemala,15.7835,-90.2308,1148253,0,19937,1128316
11/20/22,Guatemala,15.7835,-90.2308,1148436,0,19938,1128498
11/21/22,Guatemala,15.7835,-90.2308,1148614,0,19939,1128675
11/22/22,Guatemala,15.7835,-90.2308,1149459,0,19940,1129519
11/23/22,Guatemala,15.7835,-90.2308,1150400,0,19942,1130458
11/24/22,Guatemala,15.7835,-90.2308,1151582,0,19943,1131639
11/25/22,Guatemala,15.7835,-90.2308,1152798,0,19944,1132854
11/26/22,Guatemala,15.7835,-90.2308,1153644,0,19946,1133698
11/27/22,Guatemala,15.7835,-90.2308,1153985,0,19948,1134037
11/28/22,Guatemala,15.7835,-90.2308,1154211,0,19949,1134262
11/29/22,Guatemala,15.7835,-90.2308,1155277,0,19950,1135327
11/30/22,Guatemala,15.7835,-90.2308,1156468,0,19951,1136517
12/1/22,Guatemala,15.7835,-90.2308,1157543,0,19952,1137591
12/2/22,Guatemala,15.7835,-90.2308,1158498,0,19953,1138545
12/3/22,Guatemala,15.7835,-90.2308,1159705,0,19954,1139751
12/4/22,Guatemala,15.7835,-90.2308,1160002,0,19956,1140046
12/5/22,Guatemala,15.7835,-90.2308,1160363,0,19957,1140406
12/6/22,Guatemala,15.7835,-90.2308,1161983,0,19958,1142025
12/7/22,Guatemala,15.7835,-90.2308,1164240,0,19959,1144281
12/8/22,Guatemala,15.7835,-90.2308,1166662,0,19960,1146702
12/9/22,Guatemala,15.7835,-90.2308,1168635,0,19961,1148674
12/10/22,Guatemala,15.7835,-90.2308,1170585,0,19962,1150623
12/11/22,Guatemala,15.7835,-90.2308,1171512,0,19963,1151549
12/12/22,Guatemala,15.7835,-90.2308,1172149,0,19964,1152185
12/13/22,Guatemala,15.7835,-90.2308,1174448,0,19966,1154482
12/14/22,Guatemala,15.7835,-90.2308,1177088,0,19969,1157119
12/15/22,Guatemala,15.7835,-90.2308,1179809,0,19973,1159836
12/16/22,Guatemala,15.7835,-90.2308,1182292,0,19977,1162315
12/17/22,Guatemala,15.7835,-90.2308,1184147,0,19982,1164165
1/1/22,Guinea,9.9456,-9.6966,32448,0,391,32057
1/2/22,Guinea,9.9456,-9.6966,32671,0,391,32280
1/3/22,Guinea,9.9456,-9.6966,32867,0,391,32476
1/4/22,Guinea,9.9456,-9.6966,33045,0,391,32654
1/5/22,Guinea,9.9456,-9.6966,33428,0,393,33035
1/6/22,Guinea,9.9456,-9.6966,33700,0,397,33303
1/7/22,Guinea,9.9456,-9.6966,34139,0,397,33742
1/8/22,Guinea,9.9456,-9.6966,34139,0,397,33742
1/9/22,Guinea,9.9456,-9.6966,34673,0,400,34273
1/10/22,Guinea,9.9456,-9.6966,34673,0,400,34273
1/11/22,Guinea,9.9456,-9.6966,34852,0,403,34449
1/12/22,Guinea,9.9456,-9.6966,35033,0,403,34630
1/13/22,Guinea,9.9456,-9.6966,35202,0,406,34796
1/14/22,Guinea,9.9456,-9.6966,35202,0,406,34796
1/15/22,Guinea,9.9456,-9.6966,35202,0,406,34796
1/16/22,Guinea,9.9456,-9.6966,35202,0,406,34796
1/17/22,Guinea,9.9456,-9.6966,35602,0,408,35194
1/18/22,Guinea,9.9456,-9.6966,35602,0,408,35194
1/19/22,Guinea,9.9456,-9.6966,35719,0,410,35309
1/20/22,Guinea,9.9456,-9.6966,35719,0,410,35309
1/21/22,Guinea,9.9456,-9.6966,35719,0,410,35309
1/22/22,Guinea,9.9456,-9.6966,35857,0,414,35443
1/23/22,Guinea,9.9456,-9.6966,35857,0,414,35443
1/24/22,Guinea,9.9456,-9.6966,35908,0,416,35492
1/25/22,Guinea,9.9456,-9.6966,35951,0,416,35535
1/26/22,Guinea,9.9456,-9.6966,36013,0,416,35597
1/27/22,Guinea,9.9456,-9.6966,36013,0,416,35597
1/28/22,Guinea,9.9456,-9.6966,36013,0,416,35597
1/29/22,Guinea,9.9456,-9.6966,36013,0,416,35597
1/30/22,Guinea,9.9456,-9.6966,36013,0,416,35597
1/31/22,Guinea,9.9456,-9.6966,36166,0,419,35747
2/1/22,Guinea,9.9456,-9.6966,36166,0,419,35747
2/2/22,Guinea,9.9456,-9.6966,36193,0,426,35767
2/3/22,Guinea,9.9456,-9.6966,36206,0,426,35780
2/4/22,Guinea,9.9456,-9.6966,36248,0,426,35822
2/5/22,Guinea,9.9456,-9.6966,36262,0,428,35834
2/6/22,Guinea,9.9456,-9.6966,36262,0,428,35834
2/7/22,Guinea,9.9456,-9.6966,36270,0,432,35838
2/8/22,Guinea,9.9456,-9.6966,36281,0,432,35849
2/9/22,Guinea,9.9456,-9.6966,36297,0,432,35865
2/10/22,Guinea,9.9456,-9.6966,36314,0,434,35880
2/11/22,Guinea,9.9456,-9.6966,36329,0,436,35893
2/12/22,Guinea,9.9456,-9.6966,36329,0,436,35893
2/13/22,Guinea,9.9456,-9.6966,36329,0,436,35893
2/14/22,Guinea,9.9456,-9.6966,36329,0,436,35893
2/15/22,Guinea,9.9456,-9.6966,36329,0,436,35893
2/16/22,Guinea,9.9456,-9.6966,36354,0,438,35916
2/17/22,Guinea,9.9456,-9.6966,36354,0,438,35916
2/18/22,Guinea,9.9456,-9.6966,36354,0,438,35916
2/19/22,Guinea,9.9456,-9.6966,36354,0,438,35916
2/20/22,Guinea,9.9456,-9.6966,36354,0,438,35916
2/21/22,Guinea,9.9456,-9.6966,36393,0,440,35953
2/22/22,Guinea,9.9456,-9.6966,36393,0,440,35953
2/23/22,Guinea,9.9456,-9.6966,36393,0,440,35953
2/24/22,Guinea,9.9456,-9.6966,36393,0,440,35953
2/25/22,Guinea,9.9456,-9.6966,36393,0,440,35953
2/26/22,Guinea,9.9456,-9.6966,36393,0,440,35953
2/27/22,Guinea,9.9456,-9.6966,36393,0,440,35953
2/28/22,Guinea,9.9456,-9.6966,36397,0,440,35957
3/1/22,Guinea,9.9456,-9.6966,36397,0,440,35957
3/2/22,Guinea,9.9456,-9.6966,36397,0,440,35957
3/3/22,Guinea,9.9456,-9.6966,36397,0,440,35957
3/4/22,Guinea,9.9456,-9.6966,36397,0,440,35957
3/5/22,Guinea,9.9456,-9.6966,36397,0,440,35957
3/6/22,Guinea,9.9456,-9.6966,36397,0,440,35957
3/7/22,Guinea,9.9456,-9.6966,36427,0,440,35987
3/8/22,Guinea,9.9456,-9.6966,36427,0,440,35987
3/9/22,Guinea,9.9456,-9.6966,36427,0,440,35987
3/10/22,Guinea,9.9456,-9.6966,36427,0,440,35987
3/11/22,Guinea,9.9456,-9.6966,36427,0,440,35987
3/12/22,Guinea,9.9456,-9.6966,36427,0,440,35987
3/13/22,Guinea,9.9456,-9.6966,36427,0,440,35987
3/14/22,Guinea,9.9456,-9.6966,36435,0,440,35995
3/15/22,Guinea,9.9456,-9.6966,36435,0,440,35995
3/16/22,Guinea,9.9456,-9.6966,36435,0,440,35995
3/17/22,Guinea,9.9456,-9.6966,36435,0,440,35995
3/18/22,Guinea,9.9456,-9.6966,36435,0,440,35995
3/19/22,Guinea,9.9456,-9.6966,36435,0,440,35995
3/20/22,Guinea,9.9456,-9.6966,36435,0,440,35995
3/21/22,Guinea,9.9456,-9.6966,36459,0,440,36019
3/22/22,Guinea,9.9456,-9.6966,36459,0,440,36019
3/23/22,Guinea,9.9456,-9.6966,36459,0,440,36019
3/24/22,Guinea,9.9456,-9.6966,36459,0,440,36019
3/25/22,Guinea,9.9456,-9.6966,36459,0,440,36019
3/26/22,Guinea,9.9456,-9.6966,36459,0,440,36019
3/27/22,Guinea,9.9456,-9.6966,36459,0,440,36019
3/28/22,Guinea,9.9456,-9.6966,36459,0,440,36019
3/29/22,Guinea,9.9456,-9.6966,36459,0,440,36019
3/30/22,Guinea,9.9456,-9.6966,36459,0,440,36019
3/31/22,Guinea,9.9456,-9.6966,36459,0,440,36019
4/1/22,Guinea,9.9456,-9.6966,36459,0,440,36019
4/2/22,Guinea,9.9456,-9.6966,36459,0,440,36019
4/3/22,Guinea,9.9456,-9.6966,36459,0,440,36019
4/4/22,Guinea,9.9456,-9.6966,36459,0,440,36019
4/5/22,Guinea,9.9456,-9.6966,36459,0,440,36019
4/6/22,Guinea,9.9456,-9.6966,36459,0,440,36019
4/7/22,Guinea,9.9456,-9.6966,36459,0,440,36019
4/8/22,Guinea,9.9456,-9.6966,36459,0,440,36019
4/9/22,Guinea,9.9456,-9.6966,36459,0,440,36019
4/10/22,Guinea,9.9456,-9.6966,36459,0,440,36019
4/11/22,Guinea,9.9456,-9.6966,36459,0,440,36019
4/12/22,Guinea,9.9456,-9.6966,36459,0,440,36019
4/13/22,Guinea,9.9456,-9.6966,36502,0,440,36062
4/14/22,Guinea,9.9456,-9.6966,36502,0,440,36062
4/15/22,Guinea,9.9456,-9.6966,36502,0,440,36062
4/16/22,Guinea,9.9456,-9.6966,36502,0,440,36062
4/17/22,Guinea,9.9456,-9.6966,36502,0,440,36062
4/18/22,Guinea,9.9456,-9.6966,36502,0,440,36062
4/19/22,Guinea,9.9456,-9.6966,36540,0,441,36099
4/20/22,Guinea,9.9456,-9.6966,36540,0,441,36099
4/21/22,Guinea,9.9456,-9.6966,36540,0,441,36099
4/22/22,Guinea,9.9456,-9.6966,36540,0,441,36099
4/23/22,Guinea,9.9456,-9.6966,36540,0,441,36099
4/24/22,Guinea,9.9456,-9.6966,36540,0,441,36099
4/25/22,Guinea,9.9456,-9.6966,36540,0,441,36099
4/26/22,Guinea,9.9456,-9.6966,36540,0,441,36099
4/27/22,Guinea,9.9456,-9.6966,36540,0,441,36099
4/28/22,Guinea,9.9456,-9.6966,36549,0,442,36107
4/29/22,Guinea,9.9456,-9.6966,36549,0,442,36107
4/30/22,Guinea,9.9456,-9.6966,36549,0,442,36107
5/1/22,Guinea,9.9456,-9.6966,36549,0,442,36107
5/2/22,Guinea,9.9456,-9.6966,36549,0,442,36107
5/3/22,Guinea,9.9456,-9.6966,36549,0,442,36107
5/4/22,Guinea,9.9456,-9.6966,36549,0,442,36107
5/5/22,Guinea,9.9456,-9.6966,36549,0,442,36107
5/6/22,Guinea,9.9456,-9.6966,36549,0,442,36107
5/7/22,Guinea,9.9456,-9.6966,36549,0,442,36107
5/8/22,Guinea,9.9456,-9.6966,36549,0,442,36107
5/9/22,Guinea,9.9456,-9.6966,36549,0,442,36107
5/10/22,Guinea,9.9456,-9.6966,36549,0,442,36107
5/11/22,Guinea,9.9456,-9.6966,36549,0,442,36107
5/12/22,Guinea,9.9456,-9.6966,36597,0,442,36155
5/13/22,Guinea,9.9456,-9.6966,36597,0,442,36155
5/14/22,Guinea,9.9456,-9.6966,36597,0,442,36155
5/15/22,Guinea,9.9456,-9.6966,36597,0,442,36155
5/16/22,Guinea,9.9456,-9.6966,36597,0,442,36155
5/17/22,Guinea,9.9456,-9.6966,36661,0,442,36219
5/18/22,Guinea,9.9456,-9.6966,36661,0,442,36219
5/19/22,Guinea,9.9456,-9.6966,36661,0,442,36219
5/20/22,Guinea,9.9456,-9.6966,36661,0,442,36219
5/21/22,Guinea,9.9456,-9.6966,36661,0,442,36219
5/22/22,Guinea,9.9456,-9.6966,36661,0,442,36219
5/23/22,Guinea,9.9456,-9.6966,36661,0,442,36219
5/24/22,Guinea,9.9456,-9.6966,36661,0,442,36219
5/25/22,Guinea,9.9456,-9.6966,36661,0,442,36219
5/26/22,Guinea,9.9456,-9.6966,36661,0,442,36219
5/27/22,Guinea,9.9456,-9.6966,36661,0,442,36219
5/28/22,Guinea,9.9456,-9.6966,36661,0,442,36219
5/29/22,Guinea,9.9456,-9.6966,36661,0,442,36219
5/30/22,Guinea,9.9456,-9.6966,36764,0,442,36322
5/31/22,Guinea,9.9456,-9.6966,36764,0,442,36322
6/1/22,Guinea,9.9456,-9.6966,36764,0,442,36322
6/2/22,Guinea,9.9456,-9.6966,36764,0,442,36322
6/3/22,Guinea,9.9456,-9.6966,36764,0,442,36322
6/4/22,Guinea,9.9456,-9.6966,36764,0,442,36322
6/5/22,Guinea,9.9456,-9.6966,36764,0,442,36322
6/6/22,Guinea,9.9456,-9.6966,36764,0,442,36322
6/7/22,Guinea,9.9456,-9.6966,36764,0,442,36322
6/8/22,Guinea,9.9456,-9.6966,36764,0,442,36322
6/9/22,Guinea,9.9456,-9.6966,36817,0,442,36375
6/10/22,Guinea,9.9456,-9.6966,36817,0,442,36375
6/11/22,Guinea,9.9456,-9.6966,36817,0,442,36375
6/12/22,Guinea,9.9456,-9.6966,36817,0,442,36375
6/13/22,Guinea,9.9456,-9.6966,36817,0,442,36375
6/14/22,Guinea,9.9456,-9.6966,36817,0,442,36375
6/15/22,Guinea,9.9456,-9.6966,36817,0,442,36375
6/16/22,Guinea,9.9456,-9.6966,36817,0,442,36375
6/17/22,Guinea,9.9456,-9.6966,36817,0,442,36375
6/18/22,Guinea,9.9456,-9.6966,36817,0,442,36375
6/19/22,Guinea,9.9456,-9.6966,36817,0,442,36375
6/20/22,Guinea,9.9456,-9.6966,36817,0,442,36375
6/21/22,Guinea,9.9456,-9.6966,36817,0,442,36375
6/22/22,Guinea,9.9456,-9.6966,36817,0,442,36375
6/23/22,Guinea,9.9456,-9.6966,36817,0,442,36375
6/24/22,Guinea,9.9456,-9.6966,36817,0,442,36375
6/25/22,Guinea,9.9456,-9.6966,36817,0,442,36375
6/26/22,Guinea,9.9456,-9.6966,36817,0,442,36375
6/27/22,Guinea,9.9456,-9.6966,36817,0,442,36375
6/28/22,Guinea,9.9456,-9.6966,36817,0,442,36375
6/29/22,Guinea,9.9456,-9.6966,36817,0,442,36375
6/30/22,Guinea,9.9456,-9.6966,36817,0,442,36375
7/1/22,Guinea,9.9456,-9.6966,37123,0,443,36680
7/2/22,Guinea,9.9456,-9.6966,37123,0,443,36680
7/3/22,Guinea,9.9456,-9.6966,37123,0,443,36680
7/4/22,Guinea,9.9456,-9.6966,37123,0,443,36680
7/5/22,Guinea,9.9456,-9.6966,37123,0,443,36680
7/6/22,Guinea,9.9456,-9.6966,37123,0,443,36680
7/7/22,Guinea,9.9456,-9.6966,37358,0,443,36915
7/8/22,Guinea,9.9456,-9.6966,37358,0,443,36915
7/9/22,Guinea,9.9456,-9.6966,37358,0,443,36915
7/10/22,Guinea,9.9456,-9.6966,37358,0,443,36915
7/11/22,Guinea,9.9456,-9.6966,37358,0,443,36915
7/12/22,Guinea,9.9456,-9.6966,37358,0,445,36913
7/13/22,Guinea,9.9456,-9.6966,37358,0,445,36913
7/14/22,Guinea,9.9456,-9.6966,37358,0,445,36913
7/15/22,Guinea,9.9456,-9.6966,37358,0,445,36913
7/16/22,Guinea,9.9456,-9.6966,37358,0,445,36913
7/17/22,Guinea,9.9456,-9.6966,37358,0,445,36913
7/18/22,Guinea,9.9456,-9.6966,37358,0,445,36913
7/19/22,Guinea,9.9456,-9.6966,37358,0,445,36913
7/20/22,Guinea,9.9456,-9.6966,37358,0,445,36913
7/21/22,Guinea,9.9456,-9.6966,37358,0,445,36913
7/22/22,Guinea,9.9456,-9.6966,37358,0,445,36913
7/23/22,Guinea,9.9456,-9.6966,37358,0,445,36913
7/24/22,Guinea,9.9456,-9.6966,37358,0,445,36913
7/25/22,Guinea,9.9456,-9.6966,37358,0,445,36913
7/26/22,Guinea,9.9456,-9.6966,37358,0,445,36913
7/27/22,Guinea,9.9456,-9.6966,37358,0,445,36913
7/28/22,Guinea,9.9456,-9.6966,37358,0,445,36913
7/29/22,Guinea,9.9456,-9.6966,37408,0,445,36963
7/30/22,Guinea,9.9456,-9.6966,37408,0,445,36963
7/31/22,Guinea,9.9456,-9.6966,37408,0,445,36963
8/1/22,Guinea,9.9456,-9.6966,37408,0,445,36963
8/2/22,Guinea,9.9456,-9.6966,37408,0,445,36963
8/3/22,Guinea,9.9456,-9.6966,37408,0,445,36963
8/4/22,Guinea,9.9456,-9.6966,37408,0,445,36963
8/5/22,Guinea,9.9456,-9.6966,37408,0,445,36963
8/6/22,Guinea,9.9456,-9.6966,37408,0,445,36963
8/7/22,Guinea,9.9456,-9.6966,37408,0,445,36963
8/8/22,Guinea,9.9456,-9.6966,37429,0,445,36984
8/9/22,Guinea,9.9456,-9.6966,37429,0,445,36984
8/10/22,Guinea,9.9456,-9.6966,37429,0,445,36984
8/11/22,Guinea,9.9456,-9.6966,37429,0,445,36984
8/12/22,Guinea,9.9456,-9.6966,37470,0,447,37023
8/13/22,Guinea,9.9456,-9.6966,37470,0,447,37023
8/14/22,Guinea,9.9456,-9.6966,37470,0,447,37023
8/15/22,Guinea,9.9456,-9.6966,37470,0,447,37023
8/16/22,Guinea,9.9456,-9.6966,37470,0,447,37023
8/17/22,Guinea,9.9456,-9.6966,37470,0,447,37023
8/18/22,Guinea,9.9456,-9.6966,37470,0,447,37023
8/19/22,Guinea,9.9456,-9.6966,37470,0,447,37023
8/20/22,Guinea,9.9456,-9.6966,37470,0,447,37023
8/21/22,Guinea,9.9456,-9.6966,37470,0,447,37023
8/22/22,Guinea,9.9456,-9.6966,37470,0,447,37023
8/23/22,Guinea,9.9456,-9.6966,37470,0,447,37023
8/24/22,Guinea,9.9456,-9.6966,37470,0,447,37023
8/25/22,Guinea,9.9456,-9.6966,37470,0,447,37023
8/26/22,Guinea,9.9456,-9.6966,37470,0,447,37023
8/27/22,Guinea,9.9456,-9.6966,37470,0,447,37023
8/28/22,Guinea,9.9456,-9.6966,37470,0,447,37023
8/29/22,Guinea,9.9456,-9.6966,37470,0,447,37023
8/30/22,Guinea,9.9456,-9.6966,37470,0,447,37023
8/31/22,Guinea,9.9456,-9.6966,37470,0,447,37023
9/1/22,Guinea,9.9456,-9.6966,37470,0,447,37023
9/2/22,Guinea,9.9456,-9.6966,37470,0,447,37023
9/3/22,Guinea,9.9456,-9.6966,37470,0,447,37023
9/4/22,Guinea,9.9456,-9.6966,37470,0,447,37023
9/5/22,Guinea,9.9456,-9.6966,37470,0,447,37023
9/6/22,Guinea,9.9456,-9.6966,37470,0,447,37023
9/7/22,Guinea,9.9456,-9.6966,37652,0,449,37203
9/8/22,Guinea,9.9456,-9.6966,37652,0,449,37203
9/9/22,Guinea,9.9456,-9.6966,37652,0,449,37203
9/10/22,Guinea,9.9456,-9.6966,37652,0,449,37203
9/11/22,Guinea,9.9456,-9.6966,37652,0,449,37203
9/12/22,Guinea,9.9456,-9.6966,37652,0,449,37203
9/13/22,Guinea,9.9456,-9.6966,37652,0,449,37203
9/14/22,Guinea,9.9456,-9.6966,37652,0,449,37203
9/15/22,Guinea,9.9456,-9.6966,37652,0,449,37203
9/16/22,Guinea,9.9456,-9.6966,37652,0,449,37203
9/17/22,Guinea,9.9456,-9.6966,37652,0,449,37203
9/18/22,Guinea,9.9456,-9.6966,37652,0,449,37203
9/19/22,Guinea,9.9456,-9.6966,37652,0,449,37203
9/20/22,Guinea,9.9456,-9.6966,37652,0,449,37203
9/21/22,Guinea,9.9456,-9.6966,37652,0,449,37203
9/22/22,Guinea,9.9456,-9.6966,37652,0,449,37203
9/23/22,Guinea,9.9456,-9.6966,37652,0,449,37203
9/24/22,Guinea,9.9456,-9.6966,37652,0,449,37203
9/25/22,Guinea,9.9456,-9.6966,37652,0,449,37203
9/26/22,Guinea,9.9456,-9.6966,37652,0,449,37203
9/27/22,Guinea,9.9456,-9.6966,37652,0,449,37203
9/28/22,Guinea,9.9456,-9.6966,37652,0,449,37203
9/29/22,Guinea,9.9456,-9.6966,37652,0,449,37203
9/30/22,Guinea,9.9456,-9.6966,37652,0,449,37203
10/1/22,Guinea,9.9456,-9.6966,37652,0,449,37203
10/2/22,Guinea,9.9456,-9.6966,37652,0,449,37203
10/3/22,Guinea,9.9456,-9.6966,37909,0,453,37456
10/4/22,Guinea,9.9456,-9.6966,37909,0,453,37456
10/5/22,Guinea,9.9456,-9.6966,37909,0,453,37456
10/6/22,Guinea,9.9456,-9.6966,37950,0,455,37495
10/7/22,Guinea,9.9456,-9.6966,37950,0,455,37495
10/8/22,Guinea,9.9456,-9.6966,37950,0,455,37495
10/9/22,Guinea,9.9456,-9.6966,37950,0,455,37495
10/10/22,Guinea,9.9456,-9.6966,37950,0,455,37495
10/11/22,Guinea,9.9456,-9.6966,37950,0,455,37495
10/12/22,Guinea,9.9456,-9.6966,37950,0,455,37495
10/13/22,Guinea,9.9456,-9.6966,37950,0,455,37495
10/14/22,Guinea,9.9456,-9.6966,37950,0,455,37495
10/15/22,Guinea,9.9456,-9.6966,37950,0,455,37495
10/16/22,Guinea,9.9456,-9.6966,37950,0,455,37495
10/17/22,Guinea,9.9456,-9.6966,37999,0,456,37543
10/18/22,Guinea,9.9456,-9.6966,37999,0,456,37543
10/19/22,Guinea,9.9456,-9.6966,37999,0,456,37543
10/20/22,Guinea,9.9456,-9.6966,37999,0,456,37543
10/21/22,Guinea,9.9456,-9.6966,37999,0,456,37543
10/22/22,Guinea,9.9456,-9.6966,37999,0,456,37543
10/23/22,Guinea,9.9456,-9.6966,37999,0,456,37543
10/24/22,Guinea,9.9456,-9.6966,38047,0,456,37591
10/25/22,Guinea,9.9456,-9.6966,38047,0,456,37591
10/26/22,Guinea,9.9456,-9.6966,38047,0,456,37591
10/27/22,Guinea,9.9456,-9.6966,38047,0,456,37591
10/28/22,Guinea,9.9456,-9.6966,38047,0,456,37591
10/29/22,Guinea,9.9456,-9.6966,38047,0,456,37591
10/30/22,Guinea,9.9456,-9.6966,38047,0,456,37591
10/31/22,Guinea,9.9456,-9.6966,38047,0,456,37591
11/1/22,Guinea,9.9456,-9.6966,38047,0,456,37591
11/2/22,Guinea,9.9456,-9.6966,38047,0,456,37591
11/3/22,Guinea,9.9456,-9.6966,38047,0,456,37591
11/4/22,Guinea,9.9456,-9.6966,38047,0,456,37591
11/5/22,Guinea,9.9456,-9.6966,38047,0,456,37591
11/6/22,Guinea,9.9456,-9.6966,38047,0,456,37591
11/7/22,Guinea,9.9456,-9.6966,38122,0,458,37664
11/8/22,Guinea,9.9456,-9.6966,38122,0,458,37664
11/9/22,Guinea,9.9456,-9.6966,38122,0,458,37664
11/10/22,Guinea,9.9456,-9.6966,38122,0,458,37664
11/11/22,Guinea,9.9456,-9.6966,38122,0,458,37664
11/12/22,Guinea,9.9456,-9.6966,38122,0,458,37664
11/13/22,Guinea,9.9456,-9.6966,38122,0,458,37664
11/14/22,Guinea,9.9456,-9.6966,38122,0,458,37664
11/15/22,Guinea,9.9456,-9.6966,38153,0,464,37689
11/16/22,Guinea,9.9456,-9.6966,38153,0,464,37689
11/17/22,Guinea,9.9456,-9.6966,38153,0,464,37689
11/18/22,Guinea,9.9456,-9.6966,38153,0,464,37689
11/19/22,Guinea,9.9456,-9.6966,38153,0,464,37689
11/20/22,Guinea,9.9456,-9.6966,38153,0,464,37689
11/21/22,Guinea,9.9456,-9.6966,38153,0,464,37689
11/22/22,Guinea,9.9456,-9.6966,38153,0,464,37689
11/23/22,Guinea,9.9456,-9.6966,38153,0,464,37689
11/24/22,Guinea,9.9456,-9.6966,38153,0,464,37689
11/25/22,Guinea,9.9456,-9.6966,38153,0,464,37689
11/26/22,Guinea,9.9456,-9.6966,38153,0,464,37689
11/27/22,Guinea,9.9456,-9.6966,38153,0,464,37689
11/28/22,Guinea,9.9456,-9.6966,38153,0,464,37689
11/29/22,Guinea,9.9456,-9.6966,38153,0,464,37689
11/30/22,Guinea,9.9456,-9.6966,38153,0,464,37689
12/1/22,Guinea,9.9456,-9.6966,38153,0,464,37689
12/2/22,Guinea,9.9456,-9.6966,38153,0,464,37689
12/3/22,Guinea,9.9456,-9.6966,38153,0,464,37689
12/4/22,Guinea,9.9456,-9.6966,38153,0,464,37689
12/5/22,Guinea,9.9456,-9.6966,38153,0,464,37689
12/6/22,Guinea,9.9456,-9.6966,38153,0,464,37689
12/7/22,Guinea,9.9456,-9.6966,38153,0,464,37689
12/8/22,Guinea,9.9456,-9.6966,38153,0,464,37689
12/9/22,Guinea,9.9456,-9.6966,38153,0,464,37689
12/10/22,Guinea,9.9456,-9.6966,38153,0,464,37689
12/11/22,Guinea,9.9456,-9.6966,38153,0,464,37689
12/12/22,Guinea,9.9456,-9.6966,38153,0,464,37689
12/13/22,Guinea,9.9456,-9.6966,38153,0,464,37689
12/14/22,Guinea,9.9456,-9.6966,38191,0,465,37726
12/15/22,Guinea,9.9456,-9.6966,38191,0,465,37726
12/16/22,Guinea,9.9456,-9.6966,38191,0,465,37726
12/17/22,Guinea,9.9456,-9.6966,38191,0,465,37726
1/1/22,Guinea-Bissau,11.8037,-15.1804,6484,0,149,6335
1/2/22,Guinea-Bissau,11.8037,-15.1804,6484,0,149,6335
1/3/22,Guinea-Bissau,11.8037,-15.1804,6499,0,149,6350
1/4/22,Guinea-Bissau,11.8037,-15.1804,6514,0,149,6365
1/5/22,Guinea-Bissau,11.8037,-15.1804,6531,0,149,6382
1/6/22,Guinea-Bissau,11.8037,-15.1804,6612,0,149,6463
1/7/22,Guinea-Bissau,11.8037,-15.1804,6638,0,149,6489
1/8/22,Guinea-Bissau,11.8037,-15.1804,6694,0,149,6545
1/9/22,Guinea-Bissau,11.8037,-15.1804,6694,0,149,6545
1/10/22,Guinea-Bissau,11.8037,-15.1804,6713,0,149,6564
1/11/22,Guinea-Bissau,11.8037,-15.1804,6794,0,149,6645
1/12/22,Guinea-Bissau,11.8037,-15.1804,6808,0,150,6658
1/13/22,Guinea-Bissau,11.8037,-15.1804,6898,0,150,6748
1/14/22,Guinea-Bissau,11.8037,-15.1804,6962,0,150,6812
1/15/22,Guinea-Bissau,11.8037,-15.1804,7004,0,152,6852
1/16/22,Guinea-Bissau,11.8037,-15.1804,7004,0,152,6852
1/17/22,Guinea-Bissau,11.8037,-15.1804,7034,0,152,6882
1/18/22,Guinea-Bissau,11.8037,-15.1804,7140,0,153,6987
1/19/22,Guinea-Bissau,11.8037,-15.1804,7140,0,153,6987
1/20/22,Guinea-Bissau,11.8037,-15.1804,7222,0,153,7069
1/21/22,Guinea-Bissau,11.8037,-15.1804,7284,0,153,7131
1/22/22,Guinea-Bissau,11.8037,-15.1804,7284,0,153,7131
1/23/22,Guinea-Bissau,11.8037,-15.1804,7284,0,154,7130
1/24/22,Guinea-Bissau,11.8037,-15.1804,7293,0,154,7139
1/25/22,Guinea-Bissau,11.8037,-15.1804,7484,0,154,7330
1/26/22,Guinea-Bissau,11.8037,-15.1804,7508,0,154,7354
1/27/22,Guinea-Bissau,11.8037,-15.1804,7519,0,154,7365
1/28/22,Guinea-Bissau,11.8037,-15.1804,7544,0,154,7390
1/29/22,Guinea-Bissau,11.8037,-15.1804,7576,0,154,7422
1/30/22,Guinea-Bissau,11.8037,-15.1804,7586,0,156,7430
1/31/22,Guinea-Bissau,11.8037,-15.1804,7586,0,156,7430
2/1/22,Guinea-Bissau,11.8037,-15.1804,7586,0,156,7430
2/2/22,Guinea-Bissau,11.8037,-15.1804,7691,0,156,7535
2/3/22,Guinea-Bissau,11.8037,-15.1804,7726,0,156,7570
2/4/22,Guinea-Bissau,11.8037,-15.1804,7749,0,158,7591
2/5/22,Guinea-Bissau,11.8037,-15.1804,7749,0,158,7591
2/6/22,Guinea-Bissau,11.8037,-15.1804,7770,0,158,7612
2/7/22,Guinea-Bissau,11.8037,-15.1804,7772,0,158,7614
2/8/22,Guinea-Bissau,11.8037,-15.1804,7802,0,158,7644
2/9/22,Guinea-Bissau,11.8037,-15.1804,7813,0,158,7655
2/10/22,Guinea-Bissau,11.8037,-15.1804,7820,0,158,7662
2/11/22,Guinea-Bissau,11.8037,-15.1804,7820,0,158,7662
2/12/22,Guinea-Bissau,11.8037,-15.1804,7849,0,161,7688
2/13/22,Guinea-Bissau,11.8037,-15.1804,7849,0,162,7687
2/14/22,Guinea-Bissau,11.8037,-15.1804,7849,0,164,7685
2/15/22,Guinea-Bissau,11.8037,-15.1804,7878,0,164,7714
2/16/22,Guinea-Bissau,11.8037,-15.1804,7889,0,164,7725
2/17/22,Guinea-Bissau,11.8037,-15.1804,7891,0,164,7727
2/18/22,Guinea-Bissau,11.8037,-15.1804,7905,0,166,7739
2/19/22,Guinea-Bissau,11.8037,-15.1804,7907,0,166,7741
2/20/22,Guinea-Bissau,11.8037,-15.1804,7907,0,166,7741
2/21/22,Guinea-Bissau,11.8037,-15.1804,7907,0,166,7741
2/22/22,Guinea-Bissau,11.8037,-15.1804,7953,0,166,7787
2/23/22,Guinea-Bissau,11.8037,-15.1804,7972,0,166,7806
2/24/22,Guinea-Bissau,11.8037,-15.1804,7972,0,166,7806
2/25/22,Guinea-Bissau,11.8037,-15.1804,7985,0,166,7819
2/26/22,Guinea-Bissau,11.8037,-15.1804,7985,0,166,7819
2/27/22,Guinea-Bissau,11.8037,-15.1804,8001,0,167,7834
2/28/22,Guinea-Bissau,11.8037,-15.1804,8001,0,167,7834
3/1/22,Guinea-Bissau,11.8037,-15.1804,8022,0,167,7855
3/2/22,Guinea-Bissau,11.8037,-15.1804,8027,0,167,7860
3/3/22,Guinea-Bissau,11.8037,-15.1804,8027,0,167,7860
3/4/22,Guinea-Bissau,11.8037,-15.1804,8027,0,167,7860
3/5/22,Guinea-Bissau,11.8037,-15.1804,8027,0,167,7860
3/6/22,Guinea-Bissau,11.8037,-15.1804,8033,0,167,7866
3/7/22,Guinea-Bissau,11.8037,-15.1804,8033,0,167,7866
3/8/22,Guinea-Bissau,11.8037,-15.1804,8038,0,168,7870
3/9/22,Guinea-Bissau,11.8037,-15.1804,8039,0,168,7871
3/10/22,Guinea-Bissau,11.8037,-15.1804,8050,0,168,7882
3/11/22,Guinea-Bissau,11.8037,-15.1804,8050,0,168,7882
3/12/22,Guinea-Bissau,11.8037,-15.1804,8050,0,168,7882
3/13/22,Guinea-Bissau,11.8037,-15.1804,8068,0,168,7900
3/14/22,Guinea-Bissau,11.8037,-15.1804,8068,0,168,7900
3/15/22,Guinea-Bissau,11.8037,-15.1804,8071,0,169,7902
3/16/22,Guinea-Bissau,11.8037,-15.1804,8071,0,169,7902
3/17/22,Guinea-Bissau,11.8037,-15.1804,8096,0,169,7927
3/18/22,Guinea-Bissau,11.8037,-15.1804,8096,0,169,7927
3/19/22,Guinea-Bissau,11.8037,-15.1804,8113,0,169,7944
3/20/22,Guinea-Bissau,11.8037,-15.1804,8113,0,169,7944
3/21/22,Guinea-Bissau,11.8037,-15.1804,8113,0,169,7944
3/22/22,Guinea-Bissau,11.8037,-15.1804,8124,0,169,7955
3/23/22,Guinea-Bissau,11.8037,-15.1804,8124,0,169,7955
3/24/22,Guinea-Bissau,11.8037,-15.1804,8125,0,169,7956
3/25/22,Guinea-Bissau,11.8037,-15.1804,8126,0,169,7957
3/26/22,Guinea-Bissau,11.8037,-15.1804,8131,0,169,7962
3/27/22,Guinea-Bissau,11.8037,-15.1804,8131,0,169,7962
3/28/22,Guinea-Bissau,11.8037,-15.1804,8140,0,170,7970
3/29/22,Guinea-Bissau,11.8037,-15.1804,8140,0,170,7970
3/30/22,Guinea-Bissau,11.8037,-15.1804,8149,0,170,7979
3/31/22,Guinea-Bissau,11.8037,-15.1804,8149,0,170,7979
4/1/22,Guinea-Bissau,11.8037,-15.1804,8149,0,170,7979
4/2/22,Guinea-Bissau,11.8037,-15.1804,8151,0,170,7981
4/3/22,Guinea-Bissau,11.8037,-15.1804,8151,0,170,7981
4/4/22,Guinea-Bissau,11.8037,-15.1804,8151,0,170,7981
4/5/22,Guinea-Bissau,11.8037,-15.1804,8151,0,170,7981
4/6/22,Guinea-Bissau,11.8037,-15.1804,8152,0,170,7982
4/7/22,Guinea-Bissau,11.8037,-15.1804,8172,0,170,8002
4/8/22,Guinea-Bissau,11.8037,-15.1804,8172,0,170,8002
4/9/22,Guinea-Bissau,11.8037,-15.1804,8172,0,170,8002
4/10/22,Guinea-Bissau,11.8037,-15.1804,8173,0,170,8003
4/11/22,Guinea-Bissau,11.8037,-15.1804,8173,0,170,8003
4/12/22,Guinea-Bissau,11.8037,-15.1804,8175,0,170,8005
4/13/22,Guinea-Bissau,11.8037,-15.1804,8175,0,170,8005
4/14/22,Guinea-Bissau,11.8037,-15.1804,8176,0,170,8006
4/15/22,Guinea-Bissau,11.8037,-15.1804,8176,0,170,8006
4/16/22,Guinea-Bissau,11.8037,-15.1804,8176,0,170,8006
4/17/22,Guinea-Bissau,11.8037,-15.1804,8178,0,170,8008
4/18/22,Guinea-Bissau,11.8037,-15.1804,8178,0,170,8008
4/19/22,Guinea-Bissau,11.8037,-15.1804,8182,0,171,8011
4/20/22,Guinea-Bissau,11.8037,-15.1804,8184,0,171,8013
4/21/22,Guinea-Bissau,11.8037,-15.1804,8185,0,171,8014
4/22/22,Guinea-Bissau,11.8037,-15.1804,8185,0,171,8014
4/23/22,Guinea-Bissau,11.8037,-15.1804,8185,0,171,8014
4/24/22,Guinea-Bissau,11.8037,-15.1804,8185,0,171,8014
4/25/22,Guinea-Bissau,11.8037,-15.1804,8186,0,171,8015
4/26/22,Guinea-Bissau,11.8037,-15.1804,8186,0,171,8015
4/27/22,Guinea-Bissau,11.8037,-15.1804,8186,0,171,8015
4/28/22,Guinea-Bissau,11.8037,-15.1804,8190,0,171,8019
4/29/22,Guinea-Bissau,11.8037,-15.1804,8202,0,171,8031
4/30/22,Guinea-Bissau,11.8037,-15.1804,8202,0,171,8031
5/1/22,Guinea-Bissau,11.8037,-15.1804,8202,0,171,8031
5/2/22,Guinea-Bissau,11.8037,-15.1804,8202,0,171,8031
5/3/22,Guinea-Bissau,11.8037,-15.1804,8202,0,171,8031
5/4/22,Guinea-Bissau,11.8037,-15.1804,8210,0,171,8039
5/5/22,Guinea-Bissau,11.8037,-15.1804,8213,0,171,8042
5/6/22,Guinea-Bissau,11.8037,-15.1804,8213,0,171,8042
5/7/22,Guinea-Bissau,11.8037,-15.1804,8213,0,171,8042
5/8/22,Guinea-Bissau,11.8037,-15.1804,8213,0,171,8042
5/9/22,Guinea-Bissau,11.8037,-15.1804,8215,0,171,8044
5/10/22,Guinea-Bissau,11.8037,-15.1804,8215,0,171,8044
5/11/22,Guinea-Bissau,11.8037,-15.1804,8215,0,171,8044
5/12/22,Guinea-Bissau,11.8037,-15.1804,8215,0,171,8044
5/13/22,Guinea-Bissau,11.8037,-15.1804,8216,0,171,8045
5/14/22,Guinea-Bissau,11.8037,-15.1804,8222,0,171,8051
5/15/22,Guinea-Bissau,11.8037,-15.1804,8222,0,171,8051
5/16/22,Guinea-Bissau,11.8037,-15.1804,8222,0,171,8051
5/17/22,Guinea-Bissau,11.8037,-15.1804,8222,0,171,8051
5/18/22,Guinea-Bissau,11.8037,-15.1804,8240,0,171,8069
5/19/22,Guinea-Bissau,11.8037,-15.1804,8240,0,171,8069
5/20/22,Guinea-Bissau,11.8037,-15.1804,8242,0,171,8071
5/21/22,Guinea-Bissau,11.8037,-15.1804,8246,0,171,8075
5/22/22,Guinea-Bissau,11.8037,-15.1804,8246,0,171,8075
5/23/22,Guinea-Bissau,11.8037,-15.1804,8246,0,171,8075
5/24/22,Guinea-Bissau,11.8037,-15.1804,8259,0,171,8088
5/25/22,Guinea-Bissau,11.8037,-15.1804,8259,0,171,8088
5/26/22,Guinea-Bissau,11.8037,-15.1804,8260,0,171,8089
5/27/22,Guinea-Bissau,11.8037,-15.1804,8260,0,171,8089
5/28/22,Guinea-Bissau,11.8037,-15.1804,8260,0,171,8089
5/29/22,Guinea-Bissau,11.8037,-15.1804,8260,0,171,8089
5/30/22,Guinea-Bissau,11.8037,-15.1804,8260,0,171,8089
5/31/22,Guinea-Bissau,11.8037,-15.1804,8269,0,171,8098
6/1/22,Guinea-Bissau,11.8037,-15.1804,8269,0,171,8098
6/2/22,Guinea-Bissau,11.8037,-15.1804,8283,0,171,8112
6/3/22,Guinea-Bissau,11.8037,-15.1804,8283,0,171,8112
6/4/22,Guinea-Bissau,11.8037,-15.1804,8283,0,171,8112
6/5/22,Guinea-Bissau,11.8037,-15.1804,8283,0,171,8112
6/6/22,Guinea-Bissau,11.8037,-15.1804,8283,0,171,8112
6/7/22,Guinea-Bissau,11.8037,-15.1804,8290,0,171,8119
6/8/22,Guinea-Bissau,11.8037,-15.1804,8290,0,171,8119
6/9/22,Guinea-Bissau,11.8037,-15.1804,8297,0,171,8126
6/10/22,Guinea-Bissau,11.8037,-15.1804,8305,0,171,8134
6/11/22,Guinea-Bissau,11.8037,-15.1804,8305,0,171,8134
6/12/22,Guinea-Bissau,11.8037,-15.1804,8306,0,171,8135
6/13/22,Guinea-Bissau,11.8037,-15.1804,8306,0,171,8135
6/14/22,Guinea-Bissau,11.8037,-15.1804,8307,0,171,8136
6/15/22,Guinea-Bissau,11.8037,-15.1804,8307,0,171,8136
6/16/22,Guinea-Bissau,11.8037,-15.1804,8307,0,171,8136
6/17/22,Guinea-Bissau,11.8037,-15.1804,8307,0,171,8136
6/18/22,Guinea-Bissau,11.8037,-15.1804,8307,0,171,8136
6/19/22,Guinea-Bissau,11.8037,-15.1804,8307,0,171,8136
6/20/22,Guinea-Bissau,11.8037,-15.1804,8307,0,171,8136
6/21/22,Guinea-Bissau,11.8037,-15.1804,8347,0,171,8176
6/22/22,Guinea-Bissau,11.8037,-15.1804,8347,0,171,8176
6/23/22,Guinea-Bissau,11.8037,-15.1804,8347,0,171,8176
6/24/22,Guinea-Bissau,11.8037,-15.1804,8348,0,171,8177
6/25/22,Guinea-Bissau,11.8037,-15.1804,8348,0,171,8177
6/26/22,Guinea-Bissau,11.8037,-15.1804,8348,0,171,8177
6/27/22,Guinea-Bissau,11.8037,-15.1804,8348,0,171,8177
6/28/22,Guinea-Bissau,11.8037,-15.1804,8348,0,171,8177
6/29/22,Guinea-Bissau,11.8037,-15.1804,8348,0,171,8177
6/30/22,Guinea-Bissau,11.8037,-15.1804,8348,0,171,8177
7/1/22,Guinea-Bissau,11.8037,-15.1804,8369,0,171,8198
7/2/22,Guinea-Bissau,11.8037,-15.1804,8369,0,171,8198
7/3/22,Guinea-Bissau,11.8037,-15.1804,8369,0,171,8198
7/4/22,Guinea-Bissau,11.8037,-15.1804,8369,0,171,8198
7/5/22,Guinea-Bissau,11.8037,-15.1804,8369,0,171,8198
7/6/22,Guinea-Bissau,11.8037,-15.1804,8391,0,171,8220
7/7/22,Guinea-Bissau,11.8037,-15.1804,8396,0,171,8225
7/8/22,Guinea-Bissau,11.8037,-15.1804,8400,0,171,8229
7/9/22,Guinea-Bissau,11.8037,-15.1804,8400,0,171,8229
7/10/22,Guinea-Bissau,11.8037,-15.1804,8400,0,171,8229
7/11/22,Guinea-Bissau,11.8037,-15.1804,8400,0,171,8229
7/12/22,Guinea-Bissau,11.8037,-15.1804,8400,0,171,8229
7/13/22,Guinea-Bissau,11.8037,-15.1804,8400,0,171,8229
7/14/22,Guinea-Bissau,11.8037,-15.1804,8400,0,171,8229
7/15/22,Guinea-Bissau,11.8037,-15.1804,8400,0,171,8229
7/16/22,Guinea-Bissau,11.8037,-15.1804,8400,0,171,8229
7/17/22,Guinea-Bissau,11.8037,-15.1804,8400,0,171,8229
7/18/22,Guinea-Bissau,11.8037,-15.1804,8400,0,171,8229
7/19/22,Guinea-Bissau,11.8037,-15.1804,8400,0,171,8229
7/20/22,Guinea-Bissau,11.8037,-15.1804,8400,0,171,8229
7/21/22,Guinea-Bissau,11.8037,-15.1804,8400,0,171,8229
7/22/22,Guinea-Bissau,11.8037,-15.1804,8400,0,171,8229
7/23/22,Guinea-Bissau,11.8037,-15.1804,8400,0,171,8229
7/24/22,Guinea-Bissau,11.8037,-15.1804,8400,0,171,8229
7/25/22,Guinea-Bissau,11.8037,-15.1804,8400,0,171,8229
7/26/22,Guinea-Bissau,11.8037,-15.1804,8412,0,172,8240
7/27/22,Guinea-Bissau,11.8037,-15.1804,8412,0,172,8240
7/28/22,Guinea-Bissau,11.8037,-15.1804,8412,0,172,8240
7/29/22,Guinea-Bissau,11.8037,-15.1804,8412,0,172,8240
7/30/22,Guinea-Bissau,11.8037,-15.1804,8412,0,172,8240
7/31/22,Guinea-Bissau,11.8037,-15.1804,8412,0,172,8240
8/1/22,Guinea-Bissau,11.8037,-15.1804,8412,0,172,8240
8/2/22,Guinea-Bissau,11.8037,-15.1804,8440,0,174,8266
8/3/22,Guinea-Bissau,11.8037,-15.1804,8440,0,174,8266
8/4/22,Guinea-Bissau,11.8037,-15.1804,8440,0,174,8266
8/5/22,Guinea-Bissau,11.8037,-15.1804,8440,0,174,8266
8/6/22,Guinea-Bissau,11.8037,-15.1804,8440,0,174,8266
8/7/22,Guinea-Bissau,11.8037,-15.1804,8440,0,174,8266
8/8/22,Guinea-Bissau,11.8037,-15.1804,8452,0,174,8278
8/9/22,Guinea-Bissau,11.8037,-15.1804,8452,0,174,8278
8/10/22,Guinea-Bissau,11.8037,-15.1804,8452,0,174,8278
8/11/22,Guinea-Bissau,11.8037,-15.1804,8452,0,174,8278
8/12/22,Guinea-Bissau,11.8037,-15.1804,8452,0,174,8278
8/13/22,Guinea-Bissau,11.8037,-15.1804,8452,0,174,8278
8/14/22,Guinea-Bissau,11.8037,-15.1804,8452,0,174,8278
8/15/22,Guinea-Bissau,11.8037,-15.1804,8452,0,174,8278
8/16/22,Guinea-Bissau,11.8037,-15.1804,8482,0,174,8308
8/17/22,Guinea-Bissau,11.8037,-15.1804,8482,0,174,8308
8/18/22,Guinea-Bissau,11.8037,-15.1804,8482,0,174,8308
8/19/22,Guinea-Bissau,11.8037,-15.1804,8482,0,174,8308
8/20/22,Guinea-Bissau,11.8037,-15.1804,8482,0,174,8308
8/21/22,Guinea-Bissau,11.8037,-15.1804,8482,0,174,8308
8/22/22,Guinea-Bissau,11.8037,-15.1804,8482,0,174,8308
8/23/22,Guinea-Bissau,11.8037,-15.1804,8482,0,174,8308
8/24/22,Guinea-Bissau,11.8037,-15.1804,8482,0,174,8308
8/25/22,Guinea-Bissau,11.8037,-15.1804,8482,0,174,8308
8/26/22,Guinea-Bissau,11.8037,-15.1804,8482,0,174,8308
8/27/22,Guinea-Bissau,11.8037,-15.1804,8482,0,174,8308
8/28/22,Guinea-Bissau,11.8037,-15.1804,8482,0,174,8308
8/29/22,Guinea-Bissau,11.8037,-15.1804,8491,0,175,8316
8/30/22,Guinea-Bissau,11.8037,-15.1804,8491,0,175,8316
8/31/22,Guinea-Bissau,11.8037,-15.1804,8491,0,175,8316
9/1/22,Guinea-Bissau,11.8037,-15.1804,8491,0,175,8316
9/2/22,Guinea-Bissau,11.8037,-15.1804,8796,0,175,8621
9/3/22,Guinea-Bissau,11.8037,-15.1804,8796,0,175,8621
9/4/22,Guinea-Bissau,11.8037,-15.1804,8796,0,175,8621
9/5/22,Guinea-Bissau,11.8037,-15.1804,8796,0,175,8621
9/6/22,Guinea-Bissau,11.8037,-15.1804,8796,0,175,8621
9/7/22,Guinea-Bissau,11.8037,-15.1804,8796,0,175,8621
9/8/22,Guinea-Bissau,11.8037,-15.1804,8796,0,175,8621
9/9/22,Guinea-Bissau,11.8037,-15.1804,8796,0,175,8621
9/10/22,Guinea-Bissau,11.8037,-15.1804,8796,0,175,8621
9/11/22,Guinea-Bissau,11.8037,-15.1804,8796,0,175,8621
9/12/22,Guinea-Bissau,11.8037,-15.1804,8796,0,175,8621
9/13/22,Guinea-Bissau,11.8037,-15.1804,8796,0,175,8621
9/14/22,Guinea-Bissau,11.8037,-15.1804,8796,0,175,8621
9/15/22,Guinea-Bissau,11.8037,-15.1804,8796,0,175,8621
9/16/22,Guinea-Bissau,11.8037,-15.1804,8796,0,175,8621
9/17/22,Guinea-Bissau,11.8037,-15.1804,8796,0,175,8621
9/18/22,Guinea-Bissau,11.8037,-15.1804,8796,0,175,8621
9/19/22,Guinea-Bissau,11.8037,-15.1804,8796,0,175,8621
9/20/22,Guinea-Bissau,11.8037,-15.1804,8796,0,175,8621
9/21/22,Guinea-Bissau,11.8037,-15.1804,8796,0,175,8621
9/22/22,Guinea-Bissau,11.8037,-15.1804,8796,0,175,8621
9/23/22,Guinea-Bissau,11.8037,-15.1804,8796,0,175,8621
9/24/22,Guinea-Bissau,11.8037,-15.1804,8796,0,175,8621
9/25/22,Guinea-Bissau,11.8037,-15.1804,8796,0,175,8621
9/26/22,Guinea-Bissau,11.8037,-15.1804,8796,0,175,8621
9/27/22,Guinea-Bissau,11.8037,-15.1804,8796,0,175,8621
9/28/22,Guinea-Bissau,11.8037,-15.1804,8796,0,175,8621
9/29/22,Guinea-Bissau,11.8037,-15.1804,8796,0,175,8621
9/30/22,Guinea-Bissau,11.8037,-15.1804,8796,0,175,8621
10/1/22,Guinea-Bissau,11.8037,-15.1804,8796,0,175,8621
10/2/22,Guinea-Bissau,11.8037,-15.1804,8796,0,175,8621
10/3/22,Guinea-Bissau,11.8037,-15.1804,8796,0,175,8621
10/4/22,Guinea-Bissau,11.8037,-15.1804,8796,0,175,8621
10/5/22,Guinea-Bissau,11.8037,-15.1804,8796,0,175,8621
10/6/22,Guinea-Bissau,11.8037,-15.1804,8796,0,175,8621
10/7/22,Guinea-Bissau,11.8037,-15.1804,8796,0,175,8621
10/8/22,Guinea-Bissau,11.8037,-15.1804,8796,0,175,8621
10/9/22,Guinea-Bissau,11.8037,-15.1804,8796,0,175,8621
10/10/22,Guinea-Bissau,11.8037,-15.1804,8831,0,176,8655
10/11/22,Guinea-Bissau,11.8037,-15.1804,8831,0,176,8655
10/12/22,Guinea-Bissau,11.8037,-15.1804,8831,0,176,8655
10/13/22,Guinea-Bissau,11.8037,-15.1804,8831,0,176,8655
10/14/22,Guinea-Bissau,11.8037,-15.1804,8831,0,176,8655
10/15/22,Guinea-Bissau,11.8037,-15.1804,8831,0,176,8655
10/16/22,Guinea-Bissau,11.8037,-15.1804,8831,0,176,8655
10/17/22,Guinea-Bissau,11.8037,-15.1804,8831,0,176,8655
10/18/22,Guinea-Bissau,11.8037,-15.1804,8831,0,176,8655
10/19/22,Guinea-Bissau,11.8037,-15.1804,8831,0,176,8655
10/20/22,Guinea-Bissau,11.8037,-15.1804,8831,0,176,8655
10/21/22,Guinea-Bissau,11.8037,-15.1804,8831,0,176,8655
10/22/22,Guinea-Bissau,11.8037,-15.1804,8831,0,176,8655
10/23/22,Guinea-Bissau,11.8037,-15.1804,8831,0,176,8655
10/24/22,Guinea-Bissau,11.8037,-15.1804,8831,0,176,8655
10/25/22,Guinea-Bissau,11.8037,-15.1804,8848,0,176,8672
10/26/22,Guinea-Bissau,11.8037,-15.1804,8848,0,176,8672
10/27/22,Guinea-Bissau,11.8037,-15.1804,8848,0,176,8672
10/28/22,Guinea-Bissau,11.8037,-15.1804,8848,0,176,8672
10/29/22,Guinea-Bissau,11.8037,-15.1804,8848,0,176,8672
10/30/22,Guinea-Bissau,11.8037,-15.1804,8848,0,176,8672
10/31/22,Guinea-Bissau,11.8037,-15.1804,8848,0,176,8672
11/1/22,Guinea-Bissau,11.8037,-15.1804,8848,0,176,8672
11/2/22,Guinea-Bissau,11.8037,-15.1804,8848,0,176,8672
11/3/22,Guinea-Bissau,11.8037,-15.1804,8848,0,176,8672
11/4/22,Guinea-Bissau,11.8037,-15.1804,8848,0,176,8672
11/5/22,Guinea-Bissau,11.8037,-15.1804,8848,0,176,8672
11/6/22,Guinea-Bissau,11.8037,-15.1804,8848,0,176,8672
11/7/22,Guinea-Bissau,11.8037,-15.1804,8848,0,176,8672
11/8/22,Guinea-Bissau,11.8037,-15.1804,8848,0,176,8672
11/9/22,Guinea-Bissau,11.8037,-15.1804,8848,0,176,8672
11/10/22,Guinea-Bissau,11.8037,-15.1804,8848,0,176,8672
11/11/22,Guinea-Bissau,11.8037,-15.1804,8848,0,176,8672
11/12/22,Guinea-Bissau,11.8037,-15.1804,8848,0,176,8672
11/13/22,Guinea-Bissau,11.8037,-15.1804,8848,0,176,8672
11/14/22,Guinea-Bissau,11.8037,-15.1804,8848,0,176,8672
11/15/22,Guinea-Bissau,11.8037,-15.1804,8848,0,176,8672
11/16/22,Guinea-Bissau,11.8037,-15.1804,8848,0,176,8672
11/17/22,Guinea-Bissau,11.8037,-15.1804,8848,0,176,8672
11/18/22,Guinea-Bissau,11.8037,-15.1804,8848,0,176,8672
11/19/22,Guinea-Bissau,11.8037,-15.1804,8848,0,176,8672
11/20/22,Guinea-Bissau,11.8037,-15.1804,8848,0,176,8672
11/21/22,Guinea-Bissau,11.8037,-15.1804,8848,0,176,8672
11/22/22,Guinea-Bissau,11.8037,-15.1804,8848,0,176,8672
11/23/22,Guinea-Bissau,11.8037,-15.1804,8848,0,176,8672
11/24/22,Guinea-Bissau,11.8037,-15.1804,8848,0,176,8672
11/25/22,Guinea-Bissau,11.8037,-15.1804,8848,0,176,8672
11/26/22,Guinea-Bissau,11.8037,-15.1804,8848,0,176,8672
11/27/22,Guinea-Bissau,11.8037,-15.1804,8848,0,176,8672
11/28/22,Guinea-Bissau,11.8037,-15.1804,8848,0,176,8672
11/29/22,Guinea-Bissau,11.8037,-15.1804,8848,0,176,8672
11/30/22,Guinea-Bissau,11.8037,-15.1804,8848,0,176,8672
12/1/22,Guinea-Bissau,11.8037,-15.1804,8848,0,176,8672
12/2/22,Guinea-Bissau,11.8037,-15.1804,8848,0,176,8672
12/3/22,Guinea-Bissau,11.8037,-15.1804,8848,0,176,8672
12/4/22,Guinea-Bissau,11.8037,-15.1804,8848,0,176,8672
12/5/22,Guinea-Bissau,11.8037,-15.1804,8848,0,176,8672
12/6/22,Guinea-Bissau,11.8037,-15.1804,8848,0,176,8672
12/7/22,Guinea-Bissau,11.8037,-15.1804,8848,0,176,8672
12/8/22,Guinea-Bissau,11.8037,-15.1804,8848,0,176,8672
12/9/22,Guinea-Bissau,11.8037,-15.1804,8848,0,176,8672
12/10/22,Guinea-Bissau,11.8037,-15.1804,8848,0,176,8672
12/11/22,Guinea-Bissau,11.8037,-15.1804,8848,0,176,8672
12/12/22,Guinea-Bissau,11.8037,-15.1804,8848,0,176,8672
12/13/22,Guinea-Bissau,11.8037,-15.1804,8848,0,176,8672
12/14/22,Guinea-Bissau,11.8037,-15.1804,8848,0,176,8672
12/15/22,Guinea-Bissau,11.8037,-15.1804,8848,0,176,8672
12/16/22,Guinea-Bissau,11.8037,-15.1804,8848,0,176,8672
12/17/22,Guinea-Bissau,11.8037,-15.1804,8848,0,176,8672
1/1/22,Guyana,4.860416,-58.93018,39779,0,1054,38725
1/2/22,Guyana,4.860416,-58.93018,40060,0,1055,39005
1/3/22,Guyana,4.860416,-58.93018,40154,0,1056,39098
1/4/22,Guyana,4.860416,-58.93018,40639,0,1058,39581
1/5/22,Guyana,4.860416,-58.93018,41418,0,1060,40358
1/6/22,Guyana,4.860416,-58.93018,42385,0,1064,41321
1/7/22,Guyana,4.860416,-58.93018,43229,0,1066,42163
1/8/22,Guyana,4.860416,-58.93018,44245,0,1067,43178
1/9/22,Guyana,4.860416,-58.93018,44902,0,1070,43832
1/10/22,Guyana,4.860416,-58.93018,45340,0,1070,44270
1/11/22,Guyana,4.860416,-58.93018,46005,0,1073,44932
1/12/22,Guyana,4.860416,-58.93018,47005,0,1075,45930
1/13/22,Guyana,4.860416,-58.93018,48191,0,1075,47116
1/14/22,Guyana,4.860416,-58.93018,49056,0,1081,47975
1/15/22,Guyana,4.860416,-58.93018,50121,0,1086,49035
1/16/22,Guyana,4.860416,-58.93018,51203,0,1095,50108
1/17/22,Guyana,4.860416,-58.93018,52095,0,1096,50999
1/18/22,Guyana,4.860416,-58.93018,53178,0,1101,52077
1/19/22,Guyana,4.860416,-58.93018,53921,0,1108,52813
1/20/22,Guyana,4.860416,-58.93018,54736,0,1111,53625
1/21/22,Guyana,4.860416,-58.93018,55628,0,1122,54506
1/22/22,Guyana,4.860416,-58.93018,56585,0,1130,55455
1/23/22,Guyana,4.860416,-58.93018,57227,0,1134,56093
1/24/22,Guyana,4.860416,-58.93018,57400,0,1138,56262
1/25/22,Guyana,4.860416,-58.93018,57772,0,1148,56624
1/26/22,Guyana,4.860416,-58.93018,58196,0,1154,57042
1/27/22,Guyana,4.860416,-58.93018,58604,0,1156,57448
1/28/22,Guyana,4.860416,-58.93018,58604,0,1156,57448
1/29/22,Guyana,4.860416,-58.93018,59450,0,1165,58285
1/30/22,Guyana,4.860416,-58.93018,59803,0,1166,58637
1/31/22,Guyana,4.860416,-58.93018,59889,0,1168,58721
2/1/22,Guyana,4.860416,-58.93018,60109,0,1171,58938
2/2/22,Guyana,4.860416,-58.93018,60385,0,1176,59209
2/3/22,Guyana,4.860416,-58.93018,60676,0,1176,59500
2/4/22,Guyana,4.860416,-58.93018,61108,0,1179,59929
2/5/22,Guyana,4.860416,-58.93018,61404,0,1180,60224
2/6/22,Guyana,4.860416,-58.93018,61600,0,1181,60419
2/7/22,Guyana,4.860416,-58.93018,61616,0,1182,60434
2/8/22,Guyana,4.860416,-58.93018,61734,0,1185,60549
2/9/22,Guyana,4.860416,-58.93018,61901,0,1188,60713
2/10/22,Guyana,4.860416,-58.93018,62061,0,1188,60873
2/11/22,Guyana,4.860416,-58.93018,62156,0,1190,60966
2/12/22,Guyana,4.860416,-58.93018,62156,0,1190,60966
2/13/22,Guyana,4.860416,-58.93018,62156,0,1190,60966
2/14/22,Guyana,4.860416,-58.93018,62265,0,1196,61069
2/15/22,Guyana,4.860416,-58.93018,62360,0,1199,61161
2/16/22,Guyana,4.860416,-58.93018,62465,0,1202,61263
2/17/22,Guyana,4.860416,-58.93018,62537,0,1203,61334
2/18/22,Guyana,4.860416,-58.93018,62585,0,1208,61377
2/19/22,Guyana,4.860416,-58.93018,62638,0,1210,61428
2/20/22,Guyana,4.860416,-58.93018,62656,0,1211,61445
2/21/22,Guyana,4.860416,-58.93018,62668,0,1213,61455
2/22/22,Guyana,4.860416,-58.93018,62746,0,1215,61531
2/23/22,Guyana,4.860416,-58.93018,62779,0,1215,61564
2/24/22,Guyana,4.860416,-58.93018,62798,0,1216,61582
2/25/22,Guyana,4.860416,-58.93018,62856,0,1216,61640
2/26/22,Guyana,4.860416,-58.93018,62891,0,1220,61671
2/27/22,Guyana,4.860416,-58.93018,62891,0,1220,61671
2/28/22,Guyana,4.860416,-58.93018,62921,0,1220,61701
3/1/22,Guyana,4.860416,-58.93018,62946,0,1220,61726
3/2/22,Guyana,4.860416,-58.93018,62971,0,1222,61749
3/3/22,Guyana,4.860416,-58.93018,63002,0,1223,61779
3/4/22,Guyana,4.860416,-58.93018,63024,0,1223,61801
3/5/22,Guyana,4.860416,-58.93018,63040,0,1223,61817
3/6/22,Guyana,4.860416,-58.93018,63055,0,1223,61832
3/7/22,Guyana,4.860416,-58.93018,63062,0,1223,61839
3/8/22,Guyana,4.860416,-58.93018,63076,0,1223,61853
3/9/22,Guyana,4.860416,-58.93018,63090,0,1224,61866
3/10/22,Guyana,4.860416,-58.93018,63107,0,1224,61883
3/11/22,Guyana,4.860416,-58.93018,63107,0,1224,61883
3/12/22,Guyana,4.860416,-58.93018,63127,0,1224,61903
3/13/22,Guyana,4.860416,-58.93018,63144,0,1224,61920
3/14/22,Guyana,4.860416,-58.93018,63147,0,1225,61922
3/15/22,Guyana,4.860416,-58.93018,63157,0,1225,61932
3/16/22,Guyana,4.860416,-58.93018,63169,0,1226,61943
3/17/22,Guyana,4.860416,-58.93018,63175,0,1226,61949
3/18/22,Guyana,4.860416,-58.93018,63175,0,1226,61949
3/19/22,Guyana,4.860416,-58.93018,63183,0,1226,61957
3/20/22,Guyana,4.860416,-58.93018,63194,0,1226,61968
3/21/22,Guyana,4.860416,-58.93018,63195,0,1226,61969
3/22/22,Guyana,4.860416,-58.93018,63202,0,1226,61976
3/23/22,Guyana,4.860416,-58.93018,63208,0,1226,61982
3/24/22,Guyana,4.860416,-58.93018,63208,0,1226,61982
3/25/22,Guyana,4.860416,-58.93018,63223,0,1226,61997
3/26/22,Guyana,4.860416,-58.93018,63232,0,1226,62006
3/27/22,Guyana,4.860416,-58.93018,63234,0,1226,62008
3/28/22,Guyana,4.860416,-58.93018,63235,0,1226,62009
3/29/22,Guyana,4.860416,-58.93018,63239,0,1226,62013
3/30/22,Guyana,4.860416,-58.93018,63246,0,1226,62020
3/31/22,Guyana,4.860416,-58.93018,63253,0,1226,62027
4/1/22,Guyana,4.860416,-58.93018,63258,0,1226,62032
4/2/22,Guyana,4.860416,-58.93018,63267,0,1226,62041
4/3/22,Guyana,4.860416,-58.93018,63272,0,1226,62046
4/4/22,Guyana,4.860416,-58.93018,63273,0,1226,62047
4/5/22,Guyana,4.860416,-58.93018,63283,0,1226,62057
4/6/22,Guyana,4.860416,-58.93018,63294,0,1226,62068
4/7/22,Guyana,4.860416,-58.93018,63305,0,1226,62079
4/8/22,Guyana,4.860416,-58.93018,63310,0,1226,62084
4/9/22,Guyana,4.860416,-58.93018,63315,0,1226,62089
4/10/22,Guyana,4.860416,-58.93018,63326,0,1226,62100
4/11/22,Guyana,4.860416,-58.93018,63326,0,1226,62100
4/12/22,Guyana,4.860416,-58.93018,63340,0,1226,62114
4/13/22,Guyana,4.860416,-58.93018,63349,0,1227,62122
4/14/22,Guyana,4.860416,-58.93018,63358,0,1228,62130
4/15/22,Guyana,4.860416,-58.93018,63364,0,1228,62136
4/16/22,Guyana,4.860416,-58.93018,63368,0,1228,62140
4/17/22,Guyana,4.860416,-58.93018,63368,0,1228,62140
4/18/22,Guyana,4.860416,-58.93018,63371,0,1228,62143
4/19/22,Guyana,4.860416,-58.93018,63380,0,1228,62152
4/20/22,Guyana,4.860416,-58.93018,63389,0,1228,62161
4/21/22,Guyana,4.860416,-58.93018,63399,0,1228,62171
4/22/22,Guyana,4.860416,-58.93018,63407,0,1228,62179
4/23/22,Guyana,4.860416,-58.93018,63413,0,1228,62185
4/24/22,Guyana,4.860416,-58.93018,63416,0,1228,62188
4/25/22,Guyana,4.860416,-58.93018,63420,0,1228,62192
4/26/22,Guyana,4.860416,-58.93018,63420,0,1228,62192
4/27/22,Guyana,4.860416,-58.93018,63447,0,1228,62219
4/28/22,Guyana,4.860416,-58.93018,63457,0,1228,62229
4/29/22,Guyana,4.860416,-58.93018,63457,0,1228,62229
4/30/22,Guyana,4.860416,-58.93018,63473,0,1228,62245
5/1/22,Guyana,4.860416,-58.93018,63482,0,1228,62254
5/2/22,Guyana,4.860416,-58.93018,63484,0,1228,62256
5/3/22,Guyana,4.860416,-58.93018,63491,0,1228,62263
5/4/22,Guyana,4.860416,-58.93018,63518,0,1228,62290
5/5/22,Guyana,4.860416,-58.93018,63533,0,1228,62305
5/6/22,Guyana,4.860416,-58.93018,63533,0,1228,62305
5/7/22,Guyana,4.860416,-58.93018,63570,0,1228,62342
5/8/22,Guyana,4.860416,-58.93018,63583,0,1228,62355
5/9/22,Guyana,4.860416,-58.93018,63586,0,1228,62358
5/10/22,Guyana,4.860416,-58.93018,63586,0,1228,62358
5/11/22,Guyana,4.860416,-58.93018,63684,0,1228,62456
5/12/22,Guyana,4.860416,-58.93018,63736,0,1228,62508
5/13/22,Guyana,4.860416,-58.93018,63772,0,1228,62544
5/14/22,Guyana,4.860416,-58.93018,63804,0,1228,62576
5/15/22,Guyana,4.860416,-58.93018,63849,0,1228,62621
5/16/22,Guyana,4.860416,-58.93018,63861,0,1228,62633
5/17/22,Guyana,4.860416,-58.93018,63926,0,1228,62698
5/18/22,Guyana,4.860416,-58.93018,64020,0,1228,62792
5/19/22,Guyana,4.860416,-58.93018,64082,0,1229,62853
5/20/22,Guyana,4.860416,-58.93018,64174,0,1231,62943
5/21/22,Guyana,4.860416,-58.93018,64228,0,1231,62997
5/22/22,Guyana,4.860416,-58.93018,64276,0,1231,63045
5/23/22,Guyana,4.860416,-58.93018,64297,0,1231,63066
5/24/22,Guyana,4.860416,-58.93018,64342,0,1232,63110
5/25/22,Guyana,4.860416,-58.93018,64435,0,1232,63203
5/26/22,Guyana,4.860416,-58.93018,64492,0,1232,63260
5/27/22,Guyana,4.860416,-58.93018,64521,0,1232,63289
5/28/22,Guyana,4.860416,-58.93018,64521,0,1232,63289
5/29/22,Guyana,4.860416,-58.93018,64617,0,1233,63384
5/30/22,Guyana,4.860416,-58.93018,64628,0,1234,63394
5/31/22,Guyana,4.860416,-58.93018,64763,0,1234,63529
6/1/22,Guyana,4.860416,-58.93018,64969,0,1237,63732
6/2/22,Guyana,4.860416,-58.93018,65075,0,1237,63838
6/3/22,Guyana,4.860416,-58.93018,65148,0,1237,63911
6/4/22,Guyana,4.860416,-58.93018,65243,0,1238,64005
6/5/22,Guyana,4.860416,-58.93018,65272,0,1238,64034
6/6/22,Guyana,4.860416,-58.93018,65294,0,1238,64056
6/7/22,Guyana,4.860416,-58.93018,65422,0,1238,64184
6/8/22,Guyana,4.860416,-58.93018,65560,0,1239,64321
6/9/22,Guyana,4.860416,-58.93018,65714,0,1239,64475
6/10/22,Guyana,4.860416,-58.93018,65799,0,1239,64560
6/11/22,Guyana,4.860416,-58.93018,65859,0,1239,64620
6/12/22,Guyana,4.860416,-58.93018,65892,0,1239,64653
6/13/22,Guyana,4.860416,-58.93018,65926,0,1240,64686
6/14/22,Guyana,4.860416,-58.93018,66009,0,1242,64767
6/15/22,Guyana,4.860416,-58.93018,66129,0,1244,64885
6/16/22,Guyana,4.860416,-58.93018,66300,0,1244,65056
6/17/22,Guyana,4.860416,-58.93018,66385,0,1245,65140
6/18/22,Guyana,4.860416,-58.93018,66456,0,1245,65211
6/19/22,Guyana,4.860416,-58.93018,66491,0,1247,65244
6/20/22,Guyana,4.860416,-58.93018,66506,0,1248,65258
6/21/22,Guyana,4.860416,-58.93018,66588,0,1248,65340
6/22/22,Guyana,4.860416,-58.93018,66695,0,1249,65446
6/23/22,Guyana,4.860416,-58.93018,66835,0,1249,65586
6/24/22,Guyana,4.860416,-58.93018,66947,0,1249,65698
6/25/22,Guyana,4.860416,-58.93018,67058,0,1251,65807
6/26/22,Guyana,4.860416,-58.93018,67099,0,1251,65848
6/27/22,Guyana,4.860416,-58.93018,67114,0,1251,65863
6/28/22,Guyana,4.860416,-58.93018,67221,0,1251,65970
6/29/22,Guyana,4.860416,-58.93018,67325,0,1253,66072
6/30/22,Guyana,4.860416,-58.93018,67395,0,1254,66141
7/1/22,Guyana,4.860416,-58.93018,67472,0,1255,66217
7/2/22,Guyana,4.860416,-58.93018,67591,0,1255,66336
7/3/22,Guyana,4.860416,-58.93018,67615,0,1255,66360
7/4/22,Guyana,4.860416,-58.93018,67657,0,1256,66401
7/5/22,Guyana,4.860416,-58.93018,67699,0,1256,66443
7/6/22,Guyana,4.860416,-58.93018,67843,0,1258,66585
7/7/22,Guyana,4.860416,-58.93018,67929,0,1258,66671
7/8/22,Guyana,4.860416,-58.93018,68020,0,1259,66761
7/9/22,Guyana,4.860416,-58.93018,68162,0,1262,66900
7/10/22,Guyana,4.860416,-58.93018,68194,0,1262,66932
7/11/22,Guyana,4.860416,-58.93018,68225,0,1262,66963
7/12/22,Guyana,4.860416,-58.93018,68409,0,1263,67146
7/13/22,Guyana,4.860416,-58.93018,68500,0,1264,67236
7/14/22,Guyana,4.860416,-58.93018,68627,0,1264,67363
7/15/22,Guyana,4.860416,-58.93018,68730,0,1264,67466
7/16/22,Guyana,4.860416,-58.93018,68867,0,1264,67603
7/17/22,Guyana,4.860416,-58.93018,68913,0,1266,67647
7/18/22,Guyana,4.860416,-58.93018,68972,0,1267,67705
7/19/22,Guyana,4.860416,-58.93018,69058,0,1267,67791
7/20/22,Guyana,4.860416,-58.93018,69172,0,1268,67904
7/21/22,Guyana,4.860416,-58.93018,69252,0,1268,67984
7/22/22,Guyana,4.860416,-58.93018,69332,0,1268,68064
7/23/22,Guyana,4.860416,-58.93018,69413,0,1269,68144
7/24/22,Guyana,4.860416,-58.93018,69447,0,1270,68177
7/25/22,Guyana,4.860416,-58.93018,69468,0,1270,68198
7/26/22,Guyana,4.860416,-58.93018,69547,0,1271,68276
7/27/22,Guyana,4.860416,-58.93018,69620,0,1271,68349
7/28/22,Guyana,4.860416,-58.93018,69676,0,1271,68405
7/29/22,Guyana,4.860416,-58.93018,69745,0,1271,68474
7/30/22,Guyana,4.860416,-58.93018,69792,0,1271,68521
7/31/22,Guyana,4.860416,-58.93018,69807,0,1271,68536
8/1/22,Guyana,4.860416,-58.93018,69834,0,1271,68563
8/2/22,Guyana,4.860416,-58.93018,69846,0,1271,68575
8/3/22,Guyana,4.860416,-58.93018,69948,0,1271,68677
8/4/22,Guyana,4.860416,-58.93018,70009,0,1271,68738
8/5/22,Guyana,4.860416,-58.93018,70083,0,1271,68812
8/6/22,Guyana,4.860416,-58.93018,70126,0,1271,68855
8/7/22,Guyana,4.860416,-58.93018,70152,0,1271,68881
8/8/22,Guyana,4.860416,-58.93018,70159,0,1272,68887
8/9/22,Guyana,4.860416,-58.93018,70222,0,1272,68950
8/10/22,Guyana,4.860416,-58.93018,70284,0,1272,69012
8/11/22,Guyana,4.860416,-58.93018,70353,0,1274,69079
8/12/22,Guyana,4.860416,-58.93018,70398,0,1275,69123
8/13/22,Guyana,4.860416,-58.93018,70439,0,1275,69164
8/14/22,Guyana,4.860416,-58.93018,70457,0,1275,69182
8/15/22,Guyana,4.860416,-58.93018,70470,0,1275,69195
8/16/22,Guyana,4.860416,-58.93018,70561,0,1275,69286
8/17/22,Guyana,4.860416,-58.93018,70703,0,1276,69427
8/18/22,Guyana,4.860416,-58.93018,70744,0,1278,69466
8/19/22,Guyana,4.860416,-58.93018,70788,0,1278,69510
8/20/22,Guyana,4.860416,-58.93018,70803,0,1278,69525
8/21/22,Guyana,4.860416,-58.93018,70809,0,1278,69531
8/22/22,Guyana,4.860416,-58.93018,70815,0,1278,69537
8/23/22,Guyana,4.860416,-58.93018,70841,0,1278,69563
8/24/22,Guyana,4.860416,-58.93018,70841,0,1278,69563
8/25/22,Guyana,4.860416,-58.93018,70926,0,1278,69648
8/26/22,Guyana,4.860416,-58.93018,70943,0,1278,69665
8/27/22,Guyana,4.860416,-58.93018,70966,0,1278,69688
8/28/22,Guyana,4.860416,-58.93018,70974,0,1278,69696
8/29/22,Guyana,4.860416,-58.93018,70982,0,1278,69704
8/30/22,Guyana,4.860416,-58.93018,71005,0,1278,69727
8/31/22,Guyana,4.860416,-58.93018,71035,0,1278,69757
9/1/22,Guyana,4.860416,-58.93018,71062,0,1278,69784
9/2/22,Guyana,4.860416,-58.93018,71076,0,1279,69797
9/3/22,Guyana,4.860416,-58.93018,71085,0,1279,69806
9/4/22,Guyana,4.860416,-58.93018,71100,0,1279,69821
9/5/22,Guyana,4.860416,-58.93018,71102,0,1279,69823
9/6/22,Guyana,4.860416,-58.93018,71114,0,1279,69835
9/7/22,Guyana,4.860416,-58.93018,71133,0,1279,69854
9/8/22,Guyana,4.860416,-58.93018,71150,0,1279,69871
9/9/22,Guyana,4.860416,-58.93018,71174,0,1279,69895
9/10/22,Guyana,4.860416,-58.93018,71186,0,1279,69907
9/11/22,Guyana,4.860416,-58.93018,71191,0,1279,69912
9/12/22,Guyana,4.860416,-58.93018,71192,0,1279,69913
9/13/22,Guyana,4.860416,-58.93018,71209,0,1279,69930
9/14/22,Guyana,4.860416,-58.93018,71222,0,1280,69942
9/15/22,Guyana,4.860416,-58.93018,71239,0,1280,69959
9/16/22,Guyana,4.860416,-58.93018,71243,0,1281,69962
9/17/22,Guyana,4.860416,-58.93018,71251,0,1281,69970
9/18/22,Guyana,4.860416,-58.93018,71256,0,1281,69975
9/19/22,Guyana,4.860416,-58.93018,71263,0,1281,69982
9/20/22,Guyana,4.860416,-58.93018,71280,0,1281,69999
9/21/22,Guyana,4.860416,-58.93018,71287,0,1281,70006
9/22/22,Guyana,4.860416,-58.93018,71304,0,1281,70023
9/23/22,Guyana,4.860416,-58.93018,71311,0,1281,70030
9/24/22,Guyana,4.860416,-58.93018,71312,0,1281,70031
9/25/22,Guyana,4.860416,-58.93018,71315,0,1281,70034
9/26/22,Guyana,4.860416,-58.93018,71315,0,1281,70034
9/27/22,Guyana,4.860416,-58.93018,71322,0,1281,70041
9/28/22,Guyana,4.860416,-58.93018,71331,0,1281,70050
9/29/22,Guyana,4.860416,-58.93018,71336,0,1281,70055
9/30/22,Guyana,4.860416,-58.93018,71340,0,1281,70059
10/1/22,Guyana,4.860416,-58.93018,71348,0,1281,70067
10/2/22,Guyana,4.860416,-58.93018,71349,0,1281,70068
10/3/22,Guyana,4.860416,-58.93018,71351,0,1281,70070
10/4/22,Guyana,4.860416,-58.93018,71353,0,1281,70072
10/5/22,Guyana,4.860416,-58.93018,71356,0,1281,70075
10/6/22,Guyana,4.860416,-58.93018,71361,0,1281,70080
10/7/22,Guyana,4.860416,-58.93018,71361,0,1281,70080
10/8/22,Guyana,4.860416,-58.93018,71379,0,1281,70098
10/9/22,Guyana,4.860416,-58.93018,71380,0,1281,70099
10/10/22,Guyana,4.860416,-58.93018,71383,0,1281,70102
10/11/22,Guyana,4.860416,-58.93018,71383,0,1281,70102
10/12/22,Guyana,4.860416,-58.93018,71393,0,1281,70112
10/13/22,Guyana,4.860416,-58.93018,71397,0,1281,70116
10/14/22,Guyana,4.860416,-58.93018,71399,0,1281,70118
10/15/22,Guyana,4.860416,-58.93018,71401,0,1281,70120
10/16/22,Guyana,4.860416,-58.93018,71403,0,1281,70122
10/17/22,Guyana,4.860416,-58.93018,71404,0,1281,70123
10/18/22,Guyana,4.860416,-58.93018,71404,0,1281,70123
10/19/22,Guyana,4.860416,-58.93018,71418,0,1281,70137
10/20/22,Guyana,4.860416,-58.93018,71418,0,1281,70137
10/21/22,Guyana,4.860416,-58.93018,71419,0,1281,70138
10/22/22,Guyana,4.860416,-58.93018,71422,0,1281,70141
10/23/22,Guyana,4.860416,-58.93018,71422,0,1281,70141
10/24/22,Guyana,4.860416,-58.93018,71422,0,1281,70141
10/25/22,Guyana,4.860416,-58.93018,71422,0,1281,70141
10/26/22,Guyana,4.860416,-58.93018,71431,0,1281,70150
10/27/22,Guyana,4.860416,-58.93018,71436,0,1281,70155
10/28/22,Guyana,4.860416,-58.93018,71436,0,1281,70155
10/29/22,Guyana,4.860416,-58.93018,71436,0,1281,70155
10/30/22,Guyana,4.860416,-58.93018,71437,0,1281,70156
10/31/22,Guyana,4.860416,-58.93018,71437,0,1281,70156
11/1/22,Guyana,4.860416,-58.93018,71438,0,1281,70157
11/2/22,Guyana,4.860416,-58.93018,71438,0,1281,70157
11/3/22,Guyana,4.860416,-58.93018,71438,0,1281,70157
11/4/22,Guyana,4.860416,-58.93018,71442,0,1281,70161
11/5/22,Guyana,4.860416,-58.93018,71443,0,1281,70162
11/6/22,Guyana,4.860416,-58.93018,71447,0,1281,70166
11/7/22,Guyana,4.860416,-58.93018,71449,0,1281,70168
11/8/22,Guyana,4.860416,-58.93018,71453,0,1281,70172
11/9/22,Guyana,4.860416,-58.93018,71453,0,1281,70172
11/10/22,Guyana,4.860416,-58.93018,71461,0,1281,70180
11/11/22,Guyana,4.860416,-58.93018,71461,0,1281,70180
11/12/22,Guyana,4.860416,-58.93018,71468,0,1281,70187
11/13/22,Guyana,4.860416,-58.93018,71471,0,1281,70190
11/14/22,Guyana,4.860416,-58.93018,71471,0,1281,70190
11/15/22,Guyana,4.860416,-58.93018,71488,0,1281,70207
11/16/22,Guyana,4.860416,-58.93018,71499,0,1281,70218
11/17/22,Guyana,4.860416,-58.93018,71520,0,1281,70239
11/18/22,Guyana,4.860416,-58.93018,71522,0,1281,70241
11/19/22,Guyana,4.860416,-58.93018,71536,0,1281,70255
11/20/22,Guyana,4.860416,-58.93018,71541,0,1281,70260
11/21/22,Guyana,4.860416,-58.93018,71545,0,1283,70262
11/22/22,Guyana,4.860416,-58.93018,71548,0,1283,70265
11/23/22,Guyana,4.860416,-58.93018,71558,0,1284,70274
11/24/22,Guyana,4.860416,-58.93018,71560,0,1284,70276
11/25/22,Guyana,4.860416,-58.93018,71560,0,1284,70276
11/26/22,Guyana,4.860416,-58.93018,71573,0,1285,70288
11/27/22,Guyana,4.860416,-58.93018,71573,0,1285,70288
11/28/22,Guyana,4.860416,-58.93018,71584,0,1285,70299
11/29/22,Guyana,4.860416,-58.93018,71603,0,1285,70318
11/30/22,Guyana,4.860416,-58.93018,71620,0,1285,70335
12/1/22,Guyana,4.860416,-58.93018,71627,0,1285,70342
12/2/22,Guyana,4.860416,-58.93018,71627,0,1285,70342
12/3/22,Guyana,4.860416,-58.93018,71642,0,1285,70357
12/4/22,Guyana,4.860416,-58.93018,71650,0,1285,70365
12/5/22,Guyana,4.860416,-58.93018,71650,0,1285,70365
12/6/22,Guyana,4.860416,-58.93018,71679,0,1285,70394
12/7/22,Guyana,4.860416,-58.93018,71679,0,1285,70394
12/8/22,Guyana,4.860416,-58.93018,71700,0,1285,70415
12/9/22,Guyana,4.860416,-58.93018,71728,0,1285,70443
12/10/22,Guyana,4.860416,-58.93018,71745,0,1285,70460
12/11/22,Guyana,4.860416,-58.93018,71752,0,1285,70467
12/12/22,Guyana,4.860416,-58.93018,71757,0,1285,70472
12/13/22,Guyana,4.860416,-58.93018,71757,0,1285,70472
12/14/22,Guyana,4.860416,-58.93018,71757,0,1285,70472
12/15/22,Guyana,4.860416,-58.93018,71757,0,1285,70472
12/16/22,Guyana,4.860416,-58.93018,71757,0,1285,70472
12/17/22,Guyana,4.860416,-58.93018,71757,0,1285,70472
1/1/22,Haiti,18.9712,-72.2852,26213,0,773,25440
1/2/22,Haiti,18.9712,-72.2852,26255,0,773,25482
1/3/22,Haiti,18.9712,-72.2852,26259,0,774,25485
1/4/22,Haiti,18.9712,-72.2852,26259,0,774,25485
1/5/22,Haiti,18.9712,-72.2852,26304,0,774,25530
1/6/22,Haiti,18.9712,-72.2852,26406,0,780,25626
1/7/22,Haiti,18.9712,-72.2852,26509,0,780,25729
1/8/22,Haiti,18.9712,-72.2852,26654,0,780,25874
1/9/22,Haiti,18.9712,-72.2852,26807,0,780,26027
1/10/22,Haiti,18.9712,-72.2852,27000,0,780,26220
1/11/22,Haiti,18.9712,-72.2852,27082,0,780,26302
1/12/22,Haiti,18.9712,-72.2852,27318,0,780,26538
1/13/22,Haiti,18.9712,-72.2852,27490,0,780,26710
1/14/22,Haiti,18.9712,-72.2852,27619,0,780,26839
1/15/22,Haiti,18.9712,-72.2852,27819,0,780,27039
1/16/22,Haiti,18.9712,-72.2852,27973,0,780,27193
1/17/22,Haiti,18.9712,-72.2852,28030,0,780,27250
1/18/22,Haiti,18.9712,-72.2852,28117,0,780,27337
1/19/22,Haiti,18.9712,-72.2852,28250,0,780,27470
1/20/22,Haiti,18.9712,-72.2852,28352,0,783,27569
1/21/22,Haiti,18.9712,-72.2852,28471,0,783,27688
1/22/22,Haiti,18.9712,-72.2852,28561,0,783,27778
1/23/22,Haiti,18.9712,-72.2852,28709,0,783,27926
1/24/22,Haiti,18.9712,-72.2852,28743,0,783,27960
1/25/22,Haiti,18.9712,-72.2852,28875,0,784,28091
1/26/22,Haiti,18.9712,-72.2852,29053,0,784,28269
1/27/22,Haiti,18.9712,-72.2852,29123,0,784,28339
1/28/22,Haiti,18.9712,-72.2852,29217,0,786,28431
1/29/22,Haiti,18.9712,-72.2852,29323,0,792,28531
1/30/22,Haiti,18.9712,-72.2852,29444,0,799,28645
1/31/22,Haiti,18.9712,-72.2852,29477,0,804,28673
2/1/22,Haiti,18.9712,-72.2852,29549,0,804,28745
2/2/22,Haiti,18.9712,-72.2852,29549,0,804,28745
2/3/22,Haiti,18.9712,-72.2852,29715,0,804,28911
2/4/22,Haiti,18.9712,-72.2852,29779,0,804,28975
2/5/22,Haiti,18.9712,-72.2852,29832,0,804,29028
2/6/22,Haiti,18.9712,-72.2852,29848,0,804,29044
2/7/22,Haiti,18.9712,-72.2852,29879,0,806,29073
2/8/22,Haiti,18.9712,-72.2852,29888,0,806,29082
2/9/22,Haiti,18.9712,-72.2852,29907,0,807,29100
2/10/22,Haiti,18.9712,-72.2852,29907,0,807,29100
2/11/22,Haiti,18.9712,-72.2852,29907,0,807,29100
2/12/22,Haiti,18.9712,-72.2852,30055,0,809,29246
2/13/22,Haiti,18.9712,-72.2852,30055,0,809,29246
2/14/22,Haiti,18.9712,-72.2852,30102,0,809,29293
2/15/22,Haiti,18.9712,-72.2852,30121,0,809,29312
2/16/22,Haiti,18.9712,-72.2852,30162,0,814,29348
2/17/22,Haiti,18.9712,-72.2852,30208,0,819,29389
2/18/22,Haiti,18.9712,-72.2852,30226,0,819,29407
2/19/22,Haiti,18.9712,-72.2852,30260,0,819,29441
2/20/22,Haiti,18.9712,-72.2852,30273,0,819,29454
2/21/22,Haiti,18.9712,-72.2852,30287,0,819,29468
2/22/22,Haiti,18.9712,-72.2852,30299,0,820,29479
2/23/22,Haiti,18.9712,-72.2852,30314,0,820,29494
2/24/22,Haiti,18.9712,-72.2852,30336,0,820,29516
2/25/22,Haiti,18.9712,-72.2852,30340,0,820,29520
2/26/22,Haiti,18.9712,-72.2852,30342,0,820,29522
2/27/22,Haiti,18.9712,-72.2852,30342,0,820,29522
2/28/22,Haiti,18.9712,-72.2852,30350,0,820,29530
3/1/22,Haiti,18.9712,-72.2852,30353,0,820,29533
3/2/22,Haiti,18.9712,-72.2852,30375,0,820,29555
3/3/22,Haiti,18.9712,-72.2852,30382,0,820,29562
3/4/22,Haiti,18.9712,-72.2852,30385,0,823,29562
3/5/22,Haiti,18.9712,-72.2852,30400,0,825,29575
3/6/22,Haiti,18.9712,-72.2852,30430,0,827,29603
3/7/22,Haiti,18.9712,-72.2852,30430,0,827,29603
3/8/22,Haiti,18.9712,-72.2852,30432,0,827,29605
3/9/22,Haiti,18.9712,-72.2852,30433,0,827,29606
3/10/22,Haiti,18.9712,-72.2852,30438,0,827,29611
3/11/22,Haiti,18.9712,-72.2852,30446,0,827,29619
3/12/22,Haiti,18.9712,-72.2852,30461,0,827,29634
3/13/22,Haiti,18.9712,-72.2852,30473,0,827,29646
3/14/22,Haiti,18.9712,-72.2852,30473,0,827,29646
3/15/22,Haiti,18.9712,-72.2852,30478,0,827,29651
3/16/22,Haiti,18.9712,-72.2852,30487,0,827,29660
3/17/22,Haiti,18.9712,-72.2852,30488,0,827,29661
3/18/22,Haiti,18.9712,-72.2852,30494,0,827,29667
3/19/22,Haiti,18.9712,-72.2852,30496,0,827,29669
3/20/22,Haiti,18.9712,-72.2852,30509,0,827,29682
3/21/22,Haiti,18.9712,-72.2852,30511,0,827,29684
3/22/22,Haiti,18.9712,-72.2852,30511,0,827,29684
3/23/22,Haiti,18.9712,-72.2852,30515,0,827,29688
3/24/22,Haiti,18.9712,-72.2852,30522,0,829,29693
3/25/22,Haiti,18.9712,-72.2852,30528,0,833,29695
3/26/22,Haiti,18.9712,-72.2852,30528,0,833,29695
3/27/22,Haiti,18.9712,-72.2852,30528,0,833,29695
3/28/22,Haiti,18.9712,-72.2852,30545,0,833,29712
3/29/22,Haiti,18.9712,-72.2852,30545,0,833,29712
3/30/22,Haiti,18.9712,-72.2852,30545,0,833,29712
3/31/22,Haiti,18.9712,-72.2852,30563,0,833,29730
4/1/22,Haiti,18.9712,-72.2852,30567,0,833,29734
4/2/22,Haiti,18.9712,-72.2852,30571,0,833,29738
4/3/22,Haiti,18.9712,-72.2852,30575,0,833,29742
4/4/22,Haiti,18.9712,-72.2852,30575,0,833,29742
4/5/22,Haiti,18.9712,-72.2852,30576,0,834,29742
4/6/22,Haiti,18.9712,-72.2852,30578,0,834,29744
4/7/22,Haiti,18.9712,-72.2852,30578,0,834,29744
4/8/22,Haiti,18.9712,-72.2852,30585,0,835,29750
4/9/22,Haiti,18.9712,-72.2852,30586,0,835,29751
4/10/22,Haiti,18.9712,-72.2852,30586,0,835,29751
4/11/22,Haiti,18.9712,-72.2852,30587,0,835,29752
4/12/22,Haiti,18.9712,-72.2852,30594,0,835,29759
4/13/22,Haiti,18.9712,-72.2852,30610,0,835,29775
4/14/22,Haiti,18.9712,-72.2852,30612,0,835,29777
4/15/22,Haiti,18.9712,-72.2852,30615,0,835,29780
4/16/22,Haiti,18.9712,-72.2852,30623,0,835,29788
4/17/22,Haiti,18.9712,-72.2852,30640,0,835,29805
4/18/22,Haiti,18.9712,-72.2852,30643,0,835,29808
4/19/22,Haiti,18.9712,-72.2852,30648,0,835,29813
4/20/22,Haiti,18.9712,-72.2852,30649,0,835,29814
4/21/22,Haiti,18.9712,-72.2852,30650,0,835,29815
4/22/22,Haiti,18.9712,-72.2852,30655,0,835,29820
4/23/22,Haiti,18.9712,-72.2852,30659,0,835,29824
4/24/22,Haiti,18.9712,-72.2852,30659,0,835,29824
4/25/22,Haiti,18.9712,-72.2852,30690,0,835,29855
4/26/22,Haiti,18.9712,-72.2852,30690,0,835,29855
4/27/22,Haiti,18.9712,-72.2852,30697,0,835,29862
4/28/22,Haiti,18.9712,-72.2852,30699,0,835,29864
4/29/22,Haiti,18.9712,-72.2852,30702,0,835,29867
4/30/22,Haiti,18.9712,-72.2852,30703,0,835,29868
5/1/22,Haiti,18.9712,-72.2852,30704,0,835,29869
5/2/22,Haiti,18.9712,-72.2852,30705,0,835,29870
5/3/22,Haiti,18.9712,-72.2852,30707,0,835,29872
5/4/22,Haiti,18.9712,-72.2852,30707,0,835,29872
5/5/22,Haiti,18.9712,-72.2852,30707,0,835,29872
5/6/22,Haiti,18.9712,-72.2852,30707,0,835,29872
5/7/22,Haiti,18.9712,-72.2852,30712,0,835,29877
5/8/22,Haiti,18.9712,-72.2852,30713,0,835,29878
5/9/22,Haiti,18.9712,-72.2852,30713,0,835,29878
5/10/22,Haiti,18.9712,-72.2852,30713,0,835,29878
5/11/22,Haiti,18.9712,-72.2852,30725,0,835,29890
5/12/22,Haiti,18.9712,-72.2852,30730,0,835,29895
5/13/22,Haiti,18.9712,-72.2852,30734,0,835,29899
5/14/22,Haiti,18.9712,-72.2852,30740,0,835,29905
5/15/22,Haiti,18.9712,-72.2852,30746,0,835,29911
5/16/22,Haiti,18.9712,-72.2852,30754,0,835,29919
5/17/22,Haiti,18.9712,-72.2852,30760,0,835,29925
5/18/22,Haiti,18.9712,-72.2852,30771,0,835,29936
5/19/22,Haiti,18.9712,-72.2852,30781,0,835,29946
5/20/22,Haiti,18.9712,-72.2852,30781,0,835,29946
5/21/22,Haiti,18.9712,-72.2852,30789,0,835,29954
5/22/22,Haiti,18.9712,-72.2852,30754,0,835,29919
5/23/22,Haiti,18.9712,-72.2852,30803,0,835,29968
5/24/22,Haiti,18.9712,-72.2852,30805,0,835,29970
5/25/22,Haiti,18.9712,-72.2852,30818,0,835,29983
5/26/22,Haiti,18.9712,-72.2852,30818,0,835,29983
5/27/22,Haiti,18.9712,-72.2852,30818,0,835,29983
5/28/22,Haiti,18.9712,-72.2852,30818,0,835,29983
5/29/22,Haiti,18.9712,-72.2852,30818,0,835,29983
5/30/22,Haiti,18.9712,-72.2852,30818,0,835,29983
5/31/22,Haiti,18.9712,-72.2852,30892,0,835,30057
6/1/22,Haiti,18.9712,-72.2852,30905,0,835,30070
6/2/22,Haiti,18.9712,-72.2852,30924,0,835,30089
6/3/22,Haiti,18.9712,-72.2852,30940,0,835,30105
6/4/22,Haiti,18.9712,-72.2852,30952,0,835,30117
6/5/22,Haiti,18.9712,-72.2852,30963,0,835,30128
6/6/22,Haiti,18.9712,-72.2852,30970,0,835,30135
6/7/22,Haiti,18.9712,-72.2852,30985,0,837,30148
6/8/22,Haiti,18.9712,-72.2852,31004,0,837,30167
6/9/22,Haiti,18.9712,-72.2852,31025,0,837,30188
6/10/22,Haiti,18.9712,-72.2852,31034,0,837,30197
6/11/22,Haiti,18.9712,-72.2852,31054,0,837,30217
6/12/22,Haiti,18.9712,-72.2852,31075,0,837,30238
6/13/22,Haiti,18.9712,-72.2852,31092,0,837,30255
6/14/22,Haiti,18.9712,-72.2852,31115,0,837,30278
6/15/22,Haiti,18.9712,-72.2852,31133,0,837,30296
6/16/22,Haiti,18.9712,-72.2852,31163,0,837,30326
6/17/22,Haiti,18.9712,-72.2852,31195,0,837,30358
6/18/22,Haiti,18.9712,-72.2852,31200,0,837,30363
6/19/22,Haiti,18.9712,-72.2852,31226,0,837,30389
6/20/22,Haiti,18.9712,-72.2852,31242,0,837,30405
6/21/22,Haiti,18.9712,-72.2852,31248,0,837,30411
6/22/22,Haiti,18.9712,-72.2852,31301,0,837,30464
6/23/22,Haiti,18.9712,-72.2852,31355,0,837,30518
6/24/22,Haiti,18.9712,-72.2852,31410,0,837,30573
6/25/22,Haiti,18.9712,-72.2852,31470,0,837,30633
6/26/22,Haiti,18.9712,-72.2852,31470,0,837,30633
6/27/22,Haiti,18.9712,-72.2852,31550,0,837,30713
6/28/22,Haiti,18.9712,-72.2852,31603,0,837,30766
6/29/22,Haiti,18.9712,-72.2852,31656,0,837,30819
6/30/22,Haiti,18.9712,-72.2852,31677,0,837,30840
7/1/22,Haiti,18.9712,-72.2852,31703,0,837,30866
7/2/22,Haiti,18.9712,-72.2852,31767,0,837,30930
7/3/22,Haiti,18.9712,-72.2852,31795,0,837,30958
7/4/22,Haiti,18.9712,-72.2852,31843,0,837,31006
7/5/22,Haiti,18.9712,-72.2852,31884,0,837,31047
7/6/22,Haiti,18.9712,-72.2852,31908,0,837,31071
7/7/22,Haiti,18.9712,-72.2852,31931,0,837,31094
7/8/22,Haiti,18.9712,-72.2852,31980,0,837,31143
7/9/22,Haiti,18.9712,-72.2852,31980,0,837,31143
7/10/22,Haiti,18.9712,-72.2852,31980,0,837,31143
7/11/22,Haiti,18.9712,-72.2852,31980,0,837,31143
7/12/22,Haiti,18.9712,-72.2852,32103,0,837,31266
7/13/22,Haiti,18.9712,-72.2852,32103,0,837,31266
7/14/22,Haiti,18.9712,-72.2852,32131,0,838,31293
7/15/22,Haiti,18.9712,-72.2852,32145,0,838,31307
7/16/22,Haiti,18.9712,-72.2852,32155,0,838,31317
7/17/22,Haiti,18.9712,-72.2852,32178,0,838,31340
7/18/22,Haiti,18.9712,-72.2852,32197,0,838,31359
7/19/22,Haiti,18.9712,-72.2852,32223,0,838,31385
7/20/22,Haiti,18.9712,-72.2852,32223,0,838,31385
7/21/22,Haiti,18.9712,-72.2852,32223,0,838,31385
7/22/22,Haiti,18.9712,-72.2852,32223,0,838,31385
7/23/22,Haiti,18.9712,-72.2852,32223,0,838,31385
7/24/22,Haiti,18.9712,-72.2852,32263,0,838,31425
7/25/22,Haiti,18.9712,-72.2852,32263,0,838,31425
7/26/22,Haiti,18.9712,-72.2852,32272,0,838,31434
7/27/22,Haiti,18.9712,-72.2852,32285,0,838,31447
7/28/22,Haiti,18.9712,-72.2852,32296,0,838,31458
7/29/22,Haiti,18.9712,-72.2852,32314,0,838,31476
7/30/22,Haiti,18.9712,-72.2852,32361,0,838,31523
7/31/22,Haiti,18.9712,-72.2852,32405,0,838,31567
8/1/22,Haiti,18.9712,-72.2852,32464,0,838,31626
8/2/22,Haiti,18.9712,-72.2852,32516,0,838,31678
8/3/22,Haiti,18.9712,-72.2852,32516,0,838,31678
8/4/22,Haiti,18.9712,-72.2852,32516,0,838,31678
8/5/22,Haiti,18.9712,-72.2852,32516,0,838,31678
8/6/22,Haiti,18.9712,-72.2852,32516,0,838,31678
8/7/22,Haiti,18.9712,-72.2852,32703,0,838,31865
8/8/22,Haiti,18.9712,-72.2852,32715,0,838,31877
8/9/22,Haiti,18.9712,-72.2852,32738,0,838,31900
8/10/22,Haiti,18.9712,-72.2852,32791,0,838,31953
8/11/22,Haiti,18.9712,-72.2852,32809,0,838,31971
8/12/22,Haiti,18.9712,-72.2852,32843,0,840,32003
8/13/22,Haiti,18.9712,-72.2852,32873,0,840,32033
8/14/22,Haiti,18.9712,-72.2852,32942,0,840,32102
8/15/22,Haiti,18.9712,-72.2852,32961,0,840,32121
8/16/22,Haiti,18.9712,-72.2852,32994,0,840,32154
8/17/22,Haiti,18.9712,-72.2852,33017,0,840,32177
8/18/22,Haiti,18.9712,-72.2852,33043,0,841,32202
8/19/22,Haiti,18.9712,-72.2852,33070,0,841,32229
8/20/22,Haiti,18.9712,-72.2852,33133,0,841,32292
8/21/22,Haiti,18.9712,-72.2852,33189,0,841,32348
8/22/22,Haiti,18.9712,-72.2852,33239,0,841,32398
8/23/22,Haiti,18.9712,-72.2852,33295,0,841,32454
8/24/22,Haiti,18.9712,-72.2852,33331,0,841,32490
8/25/22,Haiti,18.9712,-72.2852,33360,0,841,32519
8/26/22,Haiti,18.9712,-72.2852,33381,0,841,32540
8/27/22,Haiti,18.9712,-72.2852,33400,0,841,32559
8/28/22,Haiti,18.9712,-72.2852,33442,0,841,32601
8/29/22,Haiti,18.9712,-72.2852,33468,0,841,32627
8/30/22,Haiti,18.9712,-72.2852,33520,0,841,32679
8/31/22,Haiti,18.9712,-72.2852,33551,0,841,32710
9/1/22,Haiti,18.9712,-72.2852,33551,0,841,32710
9/2/22,Haiti,18.9712,-72.2852,33551,0,841,32710
9/3/22,Haiti,18.9712,-72.2852,33551,0,841,32710
9/4/22,Haiti,18.9712,-72.2852,33551,0,841,32710
9/5/22,Haiti,18.9712,-72.2852,33551,0,841,32710
9/6/22,Haiti,18.9712,-72.2852,33551,0,841,32710
9/7/22,Haiti,18.9712,-72.2852,33551,0,841,32710
9/8/22,Haiti,18.9712,-72.2852,33551,0,841,32710
9/9/22,Haiti,18.9712,-72.2852,33658,0,851,32807
9/10/22,Haiti,18.9712,-72.2852,33658,0,851,32807
9/11/22,Haiti,18.9712,-72.2852,33658,0,851,32807
9/12/22,Haiti,18.9712,-72.2852,33702,0,857,32845
9/13/22,Haiti,18.9712,-72.2852,33702,0,857,32845
9/14/22,Haiti,18.9712,-72.2852,33702,0,857,32845
9/15/22,Haiti,18.9712,-72.2852,33721,0,857,32864
9/16/22,Haiti,18.9712,-72.2852,33721,0,857,32864
9/17/22,Haiti,18.9712,-72.2852,33721,0,857,32864
9/18/22,Haiti,18.9712,-72.2852,33721,0,857,32864
9/19/22,Haiti,18.9712,-72.2852,33721,0,857,32864
9/20/22,Haiti,18.9712,-72.2852,33721,0,857,32864
9/21/22,Haiti,18.9712,-72.2852,33721,0,857,32864
9/22/22,Haiti,18.9712,-72.2852,33733,0,857,32876
9/23/22,Haiti,18.9712,-72.2852,33733,0,857,32876
9/24/22,Haiti,18.9712,-72.2852,33733,0,857,32876
9/25/22,Haiti,18.9712,-72.2852,33733,0,857,32876
9/26/22,Haiti,18.9712,-72.2852,33733,0,857,32876
9/27/22,Haiti,18.9712,-72.2852,33733,0,857,32876
9/28/22,Haiti,18.9712,-72.2852,33733,0,857,32876
9/29/22,Haiti,18.9712,-72.2852,33733,0,857,32876
9/30/22,Haiti,18.9712,-72.2852,33733,0,857,32876
10/1/22,Haiti,18.9712,-72.2852,33756,0,857,32899
10/2/22,Haiti,18.9712,-72.2852,33756,0,857,32899
10/3/22,Haiti,18.9712,-72.2852,33756,0,857,32899
10/4/22,Haiti,18.9712,-72.2852,33756,0,857,32899
10/5/22,Haiti,18.9712,-72.2852,33756,0,857,32899
10/6/22,Haiti,18.9712,-72.2852,33756,0,857,32899
10/7/22,Haiti,18.9712,-72.2852,33756,0,857,32899
10/8/22,Haiti,18.9712,-72.2852,33756,0,857,32899
10/9/22,Haiti,18.9712,-72.2852,33756,0,857,32899
10/10/22,Haiti,18.9712,-72.2852,33756,0,857,32899
10/11/22,Haiti,18.9712,-72.2852,33756,0,857,32899
10/12/22,Haiti,18.9712,-72.2852,33761,0,857,32904
10/13/22,Haiti,18.9712,-72.2852,33764,0,857,32907
10/14/22,Haiti,18.9712,-72.2852,33764,0,857,32907
10/15/22,Haiti,18.9712,-72.2852,33764,0,857,32907
10/16/22,Haiti,18.9712,-72.2852,33764,0,857,32907
10/17/22,Haiti,18.9712,-72.2852,33764,0,857,32907
10/18/22,Haiti,18.9712,-72.2852,33764,0,857,32907
10/19/22,Haiti,18.9712,-72.2852,33764,0,857,32907
10/20/22,Haiti,18.9712,-72.2852,33764,0,857,32907
10/21/22,Haiti,18.9712,-72.2852,33764,0,857,32907
10/22/22,Haiti,18.9712,-72.2852,33764,0,857,32907
10/23/22,Haiti,18.9712,-72.2852,33764,0,857,32907
10/24/22,Haiti,18.9712,-72.2852,33764,0,857,32907
10/25/22,Haiti,18.9712,-72.2852,33764,0,857,32907
10/26/22,Haiti,18.9712,-72.2852,33811,0,857,32954
10/27/22,Haiti,18.9712,-72.2852,33811,0,857,32954
10/28/22,Haiti,18.9712,-72.2852,33811,0,857,32954
10/29/22,Haiti,18.9712,-72.2852,33811,0,857,32954
10/30/22,Haiti,18.9712,-72.2852,33811,0,857,32954
10/31/22,Haiti,18.9712,-72.2852,33811,0,857,32954
11/1/22,Haiti,18.9712,-72.2852,33811,0,857,32954
11/2/22,Haiti,18.9712,-72.2852,33811,0,857,32954
11/3/22,Haiti,18.9712,-72.2852,33828,0,860,32968
11/4/22,Haiti,18.9712,-72.2852,33828,0,860,32968
11/5/22,Haiti,18.9712,-72.2852,33828,0,860,32968
11/6/22,Haiti,18.9712,-72.2852,33828,0,860,32968
11/7/22,Haiti,18.9712,-72.2852,33828,0,860,32968
11/8/22,Haiti,18.9712,-72.2852,33828,0,860,32968
11/9/22,Haiti,18.9712,-72.2852,33828,0,860,32968
11/10/22,Haiti,18.9712,-72.2852,33828,0,860,32968
11/11/22,Haiti,18.9712,-72.2852,33828,0,860,32968
11/12/22,Haiti,18.9712,-72.2852,33828,0,860,32968
11/13/22,Haiti,18.9712,-72.2852,33832,0,860,32972
11/14/22,Haiti,18.9712,-72.2852,33832,0,860,32972
11/15/22,Haiti,18.9712,-72.2852,33832,0,860,32972
11/16/22,Haiti,18.9712,-72.2852,33832,0,860,32972
11/17/22,Haiti,18.9712,-72.2852,33837,0,860,32977
11/18/22,Haiti,18.9712,-72.2852,33837,0,860,32977
11/19/22,Haiti,18.9712,-72.2852,33837,0,860,32977
11/20/22,Haiti,18.9712,-72.2852,33837,0,860,32977
11/21/22,Haiti,18.9712,-72.2852,33837,0,860,32977
11/22/22,Haiti,18.9712,-72.2852,33837,0,860,32977
11/23/22,Haiti,18.9712,-72.2852,33837,0,860,32977
11/24/22,Haiti,18.9712,-72.2852,33846,0,860,32986
11/25/22,Haiti,18.9712,-72.2852,33846,0,860,32986
11/26/22,Haiti,18.9712,-72.2852,33846,0,860,32986
11/27/22,Haiti,18.9712,-72.2852,33846,0,860,32986
11/28/22,Haiti,18.9712,-72.2852,33846,0,860,32986
11/29/22,Haiti,18.9712,-72.2852,33846,0,860,32986
11/30/22,Haiti,18.9712,-72.2852,33846,0,860,32986
12/1/22,Haiti,18.9712,-72.2852,33862,0,860,33002
12/2/22,Haiti,18.9712,-72.2852,33862,0,860,33002
12/3/22,Haiti,18.9712,-72.2852,33862,0,860,33002
12/4/22,Haiti,18.9712,-72.2852,33862,0,860,33002
12/5/22,Haiti,18.9712,-72.2852,33862,0,860,33002
12/6/22,Haiti,18.9712,-72.2852,33862,0,860,33002
12/7/22,Haiti,18.9712,-72.2852,33862,0,860,33002
12/8/22,Haiti,18.9712,-72.2852,33862,0,860,33002
12/9/22,Haiti,18.9712,-72.2852,33874,0,860,33014
12/10/22,Haiti,18.9712,-72.2852,33874,0,860,33014
12/11/22,Haiti,18.9712,-72.2852,33874,0,860,33014
12/12/22,Haiti,18.9712,-72.2852,33874,0,860,33014
12/13/22,Haiti,18.9712,-72.2852,33874,0,860,33014
12/14/22,Haiti,18.9712,-72.2852,33874,0,860,33014
12/15/22,Haiti,18.9712,-72.2852,33876,0,860,33016
12/16/22,Haiti,18.9712,-72.2852,33876,0,860,33016
12/17/22,Haiti,18.9712,-72.2852,33876,0,860,33016
1/1/22,Holy See,41.9029,12.4534,27,0,0,27
1/2/22,Holy See,41.9029,12.4534,27,0,0,27
1/3/22,Holy See,41.9029,12.4534,27,0,0,27
1/4/22,Holy See,41.9029,12.4534,27,0,0,27
1/5/22,Holy See,41.9029,12.4534,27,0,0,27
1/6/22,Holy See,41.9029,12.4534,27,0,0,27
1/7/22,Holy See,41.9029,12.4534,27,0,0,27
1/8/22,Holy See,41.9029,12.4534,27,0,0,27
1/9/22,Holy See,41.9029,12.4534,27,0,0,27
1/10/22,Holy See,41.9029,12.4534,27,0,0,27
1/11/22,Holy See,41.9029,12.4534,27,0,0,27
1/12/22,Holy See,41.9029,12.4534,27,0,0,27
1/13/22,Holy See,41.9029,12.4534,27,0,0,27
1/14/22,Holy See,41.9029,12.4534,27,0,0,27
1/15/22,Holy See,41.9029,12.4534,27,0,0,27
1/16/22,Holy See,41.9029,12.4534,27,0,0,27
1/17/22,Holy See,41.9029,12.4534,27,0,0,27
1/18/22,Holy See,41.9029,12.4534,29,0,0,29
1/19/22,Holy See,41.9029,12.4534,29,0,0,29
1/20/22,Holy See,41.9029,12.4534,29,0,0,29
1/21/22,Holy See,41.9029,12.4534,29,0,0,29
1/22/22,Holy See,41.9029,12.4534,29,0,0,29
1/23/22,Holy See,41.9029,12.4534,29,0,0,29
1/24/22,Holy See,41.9029,12.4534,29,0,0,29
1/25/22,Holy See,41.9029,12.4534,29,0,0,29
1/26/22,Holy See,41.9029,12.4534,29,0,0,29
1/27/22,Holy See,41.9029,12.4534,29,0,0,29
1/28/22,Holy See,41.9029,12.4534,29,0,0,29
1/29/22,Holy See,41.9029,12.4534,29,0,0,29
1/30/22,Holy See,41.9029,12.4534,29,0,0,29
1/31/22,Holy See,41.9029,12.4534,29,0,0,29
2/1/22,Holy See,41.9029,12.4534,29,0,0,29
2/2/22,Holy See,41.9029,12.4534,29,0,0,29
2/3/22,Holy See,41.9029,12.4534,29,0,0,29
2/4/22,Holy See,41.9029,12.4534,29,0,0,29
2/5/22,Holy See,41.9029,12.4534,29,0,0,29
2/6/22,Holy See,41.9029,12.4534,29,0,0,29
2/7/22,Holy See,41.9029,12.4534,29,0,0,29
2/8/22,Holy See,41.9029,12.4534,29,0,0,29
2/9/22,Holy See,41.9029,12.4534,29,0,0,29
2/10/22,Holy See,41.9029,12.4534,29,0,0,29
2/11/22,Holy See,41.9029,12.4534,29,0,0,29
2/12/22,Holy See,41.9029,12.4534,29,0,0,29
2/13/22,Holy See,41.9029,12.4534,29,0,0,29
2/14/22,Holy See,41.9029,12.4534,29,0,0,29
2/15/22,Holy See,41.9029,12.4534,29,0,0,29
2/16/22,Holy See,41.9029,12.4534,29,0,0,29
2/17/22,Holy See,41.9029,12.4534,29,0,0,29
2/18/22,Holy See,41.9029,12.4534,29,0,0,29
2/19/22,Holy See,41.9029,12.4534,29,0,0,29
2/20/22,Holy See,41.9029,12.4534,29,0,0,29
2/21/22,Holy See,41.9029,12.4534,29,0,0,29
2/22/22,Holy See,41.9029,12.4534,29,0,0,29
2/23/22,Holy See,41.9029,12.4534,29,0,0,29
2/24/22,Holy See,41.9029,12.4534,29,0,0,29
2/25/22,Holy See,41.9029,12.4534,29,0,0,29
2/26/22,Holy See,41.9029,12.4534,29,0,0,29
2/27/22,Holy See,41.9029,12.4534,29,0,0,29
2/28/22,Holy See,41.9029,12.4534,29,0,0,29
3/1/22,Holy See,41.9029,12.4534,29,0,0,29
3/2/22,Holy See,41.9029,12.4534,29,0,0,29
3/3/22,Holy See,41.9029,12.4534,29,0,0,29
3/4/22,Holy See,41.9029,12.4534,29,0,0,29
3/5/22,Holy See,41.9029,12.4534,29,0,0,29
3/6/22,Holy See,41.9029,12.4534,29,0,0,29
3/7/22,Holy See,41.9029,12.4534,29,0,0,29
3/8/22,Holy See,41.9029,12.4534,29,0,0,29
3/9/22,Holy See,41.9029,12.4534,29,0,0,29
3/10/22,Holy See,41.9029,12.4534,29,0,0,29
3/11/22,Holy See,41.9029,12.4534,29,0,0,29
3/12/22,Holy See,41.9029,12.4534,29,0,0,29
3/13/22,Holy See,41.9029,12.4534,29,0,0,29
3/14/22,Holy See,41.9029,12.4534,29,0,0,29
3/15/22,Holy See,41.9029,12.4534,29,0,0,29
3/16/22,Holy See,41.9029,12.4534,29,0,0,29
3/17/22,Holy See,41.9029,12.4534,29,0,0,29
3/18/22,Holy See,41.9029,12.4534,29,0,0,29
3/19/22,Holy See,41.9029,12.4534,29,0,0,29
3/20/22,Holy See,41.9029,12.4534,29,0,0,29
3/21/22,Holy See,41.9029,12.4534,29,0,0,29
3/22/22,Holy See,41.9029,12.4534,29,0,0,29
3/23/22,Holy See,41.9029,12.4534,29,0,0,29
3/24/22,Holy See,41.9029,12.4534,29,0,0,29
3/25/22,Holy See,41.9029,12.4534,29,0,0,29
3/26/22,Holy See,41.9029,12.4534,29,0,0,29
3/27/22,Holy See,41.9029,12.4534,29,0,0,29
3/28/22,Holy See,41.9029,12.4534,29,0,0,29
3/29/22,Holy See,41.9029,12.4534,29,0,0,29
3/30/22,Holy See,41.9029,12.4534,29,0,0,29
3/31/22,Holy See,41.9029,12.4534,29,0,0,29
4/1/22,Holy See,41.9029,12.4534,29,0,0,29
4/2/22,Holy See,41.9029,12.4534,29,0,0,29
4/3/22,Holy See,41.9029,12.4534,29,0,0,29
4/4/22,Holy See,41.9029,12.4534,29,0,0,29
4/5/22,Holy See,41.9029,12.4534,29,0,0,29
4/6/22,Holy See,41.9029,12.4534,29,0,0,29
4/7/22,Holy See,41.9029,12.4534,29,0,0,29
4/8/22,Holy See,41.9029,12.4534,29,0,0,29
4/9/22,Holy See,41.9029,12.4534,29,0,0,29
4/10/22,Holy See,41.9029,12.4534,29,0,0,29
4/11/22,Holy See,41.9029,12.4534,29,0,0,29
4/12/22,Holy See,41.9029,12.4534,29,0,0,29
4/13/22,Holy See,41.9029,12.4534,29,0,0,29
4/14/22,Holy See,41.9029,12.4534,29,0,0,29
4/15/22,Holy See,41.9029,12.4534,29,0,0,29
4/16/22,Holy See,41.9029,12.4534,29,0,0,29
4/17/22,Holy See,41.9029,12.4534,29,0,0,29
4/18/22,Holy See,41.9029,12.4534,29,0,0,29
4/19/22,Holy See,41.9029,12.4534,29,0,0,29
4/20/22,Holy See,41.9029,12.4534,29,0,0,29
4/21/22,Holy See,41.9029,12.4534,29,0,0,29
4/22/22,Holy See,41.9029,12.4534,29,0,0,29
4/23/22,Holy See,41.9029,12.4534,29,0,0,29
4/24/22,Holy See,41.9029,12.4534,29,0,0,29
4/25/22,Holy See,41.9029,12.4534,29,0,0,29
4/26/22,Holy See,41.9029,12.4534,29,0,0,29
4/27/22,Holy See,41.9029,12.4534,29,0,0,29
4/28/22,Holy See,41.9029,12.4534,29,0,0,29
4/29/22,Holy See,41.9029,12.4534,29,0,0,29
4/30/22,Holy See,41.9029,12.4534,29,0,0,29
5/1/22,Holy See,41.9029,12.4534,29,0,0,29
5/2/22,Holy See,41.9029,12.4534,29,0,0,29
5/3/22,Holy See,41.9029,12.4534,29,0,0,29
5/4/22,Holy See,41.9029,12.4534,29,0,0,29
5/5/22,Holy See,41.9029,12.4534,29,0,0,29
5/6/22,Holy See,41.9029,12.4534,29,0,0,29
5/7/22,Holy See,41.9029,12.4534,29,0,0,29
5/8/22,Holy See,41.9029,12.4534,29,0,0,29
5/9/22,Holy See,41.9029,12.4534,29,0,0,29
5/10/22,Holy See,41.9029,12.4534,29,0,0,29
5/11/22,Holy See,41.9029,12.4534,29,0,0,29
5/12/22,Holy See,41.9029,12.4534,29,0,0,29
5/13/22,Holy See,41.9029,12.4534,29,0,0,29
5/14/22,Holy See,41.9029,12.4534,29,0,0,29
5/15/22,Holy See,41.9029,12.4534,29,0,0,29
5/16/22,Holy See,41.9029,12.4534,29,0,0,29
5/17/22,Holy See,41.9029,12.4534,29,0,0,29
5/18/22,Holy See,41.9029,12.4534,29,0,0,29
5/19/22,Holy See,41.9029,12.4534,29,0,0,29
5/20/22,Holy See,41.9029,12.4534,29,0,0,29
5/21/22,Holy See,41.9029,12.4534,29,0,0,29
5/22/22,Holy See,41.9029,12.4534,29,0,0,29
5/23/22,Holy See,41.9029,12.4534,29,0,0,29
5/24/22,Holy See,41.9029,12.4534,29,0,0,29
5/25/22,Holy See,41.9029,12.4534,29,0,0,29
5/26/22,Holy See,41.9029,12.4534,29,0,0,29
5/27/22,Holy See,41.9029,12.4534,29,0,0,29
5/28/22,Holy See,41.9029,12.4534,29,0,0,29
5/29/22,Holy See,41.9029,12.4534,29,0,0,29
5/30/22,Holy See,41.9029,12.4534,29,0,0,29
5/31/22,Holy See,41.9029,12.4534,29,0,0,29
6/1/22,Holy See,41.9029,12.4534,29,0,0,29
6/2/22,Holy See,41.9029,12.4534,29,0,0,29
6/3/22,Holy See,41.9029,12.4534,29,0,0,29
6/4/22,Holy See,41.9029,12.4534,29,0,0,29
6/5/22,Holy See,41.9029,12.4534,29,0,0,29
6/6/22,Holy See,41.9029,12.4534,29,0,0,29
6/7/22,Holy See,41.9029,12.4534,29,0,0,29
6/8/22,Holy See,41.9029,12.4534,29,0,0,29
6/9/22,Holy See,41.9029,12.4534,29,0,0,29
6/10/22,Holy See,41.9029,12.4534,29,0,0,29
6/11/22,Holy See,41.9029,12.4534,29,0,0,29
6/12/22,Holy See,41.9029,12.4534,29,0,0,29
6/13/22,Holy See,41.9029,12.4534,29,0,0,29
6/14/22,Holy See,41.9029,12.4534,29,0,0,29
6/15/22,Holy See,41.9029,12.4534,29,0,0,29
6/16/22,Holy See,41.9029,12.4534,29,0,0,29
6/17/22,Holy See,41.9029,12.4534,29,0,0,29
6/18/22,Holy See,41.9029,12.4534,29,0,0,29
6/19/22,Holy See,41.9029,12.4534,29,0,0,29
6/20/22,Holy See,41.9029,12.4534,29,0,0,29
6/21/22,Holy See,41.9029,12.4534,29,0,0,29
6/22/22,Holy See,41.9029,12.4534,29,0,0,29
6/23/22,Holy See,41.9029,12.4534,29,0,0,29
6/24/22,Holy See,41.9029,12.4534,29,0,0,29
6/25/22,Holy See,41.9029,12.4534,29,0,0,29
6/26/22,Holy See,41.9029,12.4534,29,0,0,29
6/27/22,Holy See,41.9029,12.4534,29,0,0,29
6/28/22,Holy See,41.9029,12.4534,29,0,0,29
6/29/22,Holy See,41.9029,12.4534,29,0,0,29
6/30/22,Holy See,41.9029,12.4534,29,0,0,29
7/1/22,Holy See,41.9029,12.4534,29,0,0,29
7/2/22,Holy See,41.9029,12.4534,29,0,0,29
7/3/22,Holy See,41.9029,12.4534,29,0,0,29
7/4/22,Holy See,41.9029,12.4534,29,0,0,29
7/5/22,Holy See,41.9029,12.4534,29,0,0,29
7/6/22,Holy See,41.9029,12.4534,29,0,0,29
7/7/22,Holy See,41.9029,12.4534,29,0,0,29
7/8/22,Holy See,41.9029,12.4534,29,0,0,29
7/9/22,Holy See,41.9029,12.4534,29,0,0,29
7/10/22,Holy See,41.9029,12.4534,29,0,0,29
7/11/22,Holy See,41.9029,12.4534,29,0,0,29
7/12/22,Holy See,41.9029,12.4534,29,0,0,29
7/13/22,Holy See,41.9029,12.4534,29,0,0,29
7/14/22,Holy See,41.9029,12.4534,29,0,0,29
7/15/22,Holy See,41.9029,12.4534,29,0,0,29
7/16/22,Holy See,41.9029,12.4534,29,0,0,29
7/17/22,Holy See,41.9029,12.4534,29,0,0,29
7/18/22,Holy See,41.9029,12.4534,29,0,0,29
7/19/22,Holy See,41.9029,12.4534,29,0,0,29
7/20/22,Holy See,41.9029,12.4534,29,0,0,29
7/21/22,Holy See,41.9029,12.4534,29,0,0,29
7/22/22,Holy See,41.9029,12.4534,29,0,0,29
7/23/22,Holy See,41.9029,12.4534,29,0,0,29
7/24/22,Holy See,41.9029,12.4534,29,0,0,29
7/25/22,Holy See,41.9029,12.4534,29,0,0,29
7/26/22,Holy See,41.9029,12.4534,29,0,0,29
7/27/22,Holy See,41.9029,12.4534,29,0,0,29
7/28/22,Holy See,41.9029,12.4534,29,0,0,29
7/29/22,Holy See,41.9029,12.4534,29,0,0,29
7/30/22,Holy See,41.9029,12.4534,29,0,0,29
7/31/22,Holy See,41.9029,12.4534,29,0,0,29
8/1/22,Holy See,41.9029,12.4534,29,0,0,29
8/2/22,Holy See,41.9029,12.4534,29,0,0,29
8/3/22,Holy See,41.9029,12.4534,29,0,0,29
8/4/22,Holy See,41.9029,12.4534,29,0,0,29
8/5/22,Holy See,41.9029,12.4534,29,0,0,29
8/6/22,Holy See,41.9029,12.4534,29,0,0,29
8/7/22,Holy See,41.9029,12.4534,29,0,0,29
8/8/22,Holy See,41.9029,12.4534,29,0,0,29
8/9/22,Holy See,41.9029,12.4534,29,0,0,29
8/10/22,Holy See,41.9029,12.4534,29,0,0,29
8/11/22,Holy See,41.9029,12.4534,29,0,0,29
8/12/22,Holy See,41.9029,12.4534,29,0,0,29
8/13/22,Holy See,41.9029,12.4534,29,0,0,29
8/14/22,Holy See,41.9029,12.4534,29,0,0,29
8/15/22,Holy See,41.9029,12.4534,29,0,0,29
8/16/22,Holy See,41.9029,12.4534,29,0,0,29
8/17/22,Holy See,41.9029,12.4534,29,0,0,29
8/18/22,Holy See,41.9029,12.4534,29,0,0,29
8/19/22,Holy See,41.9029,12.4534,29,0,0,29
8/20/22,Holy See,41.9029,12.4534,29,0,0,29
8/21/22,Holy See,41.9029,12.4534,29,0,0,29
8/22/22,Holy See,41.9029,12.4534,29,0,0,29
8/23/22,Holy See,41.9029,12.4534,29,0,0,29
8/24/22,Holy See,41.9029,12.4534,29,0,0,29
8/25/22,Holy See,41.9029,12.4534,29,0,0,29
8/26/22,Holy See,41.9029,12.4534,29,0,0,29
8/27/22,Holy See,41.9029,12.4534,29,0,0,29
8/28/22,Holy See,41.9029,12.4534,29,0,0,29
8/29/22,Holy See,41.9029,12.4534,29,0,0,29
8/30/22,Holy See,41.9029,12.4534,29,0,0,29
8/31/22,Holy See,41.9029,12.4534,29,0,0,29
9/1/22,Holy See,41.9029,12.4534,29,0,0,29
9/2/22,Holy See,41.9029,12.4534,29,0,0,29
9/3/22,Holy See,41.9029,12.4534,29,0,0,29
9/4/22,Holy See,41.9029,12.4534,29,0,0,29
9/5/22,Holy See,41.9029,12.4534,29,0,0,29
9/6/22,Holy See,41.9029,12.4534,29,0,0,29
9/7/22,Holy See,41.9029,12.4534,29,0,0,29
9/8/22,Holy See,41.9029,12.4534,29,0,0,29
9/9/22,Holy See,41.9029,12.4534,29,0,0,29
9/10/22,Holy See,41.9029,12.4534,29,0,0,29
9/11/22,Holy See,41.9029,12.4534,29,0,0,29
9/12/22,Holy See,41.9029,12.4534,29,0,0,29
9/13/22,Holy See,41.9029,12.4534,29,0,0,29
9/14/22,Holy See,41.9029,12.4534,29,0,0,29
9/15/22,Holy See,41.9029,12.4534,29,0,0,29
9/16/22,Holy See,41.9029,12.4534,29,0,0,29
9/17/22,Holy See,41.9029,12.4534,29,0,0,29
9/18/22,Holy See,41.9029,12.4534,29,0,0,29
9/19/22,Holy See,41.9029,12.4534,29,0,0,29
9/20/22,Holy See,41.9029,12.4534,29,0,0,29
9/21/22,Holy See,41.9029,12.4534,29,0,0,29
9/22/22,Holy See,41.9029,12.4534,29,0,0,29
9/23/22,Holy See,41.9029,12.4534,29,0,0,29
9/24/22,Holy See,41.9029,12.4534,29,0,0,29
9/25/22,Holy See,41.9029,12.4534,29,0,0,29
9/26/22,Holy See,41.9029,12.4534,29,0,0,29
9/27/22,Holy See,41.9029,12.4534,29,0,0,29
9/28/22,Holy See,41.9029,12.4534,29,0,0,29
9/29/22,Holy See,41.9029,12.4534,29,0,0,29
9/30/22,Holy See,41.9029,12.4534,29,0,0,29
10/1/22,Holy See,41.9029,12.4534,29,0,0,29
10/2/22,Holy See,41.9029,12.4534,29,0,0,29
10/3/22,Holy See,41.9029,12.4534,29,0,0,29
10/4/22,Holy See,41.9029,12.4534,29,0,0,29
10/5/22,Holy See,41.9029,12.4534,29,0,0,29
10/6/22,Holy See,41.9029,12.4534,29,0,0,29
10/7/22,Holy See,41.9029,12.4534,29,0,0,29
10/8/22,Holy See,41.9029,12.4534,29,0,0,29
10/9/22,Holy See,41.9029,12.4534,29,0,0,29
10/10/22,Holy See,41.9029,12.4534,29,0,0,29
10/11/22,Holy See,41.9029,12.4534,29,0,0,29
10/12/22,Holy See,41.9029,12.4534,29,0,0,29
10/13/22,Holy See,41.9029,12.4534,29,0,0,29
10/14/22,Holy See,41.9029,12.4534,29,0,0,29
10/15/22,Holy See,41.9029,12.4534,29,0,0,29
10/16/22,Holy See,41.9029,12.4534,29,0,0,29
10/17/22,Holy See,41.9029,12.4534,29,0,0,29
10/18/22,Holy See,41.9029,12.4534,29,0,0,29
10/19/22,Holy See,41.9029,12.4534,29,0,0,29
10/20/22,Holy See,41.9029,12.4534,29,0,0,29
10/21/22,Holy See,41.9029,12.4534,29,0,0,29
10/22/22,Holy See,41.9029,12.4534,29,0,0,29
10/23/22,Holy See,41.9029,12.4534,29,0,0,29
10/24/22,Holy See,41.9029,12.4534,29,0,0,29
10/25/22,Holy See,41.9029,12.4534,29,0,0,29
10/26/22,Holy See,41.9029,12.4534,29,0,0,29
10/27/22,Holy See,41.9029,12.4534,29,0,0,29
10/28/22,Holy See,41.9029,12.4534,29,0,0,29
10/29/22,Holy See,41.9029,12.4534,29,0,0,29
10/30/22,Holy See,41.9029,12.4534,29,0,0,29
10/31/22,Holy See,41.9029,12.4534,29,0,0,29
11/1/22,Holy See,41.9029,12.4534,29,0,0,29
11/2/22,Holy See,41.9029,12.4534,29,0,0,29
11/3/22,Holy See,41.9029,12.4534,29,0,0,29
11/4/22,Holy See,41.9029,12.4534,29,0,0,29
11/5/22,Holy See,41.9029,12.4534,29,0,0,29
11/6/22,Holy See,41.9029,12.4534,29,0,0,29
11/7/22,Holy See,41.9029,12.4534,29,0,0,29
11/8/22,Holy See,41.9029,12.4534,29,0,0,29
11/9/22,Holy See,41.9029,12.4534,29,0,0,29
11/10/22,Holy See,41.9029,12.4534,29,0,0,29
11/11/22,Holy See,41.9029,12.4534,29,0,0,29
11/12/22,Holy See,41.9029,12.4534,29,0,0,29
11/13/22,Holy See,41.9029,12.4534,29,0,0,29
11/14/22,Holy See,41.9029,12.4534,29,0,0,29
11/15/22,Holy See,41.9029,12.4534,29,0,0,29
11/16/22,Holy See,41.9029,12.4534,29,0,0,29
11/17/22,Holy See,41.9029,12.4534,29,0,0,29
11/18/22,Holy See,41.9029,12.4534,29,0,0,29
11/19/22,Holy See,41.9029,12.4534,29,0,0,29
11/20/22,Holy See,41.9029,12.4534,29,0,0,29
11/21/22,Holy See,41.9029,12.4534,29,0,0,29
11/22/22,Holy See,41.9029,12.4534,29,0,0,29
11/23/22,Holy See,41.9029,12.4534,29,0,0,29
11/24/22,Holy See,41.9029,12.4534,29,0,0,29
11/25/22,Holy See,41.9029,12.4534,29,0,0,29
11/26/22,Holy See,41.9029,12.4534,29,0,0,29
11/27/22,Holy See,41.9029,12.4534,29,0,0,29
11/28/22,Holy See,41.9029,12.4534,29,0,0,29
11/29/22,Holy See,41.9029,12.4534,29,0,0,29
11/30/22,Holy See,41.9029,12.4534,29,0,0,29
12/1/22,Holy See,41.9029,12.4534,29,0,0,29
12/2/22,Holy See,41.9029,12.4534,29,0,0,29
12/3/22,Holy See,41.9029,12.4534,29,0,0,29
12/4/22,Holy See,41.9029,12.4534,29,0,0,29
12/5/22,Holy See,41.9029,12.4534,29,0,0,29
12/6/22,Holy See,41.9029,12.4534,29,0,0,29
12/7/22,Holy See,41.9029,12.4534,29,0,0,29
12/8/22,Holy See,41.9029,12.4534,29,0,0,29
12/9/22,Holy See,41.9029,12.4534,29,0,0,29
12/10/22,Holy See,41.9029,12.4534,29,0,0,29
12/11/22,Holy See,41.9029,12.4534,29,0,0,29
12/12/22,Holy See,41.9029,12.4534,29,0,0,29
12/13/22,Holy See,41.9029,12.4534,29,0,0,29
12/14/22,Holy See,41.9029,12.4534,29,0,0,29
12/15/22,Holy See,41.9029,12.4534,29,0,0,29
12/16/22,Holy See,41.9029,12.4534,29,0,0,29
12/17/22,Holy See,41.9029,12.4534,29,0,0,29
1/1/22,Honduras,15.2,-86.2419,379402,0,10433,368969
1/2/22,Honduras,15.2,-86.2419,379402,0,10433,368969
1/3/22,Honduras,15.2,-86.2419,379402,0,10433,368969
1/4/22,Honduras,15.2,-86.2419,379402,0,10433,368969
1/5/22,Honduras,15.2,-86.2419,379402,0,10433,368969
1/6/22,Honduras,15.2,-86.2419,379402,0,10433,368969
1/7/22,Honduras,15.2,-86.2419,379402,0,10433,368969
1/8/22,Honduras,15.2,-86.2419,381254,0,10443,370811
1/9/22,Honduras,15.2,-86.2419,381254,0,10443,370811
1/10/22,Honduras,15.2,-86.2419,381254,0,10443,370811
1/11/22,Honduras,15.2,-86.2419,382440,0,10449,371991
1/12/22,Honduras,15.2,-86.2419,382440,0,10449,371991
1/13/22,Honduras,15.2,-86.2419,382440,0,10449,371991
1/14/22,Honduras,15.2,-86.2419,382440,0,10449,371991
1/15/22,Honduras,15.2,-86.2419,382440,0,10449,371991
1/16/22,Honduras,15.2,-86.2419,382440,0,10449,371991
1/17/22,Honduras,15.2,-86.2419,385362,0,10455,374907
1/18/22,Honduras,15.2,-86.2419,385964,0,10457,375507
1/19/22,Honduras,15.2,-86.2419,385964,0,10457,375507
1/20/22,Honduras,15.2,-86.2419,387515,0,10468,377047
1/21/22,Honduras,15.2,-86.2419,387515,0,10468,377047
1/22/22,Honduras,15.2,-86.2419,387515,0,10468,377047
1/23/22,Honduras,15.2,-86.2419,387515,0,10468,377047
1/24/22,Honduras,15.2,-86.2419,387515,0,10468,377047
1/25/22,Honduras,15.2,-86.2419,391145,0,10498,380647
1/26/22,Honduras,15.2,-86.2419,391145,0,10498,380647
1/27/22,Honduras,15.2,-86.2419,391874,0,10512,381362
1/28/22,Honduras,15.2,-86.2419,391874,0,10512,381362
1/29/22,Honduras,15.2,-86.2419,391874,0,10512,381362
1/30/22,Honduras,15.2,-86.2419,391874,0,10512,381362
1/31/22,Honduras,15.2,-86.2419,391874,0,10512,381362
2/1/22,Honduras,15.2,-86.2419,391874,0,10512,381362
2/2/22,Honduras,15.2,-86.2419,391874,0,10512,381362
2/3/22,Honduras,15.2,-86.2419,391874,0,10512,381362
2/4/22,Honduras,15.2,-86.2419,391874,0,10512,381362
2/5/22,Honduras,15.2,-86.2419,391874,0,10512,381362
2/6/22,Honduras,15.2,-86.2419,391874,0,10512,381362
2/7/22,Honduras,15.2,-86.2419,391874,0,10512,381362
2/8/22,Honduras,15.2,-86.2419,391874,0,10512,381362
2/9/22,Honduras,15.2,-86.2419,391874,0,10512,381362
2/10/22,Honduras,15.2,-86.2419,391874,0,10512,381362
2/11/22,Honduras,15.2,-86.2419,391874,0,10512,381362
2/12/22,Honduras,15.2,-86.2419,391874,0,10512,381362
2/13/22,Honduras,15.2,-86.2419,391874,0,10512,381362
2/14/22,Honduras,15.2,-86.2419,391874,0,10512,381362
2/15/22,Honduras,15.2,-86.2419,391874,0,10512,381362
2/16/22,Honduras,15.2,-86.2419,404764,0,10608,394156
2/17/22,Honduras,15.2,-86.2419,404764,0,10608,394156
2/18/22,Honduras,15.2,-86.2419,404764,0,10608,394156
2/19/22,Honduras,15.2,-86.2419,404764,0,10608,394156
2/20/22,Honduras,15.2,-86.2419,404764,0,10608,394156
2/21/22,Honduras,15.2,-86.2419,408456,0,10671,397785
2/22/22,Honduras,15.2,-86.2419,408456,0,10671,397785
2/23/22,Honduras,15.2,-86.2419,409708,0,10684,399024
2/24/22,Honduras,15.2,-86.2419,411212,0,10720,400492
2/25/22,Honduras,15.2,-86.2419,411212,0,10720,400492
2/26/22,Honduras,15.2,-86.2419,411212,0,10720,400492
2/27/22,Honduras,15.2,-86.2419,411212,0,10720,400492
2/28/22,Honduras,15.2,-86.2419,411212,0,10720,400492
3/1/22,Honduras,15.2,-86.2419,412733,0,10778,401955
3/2/22,Honduras,15.2,-86.2419,412733,0,10778,401955
3/3/22,Honduras,15.2,-86.2419,413699,0,10785,402914
3/4/22,Honduras,15.2,-86.2419,413699,0,10785,402914
3/5/22,Honduras,15.2,-86.2419,413699,0,10785,402914
3/6/22,Honduras,15.2,-86.2419,413699,0,10785,402914
3/7/22,Honduras,15.2,-86.2419,413699,0,10785,402914
3/8/22,Honduras,15.2,-86.2419,414714,0,10812,403902
3/9/22,Honduras,15.2,-86.2419,414714,0,10812,403902
3/10/22,Honduras,15.2,-86.2419,414714,0,10812,403902
3/11/22,Honduras,15.2,-86.2419,414714,0,10812,403902
3/12/22,Honduras,15.2,-86.2419,416729,0,10834,405895
3/13/22,Honduras,15.2,-86.2419,416729,0,10834,405895
3/14/22,Honduras,15.2,-86.2419,416729,0,10834,405895
3/15/22,Honduras,15.2,-86.2419,417201,0,10842,406359
3/16/22,Honduras,15.2,-86.2419,417201,0,10842,406359
3/17/22,Honduras,15.2,-86.2419,417201,0,10842,406359
3/18/22,Honduras,15.2,-86.2419,418300,0,10857,407443
3/19/22,Honduras,15.2,-86.2419,418300,0,10857,407443
3/20/22,Honduras,15.2,-86.2419,418300,0,10857,407443
3/21/22,Honduras,15.2,-86.2419,418300,0,10857,407443
3/22/22,Honduras,15.2,-86.2419,418460,0,10863,407597
3/23/22,Honduras,15.2,-86.2419,418492,0,10869,407623
3/24/22,Honduras,15.2,-86.2419,418792,0,10869,407923
3/25/22,Honduras,15.2,-86.2419,420621,0,10871,409750
3/26/22,Honduras,15.2,-86.2419,420621,0,10871,409750
3/27/22,Honduras,15.2,-86.2419,420621,0,10871,409750
3/28/22,Honduras,15.2,-86.2419,420621,0,10971,409650
3/29/22,Honduras,15.2,-86.2419,420978,0,10878,410100
3/30/22,Honduras,15.2,-86.2419,421013,0,10880,410133
3/31/22,Honduras,15.2,-86.2419,421062,0,10880,410182
4/1/22,Honduras,15.2,-86.2419,421062,0,10880,410182
4/2/22,Honduras,15.2,-86.2419,421062,0,10880,410182
4/3/22,Honduras,15.2,-86.2419,421062,0,10880,410182
4/4/22,Honduras,15.2,-86.2419,421121,0,10882,410239
4/5/22,Honduras,15.2,-86.2419,421121,0,10882,410239
4/6/22,Honduras,15.2,-86.2419,421170,0,10885,410285
4/7/22,Honduras,15.2,-86.2419,421268,0,10888,410380
4/8/22,Honduras,15.2,-86.2419,421268,0,10888,410380
4/9/22,Honduras,15.2,-86.2419,421268,0,10888,410380
4/10/22,Honduras,15.2,-86.2419,421268,0,10888,410380
4/11/22,Honduras,15.2,-86.2419,421268,0,10888,410380
4/12/22,Honduras,15.2,-86.2419,421268,0,10888,410380
4/13/22,Honduras,15.2,-86.2419,421268,0,10888,410380
4/14/22,Honduras,15.2,-86.2419,421268,0,10888,410380
4/15/22,Honduras,15.2,-86.2419,421268,0,10888,410380
4/16/22,Honduras,15.2,-86.2419,421268,0,10888,410380
4/17/22,Honduras,15.2,-86.2419,421268,0,10888,410380
4/18/22,Honduras,15.2,-86.2419,421659,0,10891,410768
4/19/22,Honduras,15.2,-86.2419,422239,0,10892,411347
4/20/22,Honduras,15.2,-86.2419,422275,0,10892,411383
4/21/22,Honduras,15.2,-86.2419,422275,0,10892,411383
4/22/22,Honduras,15.2,-86.2419,422275,0,10892,411383
4/23/22,Honduras,15.2,-86.2419,422275,0,10892,411383
4/24/22,Honduras,15.2,-86.2419,422275,0,10892,411383
4/25/22,Honduras,15.2,-86.2419,422469,0,10893,411576
4/26/22,Honduras,15.2,-86.2419,422545,0,10893,411652
4/27/22,Honduras,15.2,-86.2419,423179,0,10893,412286
4/28/22,Honduras,15.2,-86.2419,423179,0,10893,412286
4/29/22,Honduras,15.2,-86.2419,423179,0,10893,412286
4/30/22,Honduras,15.2,-86.2419,423179,0,10893,412286
5/1/22,Honduras,15.2,-86.2419,423179,0,10893,412286
5/2/22,Honduras,15.2,-86.2419,423718,0,10893,412825
5/3/22,Honduras,15.2,-86.2419,423775,0,10895,412880
5/4/22,Honduras,15.2,-86.2419,423794,0,10895,412899
5/5/22,Honduras,15.2,-86.2419,423879,0,10895,412984
5/6/22,Honduras,15.2,-86.2419,423879,0,10895,412984
5/7/22,Honduras,15.2,-86.2419,423879,0,10895,412984
5/8/22,Honduras,15.2,-86.2419,423879,0,10895,412984
5/9/22,Honduras,15.2,-86.2419,424365,0,10895,413470
5/10/22,Honduras,15.2,-86.2419,424376,0,10896,413480
5/11/22,Honduras,15.2,-86.2419,424390,0,10896,413494
5/12/22,Honduras,15.2,-86.2419,424390,0,10896,413494
5/13/22,Honduras,15.2,-86.2419,424447,0,10896,413551
5/14/22,Honduras,15.2,-86.2419,424447,0,10896,413551
5/15/22,Honduras,15.2,-86.2419,424447,0,10896,413551
5/16/22,Honduras,15.2,-86.2419,424447,0,10896,413551
5/17/22,Honduras,15.2,-86.2419,424771,0,10896,413875
5/18/22,Honduras,15.2,-86.2419,424771,0,10896,413875
5/19/22,Honduras,15.2,-86.2419,424771,0,10896,413875
5/20/22,Honduras,15.2,-86.2419,424771,0,10896,413875
5/21/22,Honduras,15.2,-86.2419,424771,0,10896,413875
5/22/22,Honduras,15.2,-86.2419,424859,0,10896,413963
5/23/22,Honduras,15.2,-86.2419,424859,0,10896,413963
5/24/22,Honduras,15.2,-86.2419,424859,0,10896,413963
5/25/22,Honduras,15.2,-86.2419,425087,0,10899,414188
5/26/22,Honduras,15.2,-86.2419,425113,0,10899,414214
5/27/22,Honduras,15.2,-86.2419,425113,0,10899,414214
5/28/22,Honduras,15.2,-86.2419,425113,0,10899,414214
5/29/22,Honduras,15.2,-86.2419,425113,0,10899,414214
5/30/22,Honduras,15.2,-86.2419,425113,0,10899,414214
5/31/22,Honduras,15.2,-86.2419,425371,0,10899,414472
6/1/22,Honduras,15.2,-86.2419,425371,0,10899,414472
6/2/22,Honduras,15.2,-86.2419,425371,0,10899,414472
6/3/22,Honduras,15.2,-86.2419,425371,0,10899,414472
6/4/22,Honduras,15.2,-86.2419,425417,0,10900,414517
6/5/22,Honduras,15.2,-86.2419,425471,0,10900,414571
6/6/22,Honduras,15.2,-86.2419,425471,0,10900,414571
6/7/22,Honduras,15.2,-86.2419,425471,0,10900,414571
6/8/22,Honduras,15.2,-86.2419,425471,0,10900,414571
6/9/22,Honduras,15.2,-86.2419,425564,0,10902,414662
6/10/22,Honduras,15.2,-86.2419,425564,0,10902,414662
6/11/22,Honduras,15.2,-86.2419,425564,0,10902,414662
6/12/22,Honduras,15.2,-86.2419,425655,0,10902,414753
6/13/22,Honduras,15.2,-86.2419,425655,0,10902,414753
6/14/22,Honduras,15.2,-86.2419,425655,0,10902,414753
6/15/22,Honduras,15.2,-86.2419,425655,0,10902,414753
6/16/22,Honduras,15.2,-86.2419,425930,0,10903,415027
6/17/22,Honduras,15.2,-86.2419,426095,0,10904,415191
6/18/22,Honduras,15.2,-86.2419,426095,0,10904,415191
6/19/22,Honduras,15.2,-86.2419,426095,0,10904,415191
6/20/22,Honduras,15.2,-86.2419,426095,0,10904,415191
6/21/22,Honduras,15.2,-86.2419,426095,0,10904,415191
6/22/22,Honduras,15.2,-86.2419,426095,0,10904,415191
6/23/22,Honduras,15.2,-86.2419,426095,0,10904,415191
6/24/22,Honduras,15.2,-86.2419,426490,0,10904,415586
6/25/22,Honduras,15.2,-86.2419,426490,0,10904,415586
6/26/22,Honduras,15.2,-86.2419,426490,0,10904,415586
6/27/22,Honduras,15.2,-86.2419,426879,0,10905,415974
6/28/22,Honduras,15.2,-86.2419,426879,0,10905,415974
6/29/22,Honduras,15.2,-86.2419,427355,0,10906,416449
6/30/22,Honduras,15.2,-86.2419,427355,0,10906,416449
7/1/22,Honduras,15.2,-86.2419,427718,0,10906,416812
7/2/22,Honduras,15.2,-86.2419,427718,0,10906,416812
7/3/22,Honduras,15.2,-86.2419,427718,0,10906,416812
7/4/22,Honduras,15.2,-86.2419,427718,0,10906,416812
7/5/22,Honduras,15.2,-86.2419,427718,0,10906,416812
7/6/22,Honduras,15.2,-86.2419,427718,0,10906,416812
7/7/22,Honduras,15.2,-86.2419,427718,0,10906,416812
7/8/22,Honduras,15.2,-86.2419,429408,0,10911,418497
7/9/22,Honduras,15.2,-86.2419,429408,0,10911,418497
7/10/22,Honduras,15.2,-86.2419,429408,0,10911,418497
7/11/22,Honduras,15.2,-86.2419,429848,0,10912,418936
7/12/22,Honduras,15.2,-86.2419,430672,0,10912,419760
7/13/22,Honduras,15.2,-86.2419,430672,0,10912,419760
7/14/22,Honduras,15.2,-86.2419,430672,0,10912,419760
7/15/22,Honduras,15.2,-86.2419,430672,0,10912,419760
7/16/22,Honduras,15.2,-86.2419,430672,0,10912,419760
7/17/22,Honduras,15.2,-86.2419,430672,0,10912,419760
7/18/22,Honduras,15.2,-86.2419,432139,0,10919,421220
7/19/22,Honduras,15.2,-86.2419,432139,0,10919,421220
7/20/22,Honduras,15.2,-86.2419,434796,0,10930,423866
7/21/22,Honduras,15.2,-86.2419,434796,0,10930,423866
7/22/22,Honduras,15.2,-86.2419,436210,0,10931,425279
7/23/22,Honduras,15.2,-86.2419,436210,0,10931,425279
7/24/22,Honduras,15.2,-86.2419,436210,0,10931,425279
7/25/22,Honduras,15.2,-86.2419,436210,0,10931,425279
7/26/22,Honduras,15.2,-86.2419,436210,0,10931,425279
7/27/22,Honduras,15.2,-86.2419,438050,0,10932,427118
7/28/22,Honduras,15.2,-86.2419,438050,0,10932,427118
7/29/22,Honduras,15.2,-86.2419,439901,0,10932,428969
7/30/22,Honduras,15.2,-86.2419,439901,0,10932,428969
7/31/22,Honduras,15.2,-86.2419,439901,0,10932,428969
8/1/22,Honduras,15.2,-86.2419,439901,0,10932,428969
8/2/22,Honduras,15.2,-86.2419,442319,0,10939,431380
8/3/22,Honduras,15.2,-86.2419,442319,0,10939,431380
8/4/22,Honduras,15.2,-86.2419,444152,0,10940,433212
8/5/22,Honduras,15.2,-86.2419,445271,0,10945,434326
8/6/22,Honduras,15.2,-86.2419,445271,0,10945,434326
8/7/22,Honduras,15.2,-86.2419,445271,0,10945,434326
8/8/22,Honduras,15.2,-86.2419,445271,0,10945,434326
8/9/22,Honduras,15.2,-86.2419,445271,0,10945,434326
8/10/22,Honduras,15.2,-86.2419,446454,0,10952,435502
8/11/22,Honduras,15.2,-86.2419,446454,0,10952,435502
8/12/22,Honduras,15.2,-86.2419,447365,0,10954,436411
8/13/22,Honduras,15.2,-86.2419,447365,0,10954,436411
8/14/22,Honduras,15.2,-86.2419,447365,0,10954,436411
8/15/22,Honduras,15.2,-86.2419,447365,0,10954,436411
8/16/22,Honduras,15.2,-86.2419,449495,0,10958,438537
8/17/22,Honduras,15.2,-86.2419,449495,0,10958,438537
8/18/22,Honduras,15.2,-86.2419,449495,0,10958,438537
8/19/22,Honduras,15.2,-86.2419,450393,0,10965,439428
8/20/22,Honduras,15.2,-86.2419,450393,0,10965,439428
8/21/22,Honduras,15.2,-86.2419,450393,0,10965,439428
8/22/22,Honduras,15.2,-86.2419,450393,0,10965,439428
8/23/22,Honduras,15.2,-86.2419,450393,0,10965,439428
8/24/22,Honduras,15.2,-86.2419,451595,0,10965,440630
8/25/22,Honduras,15.2,-86.2419,452305,0,10972,441333
8/26/22,Honduras,15.2,-86.2419,452305,0,10972,441333
8/27/22,Honduras,15.2,-86.2419,452305,0,10972,441333
8/28/22,Honduras,15.2,-86.2419,452305,0,10972,441333
8/29/22,Honduras,15.2,-86.2419,453443,0,10972,442471
8/30/22,Honduras,15.2,-86.2419,453443,0,10972,442471
8/31/22,Honduras,15.2,-86.2419,453443,0,10972,442471
9/1/22,Honduras,15.2,-86.2419,454192,0,10974,443218
9/2/22,Honduras,15.2,-86.2419,454779,0,10989,443790
9/3/22,Honduras,15.2,-86.2419,454779,0,10989,443790
9/4/22,Honduras,15.2,-86.2419,454779,0,10989,443790
9/5/22,Honduras,15.2,-86.2419,454779,0,10989,443790
9/6/22,Honduras,15.2,-86.2419,454779,0,10989,443790
9/7/22,Honduras,15.2,-86.2419,454779,0,10989,443790
9/8/22,Honduras,15.2,-86.2419,454779,0,10989,443790
9/9/22,Honduras,15.2,-86.2419,455011,0,10989,444022
9/10/22,Honduras,15.2,-86.2419,455011,0,10989,444022
9/11/22,Honduras,15.2,-86.2419,455011,0,10989,444022
9/12/22,Honduras,15.2,-86.2419,455011,0,10989,444022
9/13/22,Honduras,15.2,-86.2419,455669,0,10989,444680
9/14/22,Honduras,15.2,-86.2419,455669,0,10989,444680
9/15/22,Honduras,15.2,-86.2419,455669,0,10989,444680
9/16/22,Honduras,15.2,-86.2419,455836,0,10992,444844
9/17/22,Honduras,15.2,-86.2419,455836,0,10992,444844
9/18/22,Honduras,15.2,-86.2419,455836,0,10992,444844
9/19/22,Honduras,15.2,-86.2419,455836,0,10992,444844
9/20/22,Honduras,15.2,-86.2419,456035,0,10992,445043
9/21/22,Honduras,15.2,-86.2419,456035,0,10992,445043
9/22/22,Honduras,15.2,-86.2419,456106,0,10992,445114
9/23/22,Honduras,15.2,-86.2419,456106,0,10992,445114
9/24/22,Honduras,15.2,-86.2419,456106,0,10992,445114
9/25/22,Honduras,15.2,-86.2419,456336,0,10992,445344
9/26/22,Honduras,15.2,-86.2419,456391,0,10993,445398
9/27/22,Honduras,15.2,-86.2419,456391,0,10993,445398
9/28/22,Honduras,15.2,-86.2419,456391,0,10993,445398
9/29/22,Honduras,15.2,-86.2419,456391,0,10993,445398
9/30/22,Honduras,15.2,-86.2419,456391,0,10993,445398
10/1/22,Honduras,15.2,-86.2419,456391,0,10993,445398
10/2/22,Honduras,15.2,-86.2419,456391,0,10993,445398
10/3/22,Honduras,15.2,-86.2419,456391,0,10993,445398
10/4/22,Honduras,15.2,-86.2419,456391,0,10993,445398
10/5/22,Honduras,15.2,-86.2419,456664,0,10996,445668
10/6/22,Honduras,15.2,-86.2419,456664,0,10996,445668
10/7/22,Honduras,15.2,-86.2419,456664,0,10996,445668
10/8/22,Honduras,15.2,-86.2419,456664,0,10996,445668
10/9/22,Honduras,15.2,-86.2419,456664,0,10996,445668
10/10/22,Honduras,15.2,-86.2419,456664,0,10996,445668
10/11/22,Honduras,15.2,-86.2419,456664,0,10996,445668
10/12/22,Honduras,15.2,-86.2419,456664,0,10996,445668
10/13/22,Honduras,15.2,-86.2419,456664,0,10996,445668
10/14/22,Honduras,15.2,-86.2419,456664,0,10996,445668
10/15/22,Honduras,15.2,-86.2419,456664,0,10996,445668
10/16/22,Honduras,15.2,-86.2419,456664,0,10996,445668
10/17/22,Honduras,15.2,-86.2419,456886,0,11007,445879
10/18/22,Honduras,15.2,-86.2419,456886,0,11007,445879
10/19/22,Honduras,15.2,-86.2419,456886,0,11007,445879
10/20/22,Honduras,15.2,-86.2419,456886,0,11007,445879
10/21/22,Honduras,15.2,-86.2419,456886,0,11007,445879
10/22/22,Honduras,15.2,-86.2419,456886,0,11007,445879
10/23/22,Honduras,15.2,-86.2419,456988,0,11037,445951
10/24/22,Honduras,15.2,-86.2419,456988,0,11037,445951
10/25/22,Honduras,15.2,-86.2419,456988,0,11037,445951
10/26/22,Honduras,15.2,-86.2419,456988,0,11037,445951
10/27/22,Honduras,15.2,-86.2419,456988,0,11037,445951
10/28/22,Honduras,15.2,-86.2419,456988,0,11037,445951
10/29/22,Honduras,15.2,-86.2419,456988,0,11037,445951
10/30/22,Honduras,15.2,-86.2419,456988,0,11037,445951
10/31/22,Honduras,15.2,-86.2419,456988,0,11037,445951
11/1/22,Honduras,15.2,-86.2419,456988,0,11037,445951
11/2/22,Honduras,15.2,-86.2419,457196,0,11039,446157
11/3/22,Honduras,15.2,-86.2419,457196,0,11039,446157
11/4/22,Honduras,15.2,-86.2419,457196,0,11039,446157
11/5/22,Honduras,15.2,-86.2419,457196,0,11039,446157
11/6/22,Honduras,15.2,-86.2419,457196,0,11039,446157
11/7/22,Honduras,15.2,-86.2419,457196,0,11039,446157
11/8/22,Honduras,15.2,-86.2419,457196,0,11039,446157
11/9/22,Honduras,15.2,-86.2419,457196,0,11039,446157
11/10/22,Honduras,15.2,-86.2419,457196,0,11039,446157
11/11/22,Honduras,15.2,-86.2419,457406,0,11041,446365
11/12/22,Honduras,15.2,-86.2419,457406,0,11041,446365
11/13/22,Honduras,15.2,-86.2419,457406,0,11041,446365
11/14/22,Honduras,15.2,-86.2419,457406,0,11041,446365
11/15/22,Honduras,15.2,-86.2419,457459,0,11043,446416
11/16/22,Honduras,15.2,-86.2419,457459,0,11043,446416
11/17/22,Honduras,15.2,-86.2419,457459,0,11043,446416
11/18/22,Honduras,15.2,-86.2419,457508,0,11043,446465
11/19/22,Honduras,15.2,-86.2419,457508,0,11043,446465
11/20/22,Honduras,15.2,-86.2419,457508,0,11043,446465
11/21/22,Honduras,15.2,-86.2419,457543,0,11043,446500
11/22/22,Honduras,15.2,-86.2419,457676,0,11043,446633
11/23/22,Honduras,15.2,-86.2419,457676,0,11043,446633
11/24/22,Honduras,15.2,-86.2419,457676,0,11043,446633
11/25/22,Honduras,15.2,-86.2419,457676,0,11043,446633
11/26/22,Honduras,15.2,-86.2419,457676,0,11043,446633
11/27/22,Honduras,15.2,-86.2419,457676,0,11043,446633
11/28/22,Honduras,15.2,-86.2419,458023,0,11043,446980
11/29/22,Honduras,15.2,-86.2419,458023,0,11043,446980
11/30/22,Honduras,15.2,-86.2419,458023,0,11043,446980
12/1/22,Honduras,15.2,-86.2419,458735,0,11051,447684
12/2/22,Honduras,15.2,-86.2419,458921,0,11051,447870
12/3/22,Honduras,15.2,-86.2419,458921,0,11051,447870
12/4/22,Honduras,15.2,-86.2419,458921,0,11051,447870
12/5/22,Honduras,15.2,-86.2419,458921,0,11051,447870
12/6/22,Honduras,15.2,-86.2419,458921,0,11051,447870
12/7/22,Honduras,15.2,-86.2419,458921,0,11051,447870
12/8/22,Honduras,15.2,-86.2419,458921,0,11051,447870
12/9/22,Honduras,15.2,-86.2419,458921,0,11051,447870
12/10/22,Honduras,15.2,-86.2419,458921,0,11051,447870
12/11/22,Honduras,15.2,-86.2419,458921,0,11051,447870
12/12/22,Honduras,15.2,-86.2419,460714,0,11054,449660
12/13/22,Honduras,15.2,-86.2419,460714,0,11054,449660
12/14/22,Honduras,15.2,-86.2419,460714,0,11054,449660
12/15/22,Honduras,15.2,-86.2419,461988,0,11060,450928
12/16/22,Honduras,15.2,-86.2419,462340,0,11060,451280
12/17/22,Honduras,15.2,-86.2419,462340,0,11060,451280
1/1/22,Hungary,47.1625,19.5033,1256415,0,39186,1217229
1/2/22,Hungary,47.1625,19.5033,1256415,0,39186,1217229
1/3/22,Hungary,47.1625,19.5033,1262280,0,39434,1222846
1/4/22,Hungary,47.1625,19.5033,1264709,0,39517,1225192
1/5/22,Hungary,47.1625,19.5033,1269979,0,39599,1230380
1/6/22,Hungary,47.1625,19.5033,1276433,0,39679,1236754
1/7/22,Hungary,47.1625,19.5033,1282957,0,39780,1243177
1/8/22,Hungary,47.1625,19.5033,1282957,0,39780,1243177
1/9/22,Hungary,47.1625,19.5033,1282957,0,39780,1243177
1/10/22,Hungary,47.1625,19.5033,1297612,0,39947,1257665
1/11/22,Hungary,47.1625,19.5033,1300994,0,40016,1260978
1/12/22,Hungary,47.1625,19.5033,1308877,0,40083,1268794
1/13/22,Hungary,47.1625,19.5033,1318093,0,40164,1277929
1/14/22,Hungary,47.1625,19.5033,1327014,0,40237,1286777
1/15/22,Hungary,47.1625,19.5033,1327014,0,40237,1286777
1/16/22,Hungary,47.1625,19.5033,1327014,0,40237,1286777
1/17/22,Hungary,47.1625,19.5033,1348233,0,40507,1307726
1/18/22,Hungary,47.1625,19.5033,1355084,0,40601,1314483
1/19/22,Hungary,47.1625,19.5033,1369974,0,40686,1329288
1/20/22,Hungary,47.1625,19.5033,1385500,0,40757,1344743
1/21/22,Hungary,47.1625,19.5033,1401457,0,40822,1360635
1/22/22,Hungary,47.1625,19.5033,1401457,0,40822,1360635
1/23/22,Hungary,47.1625,19.5033,1401457,0,40822,1360635
1/24/22,Hungary,47.1625,19.5033,1441385,0,40944,1400441
1/25/22,Hungary,47.1625,19.5033,1451102,0,41018,1410084
1/26/22,Hungary,47.1625,19.5033,1471276,0,41087,1430189
1/27/22,Hungary,47.1625,19.5033,1490489,0,41151,1449338
1/28/22,Hungary,47.1625,19.5033,1508358,0,41229,1467129
1/29/22,Hungary,47.1625,19.5033,1508358,0,41229,1467129
1/30/22,Hungary,47.1625,19.5033,1508358,0,41229,1467129
1/31/22,Hungary,47.1625,19.5033,1553405,0,41405,1512000
2/1/22,Hungary,47.1625,19.5033,1562827,0,41471,1521356
2/2/22,Hungary,47.1625,19.5033,1582517,0,41548,1540969
2/3/22,Hungary,47.1625,19.5033,1600411,0,41636,1558775
2/4/22,Hungary,47.1625,19.5033,1616846,0,41741,1575105
2/5/22,Hungary,47.1625,19.5033,1616846,0,41741,1575105
2/6/22,Hungary,47.1625,19.5033,1616846,0,41741,1575105
2/7/22,Hungary,47.1625,19.5033,1650562,0,41975,1608587
2/8/22,Hungary,47.1625,19.5033,1657615,0,42069,1615546
2/9/22,Hungary,47.1625,19.5033,1671547,0,42170,1629377
2/10/22,Hungary,47.1625,19.5033,1684432,0,42269,1642163
2/11/22,Hungary,47.1625,19.5033,1695991,0,42360,1653631
2/12/22,Hungary,47.1625,19.5033,1695991,0,42360,1653631
2/13/22,Hungary,47.1625,19.5033,1695991,0,42360,1653631
2/14/22,Hungary,47.1625,19.5033,1717072,0,42631,1674441
2/15/22,Hungary,47.1625,19.5033,1721483,0,42754,1678729
2/16/22,Hungary,47.1625,19.5033,1730366,0,42851,1687515
2/17/22,Hungary,47.1625,19.5033,1738944,0,42966,1695978
2/18/22,Hungary,47.1625,19.5033,1746424,0,43066,1703358
2/19/22,Hungary,47.1625,19.5033,1746424,0,43066,1703358
2/20/22,Hungary,47.1625,19.5033,1746424,0,43066,1703358
2/21/22,Hungary,47.1625,19.5033,1759685,0,43299,1716386
2/22/22,Hungary,47.1625,19.5033,1762878,0,43430,1719448
2/23/22,Hungary,47.1625,19.5033,1769164,0,43562,1725602
2/24/22,Hungary,47.1625,19.5033,1774676,0,43664,1731012
2/25/22,Hungary,47.1625,19.5033,1779174,0,43752,1735422
2/26/22,Hungary,47.1625,19.5033,1779174,0,43752,1735422
2/27/22,Hungary,47.1625,19.5033,1779174,0,43752,1735422
2/28/22,Hungary,47.1625,19.5033,1787544,0,43949,1743595
3/1/22,Hungary,47.1625,19.5033,1789581,0,44051,1745530
3/2/22,Hungary,47.1625,19.5033,1793120,0,44134,1748986
3/3/22,Hungary,47.1625,19.5033,1796982,0,44211,1752771
3/4/22,Hungary,47.1625,19.5033,1800046,0,44286,1755760
3/5/22,Hungary,47.1625,19.5033,1800046,0,44286,1755760
3/6/22,Hungary,47.1625,19.5033,1800046,0,44286,1755760
3/7/22,Hungary,47.1625,19.5033,1805898,0,44436,1761462
3/8/22,Hungary,47.1625,19.5033,1807285,0,44495,1762790
3/9/22,Hungary,47.1625,19.5033,1809917,0,44549,1765368
3/10/22,Hungary,47.1625,19.5033,1812294,0,44603,1767691
3/11/22,Hungary,47.1625,19.5033,1814362,0,44653,1769709
3/12/22,Hungary,47.1625,19.5033,1814362,0,44653,1769709
3/13/22,Hungary,47.1625,19.5033,1814362,0,44653,1769709
3/14/22,Hungary,47.1625,19.5033,1814362,0,44653,1769709
3/15/22,Hungary,47.1625,19.5033,1814362,0,44653,1769709
3/16/22,Hungary,47.1625,19.5033,1819264,0,44831,1774433
3/17/22,Hungary,47.1625,19.5033,1820767,0,44895,1775872
3/18/22,Hungary,47.1625,19.5033,1824089,0,44961,1779128
3/19/22,Hungary,47.1625,19.5033,1824089,0,44961,1779128
3/20/22,Hungary,47.1625,19.5033,1824089,0,44961,1779128
3/21/22,Hungary,47.1625,19.5033,1829928,0,45095,1784833
3/22/22,Hungary,47.1625,19.5033,1831423,0,45143,1786280
3/23/22,Hungary,47.1625,19.5033,1834268,0,45185,1789083
3/24/22,Hungary,47.1625,19.5033,1836919,0,45220,1791699
3/25/22,Hungary,47.1625,19.5033,1839358,0,45258,1794100
3/26/22,Hungary,47.1625,19.5033,1839358,0,45258,1794100
3/27/22,Hungary,47.1625,19.5033,1839358,0,45258,1794100
3/28/22,Hungary,47.1625,19.5033,1844581,0,45342,1799239
3/29/22,Hungary,47.1625,19.5033,1846311,0,45390,1800921
3/30/22,Hungary,47.1625,19.5033,1849217,0,45430,1803787
3/31/22,Hungary,47.1625,19.5033,1851871,0,45470,1806401
4/1/22,Hungary,47.1625,19.5033,1854198,0,45510,1808688
4/2/22,Hungary,47.1625,19.5033,1854198,0,45510,1808688
4/3/22,Hungary,47.1625,19.5033,1854198,0,45510,1808688
4/4/22,Hungary,47.1625,19.5033,1854198,0,45510,1808688
4/5/22,Hungary,47.1625,19.5033,1860159,0,45611,1814548
4/6/22,Hungary,47.1625,19.5033,1863039,0,45647,1817392
4/7/22,Hungary,47.1625,19.5033,1865607,0,45684,1819923
4/8/22,Hungary,47.1625,19.5033,1868007,0,45721,1822286
4/9/22,Hungary,47.1625,19.5033,1868007,0,45721,1822286
4/10/22,Hungary,47.1625,19.5033,1868007,0,45721,1822286
4/11/22,Hungary,47.1625,19.5033,1872664,0,45781,1826883
4/12/22,Hungary,47.1625,19.5033,1874206,0,45812,1828394
4/13/22,Hungary,47.1625,19.5033,1876946,0,45838,1831108
4/14/22,Hungary,47.1625,19.5033,1879480,0,45865,1833615
4/15/22,Hungary,47.1625,19.5033,1879480,0,45865,1833615
4/16/22,Hungary,47.1625,19.5033,1879480,0,45865,1833615
4/17/22,Hungary,47.1625,19.5033,1879480,0,45865,1833615
4/18/22,Hungary,47.1625,19.5033,1879480,0,45865,1833615
4/19/22,Hungary,47.1625,19.5033,1884458,0,45971,1838487
4/20/22,Hungary,47.1625,19.5033,1885865,0,46000,1839865
4/21/22,Hungary,47.1625,19.5033,1888906,0,46024,1842882
4/22/22,Hungary,47.1625,19.5033,1890953,0,46048,1844905
4/23/22,Hungary,47.1625,19.5033,1890953,0,46048,1844905
4/24/22,Hungary,47.1625,19.5033,1890953,0,46048,1844905
4/25/22,Hungary,47.1625,19.5033,1894278,0,46101,1848177
4/26/22,Hungary,47.1625,19.5033,1895677,0,46133,1849544
4/27/22,Hungary,47.1625,19.5033,1897897,0,46162,1851735
4/28/22,Hungary,47.1625,19.5033,1899633,0,46189,1853444
4/29/22,Hungary,47.1625,19.5033,1901017,0,46201,1854816
4/30/22,Hungary,47.1625,19.5033,1901017,0,46201,1854816
5/1/22,Hungary,47.1625,19.5033,1901017,0,46201,1854816
5/2/22,Hungary,47.1625,19.5033,1903200,0,46266,1856934
5/3/22,Hungary,47.1625,19.5033,1903200,0,46266,1856934
5/4/22,Hungary,47.1625,19.5033,1903200,0,46266,1856934
5/5/22,Hungary,47.1625,19.5033,1903200,0,46266,1856934
5/6/22,Hungary,47.1625,19.5033,1903200,0,46266,1856934
5/7/22,Hungary,47.1625,19.5033,1903200,0,46266,1856934
5/8/22,Hungary,47.1625,19.5033,1903200,0,46266,1856934
5/9/22,Hungary,47.1625,19.5033,1903200,0,46266,1856934
5/10/22,Hungary,47.1625,19.5033,1903200,0,46266,1856934
5/11/22,Hungary,47.1625,19.5033,1909948,0,46343,1863605
5/12/22,Hungary,47.1625,19.5033,1909948,0,46343,1863605
5/13/22,Hungary,47.1625,19.5033,1909948,0,46343,1863605
5/14/22,Hungary,47.1625,19.5033,1909948,0,46343,1863605
5/15/22,Hungary,47.1625,19.5033,1909948,0,46343,1863605
5/16/22,Hungary,47.1625,19.5033,1909948,0,46343,1863605
5/17/22,Hungary,47.1625,19.5033,1909948,0,46343,1863605
5/18/22,Hungary,47.1625,19.5033,1914697,0,46446,1868251
5/19/22,Hungary,47.1625,19.5033,1914697,0,46446,1868251
5/20/22,Hungary,47.1625,19.5033,1914697,0,46446,1868251
5/21/22,Hungary,47.1625,19.5033,1914697,0,46446,1868251
5/22/22,Hungary,47.1625,19.5033,1914697,0,46446,1868251
5/23/22,Hungary,47.1625,19.5033,1914697,0,46446,1868251
5/24/22,Hungary,47.1625,19.5033,1914697,0,46446,1868251
5/25/22,Hungary,47.1625,19.5033,1917777,0,46507,1871270
5/26/22,Hungary,47.1625,19.5033,1917777,0,46507,1871270
5/27/22,Hungary,47.1625,19.5033,1917777,0,46507,1871270
5/28/22,Hungary,47.1625,19.5033,1917777,0,46507,1871270
5/29/22,Hungary,47.1625,19.5033,1917777,0,46507,1871270
5/30/22,Hungary,47.1625,19.5033,1917777,0,46507,1871270
5/31/22,Hungary,47.1625,19.5033,1917777,0,46507,1871270
6/1/22,Hungary,47.1625,19.5033,1919840,0,46547,1873293
6/2/22,Hungary,47.1625,19.5033,1919840,0,46547,1873293
6/3/22,Hungary,47.1625,19.5033,1919840,0,46547,1873293
6/4/22,Hungary,47.1625,19.5033,1919840,0,46547,1873293
6/5/22,Hungary,47.1625,19.5033,1919840,0,46547,1873293
6/6/22,Hungary,47.1625,19.5033,1919840,0,46547,1873293
6/7/22,Hungary,47.1625,19.5033,1919840,0,46547,1873293
6/8/22,Hungary,47.1625,19.5033,1921486,0,46571,1874915
6/9/22,Hungary,47.1625,19.5033,1921486,0,46571,1874915
6/10/22,Hungary,47.1625,19.5033,1921486,0,46571,1874915
6/11/22,Hungary,47.1625,19.5033,1921486,0,46571,1874915
6/12/22,Hungary,47.1625,19.5033,1921486,0,46571,1874915
6/13/22,Hungary,47.1625,19.5033,1921486,0,46571,1874915
6/14/22,Hungary,47.1625,19.5033,1921486,0,46571,1874915
6/15/22,Hungary,47.1625,19.5033,1923122,0,46594,1876528
6/16/22,Hungary,47.1625,19.5033,1923122,0,46594,1876528
6/17/22,Hungary,47.1625,19.5033,1923122,0,46594,1876528
6/18/22,Hungary,47.1625,19.5033,1923122,0,46594,1876528
6/19/22,Hungary,47.1625,19.5033,1923122,0,46594,1876528
6/20/22,Hungary,47.1625,19.5033,1923122,0,46594,1876528
6/21/22,Hungary,47.1625,19.5033,1923122,0,46594,1876528
6/22/22,Hungary,47.1625,19.5033,1925083,0,46626,1878457
6/23/22,Hungary,47.1625,19.5033,1925083,0,46626,1878457
6/24/22,Hungary,47.1625,19.5033,1925083,0,46626,1878457
6/25/22,Hungary,47.1625,19.5033,1925083,0,46626,1878457
6/26/22,Hungary,47.1625,19.5033,1925083,0,46626,1878457
6/27/22,Hungary,47.1625,19.5033,1925083,0,46626,1878457
6/28/22,Hungary,47.1625,19.5033,1925083,0,46626,1878457
6/29/22,Hungary,47.1625,19.5033,1928125,0,46647,1881478
6/30/22,Hungary,47.1625,19.5033,1928125,0,46647,1881478
7/1/22,Hungary,47.1625,19.5033,1928125,0,46647,1881478
7/2/22,Hungary,47.1625,19.5033,1928125,0,46647,1881478
7/3/22,Hungary,47.1625,19.5033,1928125,0,46647,1881478
7/4/22,Hungary,47.1625,19.5033,1928125,0,46647,1881478
7/5/22,Hungary,47.1625,19.5033,1928125,0,46647,1881478
7/6/22,Hungary,47.1625,19.5033,1932788,0,46661,1886127
7/7/22,Hungary,47.1625,19.5033,1932788,0,46661,1886127
7/8/22,Hungary,47.1625,19.5033,1932788,0,46661,1886127
7/9/22,Hungary,47.1625,19.5033,1932788,0,46661,1886127
7/10/22,Hungary,47.1625,19.5033,1932788,0,46661,1886127
7/11/22,Hungary,47.1625,19.5033,1932788,0,46661,1886127
7/12/22,Hungary,47.1625,19.5033,1932788,0,46661,1886127
7/13/22,Hungary,47.1625,19.5033,1940824,0,46696,1894128
7/14/22,Hungary,47.1625,19.5033,1940824,0,46696,1894128
7/15/22,Hungary,47.1625,19.5033,1940824,0,46696,1894128
7/16/22,Hungary,47.1625,19.5033,1940824,0,46696,1894128
7/17/22,Hungary,47.1625,19.5033,1940824,0,46696,1894128
7/18/22,Hungary,47.1625,19.5033,1940824,0,46696,1894128
7/19/22,Hungary,47.1625,19.5033,1940824,0,46696,1894128
7/20/22,Hungary,47.1625,19.5033,1951079,0,46736,1904343
7/21/22,Hungary,47.1625,19.5033,1951079,0,46736,1904343
7/22/22,Hungary,47.1625,19.5033,1951079,0,46736,1904343
7/23/22,Hungary,47.1625,19.5033,1951079,0,46736,1904343
7/24/22,Hungary,47.1625,19.5033,1951079,0,46736,1904343
7/25/22,Hungary,47.1625,19.5033,1951079,0,46736,1904343
7/26/22,Hungary,47.1625,19.5033,1951079,0,46736,1904343
7/27/22,Hungary,47.1625,19.5033,1965481,0,46790,1918691
7/28/22,Hungary,47.1625,19.5033,1965481,0,46790,1918691
7/29/22,Hungary,47.1625,19.5033,1965481,0,46790,1918691
7/30/22,Hungary,47.1625,19.5033,1965481,0,46790,1918691
7/31/22,Hungary,47.1625,19.5033,1965481,0,46790,1918691
8/1/22,Hungary,47.1625,19.5033,1965481,0,46790,1918691
8/2/22,Hungary,47.1625,19.5033,1965481,0,46790,1918691
8/3/22,Hungary,47.1625,19.5033,1987321,0,46886,1940435
8/4/22,Hungary,47.1625,19.5033,1987321,0,46886,1940435
8/5/22,Hungary,47.1625,19.5033,1987321,0,46886,1940435
8/6/22,Hungary,47.1625,19.5033,1987321,0,46886,1940435
8/7/22,Hungary,47.1625,19.5033,1987321,0,46886,1940435
8/8/22,Hungary,47.1625,19.5033,1987321,0,46886,1940435
8/9/22,Hungary,47.1625,19.5033,1987321,0,46886,1940435
8/10/22,Hungary,47.1625,19.5033,2005399,0,46966,1958433
8/11/22,Hungary,47.1625,19.5033,2005399,0,46966,1958433
8/12/22,Hungary,47.1625,19.5033,2005399,0,46966,1958433
8/13/22,Hungary,47.1625,19.5033,2005399,0,46966,1958433
8/14/22,Hungary,47.1625,19.5033,2005399,0,46966,1958433
8/15/22,Hungary,47.1625,19.5033,2005399,0,46966,1958433
8/16/22,Hungary,47.1625,19.5033,2005399,0,46966,1958433
8/17/22,Hungary,47.1625,19.5033,2021648,0,47083,1974565
8/18/22,Hungary,47.1625,19.5033,2021648,0,47083,1974565
8/19/22,Hungary,47.1625,19.5033,2021648,0,47083,1974565
8/20/22,Hungary,47.1625,19.5033,2021648,0,47083,1974565
8/21/22,Hungary,47.1625,19.5033,2021648,0,47083,1974565
8/22/22,Hungary,47.1625,19.5033,2021648,0,47083,1974565
8/23/22,Hungary,47.1625,19.5033,2021648,0,47083,1974565
8/24/22,Hungary,47.1625,19.5033,2036390,0,47191,1989199
8/25/22,Hungary,47.1625,19.5033,2036390,0,47191,1989199
8/26/22,Hungary,47.1625,19.5033,2036390,0,47191,1989199
8/27/22,Hungary,47.1625,19.5033,2036390,0,47191,1989199
8/28/22,Hungary,47.1625,19.5033,2036390,0,47191,1989199
8/29/22,Hungary,47.1625,19.5033,2036390,0,47191,1989199
8/30/22,Hungary,47.1625,19.5033,2036390,0,47191,1989199
8/31/22,Hungary,47.1625,19.5033,2048547,0,47291,2001256
9/1/22,Hungary,47.1625,19.5033,2048547,0,47291,2001256
9/2/22,Hungary,47.1625,19.5033,2048547,0,47291,2001256
9/3/22,Hungary,47.1625,19.5033,2048547,0,47291,2001256
9/4/22,Hungary,47.1625,19.5033,2048547,0,47291,2001256
9/5/22,Hungary,47.1625,19.5033,2048547,0,47291,2001256
9/6/22,Hungary,47.1625,19.5033,2048547,0,47291,2001256
9/7/22,Hungary,47.1625,19.5033,2058847,0,47367,2011480
9/8/22,Hungary,47.1625,19.5033,2058847,0,47367,2011480
9/9/22,Hungary,47.1625,19.5033,2058847,0,47367,2011480
9/10/22,Hungary,47.1625,19.5033,2058847,0,47367,2011480
9/11/22,Hungary,47.1625,19.5033,2058847,0,47367,2011480
9/12/22,Hungary,47.1625,19.5033,2058847,0,47367,2011480
9/13/22,Hungary,47.1625,19.5033,2058847,0,47367,2011480
9/14/22,Hungary,47.1625,19.5033,2070443,0,47409,2023034
9/15/22,Hungary,47.1625,19.5033,2070443,0,47409,2023034
9/16/22,Hungary,47.1625,19.5033,2070443,0,47409,2023034
9/17/22,Hungary,47.1625,19.5033,2070443,0,47409,2023034
9/18/22,Hungary,47.1625,19.5033,2070443,0,47409,2023034
9/19/22,Hungary,47.1625,19.5033,2070443,0,47409,2023034
9/20/22,Hungary,47.1625,19.5033,2070443,0,47409,2023034
9/21/22,Hungary,47.1625,19.5033,2082750,0,47457,2035293
9/22/22,Hungary,47.1625,19.5033,2082750,0,47457,2035293
9/23/22,Hungary,47.1625,19.5033,2082750,0,47457,2035293
9/24/22,Hungary,47.1625,19.5033,2082750,0,47457,2035293
9/25/22,Hungary,47.1625,19.5033,2082750,0,47457,2035293
9/26/22,Hungary,47.1625,19.5033,2082750,0,47457,2035293
9/27/22,Hungary,47.1625,19.5033,2082750,0,47457,2035293
9/28/22,Hungary,47.1625,19.5033,2094142,0,47503,2046639
9/29/22,Hungary,47.1625,19.5033,2094142,0,47503,2046639
9/30/22,Hungary,47.1625,19.5033,2094142,0,47503,2046639
10/1/22,Hungary,47.1625,19.5033,2094142,0,47503,2046639
10/2/22,Hungary,47.1625,19.5033,2094142,0,47503,2046639
10/3/22,Hungary,47.1625,19.5033,2094142,0,47503,2046639
10/4/22,Hungary,47.1625,19.5033,2094142,0,47503,2046639
10/5/22,Hungary,47.1625,19.5033,2107907,0,47576,2060331
10/6/22,Hungary,47.1625,19.5033,2107907,0,47576,2060331
10/7/22,Hungary,47.1625,19.5033,2107907,0,47576,2060331
10/8/22,Hungary,47.1625,19.5033,2107907,0,47576,2060331
10/9/22,Hungary,47.1625,19.5033,2107907,0,47576,2060331
10/10/22,Hungary,47.1625,19.5033,2107907,0,47576,2060331
10/11/22,Hungary,47.1625,19.5033,2107907,0,47576,2060331
10/12/22,Hungary,47.1625,19.5033,2120543,0,47680,2072863
10/13/22,Hungary,47.1625,19.5033,2120543,0,47680,2072863
10/14/22,Hungary,47.1625,19.5033,2120543,0,47680,2072863
10/15/22,Hungary,47.1625,19.5033,2120543,0,47680,2072863
10/16/22,Hungary,47.1625,19.5033,2120543,0,47680,2072863
10/17/22,Hungary,47.1625,19.5033,2120543,0,47680,2072863
10/18/22,Hungary,47.1625,19.5033,2120543,0,47680,2072863
10/19/22,Hungary,47.1625,19.5033,2132490,0,47798,2084692
10/20/22,Hungary,47.1625,19.5033,2132490,0,47798,2084692
10/21/22,Hungary,47.1625,19.5033,2132490,0,47798,2084692
10/22/22,Hungary,47.1625,19.5033,2132490,0,47798,2084692
10/23/22,Hungary,47.1625,19.5033,2132490,0,47798,2084692
10/24/22,Hungary,47.1625,19.5033,2132490,0,47798,2084692
10/25/22,Hungary,47.1625,19.5033,2132490,0,47798,2084692
10/26/22,Hungary,47.1625,19.5033,2141513,0,47938,2093575
10/27/22,Hungary,47.1625,19.5033,2141513,0,47938,2093575
10/28/22,Hungary,47.1625,19.5033,2141513,0,47938,2093575
10/29/22,Hungary,47.1625,19.5033,2141513,0,47938,2093575
10/30/22,Hungary,47.1625,19.5033,2141513,0,47938,2093575
10/31/22,Hungary,47.1625,19.5033,2141513,0,47938,2093575
11/1/22,Hungary,47.1625,19.5033,2141513,0,47938,2093575
11/2/22,Hungary,47.1625,19.5033,2141513,0,47938,2093575
11/3/22,Hungary,47.1625,19.5033,2141513,0,47938,2093575
11/4/22,Hungary,47.1625,19.5033,2141513,0,47938,2093575
11/5/22,Hungary,47.1625,19.5033,2141513,0,47938,2093575
11/6/22,Hungary,47.1625,19.5033,2141513,0,47938,2093575
11/7/22,Hungary,47.1625,19.5033,2141513,0,47938,2093575
11/8/22,Hungary,47.1625,19.5033,2141513,0,47938,2093575
11/9/22,Hungary,47.1625,19.5033,2153564,0,48111,2105453
11/10/22,Hungary,47.1625,19.5033,2153564,0,48111,2105453
11/11/22,Hungary,47.1625,19.5033,2153564,0,48111,2105453
11/12/22,Hungary,47.1625,19.5033,2153564,0,48111,2105453
11/13/22,Hungary,47.1625,19.5033,2153564,0,48111,2105453
11/14/22,Hungary,47.1625,19.5033,2153564,0,48111,2105453
11/15/22,Hungary,47.1625,19.5033,2153564,0,48111,2105453
11/16/22,Hungary,47.1625,19.5033,2157995,0,48184,2109811
11/17/22,Hungary,47.1625,19.5033,2157995,0,48184,2109811
11/18/22,Hungary,47.1625,19.5033,2157995,0,48184,2109811
11/19/22,Hungary,47.1625,19.5033,2157995,0,48184,2109811
11/20/22,Hungary,47.1625,19.5033,2157995,0,48184,2109811
11/21/22,Hungary,47.1625,19.5033,2157995,0,48184,2109811
11/22/22,Hungary,47.1625,19.5033,2157995,0,48184,2109811
11/23/22,Hungary,47.1625,19.5033,2162093,0,48245,2113848
11/24/22,Hungary,47.1625,19.5033,2162093,0,48245,2113848
11/25/22,Hungary,47.1625,19.5033,2162093,0,48245,2113848
11/26/22,Hungary,47.1625,19.5033,2162093,0,48245,2113848
11/27/22,Hungary,47.1625,19.5033,2162093,0,48245,2113848
11/28/22,Hungary,47.1625,19.5033,2162093,0,48245,2113848
11/29/22,Hungary,47.1625,19.5033,2162093,0,48245,2113848
11/30/22,Hungary,47.1625,19.5033,2166352,0,48287,2118065
12/1/22,Hungary,47.1625,19.5033,2166352,0,48287,2118065
12/2/22,Hungary,47.1625,19.5033,2166352,0,48287,2118065
12/3/22,Hungary,47.1625,19.5033,2166352,0,48287,2118065
12/4/22,Hungary,47.1625,19.5033,2166352,0,48287,2118065
12/5/22,Hungary,47.1625,19.5033,2166352,0,48287,2118065
12/6/22,Hungary,47.1625,19.5033,2166352,0,48287,2118065
12/7/22,Hungary,47.1625,19.5033,2171056,0,48337,2122719
12/8/22,Hungary,47.1625,19.5033,2171056,0,48337,2122719
12/9/22,Hungary,47.1625,19.5033,2171056,0,48337,2122719
12/10/22,Hungary,47.1625,19.5033,2171056,0,48337,2122719
12/11/22,Hungary,47.1625,19.5033,2171056,0,48337,2122719
12/12/22,Hungary,47.1625,19.5033,2171056,0,48337,2122719
12/13/22,Hungary,47.1625,19.5033,2171056,0,48337,2122719
12/14/22,Hungary,47.1625,19.5033,2176249,0,48380,2127869
12/15/22,Hungary,47.1625,19.5033,2176249,0,48380,2127869
12/16/22,Hungary,47.1625,19.5033,2176249,0,48380,2127869
12/17/22,Hungary,47.1625,19.5033,2176249,0,48380,2127869
1/1/22,Iceland,64.9631,-19.0208,27059,0,37,27022
1/2/22,Iceland,64.9631,-19.0208,27059,0,37,27022
1/3/22,Iceland,64.9631,-19.0208,31070,0,38,31032
1/4/22,Iceland,64.9631,-19.0208,32540,0,38,32502
1/5/22,Iceland,64.9631,-19.0208,33901,0,39,33862
1/6/22,Iceland,64.9631,-19.0208,35239,0,39,35200
1/7/22,Iceland,64.9631,-19.0208,36447,0,39,36408
1/8/22,Iceland,64.9631,-19.0208,36447,0,39,36408
1/9/22,Iceland,64.9631,-19.0208,36447,0,39,36408
1/10/22,Iceland,64.9631,-19.0208,40037,0,39,39998
1/11/22,Iceland,64.9631,-19.0208,40037,0,39,39998
1/12/22,Iceland,64.9631,-19.0208,40037,0,39,39998
1/13/22,Iceland,64.9631,-19.0208,43768,0,43,43725
1/14/22,Iceland,64.9631,-19.0208,44974,0,44,44930
1/15/22,Iceland,64.9631,-19.0208,44974,0,44,44930
1/16/22,Iceland,64.9631,-19.0208,44974,0,44,44930
1/17/22,Iceland,64.9631,-19.0208,48482,0,44,48438
1/18/22,Iceland,64.9631,-19.0208,49972,0,44,49928
1/19/22,Iceland,64.9631,-19.0208,51535,0,44,51491
1/20/22,Iceland,64.9631,-19.0208,53121,0,44,53077
1/21/22,Iceland,64.9631,-19.0208,54579,0,44,54535
1/22/22,Iceland,64.9631,-19.0208,54579,0,44,54535
1/23/22,Iceland,64.9631,-19.0208,54579,0,44,54535
1/24/22,Iceland,64.9631,-19.0208,58409,0,44,58365
1/25/22,Iceland,64.9631,-19.0208,60096,0,45,60051
1/26/22,Iceland,64.9631,-19.0208,61737,0,45,61692
1/27/22,Iceland,64.9631,-19.0208,63188,0,46,63142
1/28/22,Iceland,64.9631,-19.0208,64486,0,46,64440
1/29/22,Iceland,64.9631,-19.0208,64486,0,46,64440
1/30/22,Iceland,64.9631,-19.0208,64486,0,46,64440
1/31/22,Iceland,64.9631,-19.0208,67673,0,46,67627
2/1/22,Iceland,64.9631,-19.0208,69177,0,46,69131
2/2/22,Iceland,64.9631,-19.0208,70721,0,47,70674
2/3/22,Iceland,64.9631,-19.0208,72136,0,47,72089
2/4/22,Iceland,64.9631,-19.0208,73530,0,49,73481
2/5/22,Iceland,64.9631,-19.0208,73530,0,49,73481
2/6/22,Iceland,64.9631,-19.0208,73530,0,49,73481
2/7/22,Iceland,64.9631,-19.0208,78201,0,50,78151
2/8/22,Iceland,64.9631,-19.0208,79511,0,50,79461
2/9/22,Iceland,64.9631,-19.0208,81981,0,50,81931
2/10/22,Iceland,64.9631,-19.0208,83942,0,52,83890
2/11/22,Iceland,64.9631,-19.0208,85980,0,54,85926
2/12/22,Iceland,64.9631,-19.0208,85980,0,54,85926
2/13/22,Iceland,64.9631,-19.0208,85980,0,54,85926
2/14/22,Iceland,64.9631,-19.0208,92127,0,55,92072
2/15/22,Iceland,64.9631,-19.0208,93933,0,56,93877
2/16/22,Iceland,64.9631,-19.0208,96623,0,58,96565
2/17/22,Iceland,64.9631,-19.0208,99764,0,58,99706
2/18/22,Iceland,64.9631,-19.0208,102086,0,58,102028
2/19/22,Iceland,64.9631,-19.0208,102086,0,58,102028
2/20/22,Iceland,64.9631,-19.0208,102086,0,58,102028
2/21/22,Iceland,64.9631,-19.0208,109494,0,58,109436
2/22/22,Iceland,64.9631,-19.0208,112094,0,61,112033
2/23/22,Iceland,64.9631,-19.0208,115241,0,60,115181
2/24/22,Iceland,64.9631,-19.0208,118684,0,61,118623
2/25/22,Iceland,64.9631,-19.0208,123373,0,61,123312
2/26/22,Iceland,64.9631,-19.0208,123373,0,61,123312
2/27/22,Iceland,64.9631,-19.0208,123373,0,61,123312
2/28/22,Iceland,64.9631,-19.0208,129844,0,62,129782
3/1/22,Iceland,64.9631,-19.0208,133211,0,65,133146
3/2/22,Iceland,64.9631,-19.0208,135747,0,65,135682
3/3/22,Iceland,64.9631,-19.0208,138281,0,68,138213
3/4/22,Iceland,64.9631,-19.0208,140929,0,68,140861
3/5/22,Iceland,64.9631,-19.0208,140929,0,68,140861
3/6/22,Iceland,64.9631,-19.0208,140929,0,68,140861
3/7/22,Iceland,64.9631,-19.0208,147151,0,71,147080
3/8/22,Iceland,64.9631,-19.0208,150467,0,73,150394
3/9/22,Iceland,64.9631,-19.0208,153244,0,76,153168
3/10/22,Iceland,64.9631,-19.0208,155877,0,77,155800
3/11/22,Iceland,64.9631,-19.0208,158533,0,79,158454
3/12/22,Iceland,64.9631,-19.0208,158533,0,79,158454
3/13/22,Iceland,64.9631,-19.0208,158533,0,79,158454
3/14/22,Iceland,64.9631,-19.0208,162938,0,81,162857
3/15/22,Iceland,64.9631,-19.0208,165299,0,83,165216
3/16/22,Iceland,64.9631,-19.0208,167379,0,87,167292
3/17/22,Iceland,64.9631,-19.0208,169258,0,91,169167
3/18/22,Iceland,64.9631,-19.0208,170806,0,91,170715
3/19/22,Iceland,64.9631,-19.0208,170806,0,91,170715
3/20/22,Iceland,64.9631,-19.0208,170806,0,91,170715
3/21/22,Iceland,64.9631,-19.0208,173796,0,91,173705
3/22/22,Iceland,64.9631,-19.0208,175329,0,93,175236
3/23/22,Iceland,64.9631,-19.0208,176179,0,93,176086
3/24/22,Iceland,64.9631,-19.0208,177015,0,95,176920
3/25/22,Iceland,64.9631,-19.0208,178385,0,97,178288
3/26/22,Iceland,64.9631,-19.0208,178385,0,97,178288
3/27/22,Iceland,64.9631,-19.0208,178385,0,97,178288
3/28/22,Iceland,64.9631,-19.0208,179813,0,97,179716
3/29/22,Iceland,64.9631,-19.0208,179813,0,97,179716
3/30/22,Iceland,64.9631,-19.0208,180950,0,98,180852
3/31/22,Iceland,64.9631,-19.0208,181391,0,101,181290
4/1/22,Iceland,64.9631,-19.0208,181830,0,101,181729
4/2/22,Iceland,64.9631,-19.0208,181830,0,101,181729
4/3/22,Iceland,64.9631,-19.0208,181830,0,101,181729
4/4/22,Iceland,64.9631,-19.0208,181830,0,101,181729
4/5/22,Iceland,64.9631,-19.0208,182633,0,102,182531
4/6/22,Iceland,64.9631,-19.0208,182633,0,102,182531
4/7/22,Iceland,64.9631,-19.0208,182633,0,102,182531
4/8/22,Iceland,64.9631,-19.0208,183363,0,105,183258
4/9/22,Iceland,64.9631,-19.0208,183363,0,105,183258
4/10/22,Iceland,64.9631,-19.0208,183363,0,105,183258
4/11/22,Iceland,64.9631,-19.0208,183363,0,105,183258
4/12/22,Iceland,64.9631,-19.0208,183974,0,110,183864
4/13/22,Iceland,64.9631,-19.0208,183974,0,110,183864
4/14/22,Iceland,64.9631,-19.0208,183974,0,110,183864
4/15/22,Iceland,64.9631,-19.0208,183974,0,110,183864
4/16/22,Iceland,64.9631,-19.0208,183974,0,110,183864
4/17/22,Iceland,64.9631,-19.0208,183974,0,110,183864
4/18/22,Iceland,64.9631,-19.0208,183974,0,110,183864
4/19/22,Iceland,64.9631,-19.0208,183701,0,112,183589
4/20/22,Iceland,64.9631,-19.0208,183701,0,112,183589
4/21/22,Iceland,64.9631,-19.0208,183701,0,112,183589
4/22/22,Iceland,64.9631,-19.0208,185074,0,114,184960
4/23/22,Iceland,64.9631,-19.0208,185074,0,114,184960
4/24/22,Iceland,64.9631,-19.0208,185074,0,114,184960
4/25/22,Iceland,64.9631,-19.0208,185074,0,114,184960
4/26/22,Iceland,64.9631,-19.0208,185353,0,119,185234
4/27/22,Iceland,64.9631,-19.0208,185353,0,119,185234
4/28/22,Iceland,64.9631,-19.0208,185353,0,119,185234
4/29/22,Iceland,64.9631,-19.0208,185579,0,119,185460
4/30/22,Iceland,64.9631,-19.0208,185579,0,119,185460
5/1/22,Iceland,64.9631,-19.0208,185579,0,119,185460
5/2/22,Iceland,64.9631,-19.0208,185579,0,119,185460
5/3/22,Iceland,64.9631,-19.0208,185795,0,119,185676
5/4/22,Iceland,64.9631,-19.0208,185795,0,119,185676
5/5/22,Iceland,64.9631,-19.0208,185795,0,119,185676
5/6/22,Iceland,64.9631,-19.0208,185961,0,119,185842
5/7/22,Iceland,64.9631,-19.0208,185961,0,119,185842
5/8/22,Iceland,64.9631,-19.0208,185961,0,119,185842
5/9/22,Iceland,64.9631,-19.0208,185961,0,119,185842
5/10/22,Iceland,64.9631,-19.0208,186179,0,120,186059
5/11/22,Iceland,64.9631,-19.0208,186179,0,120,186059
5/12/22,Iceland,64.9631,-19.0208,186179,0,120,186059
5/13/22,Iceland,64.9631,-19.0208,186545,0,120,186425
5/14/22,Iceland,64.9631,-19.0208,186545,0,120,186425
5/15/22,Iceland,64.9631,-19.0208,186545,0,120,186425
5/16/22,Iceland,64.9631,-19.0208,186545,0,120,186425
5/17/22,Iceland,64.9631,-19.0208,186969,0,153,186816
5/18/22,Iceland,64.9631,-19.0208,186969,0,153,186816
5/19/22,Iceland,64.9631,-19.0208,186969,0,153,186816
5/20/22,Iceland,64.9631,-19.0208,187262,0,153,187109
5/21/22,Iceland,64.9631,-19.0208,187262,0,153,187109
5/22/22,Iceland,64.9631,-19.0208,187262,0,153,187109
5/23/22,Iceland,64.9631,-19.0208,187262,0,153,187109
5/24/22,Iceland,64.9631,-19.0208,187664,0,153,187511
5/25/22,Iceland,64.9631,-19.0208,187664,0,153,187511
5/26/22,Iceland,64.9631,-19.0208,187664,0,153,187511
5/27/22,Iceland,64.9631,-19.0208,187949,0,153,187796
5/28/22,Iceland,64.9631,-19.0208,187949,0,153,187796
5/29/22,Iceland,64.9631,-19.0208,187949,0,153,187796
5/30/22,Iceland,64.9631,-19.0208,187949,0,153,187796
5/31/22,Iceland,64.9631,-19.0208,188291,0,153,188138
6/1/22,Iceland,64.9631,-19.0208,188291,0,153,188138
6/2/22,Iceland,64.9631,-19.0208,188291,0,153,188138
6/3/22,Iceland,64.9631,-19.0208,188924,0,153,188771
6/4/22,Iceland,64.9631,-19.0208,188924,0,153,188771
6/5/22,Iceland,64.9631,-19.0208,188924,0,153,188771
6/6/22,Iceland,64.9631,-19.0208,188924,0,153,188771
6/7/22,Iceland,64.9631,-19.0208,189319,0,153,189166
6/8/22,Iceland,64.9631,-19.0208,189319,0,153,189166
6/9/22,Iceland,64.9631,-19.0208,189319,0,153,189166
6/10/22,Iceland,64.9631,-19.0208,190014,0,153,189861
6/11/22,Iceland,64.9631,-19.0208,190014,0,153,189861
6/12/22,Iceland,64.9631,-19.0208,190014,0,153,189861
6/13/22,Iceland,64.9631,-19.0208,190014,0,153,189861
6/14/22,Iceland,64.9631,-19.0208,190643,0,153,190490
6/15/22,Iceland,64.9631,-19.0208,190643,0,153,190490
6/16/22,Iceland,64.9631,-19.0208,191079,0,153,190926
6/17/22,Iceland,64.9631,-19.0208,191079,0,153,190926
6/18/22,Iceland,64.9631,-19.0208,191079,0,153,190926
6/19/22,Iceland,64.9631,-19.0208,191079,0,153,190926
6/20/22,Iceland,64.9631,-19.0208,191079,0,153,190926
6/21/22,Iceland,64.9631,-19.0208,192031,0,153,191878
6/22/22,Iceland,64.9631,-19.0208,192031,0,153,191878
6/23/22,Iceland,64.9631,-19.0208,192031,0,153,191878
6/24/22,Iceland,64.9631,-19.0208,192991,0,153,192838
6/25/22,Iceland,64.9631,-19.0208,192991,0,153,192838
6/26/22,Iceland,64.9631,-19.0208,192991,0,153,192838
6/27/22,Iceland,64.9631,-19.0208,192991,0,153,192838
6/28/22,Iceland,64.9631,-19.0208,193987,0,153,193834
6/29/22,Iceland,64.9631,-19.0208,193987,0,153,193834
6/30/22,Iceland,64.9631,-19.0208,193987,0,153,193834
7/1/22,Iceland,64.9631,-19.0208,195259,0,179,195080
7/2/22,Iceland,64.9631,-19.0208,195259,0,179,195080
7/3/22,Iceland,64.9631,-19.0208,195259,0,179,195080
7/4/22,Iceland,64.9631,-19.0208,195259,0,179,195080
7/5/22,Iceland,64.9631,-19.0208,196527,0,179,196348
7/6/22,Iceland,64.9631,-19.0208,196527,0,179,196348
7/7/22,Iceland,64.9631,-19.0208,196527,0,179,196348
7/8/22,Iceland,64.9631,-19.0208,197707,0,179,197528
7/9/22,Iceland,64.9631,-19.0208,197707,0,179,197528
7/10/22,Iceland,64.9631,-19.0208,197707,0,179,197528
7/11/22,Iceland,64.9631,-19.0208,197707,0,179,197528
7/12/22,Iceland,64.9631,-19.0208,198721,0,179,198542
7/13/22,Iceland,64.9631,-19.0208,198721,0,179,198542
7/14/22,Iceland,64.9631,-19.0208,198721,0,179,198542
7/15/22,Iceland,64.9631,-19.0208,199611,0,179,199432
7/16/22,Iceland,64.9631,-19.0208,199611,0,179,199432
7/17/22,Iceland,64.9631,-19.0208,199611,0,179,199432
7/18/22,Iceland,64.9631,-19.0208,199611,0,179,199432
7/19/22,Iceland,64.9631,-19.0208,200397,0,179,200218
7/20/22,Iceland,64.9631,-19.0208,200397,0,179,200218
7/21/22,Iceland,64.9631,-19.0208,200397,0,179,200218
7/22/22,Iceland,64.9631,-19.0208,201082,0,179,200903
7/23/22,Iceland,64.9631,-19.0208,201082,0,179,200903
7/24/22,Iceland,64.9631,-19.0208,201082,0,179,200903
7/25/22,Iceland,64.9631,-19.0208,201082,0,179,200903
7/26/22,Iceland,64.9631,-19.0208,201648,0,179,201469
7/27/22,Iceland,64.9631,-19.0208,201648,0,179,201469
7/28/22,Iceland,64.9631,-19.0208,201648,0,179,201469
7/29/22,Iceland,64.9631,-19.0208,202157,0,179,201978
7/30/22,Iceland,64.9631,-19.0208,202157,0,179,201978
7/31/22,Iceland,64.9631,-19.0208,202157,0,179,201978
8/1/22,Iceland,64.9631,-19.0208,202157,0,179,201978
8/2/22,Iceland,64.9631,-19.0208,202502,0,179,202323
8/3/22,Iceland,64.9631,-19.0208,202502,0,179,202323
8/4/22,Iceland,64.9631,-19.0208,202502,0,179,202323
8/5/22,Iceland,64.9631,-19.0208,202831,0,179,202652
8/6/22,Iceland,64.9631,-19.0208,202831,0,179,202652
8/7/22,Iceland,64.9631,-19.0208,202831,0,179,202652
8/8/22,Iceland,64.9631,-19.0208,202831,0,179,202652
8/9/22,Iceland,64.9631,-19.0208,203162,0,179,202983
8/10/22,Iceland,64.9631,-19.0208,203162,0,179,202983
8/11/22,Iceland,64.9631,-19.0208,203162,0,179,202983
8/12/22,Iceland,64.9631,-19.0208,203518,0,179,203339
8/13/22,Iceland,64.9631,-19.0208,203518,0,179,203339
8/14/22,Iceland,64.9631,-19.0208,203518,0,179,203339
8/15/22,Iceland,64.9631,-19.0208,203518,0,179,203339
8/16/22,Iceland,64.9631,-19.0208,203814,0,179,203635
8/17/22,Iceland,64.9631,-19.0208,203814,0,179,203635
8/18/22,Iceland,64.9631,-19.0208,203814,0,179,203635
8/19/22,Iceland,64.9631,-19.0208,204057,0,179,203878
8/20/22,Iceland,64.9631,-19.0208,204057,0,179,203878
8/21/22,Iceland,64.9631,-19.0208,204057,0,179,203878
8/22/22,Iceland,64.9631,-19.0208,204057,0,179,203878
8/23/22,Iceland,64.9631,-19.0208,204268,0,179,204089
8/24/22,Iceland,64.9631,-19.0208,204268,0,179,204089
8/25/22,Iceland,64.9631,-19.0208,204268,0,179,204089
8/26/22,Iceland,64.9631,-19.0208,204268,0,179,204089
8/27/22,Iceland,64.9631,-19.0208,204268,0,179,204089
8/28/22,Iceland,64.9631,-19.0208,204268,0,179,204089
8/29/22,Iceland,64.9631,-19.0208,204268,0,179,204089
8/30/22,Iceland,64.9631,-19.0208,204717,0,213,204504
8/31/22,Iceland,64.9631,-19.0208,204717,0,213,204504
9/1/22,Iceland,64.9631,-19.0208,204717,0,213,204504
9/2/22,Iceland,64.9631,-19.0208,204717,0,213,204504
9/3/22,Iceland,64.9631,-19.0208,204717,0,213,204504
9/4/22,Iceland,64.9631,-19.0208,204717,0,213,204504
9/5/22,Iceland,64.9631,-19.0208,204717,0,213,204504
9/6/22,Iceland,64.9631,-19.0208,205009,0,213,204796
9/7/22,Iceland,64.9631,-19.0208,205009,0,213,204796
9/8/22,Iceland,64.9631,-19.0208,205009,0,213,204796
9/9/22,Iceland,64.9631,-19.0208,205009,0,213,204796
9/10/22,Iceland,64.9631,-19.0208,205009,0,213,204796
9/11/22,Iceland,64.9631,-19.0208,205009,0,213,204796
9/12/22,Iceland,64.9631,-19.0208,205009,0,213,204796
9/13/22,Iceland,64.9631,-19.0208,205284,0,213,205071
9/14/22,Iceland,64.9631,-19.0208,205284,0,213,205071
9/15/22,Iceland,64.9631,-19.0208,205284,0,213,205071
9/16/22,Iceland,64.9631,-19.0208,205284,0,213,205071
9/17/22,Iceland,64.9631,-19.0208,205284,0,213,205071
9/18/22,Iceland,64.9631,-19.0208,205284,0,213,205071
9/19/22,Iceland,64.9631,-19.0208,205284,0,213,205071
9/20/22,Iceland,64.9631,-19.0208,205454,0,213,205241
9/21/22,Iceland,64.9631,-19.0208,205454,0,213,205241
9/22/22,Iceland,64.9631,-19.0208,205454,0,213,205241
9/23/22,Iceland,64.9631,-19.0208,205454,0,213,205241
9/24/22,Iceland,64.9631,-19.0208,205454,0,213,205241
9/25/22,Iceland,64.9631,-19.0208,205454,0,213,205241
9/26/22,Iceland,64.9631,-19.0208,205454,0,213,205241
9/27/22,Iceland,64.9631,-19.0208,205637,0,213,205424
9/28/22,Iceland,64.9631,-19.0208,205637,0,213,205424
9/29/22,Iceland,64.9631,-19.0208,205637,0,213,205424
9/30/22,Iceland,64.9631,-19.0208,205637,0,213,205424
10/1/22,Iceland,64.9631,-19.0208,205637,0,213,205424
10/2/22,Iceland,64.9631,-19.0208,205637,0,213,205424
10/3/22,Iceland,64.9631,-19.0208,205637,0,213,205424
10/4/22,Iceland,64.9631,-19.0208,205823,0,213,205610
10/5/22,Iceland,64.9631,-19.0208,205823,0,213,205610
10/6/22,Iceland,64.9631,-19.0208,205823,0,213,205610
10/7/22,Iceland,64.9631,-19.0208,205823,0,213,205610
10/8/22,Iceland,64.9631,-19.0208,205823,0,213,205610
10/9/22,Iceland,64.9631,-19.0208,205823,0,213,205610
10/10/22,Iceland,64.9631,-19.0208,205823,0,213,205610
10/11/22,Iceland,64.9631,-19.0208,205963,0,213,205750
10/12/22,Iceland,64.9631,-19.0208,205963,0,213,205750
10/13/22,Iceland,64.9631,-19.0208,205963,0,213,205750
10/14/22,Iceland,64.9631,-19.0208,205963,0,213,205750
10/15/22,Iceland,64.9631,-19.0208,205963,0,213,205750
10/16/22,Iceland,64.9631,-19.0208,205963,0,213,205750
10/17/22,Iceland,64.9631,-19.0208,205963,0,213,205750
10/18/22,Iceland,64.9631,-19.0208,206134,0,213,205921
10/19/22,Iceland,64.9631,-19.0208,206134,0,213,205921
10/20/22,Iceland,64.9631,-19.0208,206134,0,213,205921
10/21/22,Iceland,64.9631,-19.0208,206134,0,213,205921
10/22/22,Iceland,64.9631,-19.0208,206134,0,213,205921
10/23/22,Iceland,64.9631,-19.0208,206134,0,213,205921
10/24/22,Iceland,64.9631,-19.0208,206134,0,213,205921
10/25/22,Iceland,64.9631,-19.0208,206356,0,213,206143
10/26/22,Iceland,64.9631,-19.0208,206356,0,213,206143
10/27/22,Iceland,64.9631,-19.0208,206356,0,213,206143
10/28/22,Iceland,64.9631,-19.0208,206356,0,213,206143
10/29/22,Iceland,64.9631,-19.0208,206356,0,213,206143
10/30/22,Iceland,64.9631,-19.0208,206356,0,213,206143
10/31/22,Iceland,64.9631,-19.0208,206356,0,213,206143
11/1/22,Iceland,64.9631,-19.0208,206571,0,219,206352
11/2/22,Iceland,64.9631,-19.0208,206571,0,219,206352
11/3/22,Iceland,64.9631,-19.0208,206571,0,219,206352
11/4/22,Iceland,64.9631,-19.0208,206571,0,219,206352
11/5/22,Iceland,64.9631,-19.0208,206571,0,219,206352
11/6/22,Iceland,64.9631,-19.0208,206571,0,219,206352
11/7/22,Iceland,64.9631,-19.0208,206571,0,219,206352
11/8/22,Iceland,64.9631,-19.0208,206803,0,219,206584
11/9/22,Iceland,64.9631,-19.0208,206803,0,219,206584
11/10/22,Iceland,64.9631,-19.0208,206803,0,219,206584
11/11/22,Iceland,64.9631,-19.0208,206803,0,219,206584
11/12/22,Iceland,64.9631,-19.0208,206803,0,219,206584
11/13/22,Iceland,64.9631,-19.0208,206803,0,219,206584
11/14/22,Iceland,64.9631,-19.0208,206803,0,219,206584
11/15/22,Iceland,64.9631,-19.0208,206803,0,219,206584
11/16/22,Iceland,64.9631,-19.0208,206803,0,219,206584
11/17/22,Iceland,64.9631,-19.0208,206803,0,219,206584
11/18/22,Iceland,64.9631,-19.0208,206803,0,219,206584
11/19/22,Iceland,64.9631,-19.0208,206803,0,219,206584
11/20/22,Iceland,64.9631,-19.0208,206803,0,219,206584
11/21/22,Iceland,64.9631,-19.0208,206803,0,219,206584
11/22/22,Iceland,64.9631,-19.0208,206803,0,219,206584
11/23/22,Iceland,64.9631,-19.0208,206803,0,219,206584
11/24/22,Iceland,64.9631,-19.0208,206803,0,219,206584
11/25/22,Iceland,64.9631,-19.0208,206803,0,219,206584
11/26/22,Iceland,64.9631,-19.0208,206803,0,219,206584
11/27/22,Iceland,64.9631,-19.0208,206803,0,219,206584
11/28/22,Iceland,64.9631,-19.0208,207101,0,219,206882
11/29/22,Iceland,64.9631,-19.0208,207101,0,219,206882
11/30/22,Iceland,64.9631,-19.0208,207101,0,219,206882
12/1/22,Iceland,64.9631,-19.0208,207101,0,219,206882
12/2/22,Iceland,64.9631,-19.0208,207101,0,219,206882
12/3/22,Iceland,64.9631,-19.0208,207101,0,219,206882
12/4/22,Iceland,64.9631,-19.0208,207101,0,219,206882
12/5/22,Iceland,64.9631,-19.0208,207101,0,219,206882
12/6/22,Iceland,64.9631,-19.0208,207101,0,219,206882
12/7/22,Iceland,64.9631,-19.0208,207101,0,219,206882
12/8/22,Iceland,64.9631,-19.0208,207101,0,219,206882
12/9/22,Iceland,64.9631,-19.0208,207101,0,219,206882
12/10/22,Iceland,64.9631,-19.0208,207101,0,219,206882
12/11/22,Iceland,64.9631,-19.0208,207101,0,219,206882
12/12/22,Iceland,64.9631,-19.0208,207101,0,219,206882
12/13/22,Iceland,64.9631,-19.0208,207101,0,219,206882
12/14/22,Iceland,64.9631,-19.0208,207101,0,219,206882
12/15/22,Iceland,64.9631,-19.0208,207101,0,219,206882
12/16/22,Iceland,64.9631,-19.0208,207101,0,219,206882
12/17/22,Iceland,64.9631,-19.0208,207101,0,219,206882
1/1/22,India,20.593684,78.96288,34889132,0,481770,34407362
1/2/22,India,20.593684,78.96288,34922882,0,481893,34440989
1/3/22,India,20.593684,78.96288,34960261,0,482017,34478244
1/4/22,India,20.593684,78.96288,35018358,0,482551,34535807
1/5/22,India,20.593684,78.96288,35109286,0,482876,34626410
1/6/22,India,20.593684,78.96288,35226386,0,483178,34743208
1/7/22,India,20.593684,78.96288,35368372,0,483463,34884909
1/8/22,India,20.593684,78.96288,35528004,0,483790,35044214
1/9/22,India,20.593684,78.96288,35707727,0,483936,35223791
1/10/22,India,20.593684,78.96288,35875790,0,484213,35391577
1/11/22,India,20.593684,78.96288,36070510,0,484655,35585855
1/12/22,India,20.593684,78.96288,36317927,0,485035,35832892
1/13/22,India,20.593684,78.96288,36582129,0,485446,36096683
1/14/22,India,20.593684,78.96288,36850962,0,485752,36365210
1/15/22,India,20.593684,78.96288,37122164,0,486066,36636098
1/16/22,India,20.593684,78.96288,37380253,0,486451,36893802
1/17/22,India,20.593684,78.96288,37618271,0,486761,37131510
1/18/22,India,20.593684,78.96288,37901241,0,487202,37414039
1/19/22,India,20.593684,78.96288,38218773,0,487693,37731080
1/20/22,India,20.593684,78.96288,38566027,0,488396,38077631
1/21/22,India,20.593684,78.96288,38903731,0,488884,38414847
1/22/22,India,20.593684,78.96288,39237264,0,489409,38747855
1/23/22,India,20.593684,78.96288,39543328,0,489848,39053480
1/24/22,India,20.593684,78.96288,39799202,0,490462,39308740
1/25/22,India,20.593684,78.96288,40085116,0,491127,39593989
1/26/22,India,20.593684,78.96288,40371500,0,491700,39879800
1/27/22,India,20.593684,78.96288,40622709,0,492327,40130382
1/28/22,India,20.593684,78.96288,40858241,0,493198,40365043
1/29/22,India,20.593684,78.96288,41092522,0,494091,40598431
1/30/22,India,20.593684,78.96288,41302440,0,495050,40807390
1/31/22,India,20.593684,78.96288,41469499,0,496242,40973257
2/1/22,India,20.593684,78.96288,41630885,0,497975,41132910
2/2/22,India,20.593684,78.96288,41803318,0,498983,41304335
2/3/22,India,20.593684,78.96288,41952712,0,500055,41452657
2/4/22,India,20.593684,78.96288,42080664,0,501114,41579550
2/5/22,India,20.593684,78.96288,42188138,0,501979,41686159
2/6/22,India,20.593684,78.96288,42272014,0,502874,41769140
2/7/22,India,20.593684,78.96288,42339611,0,504062,41835549
2/8/22,India,20.593684,78.96288,42410976,0,505279,41905697
2/9/22,India,20.593684,78.96288,42478060,0,506520,41971540
2/10/22,India,20.593684,78.96288,42536137,0,507177,42028960
2/11/22,India,20.593684,78.96288,42586544,0,507981,42078563
2/12/22,India,20.593684,78.96288,42631421,0,508665,42122756
2/13/22,India,20.593684,78.96288,42665534,0,509011,42156523
2/14/22,India,20.593684,78.96288,42692943,0,509358,42183585
2/15/22,India,20.593684,78.96288,42723558,0,509872,42213686
2/16/22,India,20.593684,78.96288,42754315,0,510413,42243902
2/17/22,India,20.593684,78.96288,42780235,0,510905,42269330
2/18/22,India,20.593684,78.96288,42802505,0,511230,42291275
2/19/22,India,20.593684,78.96288,42822473,0,511903,42310570
2/20/22,India,20.593684,78.96288,42838524,0,512109,42326415
2/21/22,India,20.593684,78.96288,42851929,0,512344,42339585
2/22/22,India,20.593684,78.96288,42867031,0,512622,42354409
2/23/22,India,20.593684,78.96288,42881179,0,512924,42368255
2/24/22,India,20.593684,78.96288,42894345,0,513226,42381119
2/25/22,India,20.593684,78.96288,42905844,0,513481,42392363
2/26/22,India,20.593684,78.96288,42916117,0,513724,42402393
2/27/22,India,20.593684,78.96288,42924130,0,513843,42410287
2/28/22,India,20.593684,78.96288,42931045,0,514023,42417022
3/1/22,India,20.593684,78.96288,42938599,0,514246,42424353
3/2/22,India,20.593684,78.96288,42945160,0,514388,42430772
3/3/22,India,20.593684,78.96288,42951556,0,514589,42436967
3/4/22,India,20.593684,78.96288,42957477,0,514878,42442599
3/5/22,India,20.593684,78.96288,42962953,0,515036,42447917
3/6/22,India,20.593684,78.96288,42967315,0,515102,42452213
3/7/22,India,20.593684,78.96288,42971308,0,515210,42456098
3/8/22,India,20.593684,78.96288,42975883,0,515355,42460528
3/9/22,India,20.593684,78.96288,42980067,0,515459,42464608
3/10/22,India,20.593684,78.96288,42984261,0,515714,42468547
3/11/22,India,20.593684,78.96288,42987875,0,515803,42472072
3/12/22,India,20.593684,78.96288,42990991,0,515850,42475141
3/13/22,India,20.593684,78.96288,42993494,0,515877,42477617
3/14/22,India,20.593684,78.96288,42996062,0,515974,42480088
3/15/22,India,20.593684,78.96288,42998938,0,516072,42482866
3/16/22,India,20.593684,78.96288,43001477,0,516132,42485345
3/17/22,India,20.593684,78.96288,43004005,0,516281,42487724
3/18/22,India,20.593684,78.96288,43006080,0,516352,42489728
3/19/22,India,20.593684,78.96288,43007841,0,516479,42491362
3/20/22,India,20.593684,78.96288,43009390,0,516510,42492880
3/21/22,India,20.593684,78.96288,43010971,0,516543,42494428
3/22/22,India,20.593684,78.96288,43012749,0,516605,42496144
3/23/22,India,20.593684,78.96288,43014687,0,516672,42498015
3/24/22,India,20.593684,78.96288,43016372,0,516755,42499617
3/25/22,India,20.593684,78.96288,43018032,0,520855,42497177
3/26/22,India,20.593684,78.96288,43019453,0,521004,42498449
3/27/22,India,20.593684,78.96288,43020723,0,521035,42499688
3/28/22,India,20.593684,78.96288,43021982,0,521070,42500912
3/29/22,India,20.593684,78.96288,43023215,0,521101,42502114
3/30/22,India,20.593684,78.96288,43024440,0,521129,42503311
3/31/22,India,20.593684,78.96288,43025775,0,521181,42504594
4/1/22,India,20.593684,78.96288,43027035,0,521264,42505771
4/2/22,India,20.593684,78.96288,43028131,0,521345,42506786
4/3/22,India,20.593684,78.96288,43029044,0,521358,42507686
4/4/22,India,20.593684,78.96288,43029839,0,521416,42508423
4/5/22,India,20.593684,78.96288,43030925,0,521487,42509438
4/6/22,India,20.593684,78.96288,43031958,0,521530,42510428
4/7/22,India,20.593684,78.96288,43033067,0,521573,42511494
4/8/22,India,20.593684,78.96288,43034217,0,521656,42512561
4/9/22,India,20.593684,78.96288,43035271,0,521685,42513586
4/10/22,India,20.593684,78.96288,43036132,0,521691,42514441
4/11/22,India,20.593684,78.96288,43036928,0,521710,42515218
4/12/22,India,20.593684,78.96288,43038016,0,521736,42516280
4/13/22,India,20.593684,78.96288,43039023,0,521737,42517286
4/14/22,India,20.593684,78.96288,43039972,0,521743,42518229
4/15/22,India,20.593684,78.96288,43040947,0,521747,42519200
4/16/22,India,20.593684,78.96288,43042097,0,521751,42520346
4/17/22,India,20.593684,78.96288,43044280,0,521965,42522315
4/18/22,India,20.593684,78.96288,43045527,0,521966,42523561
4/19/22,India,20.593684,78.96288,43047594,0,522006,42525588
4/20/22,India,20.593684,78.96288,43049974,0,522062,42527912
4/21/22,India,20.593684,78.96288,43052425,0,522116,42530309
4/22/22,India,20.593684,78.96288,43054952,0,522149,42532803
4/23/22,India,20.593684,78.96288,43057545,0,522193,42535352
4/24/22,India,20.593684,78.96288,43060086,0,522223,42537863
4/25/22,India,20.593684,78.96288,43060097,0,522223,42537874
4/26/22,India,20.593684,78.96288,43065496,0,523654,42541842
4/27/22,India,20.593684,78.96288,43068799,0,523693,42545106
4/28/22,India,20.593684,78.96288,43072176,0,523753,42548423
4/29/22,India,20.593684,78.96288,43075864,0,523803,42552061
4/30/22,India,20.593684,78.96288,43079188,0,523843,42555345
5/1/22,India,20.593684,78.96288,43082345,0,523869,42558476
5/2/22,India,20.593684,78.96288,43084913,0,523889,42561024
5/3/22,India,20.593684,78.96288,43088118,0,523920,42564198
5/4/22,India,20.593684,78.96288,43091393,0,523975,42567418
5/5/22,India,20.593684,78.96288,43094938,0,524002,42570936
5/6/22,India,20.593684,78.96288,43098743,0,524024,42574719
5/7/22,India,20.593684,78.96288,43102194,0,524064,42578130
5/8/22,India,20.593684,78.96288,43105401,0,524093,42581308
5/9/22,India,20.593684,78.96288,43107689,0,524103,42583586
5/10/22,India,20.593684,78.96288,43110586,0,524157,42586429
5/11/22,India,20.593684,78.96288,43113413,0,524181,42589232
5/12/22,India,20.593684,78.96288,43116254,0,524190,42592064
5/13/22,India,20.593684,78.96288,43119112,0,524201,42594911
5/14/22,India,20.593684,78.96288,43121599,0,524214,42597385
5/15/22,India,20.593684,78.96288,43123801,0,524241,42599560
5/16/22,India,20.593684,78.96288,43125370,0,524260,42601110
5/17/22,India,20.593684,78.96288,43127199,0,524293,42602906
5/18/22,India,20.593684,78.96288,43129563,0,524303,42605260
5/19/22,India,20.593684,78.96288,43131822,0,524323,42607499
5/20/22,India,20.593684,78.96288,43134145,0,524348,42609797
5/21/22,India,20.593684,78.96288,43136371,0,524413,42611958
5/22/22,India,20.593684,78.96288,43138393,0,524459,42613934
5/23/22,India,20.593684,78.96288,43140068,0,524490,42615578
5/24/22,India,20.593684,78.96288,43142192,0,524507,42617685
5/25/22,India,20.593684,78.96288,43144820,0,524525,42620295
5/26/22,India,20.593684,78.96288,43147530,0,524539,42622991
5/27/22,India,20.593684,78.96288,43150215,0,524572,42625643
5/28/22,India,20.593684,78.96288,43153043,0,524586,42628457
5/29/22,India,20.593684,78.96288,43155749,0,524611,42631138
5/30/22,India,20.593684,78.96288,43158087,0,524630,42633457
5/31/22,India,20.593684,78.96288,43160832,0,524636,42636196
6/1/22,India,20.593684,78.96288,43164544,0,524641,42639903
6/2/22,India,20.593684,78.96288,43168585,0,524651,42643934
6/3/22,India,20.593684,78.96288,43172547,0,524677,42647870
6/4/22,India,20.593684,78.96288,43176817,0,524692,42652125
6/5/22,India,20.593684,78.96288,43181335,0,524701,42656634
6/6/22,India,20.593684,78.96288,43185049,0,524708,42660341
6/7/22,India,20.593684,78.96288,43190282,0,524715,42665567
6/8/22,India,20.593684,78.96288,43197522,0,524723,42672799
6/9/22,India,20.593684,78.96288,43205106,0,524747,42680359
6/10/22,India,20.593684,78.96288,43213435,0,524757,42688678
6/11/22,India,20.593684,78.96288,43222017,0,524761,42697256
6/12/22,India,20.593684,78.96288,43230101,0,524771,42705330
6/13/22,India,20.593684,78.96288,43236695,0,524777,42711918
6/14/22,India,20.593684,78.96288,43245517,0,524792,42720725
6/15/22,India,20.593684,78.96288,43257730,0,524803,42732927
6/16/22,India,20.593684,78.96288,43270577,0,524817,42745760
6/17/22,India,20.593684,78.96288,43283793,0,524840,42758953
6/18/22,India,20.593684,78.96288,43296692,0,524855,42771837
6/19/22,India,20.593684,78.96288,43309473,0,524873,42784600
6/20/22,India,20.593684,78.96288,43319396,0,524890,42794506
6/21/22,India,20.593684,78.96288,43331645,0,524903,42806742
6/22/22,India,20.593684,78.96288,43344958,0,524941,42820017
6/23/22,India,20.593684,78.96288,43362294,0,524954,42837340
6/24/22,India,20.593684,78.96288,43378234,0,524974,42853260
6/25/22,India,20.593684,78.96288,43389973,0,524999,42864974
6/26/22,India,20.593684,78.96288,43407046,0,525020,42882026
6/27/22,India,20.593684,78.96288,43418839,0,525047,42893792
6/28/22,India,20.593684,78.96288,43433345,0,525077,42908268
6/29/22,India,20.593684,78.96288,43452164,0,525116,42927048
6/30/22,India,20.593684,78.96288,43469234,0,525139,42944095
7/1/22,India,20.593684,78.96288,43486326,0,525168,42961158
7/2/22,India,20.593684,78.96288,43502429,0,525199,42977230
7/3/22,India,20.593684,78.96288,43518564,0,525223,42993341
7/4/22,India,20.593684,78.96288,43531650,0,525242,43006408
7/5/22,India,20.593684,78.96288,43547809,0,525270,43022539
7/6/22,India,20.593684,78.96288,43566739,0,525305,43041434
7/7/22,India,20.593684,78.96288,43585554,0,525343,43060211
7/8/22,India,20.593684,78.96288,43604394,0,525386,43079008
7/9/22,India,20.593684,78.96288,43622651,0,525428,43097223
7/10/22,India,20.593684,78.96288,43639329,0,525454,43113875
7/11/22,India,20.593684,78.96288,43652944,0,525474,43127470
7/12/22,India,20.593684,78.96288,43669850,0,525519,43144331
7/13/22,India,20.593684,78.96288,43689989,0,525557,43164432
7/14/22,India,20.593684,78.96288,43710027,0,525604,43184423
7/15/22,India,20.593684,78.96288,43730071,0,525660,43204411
7/16/22,India,20.593684,78.96288,43750599,0,525709,43224890
7/17/22,India,20.593684,78.96288,43767534,0,525760,43241774
7/18/22,India,20.593684,78.96288,43783062,0,525785,43257277
7/19/22,India,20.593684,78.96288,43801678,0,525821,43275857
7/20/22,India,20.593684,78.96288,43824728,0,525866,43298862
7/21/22,India,20.593684,78.96288,43847065,0,525930,43321135
7/22/22,India,20.593684,78.96288,43868476,0,525997,43342479
7/23/22,India,20.593684,78.96288,43888755,0,526033,43362722
7/24/22,India,20.593684,78.96288,43905621,0,526074,43379547
7/25/22,India,20.593684,78.96288,43920451,0,526110,43394341
7/26/22,India,20.593684,78.96288,43938764,0,526167,43412597
7/27/22,India,20.593684,78.96288,43959321,0,526212,43433109
7/28/22,India,20.593684,78.96288,43979730,0,526258,43453472
7/29/22,India,20.593684,78.96288,44000138,0,526312,43473826
7/30/22,India,20.593684,78.96288,44019811,0,526357,43493454
7/31/22,India,20.593684,78.96288,44036275,0,526396,43509879
8/1/22,India,20.593684,78.96288,44050009,0,526430,43523579
8/2/22,India,20.593684,78.96288,44067144,0,526477,43540667
8/3/22,India,20.593684,78.96288,44087037,0,526530,43560507
8/4/22,India,20.593684,78.96288,44107588,0,526600,43580988
8/5/22,India,20.593684,78.96288,44126994,0,526649,43600345
8/6/22,India,20.593684,78.96288,44145709,0,526689,43619020
8/7/22,India,20.593684,78.96288,44145709,0,526689,43619020
8/8/22,India,20.593684,78.96288,44174650,0,526772,43647878
8/9/22,India,20.593684,78.96288,44190697,0,526826,43663871
8/10/22,India,20.593684,78.96288,44206996,0,526879,43680117
8/11/22,India,20.593684,78.96288,44223557,0,526928,43696629
8/12/22,India,20.593684,78.96288,44239372,0,526996,43712376
8/13/22,India,20.593684,78.96288,44253464,0,527037,43726427
8/14/22,India,20.593684,78.96288,44268381,0,527069,43741312
8/15/22,India,20.593684,78.96288,44277711,0,527098,43750613
8/16/22,India,20.593684,78.96288,44286256,0,527134,43759122
8/17/22,India,20.593684,78.96288,44298864,0,527206,43771658
8/18/22,India,20.593684,78.96288,44314618,0,527253,43787365
8/19/22,India,20.593684,78.96288,44327890,0,527289,43800601
8/20/22,India,20.593684,78.96288,44339429,0,527332,43812097
8/21/22,India,20.593684,78.96288,44348960,0,527368,43821592
8/22/22,India,20.593684,78.96288,44357546,0,527416,43830130
8/23/22,India,20.593684,78.96288,44368195,0,527452,43840743
8/24/22,India,20.593684,78.96288,44378920,0,527488,43851432
8/25/22,India,20.593684,78.96288,44389176,0,527556,43861620
8/26/22,India,20.593684,78.96288,44398696,0,527597,43871099
8/27/22,India,20.593684,78.96288,44408132,0,527754,43880378
8/28/22,India,20.593684,78.96288,44415723,0,527799,43887924
8/29/22,India,20.593684,78.96288,44415723,0,527799,43887924
8/30/22,India,20.593684,78.96288,44415723,0,527799,43887924
8/31/22,India,20.593684,78.96288,44436339,0,527911,43908428
9/1/22,India,20.593684,78.96288,44442507,0,527932,43914575
9/2/22,India,20.593684,78.96288,44449726,0,527965,43921761
9/3/22,India,20.593684,78.96288,44456535,0,527991,43928544
9/4/22,India,20.593684,78.96288,44462445,0,528007,43934438
9/5/22,India,20.593684,78.96288,44466862,0,528030,43938832
9/6/22,India,20.593684,78.96288,44469661,0,528057,43941604
9/7/22,India,20.593684,78.96288,44478636,0,528090,43950546
9/8/22,India,20.593684,78.96288,44484729,0,528121,43956608
9/9/22,India,20.593684,78.96288,44490283,0,528139,43962144
9/10/22,India,20.593684,78.96288,44495359,0,528150,43967209
9/11/22,India,20.593684,78.96288,44500580,0,528165,43972415
9/12/22,India,20.593684,78.96288,44502363,0,528185,43974178
9/13/22,India,20.593684,78.96288,44510057,0,528216,43981841
9/14/22,India,20.593684,78.96288,44516479,0,528250,43988229
9/15/22,India,20.593684,78.96288,44522777,0,528273,43994504
9/16/22,India,20.593684,78.96288,44528524,0,528302,44000222
9/17/22,India,20.593684,78.96288,44534188,0,528337,44005851
9/18/22,India,20.593684,78.96288,44539046,0,528355,44010691
9/19/22,India,20.593684,78.96288,44543089,0,528370,44014719
9/20/22,India,20.593684,78.96288,44545011,0,528403,44016608
9/21/22,India,20.593684,78.96288,44553042,0,528429,44024613
9/22/22,India,20.593684,78.96288,44558425,0,528449,44029976
9/23/22,India,20.593684,78.96288,44563337,0,528487,44034850
9/24/22,India,20.593684,78.96288,44568114,0,528510,44039604
9/25/22,India,20.593684,78.96288,44572243,0,528530,44043713
9/26/22,India,20.593684,78.96288,44575473,0,528562,44046911
9/27/22,India,20.593684,78.96288,44579088,0,528584,44050504
9/28/22,India,20.593684,78.96288,44583360,0,528611,44054749
9/29/22,India,20.593684,78.96288,44587307,0,528629,44058678
9/30/22,India,20.593684,78.96288,44591112,0,528655,44062457
10/1/22,India,20.593684,78.96288,44594487,0,528673,44065814
10/2/22,India,20.593684,78.96288,44597498,0,528701,44068797
10/3/22,India,20.593684,78.96288,44599466,0,528716,44070750
10/4/22,India,20.593684,78.96288,44601892,0,528733,44073159
10/5/22,India,20.593684,78.96288,44604463,0,528745,44075718
10/6/22,India,20.593684,78.96288,44606460,0,528754,44077706
10/7/22,India,20.593684,78.96288,44609257,0,528778,44080479
10/8/22,India,20.593684,78.96288,44612013,0,528799,44083214
10/9/22,India,20.593684,78.96288,44614437,0,528814,44085623
10/10/22,India,20.593684,78.96288,44616394,0,528822,44087572
10/11/22,India,20.593684,78.96288,44616235,0,528835,44087400
10/12/22,India,20.593684,78.96288,44621319,0,528847,44092472
10/13/22,India,20.593684,78.96288,44623997,0,528857,44095140
10/14/22,India,20.593684,78.96288,44626427,0,528874,44097553
10/15/22,India,20.593684,78.96288,44628828,0,528895,44099933
10/16/22,India,20.593684,78.96288,44630888,0,528905,44101983
10/17/22,India,20.593684,78.96288,44632430,0,528913,44103517
10/18/22,India,20.593684,78.96288,44634376,0,528923,44105453
10/19/22,India,20.593684,78.96288,44636517,0,528943,44107574
10/20/22,India,20.593684,78.96288,44638636,0,528953,44109683
10/21/22,India,20.593684,78.96288,44640748,0,528957,44111791
10/22/22,India,20.593684,78.96288,44642742,0,528961,44113781
10/23/22,India,20.593684,78.96288,44644076,0,528977,44115099
10/24/22,India,20.593684,78.96288,44644938,0,528980,44115958
10/25/22,India,20.593684,78.96288,44645768,0,528981,44116787
10/26/22,India,20.593684,78.96288,44646880,0,528987,44117893
10/27/22,India,20.593684,78.96288,44649088,0,528999,44120089
10/28/22,India,20.593684,78.96288,44650662,0,529008,44121654
10/29/22,India,20.593684,78.96288,44652256,0,529016,44123240
10/30/22,India,20.593684,78.96288,44653592,0,529024,44124568
10/31/22,India,20.593684,78.96288,44654638,0,529077,44125561
11/1/22,India,20.593684,78.96288,44655828,0,530452,44125376
11/2/22,India,20.593684,78.96288,44655926,0,530461,44125465
11/3/22,India,20.593684,78.96288,44658365,0,530479,44127886
11/4/22,India,20.593684,78.96288,44659447,0,530486,44128961
11/5/22,India,20.593684,78.96288,44660579,0,530500,44130079
11/6/22,India,20.593684,78.96288,44661504,0,530509,44130995
11/7/22,India,20.593684,78.96288,44660293,0,530509,44129784
11/8/22,India,20.593684,78.96288,44660293,0,530509,44129784
11/9/22,India,20.593684,78.96288,44660293,0,530509,44129784
11/10/22,India,20.593684,78.96288,44664810,0,530520,44134290
11/11/22,India,20.593684,78.96288,44665643,0,530528,44135115
11/12/22,India,20.593684,78.96288,44666372,0,530531,44135841
11/13/22,India,20.593684,78.96288,44666924,0,530532,44136392
11/14/22,India,20.593684,78.96288,44667390,0,530533,44136857
11/15/22,India,20.593684,78.96288,44667900,0,530535,44137365
11/16/22,India,20.593684,78.96288,44668535,0,530546,44137989
11/17/22,India,20.593684,78.96288,44667967,0,530553,44137414
11/18/22,India,20.593684,78.96288,44669748,0,530570,44139178
11/19/22,India,20.593684,78.96288,44670240,0,530574,44139666
11/20/22,India,20.593684,78.96288,44670646,0,530586,44140060
11/21/22,India,20.593684,78.96288,44670940,0,530591,44140349
11/22/22,India,20.593684,78.96288,44671300,0,530596,44140704
11/23/22,India,20.593684,78.96288,44671708,0,530601,44141107
11/24/22,India,20.593684,78.96288,44672048,0,530604,44141444
11/25/22,India,20.593684,78.96288,44672442,0,530608,44141834
11/26/22,India,20.593684,78.96288,44672787,0,530612,44142175
11/27/22,India,20.593684,78.96288,44673078,0,530614,44142464
11/28/22,India,20.593684,78.96288,44673293,0,530615,44142678
11/29/22,India,20.593684,78.96288,44673567,0,530620,44142947
11/30/22,India,20.593684,78.96288,44673863,0,530622,44143241
12/1/22,India,20.593684,78.96288,44674138,0,530624,44143514
12/2/22,India,20.593684,78.96288,44674390,0,530627,44143763
12/3/22,India,20.593684,78.96288,44674616,0,530628,44143988
12/4/22,India,20.593684,78.96288,44674842,0,530630,44144212
12/5/22,India,20.593684,78.96288,44675006,0,530633,44144373
12/6/22,India,20.593684,78.96288,44675172,0,530638,44144534
12/7/22,India,20.593684,78.96288,44675413,0,530647,44144766
12/8/22,India,20.593684,78.96288,44675662,0,530653,44145009
12/9/22,India,20.593684,78.96288,44675872,0,530654,44145218
12/10/22,India,20.593684,78.96288,44676045,0,530658,44145387
12/11/22,India,20.593684,78.96288,44676045,0,530658,44145387
12/12/22,India,20.593684,78.96288,44676318,0,530658,44145660
12/13/22,India,20.593684,78.96288,44676470,0,530658,44145812
12/14/22,India,20.593684,78.96288,44676670,0,530663,44146007
12/15/22,India,20.593684,78.96288,44676832,0,530663,44146169
12/16/22,India,20.593684,78.96288,44676999,0,530667,44146332
12/17/22,India,20.593684,78.96288,44677175,0,530672,44146503
1/1/22,Indonesia,-0.7893,113.9213,4262994,0,144096,4118898
1/2/22,Indonesia,-0.7893,113.9213,4263168,0,144097,4119071
1/3/22,Indonesia,-0.7893,113.9213,4263433,0,144102,4119331
1/4/22,Indonesia,-0.7893,113.9213,4263732,0,144105,4119627
1/5/22,Indonesia,-0.7893,113.9213,4264136,0,144109,4120027
1/6/22,Indonesia,-0.7893,113.9213,4264669,0,144116,4120553
1/7/22,Indonesia,-0.7893,113.9213,4265187,0,144121,4121066
1/8/22,Indonesia,-0.7893,113.9213,4265666,0,144127,4121539
1/9/22,Indonesia,-0.7893,113.9213,4266195,0,144129,4122066
1/10/22,Indonesia,-0.7893,113.9213,4266649,0,144136,4122513
1/11/22,Indonesia,-0.7893,113.9213,4267451,0,144144,4123307
1/12/22,Indonesia,-0.7893,113.9213,4268097,0,144150,4123947
1/13/22,Indonesia,-0.7893,113.9213,4268890,0,144155,4124735
1/14/22,Indonesia,-0.7893,113.9213,4269740,0,144163,4125577
1/15/22,Indonesia,-0.7893,113.9213,4270794,0,144167,4126627
1/16/22,Indonesia,-0.7893,113.9213,4271649,0,144170,4127479
1/17/22,Indonesia,-0.7893,113.9213,4272421,0,144174,4128247
1/18/22,Indonesia,-0.7893,113.9213,4273783,0,144183,4129600
1/19/22,Indonesia,-0.7893,113.9213,4275528,0,144192,4131336
1/20/22,Indonesia,-0.7893,113.9213,4277644,0,144199,4133445
1/21/22,Indonesia,-0.7893,113.9213,4280248,0,144201,4136047
1/22/22,Indonesia,-0.7893,113.9213,4283453,0,144206,4139247
1/23/22,Indonesia,-0.7893,113.9213,4286378,0,144220,4142158
1/24/22,Indonesia,-0.7893,113.9213,4289305,0,144227,4145078
1/25/22,Indonesia,-0.7893,113.9213,4294183,0,144247,4149936
1/26/22,Indonesia,-0.7893,113.9213,4301193,0,144254,4156939
1/27/22,Indonesia,-0.7893,113.9213,4309270,0,144261,4165009
1/28/22,Indonesia,-0.7893,113.9213,4319175,0,144268,4174907
1/29/22,Indonesia,-0.7893,113.9213,4330763,0,144285,4186478
1/30/22,Indonesia,-0.7893,113.9213,4343185,0,144303,4198882
1/31/22,Indonesia,-0.7893,113.9213,4353370,0,144320,4209050
2/1/22,Indonesia,-0.7893,113.9213,4369391,0,144348,4225043
2/2/22,Indonesia,-0.7893,113.9213,4387286,0,144373,4242913
2/3/22,Indonesia,-0.7893,113.9213,4414483,0,144411,4270072
2/4/22,Indonesia,-0.7893,113.9213,4446694,0,144453,4302241
2/5/22,Indonesia,-0.7893,113.9213,4480423,0,144497,4335926
2/6/22,Indonesia,-0.7893,113.9213,4516480,0,144554,4371926
2/7/22,Indonesia,-0.7893,113.9213,4542601,0,144636,4397965
2/8/22,Indonesia,-0.7893,113.9213,4580093,0,144719,4435374
2/9/22,Indonesia,-0.7893,113.9213,4626936,0,144784,4482152
2/10/22,Indonesia,-0.7893,113.9213,4667554,0,144858,4522696
2/11/22,Indonesia,-0.7893,113.9213,4708043,0,144958,4563085
2/12/22,Indonesia,-0.7893,113.9213,4763252,0,145065,4618187
2/13/22,Indonesia,-0.7893,113.9213,4807778,0,145176,4662602
2/14/22,Indonesia,-0.7893,113.9213,4844279,0,145321,4698958
2/15/22,Indonesia,-0.7893,113.9213,4901328,0,145455,4755873
2/16/22,Indonesia,-0.7893,113.9213,4966046,0,145622,4820424
2/17/22,Indonesia,-0.7893,113.9213,5030002,0,145828,4884174
2/18/22,Indonesia,-0.7893,113.9213,5089637,0,146044,4943593
2/19/22,Indonesia,-0.7893,113.9213,5149021,0,146202,5002819
2/20/22,Indonesia,-0.7893,113.9213,5197505,0,146365,5051140
2/21/22,Indonesia,-0.7893,113.9213,5231923,0,146541,5085382
2/22/22,Indonesia,-0.7893,113.9213,5289414,0,146798,5142616
2/23/22,Indonesia,-0.7893,113.9213,5350902,0,147025,5203877
2/24/22,Indonesia,-0.7893,113.9213,5408328,0,147342,5260986
2/25/22,Indonesia,-0.7893,113.9213,5457775,0,147586,5310189
2/26/22,Indonesia,-0.7893,113.9213,5504418,0,147844,5356574
2/27/22,Indonesia,-0.7893,113.9213,5539394,0,148073,5391321
2/28/22,Indonesia,-0.7893,113.9213,5564448,0,148335,5416113
3/1/22,Indonesia,-0.7893,113.9213,5589176,0,148660,5440516
3/2/22,Indonesia,-0.7893,113.9213,5630096,0,149036,5481060
3/3/22,Indonesia,-0.7893,113.9213,5667355,0,149268,5518087
3/4/22,Indonesia,-0.7893,113.9213,5693702,0,149596,5544106
3/5/22,Indonesia,-0.7893,113.9213,5723858,0,149918,5573940
3/6/22,Indonesia,-0.7893,113.9213,5748725,0,150172,5598553
3/7/22,Indonesia,-0.7893,113.9213,5770105,0,150430,5619675
3/8/22,Indonesia,-0.7893,113.9213,5800253,0,150831,5649422
3/9/22,Indonesia,-0.7893,113.9213,5826589,0,151135,5675454
3/10/22,Indonesia,-0.7893,113.9213,5847900,0,151413,5696487
3/11/22,Indonesia,-0.7893,113.9213,5864010,0,151703,5712307
3/12/22,Indonesia,-0.7893,113.9213,5878910,0,151951,5726959
3/13/22,Indonesia,-0.7893,113.9213,5890495,0,152166,5738329
3/14/22,Indonesia,-0.7893,113.9213,5900124,0,152437,5747687
3/15/22,Indonesia,-0.7893,113.9213,5914532,0,152745,5761787
3/16/22,Indonesia,-0.7893,113.9213,5927550,0,152975,5774575
3/17/22,Indonesia,-0.7893,113.9213,5939082,0,153212,5785870
3/18/22,Indonesia,-0.7893,113.9213,5948610,0,153411,5795199
3/19/22,Indonesia,-0.7893,113.9213,5956561,0,153599,5802962
3/20/22,Indonesia,-0.7893,113.9213,5962483,0,153738,5808745
3/21/22,Indonesia,-0.7893,113.9213,5967182,0,153892,5813290
3/22/22,Indonesia,-0.7893,113.9213,5974646,0,154062,5820584
3/23/22,Indonesia,-0.7893,113.9213,5981022,0,154221,5826801
3/24/22,Indonesia,-0.7893,113.9213,5986830,0,154343,5832487
3/25/22,Indonesia,-0.7893,113.9213,5986830,0,154343,5832487
3/26/22,Indonesia,-0.7893,113.9213,5986830,0,154343,5832487
3/27/22,Indonesia,-0.7893,113.9213,5995876,0,154570,5841306
3/28/22,Indonesia,-0.7893,113.9213,6001751,0,154774,5846977
3/29/22,Indonesia,-0.7893,113.9213,6005646,0,154882,5850764
3/30/22,Indonesia,-0.7893,113.9213,6009486,0,155000,5854486
3/31/22,Indonesia,-0.7893,113.9213,6012818,0,155089,5857729
4/1/22,Indonesia,-0.7893,113.9213,6015748,0,155164,5860584
4/2/22,Indonesia,-0.7893,113.9213,6015748,0,155164,5860584
4/3/22,Indonesia,-0.7893,113.9213,6015748,0,155164,5860584
4/4/22,Indonesia,-0.7893,113.9213,6015748,0,155164,5860584
4/5/22,Indonesia,-0.7893,113.9213,6023924,0,155421,5868503
4/6/22,Indonesia,-0.7893,113.9213,6026324,0,155464,5870860
4/7/22,Indonesia,-0.7893,113.9213,6028413,0,155509,5872904
4/8/22,Indonesia,-0.7893,113.9213,6030168,0,155556,5874612
4/9/22,Indonesia,-0.7893,113.9213,6031636,0,155597,5876039
4/10/22,Indonesia,-0.7893,113.9213,6032707,0,155626,5877081
4/11/22,Indonesia,-0.7893,113.9213,6033903,0,155674,5878229
4/12/22,Indonesia,-0.7893,113.9213,6035358,0,155717,5879641
4/13/22,Indonesia,-0.7893,113.9213,6036909,0,155746,5881163
4/14/22,Indonesia,-0.7893,113.9213,6037742,0,155794,5881948
4/15/22,Indonesia,-0.7893,113.9213,6038664,0,155820,5882844
4/16/22,Indonesia,-0.7893,113.9213,6039266,0,155844,5883422
4/17/22,Indonesia,-0.7893,113.9213,6039873,0,155866,5884007
4/18/22,Indonesia,-0.7893,113.9213,6040432,0,155903,5884529
4/19/22,Indonesia,-0.7893,113.9213,6041269,0,155937,5885332
4/20/22,Indonesia,-0.7893,113.9213,6041269,0,155937,5885332
4/21/22,Indonesia,-0.7893,113.9213,6042595,0,156015,5886580
4/22/22,Indonesia,-0.7893,113.9213,6043246,0,156040,5887206
4/23/22,Indonesia,-0.7893,113.9213,6043768,0,156067,5887701
4/24/22,Indonesia,-0.7893,113.9213,6044150,0,156100,5888050
4/25/22,Indonesia,-0.7893,113.9213,6044467,0,156133,5888334
4/26/22,Indonesia,-0.7893,113.9213,6045043,0,156163,5888880
4/27/22,Indonesia,-0.7893,113.9213,6045660,0,156199,5889461
4/28/22,Indonesia,-0.7893,113.9213,6046072,0,156217,5889855
4/29/22,Indonesia,-0.7893,113.9213,6046467,0,156240,5890227
4/30/22,Indonesia,-0.7893,113.9213,6046796,0,156257,5890539
5/1/22,Indonesia,-0.7893,113.9213,6047040,0,156273,5890767
5/2/22,Indonesia,-0.7893,113.9213,6047208,0,156287,5890921
5/3/22,Indonesia,-0.7893,113.9213,6047315,0,156305,5891010
5/4/22,Indonesia,-0.7893,113.9213,6047491,0,156321,5891170
5/5/22,Indonesia,-0.7893,113.9213,6047741,0,156340,5891401
5/6/22,Indonesia,-0.7893,113.9213,6047986,0,156357,5891629
5/7/22,Indonesia,-0.7893,113.9213,6048204,0,156371,5891833
5/8/22,Indonesia,-0.7893,113.9213,6048431,0,156381,5892050
5/9/22,Indonesia,-0.7893,113.9213,6048685,0,156396,5892289
5/10/22,Indonesia,-0.7893,113.9213,6048685,0,156396,5892289
5/11/22,Indonesia,-0.7893,113.9213,6048685,0,156396,5892289
5/12/22,Indonesia,-0.7893,113.9213,6049876,0,156438,5893438
5/13/22,Indonesia,-0.7893,113.9213,6050211,0,156448,5893763
5/14/22,Indonesia,-0.7893,113.9213,6050519,0,156453,5894066
5/15/22,Indonesia,-0.7893,113.9213,6050776,0,156458,5894318
5/16/22,Indonesia,-0.7893,113.9213,6050958,0,156464,5894494
5/17/22,Indonesia,-0.7893,113.9213,6051205,0,156481,5894724
5/18/22,Indonesia,-0.7893,113.9213,6051532,0,156498,5895034
5/19/22,Indonesia,-0.7893,113.9213,6051850,0,156510,5895340
5/20/22,Indonesia,-0.7893,113.9213,6052100,0,156513,5895587
5/21/22,Indonesia,-0.7893,113.9213,6052363,0,156519,5895844
5/22/22,Indonesia,-0.7893,113.9213,6052590,0,156522,5896068
5/23/22,Indonesia,-0.7893,113.9213,6052764,0,156534,5896230
5/24/22,Indonesia,-0.7893,113.9213,6053109,0,156548,5896561
5/25/22,Indonesia,-0.7893,113.9213,6053424,0,156553,5896871
5/26/22,Indonesia,-0.7893,113.9213,6053670,0,156556,5897114
5/27/22,Indonesia,-0.7893,113.9213,6053894,0,156565,5897329
5/28/22,Indonesia,-0.7893,113.9213,6054173,0,156573,5897600
5/29/22,Indonesia,-0.7893,113.9213,6054415,0,156574,5897841
5/30/22,Indonesia,-0.7893,113.9213,6054633,0,156586,5898047
5/31/22,Indonesia,-0.7893,113.9213,6054973,0,156591,5898382
6/1/22,Indonesia,-0.7893,113.9213,6055341,0,156594,5898747
6/2/22,Indonesia,-0.7893,113.9213,6055645,0,156600,5899045
6/3/22,Indonesia,-0.7893,113.9213,6056017,0,156604,5899413
6/4/22,Indonesia,-0.7893,113.9213,6056412,0,156610,5899802
6/5/22,Indonesia,-0.7893,113.9213,6056800,0,156615,5900185
6/6/22,Indonesia,-0.7893,113.9213,6057142,0,156622,5900520
6/7/22,Indonesia,-0.7893,113.9213,6057660,0,156624,5901036
6/8/22,Indonesia,-0.7893,113.9213,6058180,0,156628,5901552
6/9/22,Indonesia,-0.7893,113.9213,6058736,0,156635,5902101
6/10/22,Indonesia,-0.7893,113.9213,6059363,0,156638,5902725
6/11/22,Indonesia,-0.7893,113.9213,6059937,0,156641,5903296
6/12/22,Indonesia,-0.7893,113.9213,6060488,0,156643,5903845
6/13/22,Indonesia,-0.7893,113.9213,6061079,0,156652,5904427
6/14/22,Indonesia,-0.7893,113.9213,6062009,0,156662,5905347
6/15/22,Indonesia,-0.7893,113.9213,6063251,0,156670,5906581
6/16/22,Indonesia,-0.7893,113.9213,6064424,0,156673,5907751
6/17/22,Indonesia,-0.7893,113.9213,6065644,0,156679,5908965
6/18/22,Indonesia,-0.7893,113.9213,6066908,0,156684,5910224
6/19/22,Indonesia,-0.7893,113.9213,6068075,0,156687,5911388
6/20/22,Indonesia,-0.7893,113.9213,6069255,0,156695,5912560
6/21/22,Indonesia,-0.7893,113.9213,6070933,0,156700,5914233
6/22/22,Indonesia,-0.7893,113.9213,6072918,0,156702,5916216
6/23/22,Indonesia,-0.7893,113.9213,6074825,0,156706,5918119
6/24/22,Indonesia,-0.7893,113.9213,6076894,0,156711,5920183
6/25/22,Indonesia,-0.7893,113.9213,6078725,0,156714,5922011
6/26/22,Indonesia,-0.7893,113.9213,6080451,0,156717,5923734
6/27/22,Indonesia,-0.7893,113.9213,6081896,0,156726,5925170
6/28/22,Indonesia,-0.7893,113.9213,6084063,0,156728,5927335
6/29/22,Indonesia,-0.7893,113.9213,6086212,0,156731,5929481
6/30/22,Indonesia,-0.7893,113.9213,6088460,0,156737,5931723
7/1/22,Indonesia,-0.7893,113.9213,6090509,0,156740,5933769
7/2/22,Indonesia,-0.7893,113.9213,6092303,0,156745,5935558
7/3/22,Indonesia,-0.7893,113.9213,6093917,0,156749,5937168
7/4/22,Indonesia,-0.7893,113.9213,6095351,0,156758,5938593
7/5/22,Indonesia,-0.7893,113.9213,6097928,0,156766,5941162
7/6/22,Indonesia,-0.7893,113.9213,6100671,0,156770,5943901
7/7/22,Indonesia,-0.7893,113.9213,6103552,0,156776,5946776
7/8/22,Indonesia,-0.7893,113.9213,6106024,0,156781,5949243
7/9/22,Indonesia,-0.7893,113.9213,6108729,0,156785,5951944
7/10/22,Indonesia,-0.7893,113.9213,6111305,0,156791,5954514
7/11/22,Indonesia,-0.7893,113.9213,6112986,0,156798,5956188
7/12/22,Indonesia,-0.7893,113.9213,6116347,0,156806,5959541
7/13/22,Indonesia,-0.7893,113.9213,6120169,0,156818,5963351
7/14/22,Indonesia,-0.7893,113.9213,6123753,0,156827,5966926
7/15/22,Indonesia,-0.7893,113.9213,6127084,0,156833,5970251
7/16/22,Indonesia,-0.7893,113.9213,6131413,0,156839,5974574
7/17/22,Indonesia,-0.7893,113.9213,6134953,0,156849,5978104
7/18/22,Indonesia,-0.7893,113.9213,6138346,0,156859,5981487
7/19/22,Indonesia,-0.7893,113.9213,6143431,0,156865,5986566
7/20/22,Indonesia,-0.7893,113.9213,6149084,0,156875,5992209
7/21/22,Indonesia,-0.7893,113.9213,6154494,0,156880,5997614
7/22/22,Indonesia,-0.7893,113.9213,6159328,0,156893,6002435
7/23/22,Indonesia,-0.7893,113.9213,6164271,0,156902,6007369
7/24/22,Indonesia,-0.7893,113.9213,6168342,0,156902,6011440
7/25/22,Indonesia,-0.7893,113.9213,6172390,0,156916,6015474
7/26/22,Indonesia,-0.7893,113.9213,6178873,0,156929,6021944
7/27/22,Indonesia,-0.7893,113.9213,6185311,0,156940,6028371
7/28/22,Indonesia,-0.7893,113.9213,6191664,0,156957,6034707
7/29/22,Indonesia,-0.7893,113.9213,6197495,0,156970,6040525
7/30/22,Indonesia,-0.7893,113.9213,6202893,0,156983,6045910
7/31/22,Indonesia,-0.7893,113.9213,6207098,0,156993,6050105
8/1/22,Indonesia,-0.7893,113.9213,6210794,0,157004,6053790
8/2/22,Indonesia,-0.7893,113.9213,6216621,0,157028,6059593
8/3/22,Indonesia,-0.7893,113.9213,6222788,0,157046,6065742
8/4/22,Indonesia,-0.7893,113.9213,6229315,0,157060,6072255
8/5/22,Indonesia,-0.7893,113.9213,6235244,0,157072,6078172
8/6/22,Indonesia,-0.7893,113.9213,6240699,0,157082,6083617
8/7/22,Indonesia,-0.7893,113.9213,6244978,0,157095,6087883
8/8/22,Indonesia,-0.7893,113.9213,6249403,0,157113,6092290
8/9/22,Indonesia,-0.7893,113.9213,6255679,0,157131,6098548
8/10/22,Indonesia,-0.7893,113.9213,6261605,0,157149,6104456
8/11/22,Indonesia,-0.7893,113.9213,6267137,0,157171,6109966
8/12/22,Indonesia,-0.7893,113.9213,6273228,0,157189,6116039
8/13/22,Indonesia,-0.7893,113.9213,6278332,0,157208,6121124
8/14/22,Indonesia,-0.7893,113.9213,6282774,0,157226,6125548
8/15/22,Indonesia,-0.7893,113.9213,6286362,0,157252,6129110
8/16/22,Indonesia,-0.7893,113.9213,6292231,0,157277,6134954
8/17/22,Indonesia,-0.7893,113.9213,6297484,0,157296,6140188
8/18/22,Indonesia,-0.7893,113.9213,6301523,0,157317,6144206
8/19/22,Indonesia,-0.7893,113.9213,6306686,0,157343,6149343
8/20/22,Indonesia,-0.7893,113.9213,6311608,0,157365,6154243
8/21/22,Indonesia,-0.7893,113.9213,6315557,0,157377,6158180
8/22/22,Indonesia,-0.7893,113.9213,6318857,0,157396,6161461
8/23/22,Indonesia,-0.7893,113.9213,6323715,0,157420,6166295
8/24/22,Indonesia,-0.7893,113.9213,6329143,0,157438,6171705
8/25/22,Indonesia,-0.7893,113.9213,6334357,0,157457,6176900
8/26/22,Indonesia,-0.7893,113.9213,6338906,0,157478,6181428
8/27/22,Indonesia,-0.7893,113.9213,6343076,0,157493,6185583
8/28/22,Indonesia,-0.7893,113.9213,6346304,0,157500,6188804
8/29/22,Indonesia,-0.7893,113.9213,6349175,0,157521,6191654
8/30/22,Indonesia,-0.7893,113.9213,6354245,0,157541,6196704
8/31/22,Indonesia,-0.7893,113.9213,6358808,0,157566,6201242
9/1/22,Indonesia,-0.7893,113.9213,6362902,0,157591,6205311
9/2/22,Indonesia,-0.7893,113.9213,6366518,0,157608,6208910
9/3/22,Indonesia,-0.7893,113.9213,6369778,0,157631,6212147
9/4/22,Indonesia,-0.7893,113.9213,6372542,0,157647,6214895
9/5/22,Indonesia,-0.7893,113.9213,6374882,0,157668,6217214
9/6/22,Indonesia,-0.7893,113.9213,6378489,0,157696,6220793
9/7/22,Indonesia,-0.7893,113.9213,6382002,0,157717,6224285
9/8/22,Indonesia,-0.7893,113.9213,6385140,0,157729,6227411
9/9/22,Indonesia,-0.7893,113.9213,6387944,0,157741,6230203
9/10/22,Indonesia,-0.7893,113.9213,6390553,0,157757,6232796
9/11/22,Indonesia,-0.7893,113.9213,6392492,0,157770,6234722
9/12/22,Indonesia,-0.7893,113.9213,6394340,0,157787,6236553
9/13/22,Indonesia,-0.7893,113.9213,6397236,0,157807,6239429
9/14/22,Indonesia,-0.7893,113.9213,6400035,0,157828,6242207
9/15/22,Indonesia,-0.7893,113.9213,6402686,0,157849,6244837
9/16/22,Indonesia,-0.7893,113.9213,6405044,0,157876,6247168
9/17/22,Indonesia,-0.7893,113.9213,6407123,0,157884,6249239
9/18/22,Indonesia,-0.7893,113.9213,6408806,0,157892,6250914
9/19/22,Indonesia,-0.7893,113.9213,6410426,0,157915,6252511
9/20/22,Indonesia,-0.7893,113.9213,6412944,0,157930,6255014
9/21/22,Indonesia,-0.7893,113.9213,6415328,0,157948,6257380
9/22/22,Indonesia,-0.7893,113.9213,6417490,0,157966,6259524
9/23/22,Indonesia,-0.7893,113.9213,6419394,0,157986,6261408
9/24/22,Indonesia,-0.7893,113.9213,6421118,0,157998,6263120
9/25/22,Indonesia,-0.7893,113.9213,6422529,0,158014,6264515
9/26/22,Indonesia,-0.7893,113.9213,6423873,0,158036,6265837
9/27/22,Indonesia,-0.7893,113.9213,6425849,0,158057,6267792
9/28/22,Indonesia,-0.7893,113.9213,6427764,0,158076,6269688
9/29/22,Indonesia,-0.7893,113.9213,6429767,0,158093,6271674
9/30/22,Indonesia,-0.7893,113.9213,6431624,0,158112,6273512
10/1/22,Indonesia,-0.7893,113.9213,6433263,0,158122,6275141
10/2/22,Indonesia,-0.7893,113.9213,6434585,0,158132,6276453
10/3/22,Indonesia,-0.7893,113.9213,6435719,0,158143,6277576
10/4/22,Indonesia,-0.7893,113.9213,6437750,0,158156,6279594
10/5/22,Indonesia,-0.7893,113.9213,6439292,0,158165,6281127
10/6/22,Indonesia,-0.7893,113.9213,6441123,0,158177,6282946
10/7/22,Indonesia,-0.7893,113.9213,6442624,0,158192,6284432
10/8/22,Indonesia,-0.7893,113.9213,6443949,0,158198,6285751
10/9/22,Indonesia,-0.7893,113.9213,6444948,0,158205,6286743
10/10/22,Indonesia,-0.7893,113.9213,6446143,0,158219,6287924
10/11/22,Indonesia,-0.7893,113.9213,6448220,0,158235,6289985
10/12/22,Indonesia,-0.7893,113.9213,6450248,0,158249,6291999
10/13/22,Indonesia,-0.7893,113.9213,6452078,0,158263,6293815
10/14/22,Indonesia,-0.7893,113.9213,6453864,0,158281,6295583
10/15/22,Indonesia,-0.7893,113.9213,6455542,0,158301,6297241
10/16/22,Indonesia,-0.7893,113.9213,6456868,0,158313,6298555
10/17/22,Indonesia,-0.7893,113.9213,6458101,0,158327,6299774
10/18/22,Indonesia,-0.7893,113.9213,6460265,0,158345,6301920
10/19/22,Indonesia,-0.7893,113.9213,6462655,0,158361,6304294
10/20/22,Indonesia,-0.7893,113.9213,6464962,0,158380,6306582
10/21/22,Indonesia,-0.7893,113.9213,6467189,0,158398,6308791
10/22/22,Indonesia,-0.7893,113.9213,6469276,0,158416,6310860
10/23/22,Indonesia,-0.7893,113.9213,6470961,0,158429,6312532
10/24/22,Indonesia,-0.7893,113.9213,6472664,0,158454,6314210
10/25/22,Indonesia,-0.7893,113.9213,6475672,0,158475,6317197
10/26/22,Indonesia,-0.7893,113.9213,6478720,0,158499,6320221
10/27/22,Indonesia,-0.7893,113.9213,6481749,0,158522,6323227
10/28/22,Indonesia,-0.7893,113.9213,6484764,0,158544,6326220
10/29/22,Indonesia,-0.7893,113.9213,6487905,0,158571,6329334
10/30/22,Indonesia,-0.7893,113.9213,6490622,0,158597,6332025
10/31/22,Indonesia,-0.7893,113.9213,6493079,0,158631,6334448
11/1/22,Indonesia,-0.7893,113.9213,6497786,0,158663,6339123
11/2/22,Indonesia,-0.7893,113.9213,6502659,0,158695,6343964
11/3/22,Indonesia,-0.7893,113.9213,6507610,0,158737,6348873
11/4/22,Indonesia,-0.7893,113.9213,6512913,0,158768,6354145
11/5/22,Indonesia,-0.7893,113.9213,6517630,0,158807,6358823
11/6/22,Indonesia,-0.7893,113.9213,6521292,0,158829,6362463
11/7/22,Indonesia,-0.7893,113.9213,6525120,0,158871,6366249
11/8/22,Indonesia,-0.7893,113.9213,6531721,0,158909,6372812
11/9/22,Indonesia,-0.7893,113.9213,6537907,0,158952,6378955
11/10/22,Indonesia,-0.7893,113.9213,6544201,0,158989,6385212
11/11/22,Indonesia,-0.7893,113.9213,6550448,0,159035,6391413
11/12/22,Indonesia,-0.7893,113.9213,6556627,0,159068,6397559
11/13/22,Indonesia,-0.7893,113.9213,6561504,0,159104,6402400
11/14/22,Indonesia,-0.7893,113.9213,6565912,0,159158,6406754
11/15/22,Indonesia,-0.7893,113.9213,6573805,0,159199,6414606
11/16/22,Indonesia,-0.7893,113.9213,6582291,0,159253,6423038
11/17/22,Indonesia,-0.7893,113.9213,6590113,0,159291,6430822
11/18/22,Indonesia,-0.7893,113.9213,6596812,0,159323,6437489
11/19/22,Indonesia,-0.7893,113.9213,6603195,0,159348,6443847
11/20/22,Indonesia,-0.7893,113.9213,6608367,0,159379,6448988
11/21/22,Indonesia,-0.7893,113.9213,6612673,0,159422,6453251
11/22/22,Indonesia,-0.7893,113.9213,6620317,0,159473,6460844
11/23/22,Indonesia,-0.7893,113.9213,6627538,0,159524,6468014
11/24/22,Indonesia,-0.7893,113.9213,6634648,0,159565,6475083
11/25/22,Indonesia,-0.7893,113.9213,6640624,0,159600,6481024
11/26/22,Indonesia,-0.7893,113.9213,6646093,0,159641,6486452
11/27/22,Indonesia,-0.7893,113.9213,6650244,0,159676,6490568
11/28/22,Indonesia,-0.7893,113.9213,6653469,0,159735,6493734
11/29/22,Indonesia,-0.7893,113.9213,6659235,0,159789,6499446
11/30/22,Indonesia,-0.7893,113.9213,6664844,0,159830,6505014
12/1/22,Indonesia,-0.7893,113.9213,6669821,0,159884,6509937
12/2/22,Indonesia,-0.7893,113.9213,6674000,0,159921,6514079
12/3/22,Indonesia,-0.7893,113.9213,6677655,0,159953,6517702
12/4/22,Indonesia,-0.7893,113.9213,6680203,0,159978,6520225
12/5/22,Indonesia,-0.7893,113.9213,6682437,0,160026,6522411
12/6/22,Indonesia,-0.7893,113.9213,6686181,0,160071,6526110
12/7/22,Indonesia,-0.7893,113.9213,6689532,0,160112,6529420
12/8/22,Indonesia,-0.7893,113.9213,6692509,0,160139,6532370
12/9/22,Indonesia,-0.7893,113.9213,6695010,0,160175,6534835
12/10/22,Indonesia,-0.7893,113.9213,6697201,0,160198,6537003
12/11/22,Indonesia,-0.7893,113.9213,6698790,0,160224,6538566
12/12/22,Indonesia,-0.7893,113.9213,6700015,0,160255,6539760
12/13/22,Indonesia,-0.7893,113.9213,6702132,0,160287,6541845
12/14/22,Indonesia,-0.7893,113.9213,6704268,0,160311,6543957
12/15/22,Indonesia,-0.7893,113.9213,6706053,0,160335,6545718
12/16/22,Indonesia,-0.7893,113.9213,6707504,0,160362,6547142
12/17/22,Indonesia,-0.7893,113.9213,6708737,0,160384,6548353
1/1/22,Iran,32.427908,53.688046,6195403,0,131639,6063764
1/2/22,Iran,32.427908,53.688046,6196913,0,131680,6065233
1/3/22,Iran,32.427908,53.688046,6198590,0,131702,6066888
1/4/22,Iran,32.427908,53.688046,6200296,0,131736,6068560
1/5/22,Iran,32.427908,53.688046,6201467,0,131778,6069689
1/6/22,Iran,32.427908,53.688046,6203046,0,131802,6071244
1/7/22,Iran,32.427908,53.688046,6204224,0,131821,6072403
1/8/22,Iran,32.427908,53.688046,6204925,0,131847,6073078
1/9/22,Iran,32.427908,53.688046,6206405,0,131878,6074527
1/10/22,Iran,32.427908,53.688046,6208337,0,131915,6076422
1/11/22,Iran,32.427908,53.688046,6210298,0,131940,6078358
1/12/22,Iran,32.427908,53.688046,6212387,0,131972,6080415
1/13/22,Iran,32.427908,53.688046,6214781,0,132002,6082779
1/14/22,Iran,32.427908,53.688046,6217320,0,132026,6085294
1/15/22,Iran,32.427908,53.688046,6218741,0,132044,6086697
1/16/22,Iran,32.427908,53.688046,6221033,0,132075,6088958
1/17/22,Iran,32.427908,53.688046,6224196,0,132095,6092101
1/18/22,Iran,32.427908,53.688046,6227849,0,132113,6095736
1/19/22,Iran,32.427908,53.688046,6231909,0,132132,6099777
1/20/22,Iran,32.427908,53.688046,6236567,0,132152,6104415
1/21/22,Iran,32.427908,53.688046,6241843,0,132172,6109671
1/22/22,Iran,32.427908,53.688046,6245346,0,132202,6113144
1/23/22,Iran,32.427908,53.688046,6250490,0,132230,6118260
1/24/22,Iran,32.427908,53.688046,6258181,0,132251,6125930
1/25/22,Iran,32.427908,53.688046,6267559,0,132274,6135285
1/26/22,Iran,32.427908,53.688046,6279410,0,132303,6147107
1/27/22,Iran,32.427908,53.688046,6293695,0,132333,6161362
1/28/22,Iran,32.427908,53.688046,6310452,0,132356,6178096
1/29/22,Iran,32.427908,53.688046,6322183,0,132380,6189803
1/30/22,Iran,32.427908,53.688046,6344179,0,132424,6211755
1/31/22,Iran,32.427908,53.688046,6373174,0,132454,6240720
2/1/22,Iran,32.427908,53.688046,6408244,0,132504,6275740
2/2/22,Iran,32.427908,53.688046,6446404,0,132563,6313841
2/3/22,Iran,32.427908,53.688046,6483799,0,132624,6351175
2/4/22,Iran,32.427908,53.688046,6520707,0,132681,6388026
2/5/22,Iran,32.427908,53.688046,6543837,0,132745,6411092
2/6/22,Iran,32.427908,53.688046,6579266,0,132830,6446436
2/7/22,Iran,32.427908,53.688046,6619085,0,132934,6486151
2/8/22,Iran,32.427908,53.688046,6657842,0,133048,6524794
2/9/22,Iran,32.427908,53.688046,6696927,0,133164,6563763
2/10/22,Iran,32.427908,53.688046,6730608,0,133294,6597314
2/11/22,Iran,32.427908,53.688046,6761855,0,133437,6628418
2/12/22,Iran,32.427908,53.688046,6780453,0,133570,6646883
2/13/22,Iran,32.427908,53.688046,6806265,0,133718,6672547
2/14/22,Iran,32.427908,53.688046,6835221,0,133886,6701335
2/15/22,Iran,32.427908,53.688046,6860255,0,134053,6726202
2/16/22,Iran,32.427908,53.688046,6876565,0,134238,6742327
2/17/22,Iran,32.427908,53.688046,6894110,0,134420,6759690
2/18/22,Iran,32.427908,53.688046,6913427,0,134607,6778820
2/19/22,Iran,32.427908,53.688046,6925485,0,134798,6790687
2/20/22,Iran,32.427908,53.688046,6942452,0,135040,6807412
2/21/22,Iran,32.427908,53.688046,6961562,0,135276,6826286
2/22/22,Iran,32.427908,53.688046,6983635,0,135499,6848136
2/23/22,Iran,32.427908,53.688046,6998975,0,135726,6863249
2/24/22,Iran,32.427908,53.688046,7011932,0,135952,6875980
2/25/22,Iran,32.427908,53.688046,7023904,0,136166,6887738
2/26/22,Iran,32.427908,53.688046,7030943,0,136390,6894553
2/27/22,Iran,32.427908,53.688046,7040467,0,136631,6903836
2/28/22,Iran,32.427908,53.688046,7051429,0,136838,6914591
3/1/22,Iran,32.427908,53.688046,7060741,0,137064,6923677
3/2/22,Iran,32.427908,53.688046,7066975,0,137267,6929708
3/3/22,Iran,32.427908,53.688046,7073747,0,137439,6936308
3/4/22,Iran,32.427908,53.688046,7080217,0,137593,6942624
3/5/22,Iran,32.427908,53.688046,7084306,0,137747,6946559
3/6/22,Iran,32.427908,53.688046,7089892,0,137948,6951944
3/7/22,Iran,32.427908,53.688046,7096318,0,138116,6958202
3/8/22,Iran,32.427908,53.688046,7102159,0,138260,6963899
3/9/22,Iran,32.427908,53.688046,7107167,0,138433,6968734
3/10/22,Iran,32.427908,53.688046,7113591,0,138572,6975019
3/11/22,Iran,32.427908,53.688046,7117544,0,138711,6978833
3/12/22,Iran,32.427908,53.688046,7119763,0,138831,6980932
3/13/22,Iran,32.427908,53.688046,7123093,0,138949,6984144
3/14/22,Iran,32.427908,53.688046,7126906,0,139063,6987843
3/15/22,Iran,32.427908,53.688046,7130129,0,139180,6990949
3/16/22,Iran,32.427908,53.688046,7133139,0,139289,6993850
3/17/22,Iran,32.427908,53.688046,7135719,0,139387,6996332
3/18/22,Iran,32.427908,53.688046,7137894,0,139478,6998416
3/19/22,Iran,32.427908,53.688046,7139217,0,139550,6999667
3/20/22,Iran,32.427908,53.688046,7141033,0,139610,7001423
3/21/22,Iran,32.427908,53.688046,7142287,0,139662,7002625
3/22/22,Iran,32.427908,53.688046,7143409,0,139735,7003674
3/23/22,Iran,32.427908,53.688046,7144532,0,139802,7004730
3/24/22,Iran,32.427908,53.688046,7145877,0,139865,7006012
3/25/22,Iran,32.427908,53.688046,7147407,0,139917,7007490
3/26/22,Iran,32.427908,53.688046,7148789,0,139971,7008818
3/27/22,Iran,32.427908,53.688046,7151088,0,140021,7011067
3/28/22,Iran,32.427908,53.688046,7154003,0,140063,7013940
3/29/22,Iran,32.427908,53.688046,7156746,0,140109,7016637
3/30/22,Iran,32.427908,53.688046,7159733,0,140158,7019575
3/31/22,Iran,32.427908,53.688046,7162220,0,140204,7022016
4/1/22,Iran,32.427908,53.688046,7164484,0,140240,7024244
4/2/22,Iran,32.427908,53.688046,7166371,0,140277,7026094
4/3/22,Iran,32.427908,53.688046,7167646,0,140315,7027331
4/4/22,Iran,32.427908,53.688046,7171165,0,140368,7030797
4/5/22,Iran,32.427908,53.688046,7175780,0,140407,7035373
4/6/22,Iran,32.427908,53.688046,7180008,0,140451,7039557
4/7/22,Iran,32.427908,53.688046,7183808,0,140492,7043316
4/8/22,Iran,32.427908,53.688046,7186992,0,140528,7046464
4/9/22,Iran,32.427908,53.688046,7188749,0,140577,7048172
4/10/22,Iran,32.427908,53.688046,7191643,0,140616,7051027
4/11/22,Iran,32.427908,53.688046,7194768,0,140650,7054118
4/12/22,Iran,32.427908,53.688046,7197505,0,140678,7056827
4/13/22,Iran,32.427908,53.688046,7199861,0,140711,7059150
4/14/22,Iran,32.427908,53.688046,7202055,0,140744,7061311
4/15/22,Iran,32.427908,53.688046,7204049,0,140777,7063272
4/16/22,Iran,32.427908,53.688046,7205064,0,140800,7064264
4/17/22,Iran,32.427908,53.688046,7206959,0,140829,7066130
4/18/22,Iran,32.427908,53.688046,7208968,0,140854,7068114
4/19/22,Iran,32.427908,53.688046,7210788,0,140877,7069911
4/20/22,Iran,32.427908,53.688046,7212395,0,140896,7071499
4/21/22,Iran,32.427908,53.688046,7213808,0,140919,7072889
4/22/22,Iran,32.427908,53.688046,7214904,0,140940,7073964
4/23/22,Iran,32.427908,53.688046,7215512,0,140952,7074560
4/24/22,Iran,32.427908,53.688046,7216040,0,140975,7075065
4/25/22,Iran,32.427908,53.688046,7217117,0,140996,7076121
4/26/22,Iran,32.427908,53.688046,7218424,0,141024,7077400
4/27/22,Iran,32.427908,53.688046,7219433,0,141041,7078392
4/28/22,Iran,32.427908,53.688046,7220402,0,141058,7079344
4/29/22,Iran,32.427908,53.688046,7221121,0,141072,7080049
4/30/22,Iran,32.427908,53.688046,7221653,0,141083,7080570
5/1/22,Iran,32.427908,53.688046,7222308,0,141096,7081212
5/2/22,Iran,32.427908,53.688046,7223005,0,141114,7081891
5/3/22,Iran,32.427908,53.688046,7223576,0,141131,7082445
5/4/22,Iran,32.427908,53.688046,7223828,0,141138,7082690
5/5/22,Iran,32.427908,53.688046,7224056,0,141145,7082911
5/6/22,Iran,32.427908,53.688046,7224431,0,141157,7083274
5/7/22,Iran,32.427908,53.688046,7224701,0,141165,7083536
5/8/22,Iran,32.427908,53.688046,7225189,0,141177,7084012
5/9/22,Iran,32.427908,53.688046,7225759,0,141189,7084570
5/10/22,Iran,32.427908,53.688046,7226219,0,141192,7085027
5/11/22,Iran,32.427908,53.688046,7226672,0,141198,7085474
5/12/22,Iran,32.427908,53.688046,7227043,0,141201,7085842
5/13/22,Iran,32.427908,53.688046,7227428,0,141209,7086219
5/14/22,Iran,32.427908,53.688046,7227683,0,141216,7086467
5/15/22,Iran,32.427908,53.688046,7228051,0,141224,7086827
5/16/22,Iran,32.427908,53.688046,7228434,0,141232,7087202
5/17/22,Iran,32.427908,53.688046,7228786,0,141236,7087550
5/18/22,Iran,32.427908,53.688046,7229074,0,141244,7087830
5/19/22,Iran,32.427908,53.688046,7229354,0,141253,7088101
5/20/22,Iran,32.427908,53.688046,7229582,0,141262,7088320
5/21/22,Iran,32.427908,53.688046,7229741,0,141271,7088470
5/22/22,Iran,32.427908,53.688046,7230053,0,141274,7088779
5/23/22,Iran,32.427908,53.688046,7230321,0,141281,7089040
5/24/22,Iran,32.427908,53.688046,7230589,0,141288,7089301
5/25/22,Iran,32.427908,53.688046,7230882,0,141293,7089589
5/26/22,Iran,32.427908,53.688046,7231099,0,141296,7089803
5/27/22,Iran,32.427908,53.688046,7231284,0,141302,7089982
5/28/22,Iran,32.427908,53.688046,7231387,0,141306,7090081
5/29/22,Iran,32.427908,53.688046,7231562,0,141308,7090254
5/30/22,Iran,32.427908,53.688046,7231802,0,141310,7090492
5/31/22,Iran,32.427908,53.688046,7232034,0,141315,7090719
6/1/22,Iran,32.427908,53.688046,7232268,0,141318,7090950
6/2/22,Iran,32.427908,53.688046,7232443,0,141318,7091125
6/3/22,Iran,32.427908,53.688046,7232614,0,141321,7091293
6/4/22,Iran,32.427908,53.688046,7232678,0,141328,7091350
6/5/22,Iran,32.427908,53.688046,7232731,0,141331,7091400
6/6/22,Iran,32.427908,53.688046,7232790,0,141332,7091458
6/7/22,Iran,32.427908,53.688046,7232929,0,141339,7091590
6/8/22,Iran,32.427908,53.688046,7233117,0,141342,7091775
6/9/22,Iran,32.427908,53.688046,7233319,0,141343,7091976
6/10/22,Iran,32.427908,53.688046,7233472,0,141343,7092129
6/11/22,Iran,32.427908,53.688046,7233528,0,141349,7092179
6/12/22,Iran,32.427908,53.688046,7233688,0,141350,7092338
6/13/22,Iran,32.427908,53.688046,7233880,0,141352,7092528
6/14/22,Iran,32.427908,53.688046,7234042,0,141353,7092689
6/15/22,Iran,32.427908,53.688046,7234221,0,141357,7092864
6/16/22,Iran,32.427908,53.688046,7234367,0,141360,7093007
6/17/22,Iran,32.427908,53.688046,7234523,0,141361,7093162
6/18/22,Iran,32.427908,53.688046,7234597,0,141363,7093234
6/19/22,Iran,32.427908,53.688046,7234757,0,141363,7093394
6/20/22,Iran,32.427908,53.688046,7234988,0,141366,7093622
6/21/22,Iran,32.427908,53.688046,7235175,0,141370,7093805
6/22/22,Iran,32.427908,53.688046,7235440,0,141373,7094067
6/23/22,Iran,32.427908,53.688046,7235696,0,141377,7094319
6/24/22,Iran,32.427908,53.688046,7235928,0,141379,7094549
6/25/22,Iran,32.427908,53.688046,7236064,0,141383,7094681
6/26/22,Iran,32.427908,53.688046,7236361,0,141385,7094976
6/27/22,Iran,32.427908,53.688046,7236713,0,141386,7095327
6/28/22,Iran,32.427908,53.688046,7237156,0,141386,7095770
6/29/22,Iran,32.427908,53.688046,7237597,0,141386,7096211
6/30/22,Iran,32.427908,53.688046,7238126,0,141389,7096737
7/1/22,Iran,32.427908,53.688046,7238589,0,141390,7097199
7/2/22,Iran,32.427908,53.688046,7238840,0,141390,7097450
7/3/22,Iran,32.427908,53.688046,7239557,0,141396,7098161
7/4/22,Iran,32.427908,53.688046,7240564,0,141404,7099160
7/5/22,Iran,32.427908,53.688046,7241648,0,141408,7100240
7/6/22,Iran,32.427908,53.688046,7242919,0,141413,7101506
7/7/22,Iran,32.427908,53.688046,7244694,0,141420,7103274
7/8/22,Iran,32.427908,53.688046,7246707,0,141427,7105280
7/9/22,Iran,32.427908,53.688046,7247601,0,141429,7106172
7/10/22,Iran,32.427908,53.688046,7249976,0,141439,7108537
7/11/22,Iran,32.427908,53.688046,7251429,0,141444,7109985
7/12/22,Iran,32.427908,53.688046,7255017,0,141451,7113566
7/13/22,Iran,32.427908,53.688046,7260017,0,141456,7118561
7/14/22,Iran,32.427908,53.688046,7265251,0,141464,7123787
7/15/22,Iran,32.427908,53.688046,7270023,0,141477,7128546
7/16/22,Iran,32.427908,53.688046,7272727,0,141486,7131241
7/17/22,Iran,32.427908,53.688046,7278478,0,141499,7136979
7/18/22,Iran,32.427908,53.688046,7284165,0,141513,7142652
7/19/22,Iran,32.427908,53.688046,7289542,0,141532,7148010
7/20/22,Iran,32.427908,53.688046,7296635,0,141564,7155071
7/21/22,Iran,32.427908,53.688046,7304550,0,141593,7162957
7/22/22,Iran,32.427908,53.688046,7312401,0,141624,7170777
7/23/22,Iran,32.427908,53.688046,7319322,0,141650,7177672
7/24/22,Iran,32.427908,53.688046,7328153,0,141684,7186469
7/25/22,Iran,32.427908,53.688046,7337928,0,141717,7196211
7/26/22,Iran,32.427908,53.688046,7348963,0,141758,7207205
7/27/22,Iran,32.427908,53.688046,7359489,0,141795,7217694
7/28/22,Iran,32.427908,53.688046,7368945,0,141837,7227108
7/29/22,Iran,32.427908,53.688046,7376794,0,141891,7234903
7/30/22,Iran,32.427908,53.688046,7381299,0,141937,7239362
7/31/22,Iran,32.427908,53.688046,7391026,0,141998,7249028
8/1/22,Iran,32.427908,53.688046,7400725,0,142060,7258665
8/2/22,Iran,32.427908,53.688046,7410075,0,142134,7267941
8/3/22,Iran,32.427908,53.688046,7418615,0,142209,7276406
8/4/22,Iran,32.427908,53.688046,7426030,0,142290,7283740
8/5/22,Iran,32.427908,53.688046,7431485,0,142337,7289148
8/6/22,Iran,32.427908,53.688046,7434945,0,142398,7292547
8/7/22,Iran,32.427908,53.688046,7440422,0,142461,7297961
8/8/22,Iran,32.427908,53.688046,7443801,0,142515,7301286
8/9/22,Iran,32.427908,53.688046,7446144,0,142564,7303580
8/10/22,Iran,32.427908,53.688046,7451779,0,142654,7309125
8/11/22,Iran,32.427908,53.688046,7459175,0,142738,7316437
8/12/22,Iran,32.427908,53.688046,7465579,0,142806,7322773
8/13/22,Iran,32.427908,53.688046,7468894,0,142861,7326033
8/14/22,Iran,32.427908,53.688046,7475173,0,142944,7332229
8/15/22,Iran,32.427908,53.688046,7482521,0,143015,7339506
8/16/22,Iran,32.427908,53.688046,7488493,0,143093,7345400
8/17/22,Iran,32.427908,53.688046,7493317,0,143160,7350157
8/18/22,Iran,32.427908,53.688046,7497844,0,143222,7354622
8/19/22,Iran,32.427908,53.688046,7501534,0,143288,7358246
8/20/22,Iran,32.427908,53.688046,7503369,0,143332,7360037
8/21/22,Iran,32.427908,53.688046,7506614,0,143387,7363227
8/22/22,Iran,32.427908,53.688046,7510702,0,143449,7367253
8/23/22,Iran,32.427908,53.688046,7513928,0,143505,7370423
8/24/22,Iran,32.427908,53.688046,7516596,0,143550,7373046
8/25/22,Iran,32.427908,53.688046,7518974,0,143612,7375362
8/26/22,Iran,32.427908,53.688046,7520993,0,143647,7377346
8/27/22,Iran,32.427908,53.688046,7521969,0,143684,7378285
8/28/22,Iran,32.427908,53.688046,7523662,0,143728,7379934
8/29/22,Iran,32.427908,53.688046,7525628,0,143776,7381852
8/30/22,Iran,32.427908,53.688046,7527499,0,143820,7383679
8/31/22,Iran,32.427908,53.688046,7528961,0,143867,7385094
9/1/22,Iran,32.427908,53.688046,7530325,0,143894,7386431
9/2/22,Iran,32.427908,53.688046,7531392,0,143917,7387475
9/3/22,Iran,32.427908,53.688046,7531924,0,143947,7387977
9/4/22,Iran,32.427908,53.688046,7533087,0,143995,7389092
9/5/22,Iran,32.427908,53.688046,7534182,0,144019,7390163
9/6/22,Iran,32.427908,53.688046,7535272,0,144048,7391224
9/7/22,Iran,32.427908,53.688046,7536217,0,144085,7392132
9/8/22,Iran,32.427908,53.688046,7537081,0,144108,7392973
9/9/22,Iran,32.427908,53.688046,7537781,0,144135,7393646
9/10/22,Iran,32.427908,53.688046,7538125,0,144154,7393971
9/11/22,Iran,32.427908,53.688046,7538821,0,144178,7394643
9/12/22,Iran,32.427908,53.688046,7539698,0,144199,7395499
9/13/22,Iran,32.427908,53.688046,7540316,0,144221,7396095
9/14/22,Iran,32.427908,53.688046,7540962,0,144243,7396719
9/15/22,Iran,32.427908,53.688046,7541586,0,144258,7397328
9/16/22,Iran,32.427908,53.688046,7542230,0,144273,7397957
9/17/22,Iran,32.427908,53.688046,7542533,0,144287,7398246
9/18/22,Iran,32.427908,53.688046,7542822,0,144301,7398521
9/19/22,Iran,32.427908,53.688046,7543548,0,144319,7399229
9/20/22,Iran,32.427908,53.688046,7544540,0,144344,7400196
9/21/22,Iran,32.427908,53.688046,7545351,0,144358,7400993
9/22/22,Iran,32.427908,53.688046,7545855,0,144364,7401491
9/23/22,Iran,32.427908,53.688046,7546276,0,144367,7401909
9/24/22,Iran,32.427908,53.688046,7546673,0,144382,7402291
9/25/22,Iran,32.427908,53.688046,7547089,0,144394,7402695
9/26/22,Iran,32.427908,53.688046,7547397,0,144402,7402995
9/27/22,Iran,32.427908,53.688046,7547706,0,144409,7403297
9/28/22,Iran,32.427908,53.688046,7547968,0,144416,7403552
9/29/22,Iran,32.427908,53.688046,7548320,0,144421,7403899
9/30/22,Iran,32.427908,53.688046,7548648,0,144426,7404222
10/1/22,Iran,32.427908,53.688046,7549186,0,144429,7404757
10/2/22,Iran,32.427908,53.688046,7549586,0,144439,7405147
10/3/22,Iran,32.427908,53.688046,7550021,0,144448,7405573
10/4/22,Iran,32.427908,53.688046,7550401,0,144458,7405943
10/5/22,Iran,32.427908,53.688046,7550691,0,144466,7406225
10/6/22,Iran,32.427908,53.688046,7550856,0,144469,7406387
10/7/22,Iran,32.427908,53.688046,7551022,0,144471,7406551
10/8/22,Iran,32.427908,53.688046,7551357,0,144478,7406879
10/9/22,Iran,32.427908,53.688046,7551680,0,144486,7407194
10/10/22,Iran,32.427908,53.688046,7552404,0,144490,7407914
10/11/22,Iran,32.427908,53.688046,7552812,0,144498,7408314
10/12/22,Iran,32.427908,53.688046,7553169,0,144502,7408667
10/13/22,Iran,32.427908,53.688046,7553454,0,144506,7408948
10/14/22,Iran,32.427908,53.688046,7553609,0,144510,7409099
10/15/22,Iran,32.427908,53.688046,7554006,0,144516,7409490
10/16/22,Iran,32.427908,53.688046,7554333,0,144519,7409814
10/17/22,Iran,32.427908,53.688046,7554703,0,144523,7410180
10/18/22,Iran,32.427908,53.688046,7555010,0,144527,7410483
10/19/22,Iran,32.427908,53.688046,7555355,0,144531,7410824
10/20/22,Iran,32.427908,53.688046,7555555,0,144536,7411019
10/21/22,Iran,32.427908,53.688046,7555694,0,144540,7411154
10/22/22,Iran,32.427908,53.688046,7555903,0,144543,7411360
10/23/22,Iran,32.427908,53.688046,7556097,0,144544,7411553
10/24/22,Iran,32.427908,53.688046,7556632,0,144548,7412084
10/25/22,Iran,32.427908,53.688046,7556854,0,144555,7412299
10/26/22,Iran,32.427908,53.688046,7557024,0,144559,7412465
10/27/22,Iran,32.427908,53.688046,7557134,0,144562,7412572
10/28/22,Iran,32.427908,53.688046,7557240,0,144565,7412675
10/29/22,Iran,32.427908,53.688046,7557364,0,144571,7412793
10/30/22,Iran,32.427908,53.688046,7557437,0,144571,7412866
10/31/22,Iran,32.427908,53.688046,7557650,0,144576,7413074
11/1/22,Iran,32.427908,53.688046,7557805,0,144580,7413225
11/2/22,Iran,32.427908,53.688046,7557805,0,144580,7413225
11/3/22,Iran,32.427908,53.688046,7557962,0,144583,7413379
11/4/22,Iran,32.427908,53.688046,7558002,0,144587,7413415
11/5/22,Iran,32.427908,53.688046,7558078,0,144592,7413486
11/6/22,Iran,32.427908,53.688046,7558142,0,144596,7413546
11/7/22,Iran,32.427908,53.688046,7558502,0,144600,7413902
11/8/22,Iran,32.427908,53.688046,7558593,0,144604,7413989
11/9/22,Iran,32.427908,53.688046,7558690,0,144605,7414085
11/10/22,Iran,32.427908,53.688046,7558762,0,144607,7414155
11/11/22,Iran,32.427908,53.688046,7558812,0,144609,7414203
11/12/22,Iran,32.427908,53.688046,7558893,0,144610,7414283
11/13/22,Iran,32.427908,53.688046,7558950,0,144612,7414338
11/14/22,Iran,32.427908,53.688046,7559001,0,144613,7414388
11/15/22,Iran,32.427908,53.688046,7559055,0,144613,7414442
11/16/22,Iran,32.427908,53.688046,7559055,0,144613,7414442
11/17/22,Iran,32.427908,53.688046,7559164,0,144617,7414547
11/18/22,Iran,32.427908,53.688046,7559211,0,144620,7414591
11/19/22,Iran,32.427908,53.688046,7559258,0,144625,7414633
11/20/22,Iran,32.427908,53.688046,7559296,0,144626,7414670
11/21/22,Iran,32.427908,53.688046,7559368,0,144627,7414741
11/22/22,Iran,32.427908,53.688046,7559416,0,144630,7414786
11/23/22,Iran,32.427908,53.688046,7559446,0,144632,7414814
11/24/22,Iran,32.427908,53.688046,7559467,0,144633,7414834
11/25/22,Iran,32.427908,53.688046,7559492,0,144633,7414859
11/26/22,Iran,32.427908,53.688046,7559526,0,144633,7414893
11/27/22,Iran,32.427908,53.688046,7559589,0,144633,7414956
11/28/22,Iran,32.427908,53.688046,7559634,0,144633,7415001
11/29/22,Iran,32.427908,53.688046,7559664,0,144633,7415031
11/30/22,Iran,32.427908,53.688046,7559706,0,144633,7415073
12/1/22,Iran,32.427908,53.688046,7559737,0,144634,7415103
12/2/22,Iran,32.427908,53.688046,7559760,0,144634,7415126
12/3/22,Iran,32.427908,53.688046,7559799,0,144637,7415162
12/4/22,Iran,32.427908,53.688046,7559855,0,144640,7415215
12/5/22,Iran,32.427908,53.688046,7559924,0,144645,7415279
12/6/22,Iran,32.427908,53.688046,7559958,0,144648,7415310
12/7/22,Iran,32.427908,53.688046,7559999,0,144649,7415350
12/8/22,Iran,32.427908,53.688046,7560048,0,144651,7415397
12/9/22,Iran,32.427908,53.688046,7560067,0,144652,7415415
12/10/22,Iran,32.427908,53.688046,7560105,0,144658,7415447
12/11/22,Iran,32.427908,53.688046,7560162,0,144658,7415504
12/12/22,Iran,32.427908,53.688046,7560217,0,144658,7415559
12/13/22,Iran,32.427908,53.688046,7560247,0,144658,7415589
12/14/22,Iran,32.427908,53.688046,7560294,0,144658,7415636
12/15/22,Iran,32.427908,53.688046,7560323,0,144659,7415664
12/16/22,Iran,32.427908,53.688046,7560323,0,144659,7415664
12/17/22,Iran,32.427908,53.688046,7560389,0,144661,7415728
1/1/22,Iraq,33.223191,43.679291,2093891,0,24163,2069728
1/2/22,Iraq,33.223191,43.679291,2094097,0,24167,2069930
1/3/22,Iraq,33.223191,43.679291,2094349,0,24174,2070175
1/4/22,Iraq,33.223191,43.679291,2094667,0,24182,2070485
1/5/22,Iraq,33.223191,43.679291,2095183,0,24191,2070992
1/6/22,Iraq,33.223191,43.679291,2095848,0,24194,2071654
1/7/22,Iraq,33.223191,43.679291,2096490,0,24198,2072292
1/8/22,Iraq,33.223191,43.679291,2096806,0,24200,2072606
1/9/22,Iraq,33.223191,43.679291,2097540,0,24207,2073333
1/10/22,Iraq,33.223191,43.679291,2098908,0,24212,2074696
1/11/22,Iraq,33.223191,43.679291,2100518,0,24220,2076298
1/12/22,Iraq,33.223191,43.679291,2102555,0,24225,2078330
1/13/22,Iraq,33.223191,43.679291,2104940,0,24229,2080711
1/14/22,Iraq,33.223191,43.679291,2108206,0,24237,2083969
1/15/22,Iraq,33.223191,43.679291,2110683,0,24242,2086441
1/16/22,Iraq,33.223191,43.679291,2114313,0,24247,2090066
1/17/22,Iraq,33.223191,43.679291,2118779,0,24252,2094527
1/18/22,Iraq,33.223191,43.679291,2125266,0,24262,2101004
1/19/22,Iraq,33.223191,43.679291,2131500,0,24267,2107233
1/20/22,Iraq,33.223191,43.679291,2137267,0,24272,2112995
1/21/22,Iraq,33.223191,43.679291,2144422,0,24277,2120145
1/22/22,Iraq,33.223191,43.679291,2149306,0,24283,2125023
1/23/22,Iraq,33.223191,43.679291,2154237,0,24287,2129950
1/24/22,Iraq,33.223191,43.679291,2159993,0,24300,2135693
1/25/22,Iraq,33.223191,43.679291,2167686,0,24309,2143377
1/26/22,Iraq,33.223191,43.679291,2175793,0,24319,2151474
1/27/22,Iraq,33.223191,43.679291,2183402,0,24330,2159072
1/28/22,Iraq,33.223191,43.679291,2191956,0,24347,2167609
1/29/22,Iraq,33.223191,43.679291,2197783,0,24361,2173422
1/30/22,Iraq,33.223191,43.679291,2203365,0,24376,2178989
1/31/22,Iraq,33.223191,43.679291,2210582,0,24389,2186193
2/1/22,Iraq,33.223191,43.679291,2218483,0,24405,2194078
2/2/22,Iraq,33.223191,43.679291,2226776,0,24430,2202346
2/3/22,Iraq,33.223191,43.679291,2233725,0,24455,2209270
2/4/22,Iraq,33.223191,43.679291,2240294,0,24476,2215818
2/5/22,Iraq,33.223191,43.679291,2244610,0,24499,2220111
2/6/22,Iraq,33.223191,43.679291,2248199,0,24516,2223683
2/7/22,Iraq,33.223191,43.679291,2253484,0,24543,2228941
2/8/22,Iraq,33.223191,43.679291,2258844,0,24570,2234274
2/9/22,Iraq,33.223191,43.679291,2263525,0,24600,2238925
2/10/22,Iraq,33.223191,43.679291,2267745,0,24626,2243119
2/11/22,Iraq,33.223191,43.679291,2271521,0,24655,2246866
2/12/22,Iraq,33.223191,43.679291,2273535,0,24678,2248857
2/13/22,Iraq,33.223191,43.679291,2275571,0,24704,2250867
2/14/22,Iraq,33.223191,43.679291,2278582,0,24729,2253853
2/15/22,Iraq,33.223191,43.679291,2281566,0,24764,2256802
2/16/22,Iraq,33.223191,43.679291,2284205,0,24792,2259413
2/17/22,Iraq,33.223191,43.679291,2286451,0,24824,2261627
2/18/22,Iraq,33.223191,43.679291,2288777,0,24840,2263937
2/19/22,Iraq,33.223191,43.679291,2290011,0,24851,2265160
2/20/22,Iraq,33.223191,43.679291,2291170,0,24858,2266312
2/21/22,Iraq,33.223191,43.679291,2293244,0,24876,2268368
2/22/22,Iraq,33.223191,43.679291,2294929,0,24897,2270032
2/23/22,Iraq,33.223191,43.679291,2296665,0,24917,2271748
2/24/22,Iraq,33.223191,43.679291,2298164,0,24931,2273233
2/25/22,Iraq,33.223191,43.679291,2299767,0,24948,2274819
2/26/22,Iraq,33.223191,43.679291,2300645,0,24960,2275685
2/27/22,Iraq,33.223191,43.679291,2301590,0,24975,2276615
2/28/22,Iraq,33.223191,43.679291,2302793,0,24989,2277804
3/1/22,Iraq,33.223191,43.679291,2303816,0,24999,2278817
3/2/22,Iraq,33.223191,43.679291,2305083,0,25013,2280070
3/3/22,Iraq,33.223191,43.679291,2306092,0,25028,2281064
3/4/22,Iraq,33.223191,43.679291,2307158,0,25034,2282124
3/5/22,Iraq,33.223191,43.679291,2307555,0,25041,2282514
3/6/22,Iraq,33.223191,43.679291,2308191,0,25050,2283141
3/7/22,Iraq,33.223191,43.679291,2308928,0,25068,2283860
3/8/22,Iraq,33.223191,43.679291,2309816,0,25076,2284740
3/9/22,Iraq,33.223191,43.679291,2310539,0,25082,2285457
3/10/22,Iraq,33.223191,43.679291,2311238,0,25090,2286148
3/11/22,Iraq,33.223191,43.679291,2311926,0,25094,2286832
3/12/22,Iraq,33.223191,43.679291,2312292,0,25097,2287195
3/13/22,Iraq,33.223191,43.679291,2312713,0,25099,2287614
3/14/22,Iraq,33.223191,43.679291,2313370,0,25105,2288265
3/15/22,Iraq,33.223191,43.679291,2313943,0,25109,2288834
3/16/22,Iraq,33.223191,43.679291,2314575,0,25116,2289459
3/17/22,Iraq,33.223191,43.679291,2315134,0,25119,2290015
3/18/22,Iraq,33.223191,43.679291,2315573,0,25124,2290449
3/19/22,Iraq,33.223191,43.679291,2315791,0,25127,2290664
3/20/22,Iraq,33.223191,43.679291,2316044,0,25129,2290915
3/21/22,Iraq,33.223191,43.679291,2316306,0,25131,2291175
3/22/22,Iraq,33.223191,43.679291,2316493,0,25132,2291361
3/23/22,Iraq,33.223191,43.679291,2316758,0,25134,2291624
3/24/22,Iraq,33.223191,43.679291,2317128,0,25138,2291990
3/25/22,Iraq,33.223191,43.679291,2317498,0,25145,2292353
3/26/22,Iraq,33.223191,43.679291,2317747,0,25149,2292598
3/27/22,Iraq,33.223191,43.679291,2317977,0,25150,2292827
3/28/22,Iraq,33.223191,43.679291,2318450,0,25156,2293294
3/29/22,Iraq,33.223191,43.679291,2318865,0,25160,2293705
3/30/22,Iraq,33.223191,43.679291,2319209,0,25163,2294046
3/31/22,Iraq,33.223191,43.679291,2319550,0,25164,2294386
4/1/22,Iraq,33.223191,43.679291,2319908,0,25167,2294741
4/2/22,Iraq,33.223191,43.679291,2320126,0,25170,2294956
4/3/22,Iraq,33.223191,43.679291,2320260,0,25173,2295087
4/4/22,Iraq,33.223191,43.679291,2320526,0,25177,2295349
4/5/22,Iraq,33.223191,43.679291,2320806,0,25178,2295628
4/6/22,Iraq,33.223191,43.679291,2321095,0,25179,2295916
4/7/22,Iraq,33.223191,43.679291,2321369,0,25181,2296188
4/8/22,Iraq,33.223191,43.679291,2321630,0,25183,2296447
4/9/22,Iraq,33.223191,43.679291,2321781,0,25183,2296598
4/10/22,Iraq,33.223191,43.679291,2321874,0,25185,2296689
4/11/22,Iraq,33.223191,43.679291,2322081,0,25186,2296895
4/12/22,Iraq,33.223191,43.679291,2322303,0,25186,2297117
4/13/22,Iraq,33.223191,43.679291,2322551,0,25188,2297363
4/14/22,Iraq,33.223191,43.679291,2322734,0,25192,2297542
4/15/22,Iraq,33.223191,43.679291,2322938,0,25197,2297741
4/16/22,Iraq,33.223191,43.679291,2323040,0,25198,2297842
4/17/22,Iraq,33.223191,43.679291,2323132,0,25198,2297934
4/18/22,Iraq,33.223191,43.679291,2323284,0,25198,2298086
4/19/22,Iraq,33.223191,43.679291,2323508,0,25200,2298308
4/20/22,Iraq,33.223191,43.679291,2323707,0,25201,2298506
4/21/22,Iraq,33.223191,43.679291,2323878,0,25201,2298677
4/22/22,Iraq,33.223191,43.679291,2324031,0,25203,2298828
4/23/22,Iraq,33.223191,43.679291,2324141,0,25204,2298937
4/24/22,Iraq,33.223191,43.679291,2324223,0,25205,2299018
4/25/22,Iraq,33.223191,43.679291,2324384,0,25207,2299177
4/26/22,Iraq,33.223191,43.679291,2324531,0,25208,2299323
4/27/22,Iraq,33.223191,43.679291,2324699,0,25208,2299491
4/28/22,Iraq,33.223191,43.679291,2324847,0,25209,2299638
4/29/22,Iraq,33.223191,43.679291,2324982,0,25211,2299771
4/30/22,Iraq,33.223191,43.679291,2325092,0,25211,2299881
5/1/22,Iraq,33.223191,43.679291,2325175,0,25211,2299964
5/2/22,Iraq,33.223191,43.679291,2325247,0,25211,2300036
5/3/22,Iraq,33.223191,43.679291,2325287,0,25212,2300075
5/4/22,Iraq,33.223191,43.679291,2325352,0,25212,2300140
5/5/22,Iraq,33.223191,43.679291,2325397,0,25212,2300185
5/6/22,Iraq,33.223191,43.679291,2325467,0,25213,2300254
5/7/22,Iraq,33.223191,43.679291,2325522,0,25213,2300309
5/8/22,Iraq,33.223191,43.679291,2325614,0,25213,2300401
5/9/22,Iraq,33.223191,43.679291,2325740,0,25214,2300526
5/10/22,Iraq,33.223191,43.679291,2325871,0,25215,2300656
5/11/22,Iraq,33.223191,43.679291,2326033,0,25215,2300818
5/12/22,Iraq,33.223191,43.679291,2326162,0,25216,2300946
5/13/22,Iraq,33.223191,43.679291,2326288,0,25216,2301072
5/14/22,Iraq,33.223191,43.679291,2326356,0,25216,2301140
5/15/22,Iraq,33.223191,43.679291,2326458,0,25216,2301242
5/16/22,Iraq,33.223191,43.679291,2326577,0,25216,2301361
5/17/22,Iraq,33.223191,43.679291,2326726,0,25216,2301510
5/18/22,Iraq,33.223191,43.679291,2326852,0,25216,2301636
5/19/22,Iraq,33.223191,43.679291,2326965,0,25216,2301749
5/20/22,Iraq,33.223191,43.679291,2327114,0,25216,2301898
5/21/22,Iraq,33.223191,43.679291,2327192,0,25216,2301976
5/22/22,Iraq,33.223191,43.679291,2327269,0,25216,2302053
5/23/22,Iraq,33.223191,43.679291,2327387,0,25218,2302169
5/24/22,Iraq,33.223191,43.679291,2327486,0,25218,2302268
5/25/22,Iraq,33.223191,43.679291,2327557,0,25218,2302339
5/26/22,Iraq,33.223191,43.679291,2327665,0,25218,2302447
5/27/22,Iraq,33.223191,43.679291,2327777,0,25219,2302558
5/28/22,Iraq,33.223191,43.679291,2327837,0,25219,2302618
5/29/22,Iraq,33.223191,43.679291,2327908,0,25219,2302689
5/30/22,Iraq,33.223191,43.679291,2328019,0,25219,2302800
5/31/22,Iraq,33.223191,43.679291,2328154,0,25219,2302935
6/1/22,Iraq,33.223191,43.679291,2328264,0,25219,2303045
6/2/22,Iraq,33.223191,43.679291,2328369,0,25219,2303150
6/3/22,Iraq,33.223191,43.679291,2328498,0,25220,2303278
6/4/22,Iraq,33.223191,43.679291,2328582,0,25220,2303362
6/5/22,Iraq,33.223191,43.679291,2328670,0,25221,2303449
6/6/22,Iraq,33.223191,43.679291,2328787,0,25221,2303566
6/7/22,Iraq,33.223191,43.679291,2328957,0,25221,2303736
6/8/22,Iraq,33.223191,43.679291,2329108,0,25221,2303887
6/9/22,Iraq,33.223191,43.679291,2329313,0,25221,2304092
6/10/22,Iraq,33.223191,43.679291,2329525,0,25221,2304304
6/11/22,Iraq,33.223191,43.679291,2329662,0,25222,2304440
6/12/22,Iraq,33.223191,43.679291,2329813,0,25222,2304591
6/13/22,Iraq,33.223191,43.679291,2330049,0,25223,2304826
6/14/22,Iraq,33.223191,43.679291,2330393,0,25224,2305169
6/15/22,Iraq,33.223191,43.679291,2330735,0,25225,2305510
6/16/22,Iraq,33.223191,43.679291,2331148,0,25225,2305923
6/17/22,Iraq,33.223191,43.679291,2331487,0,25226,2306261
6/18/22,Iraq,33.223191,43.679291,2331872,0,25228,2306644
6/19/22,Iraq,33.223191,43.679291,2332177,0,25228,2306949
6/20/22,Iraq,33.223191,43.679291,2332692,0,25229,2307463
6/21/22,Iraq,33.223191,43.679291,2333443,0,25229,2308214
6/22/22,Iraq,33.223191,43.679291,2334375,0,25229,2309146
6/23/22,Iraq,33.223191,43.679291,2335436,0,25229,2310207
6/24/22,Iraq,33.223191,43.679291,2336764,0,25229,2311535
6/25/22,Iraq,33.223191,43.679291,2338109,0,25229,2312880
6/26/22,Iraq,33.223191,43.679291,2339148,0,25231,2313917
6/27/22,Iraq,33.223191,43.679291,2341053,0,25233,2315820
6/28/22,Iraq,33.223191,43.679291,2343265,0,25237,2318028
6/29/22,Iraq,33.223191,43.679291,2345893,0,25239,2320654
6/30/22,Iraq,33.223191,43.679291,2348662,0,25241,2323421
7/1/22,Iraq,33.223191,43.679291,2351614,0,25242,2326372
7/2/22,Iraq,33.223191,43.679291,2353900,0,25243,2328657
7/3/22,Iraq,33.223191,43.679291,2356264,0,25243,2331021
7/4/22,Iraq,33.223191,43.679291,2359755,0,25247,2334508
7/5/22,Iraq,33.223191,43.679291,2364453,0,25247,2339206
7/6/22,Iraq,33.223191,43.679291,2369272,0,25249,2344023
7/7/22,Iraq,33.223191,43.679291,2374046,0,25253,2348793
7/8/22,Iraq,33.223191,43.679291,2379077,0,25253,2353824
7/9/22,Iraq,33.223191,43.679291,2383094,0,25253,2357841
7/10/22,Iraq,33.223191,43.679291,2385477,0,25254,2360223
7/11/22,Iraq,33.223191,43.679291,2388414,0,25255,2363159
7/12/22,Iraq,33.223191,43.679291,2390684,0,25257,2365427
7/13/22,Iraq,33.223191,43.679291,2393726,0,25259,2368467
7/14/22,Iraq,33.223191,43.679291,2396707,0,25261,2371446
7/15/22,Iraq,33.223191,43.679291,2399795,0,25263,2374532
7/16/22,Iraq,33.223191,43.679291,2402311,0,25267,2377044
7/17/22,Iraq,33.223191,43.679291,2405186,0,25270,2379916
7/18/22,Iraq,33.223191,43.679291,2409641,0,25273,2384368
7/19/22,Iraq,33.223191,43.679291,2413472,0,25274,2388198
7/20/22,Iraq,33.223191,43.679291,2417719,0,25277,2392442
7/21/22,Iraq,33.223191,43.679291,2421716,0,25280,2396436
7/22/22,Iraq,33.223191,43.679291,2425731,0,25284,2400447
7/23/22,Iraq,33.223191,43.679291,2427884,0,25286,2402598
7/24/22,Iraq,33.223191,43.679291,2429833,0,25290,2404543
7/25/22,Iraq,33.223191,43.679291,2432786,0,25293,2407493
7/26/22,Iraq,33.223191,43.679291,2435440,0,25297,2410143
7/27/22,Iraq,33.223191,43.679291,2438101,0,25304,2412797
7/28/22,Iraq,33.223191,43.679291,2440414,0,25308,2415106
7/29/22,Iraq,33.223191,43.679291,2442499,0,25311,2417188
7/30/22,Iraq,33.223191,43.679291,2443772,0,25313,2418459
7/31/22,Iraq,33.223191,43.679291,2444798,0,25315,2419483
8/1/22,Iraq,33.223191,43.679291,2445888,0,25316,2420572
8/2/22,Iraq,33.223191,43.679291,2447232,0,25318,2421914
8/3/22,Iraq,33.223191,43.679291,2448484,0,25321,2423163
8/4/22,Iraq,33.223191,43.679291,2449440,0,25322,2424118
8/5/22,Iraq,33.223191,43.679291,2450257,0,25323,2424934
8/6/22,Iraq,33.223191,43.679291,2450637,0,25325,2425312
8/7/22,Iraq,33.223191,43.679291,2450637,0,25325,2425312
8/8/22,Iraq,33.223191,43.679291,2451178,0,25326,2425852
8/9/22,Iraq,33.223191,43.679291,2451178,0,25326,2425852
8/10/22,Iraq,33.223191,43.679291,2451178,0,25326,2425852
8/11/22,Iraq,33.223191,43.679291,2451178,0,25326,2425852
8/12/22,Iraq,33.223191,43.679291,2451178,0,25326,2425852
8/13/22,Iraq,33.223191,43.679291,2451178,0,25326,2425852
8/14/22,Iraq,33.223191,43.679291,2451178,0,25326,2425852
8/15/22,Iraq,33.223191,43.679291,2454213,0,25338,2428875
8/16/22,Iraq,33.223191,43.679291,2454213,0,25338,2428875
8/17/22,Iraq,33.223191,43.679291,2454213,0,25338,2428875
8/18/22,Iraq,33.223191,43.679291,2454213,0,25338,2428875
8/19/22,Iraq,33.223191,43.679291,2454213,0,25338,2428875
8/20/22,Iraq,33.223191,43.679291,2454213,0,25338,2428875
8/21/22,Iraq,33.223191,43.679291,2454213,0,25338,2428875
8/22/22,Iraq,33.223191,43.679291,2456555,0,25343,2431212
8/23/22,Iraq,33.223191,43.679291,2456555,0,25343,2431212
8/24/22,Iraq,33.223191,43.679291,2456555,0,25343,2431212
8/25/22,Iraq,33.223191,43.679291,2456555,0,25343,2431212
8/26/22,Iraq,33.223191,43.679291,2456555,0,25343,2431212
8/27/22,Iraq,33.223191,43.679291,2456555,0,25343,2431212
8/28/22,Iraq,33.223191,43.679291,2456555,0,25343,2431212
8/29/22,Iraq,33.223191,43.679291,2456555,0,25343,2431212
8/30/22,Iraq,33.223191,43.679291,2457871,0,25346,2432525
8/31/22,Iraq,33.223191,43.679291,2457871,0,25346,2432525
9/1/22,Iraq,33.223191,43.679291,2457871,0,25346,2432525
9/2/22,Iraq,33.223191,43.679291,2457871,0,25346,2432525
9/3/22,Iraq,33.223191,43.679291,2457871,0,25346,2432525
9/4/22,Iraq,33.223191,43.679291,2457871,0,25346,2432525
9/5/22,Iraq,33.223191,43.679291,2458509,0,25348,2433161
9/6/22,Iraq,33.223191,43.679291,2458509,0,25348,2433161
9/7/22,Iraq,33.223191,43.679291,2458509,0,25348,2433161
9/8/22,Iraq,33.223191,43.679291,2458509,0,25348,2433161
9/9/22,Iraq,33.223191,43.679291,2458509,0,25348,2433161
9/10/22,Iraq,33.223191,43.679291,2458509,0,25348,2433161
9/11/22,Iraq,33.223191,43.679291,2458509,0,25348,2433161
9/12/22,Iraq,33.223191,43.679291,2458509,0,25348,2433161
9/13/22,Iraq,33.223191,43.679291,2458509,0,25348,2433161
9/14/22,Iraq,33.223191,43.679291,2458509,0,25348,2433161
9/15/22,Iraq,33.223191,43.679291,2458509,0,25348,2433161
9/16/22,Iraq,33.223191,43.679291,2458509,0,25348,2433161
9/17/22,Iraq,33.223191,43.679291,2458509,0,25348,2433161
9/18/22,Iraq,33.223191,43.679291,2458509,0,25348,2433161
9/19/22,Iraq,33.223191,43.679291,2459178,0,25352,2433826
9/20/22,Iraq,33.223191,43.679291,2459249,0,25352,2433897
9/21/22,Iraq,33.223191,43.679291,2459249,0,25352,2433897
9/22/22,Iraq,33.223191,43.679291,2459249,0,25352,2433897
9/23/22,Iraq,33.223191,43.679291,2459249,0,25352,2433897
9/24/22,Iraq,33.223191,43.679291,2459249,0,25352,2433897
9/25/22,Iraq,33.223191,43.679291,2459249,0,25352,2433897
9/26/22,Iraq,33.223191,43.679291,2459505,0,25352,2434153
9/27/22,Iraq,33.223191,43.679291,2459982,0,25355,2434627
9/28/22,Iraq,33.223191,43.679291,2459982,0,25355,2434627
9/29/22,Iraq,33.223191,43.679291,2459982,0,25355,2434627
9/30/22,Iraq,33.223191,43.679291,2459982,0,25355,2434627
10/1/22,Iraq,33.223191,43.679291,2459982,0,25355,2434627
10/2/22,Iraq,33.223191,43.679291,2459982,0,25355,2434627
10/3/22,Iraq,33.223191,43.679291,2460318,0,25356,2434962
10/4/22,Iraq,33.223191,43.679291,2460572,0,25356,2435216
10/5/22,Iraq,33.223191,43.679291,2460572,0,25356,2435216
10/6/22,Iraq,33.223191,43.679291,2460670,0,25356,2435314
10/7/22,Iraq,33.223191,43.679291,2460670,0,25356,2435314
10/8/22,Iraq,33.223191,43.679291,2460670,0,25356,2435314
10/9/22,Iraq,33.223191,43.679291,2460670,0,25356,2435314
10/10/22,Iraq,33.223191,43.679291,2460868,0,25356,2435512
10/11/22,Iraq,33.223191,43.679291,2460868,0,25356,2435512
10/12/22,Iraq,33.223191,43.679291,2460868,0,25356,2435512
10/13/22,Iraq,33.223191,43.679291,2460868,0,25356,2435512
10/14/22,Iraq,33.223191,43.679291,2460868,0,25356,2435512
10/15/22,Iraq,33.223191,43.679291,2460868,0,25356,2435512
10/16/22,Iraq,33.223191,43.679291,2460868,0,25356,2435512
10/17/22,Iraq,33.223191,43.679291,2460868,0,25356,2435512
10/18/22,Iraq,33.223191,43.679291,2460868,0,25356,2435512
10/19/22,Iraq,33.223191,43.679291,2460868,0,25356,2435512
10/20/22,Iraq,33.223191,43.679291,2460868,0,25356,2435512
10/21/22,Iraq,33.223191,43.679291,2460868,0,25356,2435512
10/22/22,Iraq,33.223191,43.679291,2460868,0,25356,2435512
10/23/22,Iraq,33.223191,43.679291,2460868,0,25356,2435512
10/24/22,Iraq,33.223191,43.679291,2461247,0,25358,2435889
10/25/22,Iraq,33.223191,43.679291,2461247,0,25358,2435889
10/26/22,Iraq,33.223191,43.679291,2461247,0,25358,2435889
10/27/22,Iraq,33.223191,43.679291,2461247,0,25358,2435889
10/28/22,Iraq,33.223191,43.679291,2461247,0,25358,2435889
10/29/22,Iraq,33.223191,43.679291,2461247,0,25358,2435889
10/30/22,Iraq,33.223191,43.679291,2461247,0,25358,2435889
10/31/22,Iraq,33.223191,43.679291,2461484,0,25358,2436126
11/1/22,Iraq,33.223191,43.679291,2461484,0,25358,2436126
11/2/22,Iraq,33.223191,43.679291,2461484,0,25358,2436126
11/3/22,Iraq,33.223191,43.679291,2461484,0,25358,2436126
11/4/22,Iraq,33.223191,43.679291,2461484,0,25358,2436126
11/5/22,Iraq,33.223191,43.679291,2461484,0,25358,2436126
11/6/22,Iraq,33.223191,43.679291,2461484,0,25358,2436126
11/7/22,Iraq,33.223191,43.679291,2461857,0,25361,2436496
11/8/22,Iraq,33.223191,43.679291,2461857,0,25361,2436496
11/9/22,Iraq,33.223191,43.679291,2461857,0,25361,2436496
11/10/22,Iraq,33.223191,43.679291,2461857,0,25361,2436496
11/11/22,Iraq,33.223191,43.679291,2461857,0,25361,2436496
11/12/22,Iraq,33.223191,43.679291,2461857,0,25361,2436496
11/13/22,Iraq,33.223191,43.679291,2461857,0,25361,2436496
11/14/22,Iraq,33.223191,43.679291,2462317,0,25361,2436956
11/15/22,Iraq,33.223191,43.679291,2462317,0,25361,2436956
11/16/22,Iraq,33.223191,43.679291,2462317,0,25361,2436956
11/17/22,Iraq,33.223191,43.679291,2462317,0,25361,2436956
11/18/22,Iraq,33.223191,43.679291,2462317,0,25361,2436956
11/19/22,Iraq,33.223191,43.679291,2462317,0,25361,2436956
11/20/22,Iraq,33.223191,43.679291,2462317,0,25361,2436956
11/21/22,Iraq,33.223191,43.679291,2463021,0,25363,2437658
11/22/22,Iraq,33.223191,43.679291,2463021,0,25363,2437658
11/23/22,Iraq,33.223191,43.679291,2463021,0,25363,2437658
11/24/22,Iraq,33.223191,43.679291,2463021,0,25363,2437658
11/25/22,Iraq,33.223191,43.679291,2463021,0,25363,2437658
11/26/22,Iraq,33.223191,43.679291,2463021,0,25363,2437658
11/27/22,Iraq,33.223191,43.679291,2463021,0,25363,2437658
11/28/22,Iraq,33.223191,43.679291,2463724,0,25364,2438360
11/29/22,Iraq,33.223191,43.679291,2463724,0,25364,2438360
11/30/22,Iraq,33.223191,43.679291,2463724,0,25364,2438360
12/1/22,Iraq,33.223191,43.679291,2463724,0,25364,2438360
12/2/22,Iraq,33.223191,43.679291,2463724,0,25364,2438360
12/3/22,Iraq,33.223191,43.679291,2463724,0,25364,2438360
12/4/22,Iraq,33.223191,43.679291,2463724,0,25364,2438360
12/5/22,Iraq,33.223191,43.679291,2464375,0,25366,2439009
12/6/22,Iraq,33.223191,43.679291,2464375,0,25366,2439009
12/7/22,Iraq,33.223191,43.679291,2464375,0,25366,2439009
12/8/22,Iraq,33.223191,43.679291,2464375,0,25366,2439009
12/9/22,Iraq,33.223191,43.679291,2464375,0,25366,2439009
12/10/22,Iraq,33.223191,43.679291,2464375,0,25366,2439009
12/11/22,Iraq,33.223191,43.679291,2464375,0,25366,2439009
12/12/22,Iraq,33.223191,43.679291,2464375,0,25366,2439009
12/13/22,Iraq,33.223191,43.679291,2464375,0,25366,2439009
12/14/22,Iraq,33.223191,43.679291,2464375,0,25366,2439009
12/15/22,Iraq,33.223191,43.679291,2464375,0,25366,2439009
12/16/22,Iraq,33.223191,43.679291,2464375,0,25366,2439009
12/17/22,Iraq,33.223191,43.679291,2464375,0,25366,2439009
1/1/22,Ireland,53.1424,-7.6921,811840,0,5912,805928
1/2/22,Ireland,53.1424,-7.6921,811840,0,5912,805928
1/3/22,Ireland,53.1424,-7.6921,845897,0,5912,839985
1/4/22,Ireland,53.1424,-7.6921,867199,0,5912,861287
1/5/22,Ireland,53.1424,-7.6921,884855,0,5952,878903
1/6/22,Ireland,53.1424,-7.6921,908672,0,5952,902720
1/7/22,Ireland,53.1424,-7.6921,930598,0,5952,924646
1/8/22,Ireland,53.1424,-7.6921,956720,0,5952,950768
1/9/22,Ireland,53.1424,-7.6921,978104,0,5952,972152
1/10/22,Ireland,53.1424,-7.6921,978104,0,5952,972152
1/11/22,Ireland,53.1424,-7.6921,1021303,0,5952,1015351
1/12/22,Ireland,53.1424,-7.6921,1042212,0,6035,1036177
1/13/22,Ireland,53.1424,-7.6921,1061116,0,6035,1055081
1/14/22,Ireland,53.1424,-7.6921,1078181,0,6035,1072146
1/15/22,Ireland,53.1424,-7.6921,1092736,0,6035,1086701
1/16/22,Ireland,53.1424,-7.6921,1103489,0,6035,1097454
1/17/22,Ireland,53.1424,-7.6921,1109818,0,6035,1103783
1/18/22,Ireland,53.1424,-7.6921,1115585,0,6035,1109550
1/19/22,Ireland,53.1424,-7.6921,1122428,0,6087,1116341
1/20/22,Ireland,53.1424,-7.6921,1127951,0,6087,1121864
1/21/22,Ireland,53.1424,-7.6921,1134548,0,6087,1128461
1/22/22,Ireland,53.1424,-7.6921,1141237,0,6087,1135150
1/23/22,Ireland,53.1424,-7.6921,1145968,0,6087,1139881
1/24/22,Ireland,53.1424,-7.6921,1149660,0,6087,1143573
1/25/22,Ireland,53.1424,-7.6921,1153666,0,6087,1147579
1/26/22,Ireland,53.1424,-7.6921,1159271,0,6136,1153135
1/27/22,Ireland,53.1424,-7.6921,1164536,0,6136,1158400
1/28/22,Ireland,53.1424,-7.6921,1169645,0,6136,1163509
1/29/22,Ireland,53.1424,-7.6921,1169645,0,6136,1163509
1/30/22,Ireland,53.1424,-7.6921,1169645,0,6136,1163509
1/31/22,Ireland,53.1424,-7.6921,1183008,0,6136,1176872
2/1/22,Ireland,53.1424,-7.6921,1187216,0,6136,1181080
2/2/22,Ireland,53.1424,-7.6921,1193156,0,6228,1186928
2/3/22,Ireland,53.1424,-7.6921,1199217,0,6228,1192989
2/4/22,Ireland,53.1424,-7.6921,1205914,0,6228,1199686
2/5/22,Ireland,53.1424,-7.6921,1205914,0,6228,1199686
2/6/22,Ireland,53.1424,-7.6921,1205914,0,6228,1199686
2/7/22,Ireland,53.1424,-7.6921,1221082,0,6228,1214854
2/8/22,Ireland,53.1424,-7.6921,1224862,0,6228,1218634
2/9/22,Ireland,53.1424,-7.6921,1230539,0,6291,1224248
2/10/22,Ireland,53.1424,-7.6921,1236188,0,6291,1229897
2/11/22,Ireland,53.1424,-7.6921,1242806,0,6291,1236515
2/12/22,Ireland,53.1424,-7.6921,1242806,0,6291,1236515
2/13/22,Ireland,53.1424,-7.6921,1242806,0,6291,1236515
2/14/22,Ireland,53.1424,-7.6921,1255571,0,6291,1249280
2/15/22,Ireland,53.1424,-7.6921,1250039,0,6390,1243649
2/16/22,Ireland,53.1424,-7.6921,1255303,0,6399,1248904
2/17/22,Ireland,53.1424,-7.6921,1260329,0,6402,1253927
2/18/22,Ireland,53.1424,-7.6921,1265124,0,6417,1258707
2/19/22,Ireland,53.1424,-7.6921,1265124,0,6417,1258707
2/20/22,Ireland,53.1424,-7.6921,1265124,0,6417,1258707
2/21/22,Ireland,53.1424,-7.6921,1276778,0,6443,1270335
2/22/22,Ireland,53.1424,-7.6921,1280058,0,6452,1273606
2/23/22,Ireland,53.1424,-7.6921,1284179,0,6460,1277719
2/24/22,Ireland,53.1424,-7.6921,1287908,0,6471,1281437
2/25/22,Ireland,53.1424,-7.6921,1292212,0,6475,1285737
2/26/22,Ireland,53.1424,-7.6921,1292212,0,6475,1285737
2/27/22,Ireland,53.1424,-7.6921,1292212,0,6475,1285737
2/28/22,Ireland,53.1424,-7.6921,1300422,0,6497,1293925
3/1/22,Ireland,53.1424,-7.6921,1303720,0,6508,1297212
3/2/22,Ireland,53.1424,-7.6921,1307062,0,6521,1300541
3/3/22,Ireland,53.1424,-7.6921,1311105,0,6527,1304578
3/4/22,Ireland,53.1424,-7.6921,1315100,0,6531,1308569
3/5/22,Ireland,53.1424,-7.6921,1315100,0,6531,1308569
3/6/22,Ireland,53.1424,-7.6921,1315100,0,6531,1308569
3/7/22,Ireland,53.1424,-7.6921,1322591,0,6570,1316021
3/8/22,Ireland,53.1424,-7.6921,1326946,0,6571,1320375
3/9/22,Ireland,53.1424,-7.6921,1328644,0,6578,1322066
3/10/22,Ireland,53.1424,-7.6921,1332701,0,6590,1326111
3/11/22,Ireland,53.1424,-7.6921,1341826,0,6611,1335215
3/12/22,Ireland,53.1424,-7.6921,1341826,0,6611,1335215
3/13/22,Ireland,53.1424,-7.6921,1341826,0,6611,1335215
3/14/22,Ireland,53.1424,-7.6921,1353733,0,6624,1347109
3/15/22,Ireland,53.1424,-7.6921,1360015,0,6636,1353379
3/16/22,Ireland,53.1424,-7.6921,1365467,0,6638,1358829
3/17/22,Ireland,53.1424,-7.6921,1365467,0,6638,1358829
3/18/22,Ireland,53.1424,-7.6921,1365467,0,6638,1358829
3/19/22,Ireland,53.1424,-7.6921,1365467,0,6638,1358829
3/20/22,Ireland,53.1424,-7.6921,1365467,0,6638,1358829
3/21/22,Ireland,53.1424,-7.6921,1390177,0,6664,1383513
3/22/22,Ireland,53.1424,-7.6921,1397885,0,6680,1391205
3/23/22,Ireland,53.1424,-7.6921,1404929,0,6685,1398244
3/24/22,Ireland,53.1424,-7.6921,1413798,0,6693,1407105
3/25/22,Ireland,53.1424,-7.6921,1422945,0,6710,1416235
3/26/22,Ireland,53.1424,-7.6921,1422945,0,6710,1416235
3/27/22,Ireland,53.1424,-7.6921,1422945,0,6710,1416235
3/28/22,Ireland,53.1424,-7.6921,1442877,0,6721,1436156
3/29/22,Ireland,53.1424,-7.6921,1448812,0,6730,1442082
3/30/22,Ireland,53.1424,-7.6921,1454182,0,6740,1447442
3/31/22,Ireland,53.1424,-7.6921,1459425,0,6753,1452672
4/1/22,Ireland,53.1424,-7.6921,1465150,0,6786,1458364
4/2/22,Ireland,53.1424,-7.6921,1465150,0,6786,1458364
4/3/22,Ireland,53.1424,-7.6921,1465150,0,6786,1458364
4/4/22,Ireland,53.1424,-7.6921,1474374,0,6799,1467575
4/5/22,Ireland,53.1424,-7.6921,1477112,0,6805,1470307
4/6/22,Ireland,53.1424,-7.6921,1481171,0,6824,1474347
4/7/22,Ireland,53.1424,-7.6921,1484321,0,6843,1477478
4/8/22,Ireland,53.1424,-7.6921,1487164,0,6863,1480301
4/9/22,Ireland,53.1424,-7.6921,1487164,0,6863,1480301
4/10/22,Ireland,53.1424,-7.6921,1487164,0,6863,1480301
4/11/22,Ireland,53.1424,-7.6921,1493066,0,6884,1486182
4/12/22,Ireland,53.1424,-7.6921,1494814,0,6903,1487911
4/13/22,Ireland,53.1424,-7.6921,1496910,0,6919,1489991
4/14/22,Ireland,53.1424,-7.6921,1498834,0,6932,1491902
4/15/22,Ireland,53.1424,-7.6921,1498834,0,6932,1491902
4/16/22,Ireland,53.1424,-7.6921,1498834,0,6932,1491902
4/17/22,Ireland,53.1424,-7.6921,1498834,0,6932,1491902
4/18/22,Ireland,53.1424,-7.6921,1498834,0,6932,1491902
4/19/22,Ireland,53.1424,-7.6921,1505568,0,6964,1498604
4/20/22,Ireland,53.1424,-7.6921,1506963,0,6981,1499982
4/21/22,Ireland,53.1424,-7.6921,1508373,0,6993,1501380
4/22/22,Ireland,53.1424,-7.6921,1509536,0,6996,1502540
4/23/22,Ireland,53.1424,-7.6921,1509536,0,6996,1502540
4/24/22,Ireland,53.1424,-7.6921,1509536,0,6996,1502540
4/25/22,Ireland,53.1424,-7.6921,1512812,0,7016,1505796
4/26/22,Ireland,53.1424,-7.6921,1514035,0,7028,1507007
4/27/22,Ireland,53.1424,-7.6921,1515005,0,7054,1507951
4/28/22,Ireland,53.1424,-7.6921,1516153,0,7076,1509077
4/29/22,Ireland,53.1424,-7.6921,1517112,0,7087,1510025
4/30/22,Ireland,53.1424,-7.6921,1517112,0,7087,1510025
5/1/22,Ireland,53.1424,-7.6921,1517112,0,7087,1510025
5/2/22,Ireland,53.1424,-7.6921,1517112,0,7087,1510025
5/3/22,Ireland,53.1424,-7.6921,1519296,0,7092,1512204
5/4/22,Ireland,53.1424,-7.6921,1520327,0,7103,1513224
5/5/22,Ireland,53.1424,-7.6921,1521474,0,7108,1514366
5/6/22,Ireland,53.1424,-7.6921,1522363,0,7131,1515232
5/7/22,Ireland,53.1424,-7.6921,1522363,0,7131,1515232
5/8/22,Ireland,53.1424,-7.6921,1522363,0,7131,1515232
5/9/22,Ireland,53.1424,-7.6921,1524555,0,7163,1517392
5/10/22,Ireland,53.1424,-7.6921,1527328,0,7167,1520161
5/11/22,Ireland,53.1424,-7.6921,1529627,0,7170,1522457
5/12/22,Ireland,53.1424,-7.6921,1532771,0,7176,1525595
5/13/22,Ireland,53.1424,-7.6921,1535451,0,7203,1528248
5/14/22,Ireland,53.1424,-7.6921,1535451,0,7203,1528248
5/15/22,Ireland,53.1424,-7.6921,1535451,0,7203,1528248
5/16/22,Ireland,53.1424,-7.6921,1535451,0,7203,1528248
5/17/22,Ireland,53.1424,-7.6921,1535451,0,7203,1528248
5/18/22,Ireland,53.1424,-7.6921,1551835,0,7244,1544591
5/19/22,Ireland,53.1424,-7.6921,1551835,0,7244,1544591
5/20/22,Ireland,53.1424,-7.6921,1551835,0,7244,1544591
5/21/22,Ireland,53.1424,-7.6921,1551835,0,7244,1544591
5/22/22,Ireland,53.1424,-7.6921,1551835,0,7244,1544591
5/23/22,Ireland,53.1424,-7.6921,1551835,0,7244,1544591
5/24/22,Ireland,53.1424,-7.6921,1551835,0,7244,1544591
5/25/22,Ireland,53.1424,-7.6921,1561632,0,7304,1554328
5/26/22,Ireland,53.1424,-7.6921,1561632,0,7304,1554328
5/27/22,Ireland,53.1424,-7.6921,1561632,0,7304,1554328
5/28/22,Ireland,53.1424,-7.6921,1561632,0,7304,1554328
5/29/22,Ireland,53.1424,-7.6921,1561632,0,7304,1554328
5/30/22,Ireland,53.1424,-7.6921,1561632,0,7304,1554328
5/31/22,Ireland,53.1424,-7.6921,1561632,0,7304,1554328
6/1/22,Ireland,53.1424,-7.6921,1565970,0,7381,1558589
6/2/22,Ireland,53.1424,-7.6921,1565970,0,7381,1558589
6/3/22,Ireland,53.1424,-7.6921,1565970,0,7381,1558589
6/4/22,Ireland,53.1424,-7.6921,1565970,0,7381,1558589
6/5/22,Ireland,53.1424,-7.6921,1565970,0,7381,1558589
6/6/22,Ireland,53.1424,-7.6921,1565970,0,7381,1558589
6/7/22,Ireland,53.1424,-7.6921,1565970,0,7381,1558589
6/8/22,Ireland,53.1424,-7.6921,1570519,0,7416,1563103
6/9/22,Ireland,53.1424,-7.6921,1570519,0,7416,1563103
6/10/22,Ireland,53.1424,-7.6921,1570519,0,7416,1563103
6/11/22,Ireland,53.1424,-7.6921,1570519,0,7416,1563103
6/12/22,Ireland,53.1424,-7.6921,1570519,0,7416,1563103
6/13/22,Ireland,53.1424,-7.6921,1570519,0,7416,1563103
6/14/22,Ireland,53.1424,-7.6921,1570519,0,7416,1563103
6/15/22,Ireland,53.1424,-7.6921,1578284,0,7442,1570842
6/16/22,Ireland,53.1424,-7.6921,1578284,0,7442,1570842
6/17/22,Ireland,53.1424,-7.6921,1578284,0,7442,1570842
6/18/22,Ireland,53.1424,-7.6921,1578284,0,7442,1570842
6/19/22,Ireland,53.1424,-7.6921,1578284,0,7442,1570842
6/20/22,Ireland,53.1424,-7.6921,1578284,0,7442,1570842
6/21/22,Ireland,53.1424,-7.6921,1578284,0,7442,1570842
6/22/22,Ireland,53.1424,-7.6921,1587385,0,7469,1579916
6/23/22,Ireland,53.1424,-7.6921,1587385,0,7469,1579916
6/24/22,Ireland,53.1424,-7.6921,1587385,0,7469,1579916
6/25/22,Ireland,53.1424,-7.6921,1587385,0,7469,1579916
6/26/22,Ireland,53.1424,-7.6921,1587385,0,7469,1579916
6/27/22,Ireland,53.1424,-7.6921,1587385,0,7469,1579916
6/28/22,Ireland,53.1424,-7.6921,1587385,0,7469,1579916
6/29/22,Ireland,53.1424,-7.6921,1600614,0,7499,1593115
6/30/22,Ireland,53.1424,-7.6921,1600614,0,7499,1593115
7/1/22,Ireland,53.1424,-7.6921,1600614,0,7499,1593115
7/2/22,Ireland,53.1424,-7.6921,1600614,0,7499,1593115
7/3/22,Ireland,53.1424,-7.6921,1600614,0,7499,1593115
7/4/22,Ireland,53.1424,-7.6921,1600614,0,7499,1593115
7/5/22,Ireland,53.1424,-7.6921,1600614,0,7499,1593115
7/6/22,Ireland,53.1424,-7.6921,1614631,0,7536,1607095
7/7/22,Ireland,53.1424,-7.6921,1614631,0,7536,1607095
7/8/22,Ireland,53.1424,-7.6921,1614631,0,7536,1607095
7/9/22,Ireland,53.1424,-7.6921,1614631,0,7536,1607095
7/10/22,Ireland,53.1424,-7.6921,1614631,0,7536,1607095
7/11/22,Ireland,53.1424,-7.6921,1614631,0,7536,1607095
7/12/22,Ireland,53.1424,-7.6921,1614631,0,7536,1607095
7/13/22,Ireland,53.1424,-7.6921,1628745,0,7571,1621174
7/14/22,Ireland,53.1424,-7.6921,1628745,0,7571,1621174
7/15/22,Ireland,53.1424,-7.6921,1628745,0,7571,1621174
7/16/22,Ireland,53.1424,-7.6921,1628745,0,7571,1621174
7/17/22,Ireland,53.1424,-7.6921,1628745,0,7571,1621174
7/18/22,Ireland,53.1424,-7.6921,1628745,0,7571,1621174
7/19/22,Ireland,53.1424,-7.6921,1628745,0,7571,1621174
7/20/22,Ireland,53.1424,-7.6921,1639459,0,7620,1631839
7/21/22,Ireland,53.1424,-7.6921,1639459,0,7620,1631839
7/22/22,Ireland,53.1424,-7.6921,1639459,0,7620,1631839
7/23/22,Ireland,53.1424,-7.6921,1639459,0,7620,1631839
7/24/22,Ireland,53.1424,-7.6921,1639459,0,7620,1631839
7/25/22,Ireland,53.1424,-7.6921,1639459,0,7620,1631839
7/26/22,Ireland,53.1424,-7.6921,1639459,0,7620,1631839
7/27/22,Ireland,53.1424,-7.6921,1644166,0,7675,1636491
7/28/22,Ireland,53.1424,-7.6921,1644166,0,7675,1636491
7/29/22,Ireland,53.1424,-7.6921,1644166,0,7675,1636491
7/30/22,Ireland,53.1424,-7.6921,1644166,0,7675,1636491
7/31/22,Ireland,53.1424,-7.6921,1644166,0,7675,1636491
8/1/22,Ireland,53.1424,-7.6921,1644166,0,7675,1636491
8/2/22,Ireland,53.1424,-7.6921,1644166,0,7675,1636491
8/3/22,Ireland,53.1424,-7.6921,1647605,0,7700,1639905
8/4/22,Ireland,53.1424,-7.6921,1647605,0,7700,1639905
8/5/22,Ireland,53.1424,-7.6921,1647605,0,7700,1639905
8/6/22,Ireland,53.1424,-7.6921,1647605,0,7700,1639905
8/7/22,Ireland,53.1424,-7.6921,1647605,0,7700,1639905
8/8/22,Ireland,53.1424,-7.6921,1647605,0,7700,1639905
8/9/22,Ireland,53.1424,-7.6921,1647605,0,7700,1639905
8/10/22,Ireland,53.1424,-7.6921,1650791,0,7743,1643048
8/11/22,Ireland,53.1424,-7.6921,1650791,0,7743,1643048
8/12/22,Ireland,53.1424,-7.6921,1650791,0,7743,1643048
8/13/22,Ireland,53.1424,-7.6921,1650791,0,7743,1643048
8/14/22,Ireland,53.1424,-7.6921,1650791,0,7743,1643048
8/15/22,Ireland,53.1424,-7.6921,1650791,0,7743,1643048
8/16/22,Ireland,53.1424,-7.6921,1650791,0,7743,1643048
8/17/22,Ireland,53.1424,-7.6921,1653576,0,7782,1645794
8/18/22,Ireland,53.1424,-7.6921,1653576,0,7782,1645794
8/19/22,Ireland,53.1424,-7.6921,1653576,0,7782,1645794
8/20/22,Ireland,53.1424,-7.6921,1653576,0,7782,1645794
8/21/22,Ireland,53.1424,-7.6921,1653576,0,7782,1645794
8/22/22,Ireland,53.1424,-7.6921,1653576,0,7782,1645794
8/23/22,Ireland,53.1424,-7.6921,1653576,0,7782,1645794
8/24/22,Ireland,53.1424,-7.6921,1655338,0,7820,1647518
8/25/22,Ireland,53.1424,-7.6921,1655338,0,7820,1647518
8/26/22,Ireland,53.1424,-7.6921,1655338,0,7820,1647518
8/27/22,Ireland,53.1424,-7.6921,1655338,0,7820,1647518
8/28/22,Ireland,53.1424,-7.6921,1655338,0,7820,1647518
8/29/22,Ireland,53.1424,-7.6921,1655338,0,7820,1647518
8/30/22,Ireland,53.1424,-7.6921,1655338,0,7820,1647518
8/31/22,Ireland,53.1424,-7.6921,1656956,0,7839,1649117
9/1/22,Ireland,53.1424,-7.6921,1656956,0,7839,1649117
9/2/22,Ireland,53.1424,-7.6921,1656956,0,7839,1649117
9/3/22,Ireland,53.1424,-7.6921,1656956,0,7839,1649117
9/4/22,Ireland,53.1424,-7.6921,1656956,0,7839,1649117
9/5/22,Ireland,53.1424,-7.6921,1656956,0,7839,1649117
9/6/22,Ireland,53.1424,-7.6921,1656956,0,7839,1649117
9/7/22,Ireland,53.1424,-7.6921,1659034,0,7870,1651164
9/8/22,Ireland,53.1424,-7.6921,1659034,0,7870,1651164
9/9/22,Ireland,53.1424,-7.6921,1659034,0,7870,1651164
9/10/22,Ireland,53.1424,-7.6921,1659034,0,7870,1651164
9/11/22,Ireland,53.1424,-7.6921,1659034,0,7870,1651164
9/12/22,Ireland,53.1424,-7.6921,1659034,0,7870,1651164
9/13/22,Ireland,53.1424,-7.6921,1659034,0,7870,1651164
9/14/22,Ireland,53.1424,-7.6921,1660635,0,7901,1652734
9/15/22,Ireland,53.1424,-7.6921,1660635,0,7901,1652734
9/16/22,Ireland,53.1424,-7.6921,1660635,0,7901,1652734
9/17/22,Ireland,53.1424,-7.6921,1660635,0,7901,1652734
9/18/22,Ireland,53.1424,-7.6921,1660635,0,7901,1652734
9/19/22,Ireland,53.1424,-7.6921,1660635,0,7901,1652734
9/20/22,Ireland,53.1424,-7.6921,1660635,0,7901,1652734
9/21/22,Ireland,53.1424,-7.6921,1662008,0,7922,1654086
9/22/22,Ireland,53.1424,-7.6921,1662008,0,7922,1654086
9/23/22,Ireland,53.1424,-7.6921,1662008,0,7922,1654086
9/24/22,Ireland,53.1424,-7.6921,1662008,0,7922,1654086
9/25/22,Ireland,53.1424,-7.6921,1662008,0,7922,1654086
9/26/22,Ireland,53.1424,-7.6921,1662008,0,7922,1654086
9/27/22,Ireland,53.1424,-7.6921,1662008,0,7922,1654086
9/28/22,Ireland,53.1424,-7.6921,1663653,0,7942,1655711
9/29/22,Ireland,53.1424,-7.6921,1663653,0,7942,1655711
9/30/22,Ireland,53.1424,-7.6921,1663653,0,7942,1655711
10/1/22,Ireland,53.1424,-7.6921,1663653,0,7942,1655711
10/2/22,Ireland,53.1424,-7.6921,1663653,0,7942,1655711
10/3/22,Ireland,53.1424,-7.6921,1663653,0,7942,1655711
10/4/22,Ireland,53.1424,-7.6921,1663653,0,7942,1655711
10/5/22,Ireland,53.1424,-7.6921,1666048,0,7959,1658089
10/6/22,Ireland,53.1424,-7.6921,1666048,0,7959,1658089
10/7/22,Ireland,53.1424,-7.6921,1666048,0,7959,1658089
10/8/22,Ireland,53.1424,-7.6921,1666048,0,7959,1658089
10/9/22,Ireland,53.1424,-7.6921,1666048,0,7959,1658089
10/10/22,Ireland,53.1424,-7.6921,1666048,0,7959,1658089
10/11/22,Ireland,53.1424,-7.6921,1666048,0,7959,1658089
10/12/22,Ireland,53.1424,-7.6921,1668301,0,7988,1660313
10/13/22,Ireland,53.1424,-7.6921,1668301,0,7988,1660313
10/14/22,Ireland,53.1424,-7.6921,1668301,0,7988,1660313
10/15/22,Ireland,53.1424,-7.6921,1668301,0,7988,1660313
10/16/22,Ireland,53.1424,-7.6921,1668301,0,7988,1660313
10/17/22,Ireland,53.1424,-7.6921,1668301,0,7988,1660313
10/18/22,Ireland,53.1424,-7.6921,1668301,0,7988,1660313
10/19/22,Ireland,53.1424,-7.6921,1670377,0,8010,1662367
10/20/22,Ireland,53.1424,-7.6921,1670377,0,8010,1662367
10/21/22,Ireland,53.1424,-7.6921,1670377,0,8010,1662367
10/22/22,Ireland,53.1424,-7.6921,1670377,0,8010,1662367
10/23/22,Ireland,53.1424,-7.6921,1670377,0,8010,1662367
10/24/22,Ireland,53.1424,-7.6921,1670377,0,8010,1662367
10/25/22,Ireland,53.1424,-7.6921,1670377,0,8010,1662367
10/26/22,Ireland,53.1424,-7.6921,1672319,0,8043,1664276
10/27/22,Ireland,53.1424,-7.6921,1672319,0,8043,1664276
10/28/22,Ireland,53.1424,-7.6921,1672319,0,8043,1664276
10/29/22,Ireland,53.1424,-7.6921,1672319,0,8043,1664276
10/30/22,Ireland,53.1424,-7.6921,1672319,0,8043,1664276
10/31/22,Ireland,53.1424,-7.6921,1672319,0,8043,1664276
11/1/22,Ireland,53.1424,-7.6921,1672319,0,8043,1664276
11/2/22,Ireland,53.1424,-7.6921,1673665,0,8066,1665599
11/3/22,Ireland,53.1424,-7.6921,1673665,0,8066,1665599
11/4/22,Ireland,53.1424,-7.6921,1673665,0,8066,1665599
11/5/22,Ireland,53.1424,-7.6921,1673665,0,8066,1665599
11/6/22,Ireland,53.1424,-7.6921,1673665,0,8066,1665599
11/7/22,Ireland,53.1424,-7.6921,1673665,0,8066,1665599
11/8/22,Ireland,53.1424,-7.6921,1673665,0,8066,1665599
11/9/22,Ireland,53.1424,-7.6921,1675723,0,8100,1667623
11/10/22,Ireland,53.1424,-7.6921,1675723,0,8100,1667623
11/11/22,Ireland,53.1424,-7.6921,1675723,0,8100,1667623
11/12/22,Ireland,53.1424,-7.6921,1675723,0,8100,1667623
11/13/22,Ireland,53.1424,-7.6921,1675723,0,8100,1667623
11/14/22,Ireland,53.1424,-7.6921,1675723,0,8100,1667623
11/15/22,Ireland,53.1424,-7.6921,1675723,0,8100,1667623
11/16/22,Ireland,53.1424,-7.6921,1677386,0,8141,1669245
11/17/22,Ireland,53.1424,-7.6921,1677386,0,8141,1669245
11/18/22,Ireland,53.1424,-7.6921,1677386,0,8141,1669245
11/19/22,Ireland,53.1424,-7.6921,1677386,0,8141,1669245
11/20/22,Ireland,53.1424,-7.6921,1677386,0,8141,1669245
11/21/22,Ireland,53.1424,-7.6921,1677386,0,8141,1669245
11/22/22,Ireland,53.1424,-7.6921,1677386,0,8141,1669245
11/23/22,Ireland,53.1424,-7.6921,1678827,0,8170,1670657
11/24/22,Ireland,53.1424,-7.6921,1678827,0,8170,1670657
11/25/22,Ireland,53.1424,-7.6921,1678827,0,8170,1670657
11/26/22,Ireland,53.1424,-7.6921,1678827,0,8170,1670657
11/27/22,Ireland,53.1424,-7.6921,1678827,0,8170,1670657
11/28/22,Ireland,53.1424,-7.6921,1678827,0,8170,1670657
11/29/22,Ireland,53.1424,-7.6921,1678827,0,8170,1670657
11/30/22,Ireland,53.1424,-7.6921,1680548,0,8197,1672351
12/1/22,Ireland,53.1424,-7.6921,1680548,0,8197,1672351
12/2/22,Ireland,53.1424,-7.6921,1680548,0,8197,1672351
12/3/22,Ireland,53.1424,-7.6921,1680548,0,8197,1672351
12/4/22,Ireland,53.1424,-7.6921,1680548,0,8197,1672351
12/5/22,Ireland,53.1424,-7.6921,1680548,0,8197,1672351
12/6/22,Ireland,53.1424,-7.6921,1680548,0,8197,1672351
12/7/22,Ireland,53.1424,-7.6921,1682409,0,8231,1674178
12/8/22,Ireland,53.1424,-7.6921,1682409,0,8231,1674178
12/9/22,Ireland,53.1424,-7.6921,1682409,0,8231,1674178
12/10/22,Ireland,53.1424,-7.6921,1682409,0,8231,1674178
12/11/22,Ireland,53.1424,-7.6921,1682409,0,8231,1674178
12/12/22,Ireland,53.1424,-7.6921,1682409,0,8231,1674178
12/13/22,Ireland,53.1424,-7.6921,1682409,0,8231,1674178
12/14/22,Ireland,53.1424,-7.6921,1684717,0,8270,1676447
12/15/22,Ireland,53.1424,-7.6921,1684717,0,8270,1676447
12/16/22,Ireland,53.1424,-7.6921,1684717,0,8270,1676447
12/17/22,Ireland,53.1424,-7.6921,1684717,0,8270,1676447
1/1/22,Israel,31.046051,34.851612,1390053,0,8244,1381809
1/2/22,Israel,31.046051,34.851612,1395113,0,8244,1386869
1/3/22,Israel,31.046051,34.851612,1404916,0,8247,1396669
1/4/22,Israel,31.046051,34.851612,1411798,0,8247,1403551
1/5/22,Israel,31.046051,34.851612,1429030,0,8253,1420777
1/6/22,Israel,31.046051,34.851612,1448448,0,8259,1440189
1/7/22,Israel,31.046051,34.851612,1463193,0,8259,1454934
1/8/22,Israel,31.046051,34.851612,1485591,0,8259,1477332
1/9/22,Israel,31.046051,34.851612,1503082,0,8269,1494813
1/10/22,Israel,31.046051,34.851612,1557597,0,8271,1549326
1/11/22,Israel,31.046051,34.851612,1589099,0,8274,1580825
1/12/22,Israel,31.046051,34.851612,1669622,0,8290,1661332
1/13/22,Israel,31.046051,34.851612,1695505,0,8293,1687212
1/14/22,Israel,31.046051,34.851612,1718982,0,8298,1710684
1/15/22,Israel,31.046051,34.851612,1773629,0,8304,1765325
1/16/22,Israel,31.046051,34.851612,1792130,0,8318,1783812
1/17/22,Israel,31.046051,34.851612,1792130,0,8318,1783812
1/18/22,Israel,31.046051,34.851612,1792130,0,8318,1783812
1/19/22,Israel,31.046051,34.851612,2035425,0,8362,2027063
1/20/22,Israel,31.046051,34.851612,2103938,0,8370,2095568
1/21/22,Israel,31.046051,34.851612,2168009,0,8371,2159638
1/22/22,Israel,31.046051,34.851612,2212589,0,8393,2204196
1/23/22,Israel,31.046051,34.851612,2212589,0,8393,2204196
1/24/22,Israel,31.046051,34.851612,2424823,0,8481,2416342
1/25/22,Israel,31.046051,34.851612,2505466,0,8502,2496964
1/26/22,Israel,31.046051,34.851612,2599449,0,8513,2590936
1/27/22,Israel,31.046051,34.851612,2659720,0,8556,2651164
1/28/22,Israel,31.046051,34.851612,2705096,0,8599,2696497
1/29/22,Israel,31.046051,34.851612,2759024,0,8658,2750366
1/30/22,Israel,31.046051,34.851612,2830154,0,8725,2821429
1/31/22,Israel,31.046051,34.851612,2900569,0,8805,2891764
2/1/22,Israel,31.046051,34.851612,2966444,0,8926,2957518
2/2/22,Israel,31.046051,34.851612,3037135,0,8927,3028208
2/3/22,Israel,31.046051,34.851612,3095812,0,9013,3086799
2/4/22,Israel,31.046051,34.851612,3111300,0,9111,3102189
2/5/22,Israel,31.046051,34.851612,3142811,0,9138,3133673
2/6/22,Israel,31.046051,34.851612,3196541,0,9180,3187361
2/7/22,Israel,31.046051,34.851612,3247419,0,9226,3238193
2/8/22,Israel,31.046051,34.851612,3286273,0,9303,3276970
2/9/22,Israel,31.046051,34.851612,3316228,0,9337,3306891
2/10/22,Israel,31.046051,34.851612,3347650,0,9399,3338251
2/11/22,Israel,31.046051,34.851612,3374697,0,9434,3365263
2/12/22,Israel,31.046051,34.851612,3394758,0,9466,3385292
2/13/22,Israel,31.046051,34.851612,3426096,0,9544,3416552
2/14/22,Israel,31.046051,34.851612,3451526,0,9624,3441902
2/15/22,Israel,31.046051,34.851612,3474120,0,9651,3464469
2/16/22,Israel,31.046051,34.851612,3491958,0,9687,3482271
2/17/22,Israel,31.046051,34.851612,3511868,0,9797,3502071
2/18/22,Israel,31.046051,34.851612,3523457,0,9828,3513629
2/19/22,Israel,31.046051,34.851612,3535055,0,9842,3525213
2/20/22,Israel,31.046051,34.851612,3552858,0,9971,3542887
2/21/22,Israel,31.046051,34.851612,3566809,0,10001,3556808
2/22/22,Israel,31.046051,34.851612,3576916,0,10038,3566878
2/23/22,Israel,31.046051,34.851612,3589326,0,10075,3579251
2/24/22,Israel,31.046051,34.851612,3601897,0,10105,3591792
2/25/22,Israel,31.046051,34.851612,3607504,0,10114,3597390
2/26/22,Israel,31.046051,34.851612,3615224,0,10126,3605098
2/27/22,Israel,31.046051,34.851612,3625738,0,10154,3615584
2/28/22,Israel,31.046051,34.851612,3634503,0,10198,3624305
3/1/22,Israel,31.046051,34.851612,3642695,0,10218,3632477
3/2/22,Israel,31.046051,34.851612,3651224,0,10237,3640987
3/3/22,Israel,31.046051,34.851612,3653601,0,10239,3643362
3/4/22,Israel,31.046051,34.851612,3662064,0,10264,3651800
3/5/22,Israel,31.046051,34.851612,3669112,0,10274,3658838
3/6/22,Israel,31.046051,34.851612,3673103,0,10282,3662821
3/7/22,Israel,31.046051,34.851612,3680632,0,10317,3670315
3/8/22,Israel,31.046051,34.851612,3688096,0,10322,3677774
3/9/22,Israel,31.046051,34.851612,3690974,0,10322,3680652
3/10/22,Israel,31.046051,34.851612,3704109,0,10358,3693751
3/11/22,Israel,31.046051,34.851612,3707470,0,10359,3697111
3/12/22,Israel,31.046051,34.851612,3712880,0,10367,3702513
3/13/22,Israel,31.046051,34.851612,3719437,0,10379,3709058
3/14/22,Israel,31.046051,34.851612,3725407,0,10392,3715015
3/15/22,Israel,31.046051,34.851612,3732579,0,10399,3722180
3/16/22,Israel,31.046051,34.851612,3737345,0,10405,3726940
3/17/22,Israel,31.046051,34.851612,3745401,0,10417,3734984
3/18/22,Israel,31.046051,34.851612,3751042,0,10417,3740625
3/19/22,Israel,31.046051,34.851612,3758948,0,10419,3748529
3/20/22,Israel,31.046051,34.851612,3772751,0,10431,3762320
3/21/22,Israel,31.046051,34.851612,3785806,0,10431,3775375
3/22/22,Israel,31.046051,34.851612,3801627,0,10449,3791178
3/23/22,Israel,31.046051,34.851612,3814628,0,10455,3804173
3/24/22,Israel,31.046051,34.851612,3818058,0,10455,3807603
3/25/22,Israel,31.046051,34.851612,3835693,0,10460,3825233
3/26/22,Israel,31.046051,34.851612,3848014,0,10460,3837554
3/27/22,Israel,31.046051,34.851612,3864148,0,10485,3853663
3/28/22,Israel,31.046051,34.851612,3876115,0,10485,3865630
3/29/22,Israel,31.046051,34.851612,3894134,0,10485,3883649
3/30/22,Israel,31.046051,34.851612,3904298,0,10485,3893813
3/31/22,Israel,31.046051,34.851612,3918225,0,10485,3907740
4/1/22,Israel,31.046051,34.851612,3926812,0,10496,3916316
4/2/22,Israel,31.046051,34.851612,3935094,0,10517,3924577
4/3/22,Israel,31.046051,34.851612,3946288,0,10530,3935758
4/4/22,Israel,31.046051,34.851612,3957492,0,10554,3946938
4/5/22,Israel,31.046051,34.851612,3967733,0,10554,3957179
4/6/22,Israel,31.046051,34.851612,3974774,0,10555,3964219
4/7/22,Israel,31.046051,34.851612,3982524,0,10559,3971965
4/8/22,Israel,31.046051,34.851612,3987827,0,10559,3977268
4/9/22,Israel,31.046051,34.851612,3993515,0,10559,3982956
4/10/22,Israel,31.046051,34.851612,3997856,0,10584,3987272
4/11/22,Israel,31.046051,34.851612,4006847,0,10591,3996256
4/12/22,Israel,31.046051,34.851612,4013193,0,10601,4002592
4/13/22,Israel,31.046051,34.851612,4016912,0,10601,4006311
4/14/22,Israel,31.046051,34.851612,4022685,0,10612,4012073
4/15/22,Israel,31.046051,34.851612,4025943,0,10612,4015331
4/16/22,Israel,31.046051,34.851612,4029066,0,10612,4018454
4/17/22,Israel,31.046051,34.851612,4031754,0,10630,4021124
4/18/22,Israel,31.046051,34.851612,4036677,0,10647,4026030
4/19/22,Israel,31.046051,34.851612,4040937,0,10647,4030290
4/20/22,Israel,31.046051,34.851612,4044987,0,10658,4034329
4/21/22,Israel,31.046051,34.851612,4047686,0,10658,4037028
4/22/22,Israel,31.046051,34.851612,4047686,0,10658,4037028
4/23/22,Israel,31.046051,34.851612,4054335,0,10658,4043677
4/24/22,Israel,31.046051,34.851612,4057765,0,10670,4047095
4/25/22,Israel,31.046051,34.851612,4062271,0,10673,4051598
4/26/22,Israel,31.046051,34.851612,4066014,0,10694,4055320
4/27/22,Israel,31.046051,34.851612,4067680,0,10695,4056985
4/28/22,Israel,31.046051,34.851612,4071484,0,10695,4060789
4/29/22,Israel,31.046051,34.851612,4074112,0,10695,4063417
4/30/22,Israel,31.046051,34.851612,4076104,0,10695,4065409
5/1/22,Israel,31.046051,34.851612,4077856,0,10698,4067158
5/2/22,Israel,31.046051,34.851612,4080480,0,10697,4069783
5/3/22,Israel,31.046051,34.851612,4082954,0,10699,4072255
5/4/22,Israel,31.046051,34.851612,4085411,0,10699,4074712
5/5/22,Israel,31.046051,34.851612,4086659,0,10741,4075918
5/6/22,Israel,31.046051,34.851612,4087878,0,10741,4077137
5/7/22,Israel,31.046051,34.851612,4090373,0,10741,4079632
5/8/22,Israel,31.046051,34.851612,4092047,0,10741,4081306
5/9/22,Israel,31.046051,34.851612,4095425,0,10741,4084684
5/10/22,Israel,31.046051,34.851612,4097837,0,10749,4087088
5/11/22,Israel,31.046051,34.851612,4100092,0,10749,4089343
5/12/22,Israel,31.046051,34.851612,4102024,0,10749,4091275
5/13/22,Israel,31.046051,34.851612,4104278,0,10749,4093529
5/14/22,Israel,31.046051,34.851612,4105361,0,10748,4094613
5/15/22,Israel,31.046051,34.851612,4108393,0,10800,4097593
5/16/22,Israel,31.046051,34.851612,4110592,0,10805,4099787
5/17/22,Israel,31.046051,34.851612,4112831,0,10812,4102019
5/18/22,Israel,31.046051,34.851612,4114959,0,10812,4104147
5/19/22,Israel,31.046051,34.851612,4117071,0,10826,4106245
5/20/22,Israel,31.046051,34.851612,4118975,0,10827,4108148
5/21/22,Israel,31.046051,34.851612,4120614,0,10827,4109787
5/22/22,Israel,31.046051,34.851612,4122312,0,10832,4111480
5/23/22,Israel,31.046051,34.851612,4125039,0,10833,4114206
5/24/22,Israel,31.046051,34.851612,4127018,0,10833,4116185
5/25/22,Israel,31.046051,34.851612,4127993,0,10833,4117160
5/26/22,Israel,31.046051,34.851612,4130871,0,10839,4120032
5/27/22,Israel,31.046051,34.851612,4130871,0,10839,4120032
5/28/22,Israel,31.046051,34.851612,4133701,0,10839,4122862
5/29/22,Israel,31.046051,34.851612,4134914,0,10839,4124075
5/30/22,Israel,31.046051,34.851612,4137293,0,10852,4126441
5/31/22,Israel,31.046051,34.851612,4138515,0,10852,4127663
6/1/22,Israel,31.046051,34.851612,4143714,0,10852,4132862
6/2/22,Israel,31.046051,34.851612,4146176,0,10860,4135316
6/3/22,Israel,31.046051,34.851612,4146176,0,10860,4135316
6/4/22,Israel,31.046051,34.851612,4146176,0,10860,4135316
6/5/22,Israel,31.046051,34.851612,4151978,0,10864,4141114
6/6/22,Israel,31.046051,34.851612,4154558,0,10864,4143694
6/7/22,Israel,31.046051,34.851612,4159589,0,10867,4148722
6/8/22,Israel,31.046051,34.851612,4164474,0,10867,4153607
6/9/22,Israel,31.046051,34.851612,4169330,0,10867,4158463
6/10/22,Israel,31.046051,34.851612,4175644,0,10867,4164777
6/11/22,Israel,31.046051,34.851612,4179780,0,10871,4168909
6/12/22,Israel,31.046051,34.851612,4183477,0,10882,4172595
6/13/22,Israel,31.046051,34.851612,4189850,0,10882,4178968
6/14/22,Israel,31.046051,34.851612,4198194,0,10882,4187312
6/15/22,Israel,31.046051,34.851612,4205416,0,10882,4194534
6/16/22,Israel,31.046051,34.851612,4209564,0,10882,4198682
6/17/22,Israel,31.046051,34.851612,4220524,0,10882,4209642
6/18/22,Israel,31.046051,34.851612,4226245,0,10896,4215349
6/19/22,Israel,31.046051,34.851612,4233759,0,10904,4222855
6/20/22,Israel,31.046051,34.851612,4244453,0,10911,4233542
6/21/22,Israel,31.046051,34.851612,4255122,0,10911,4244211
6/22/22,Israel,31.046051,34.851612,4265869,0,10911,4254958
6/23/22,Israel,31.046051,34.851612,4275786,0,10911,4264875
6/24/22,Israel,31.046051,34.851612,4286123,0,10921,4275202
6/25/22,Israel,31.046051,34.851612,4293073,0,10926,4282147
6/26/22,Israel,31.046051,34.851612,4301600,0,10940,4290660
6/27/22,Israel,31.046051,34.851612,4316205,0,10942,4305263
6/28/22,Israel,31.046051,34.851612,4328732,0,10946,4317786
6/29/22,Israel,31.046051,34.851612,4338698,0,10958,4327740
6/30/22,Israel,31.046051,34.851612,4353033,0,10958,4342075
7/1/22,Israel,31.046051,34.851612,4360719,0,10958,4349761
7/2/22,Israel,31.046051,34.851612,4368399,0,10978,4357421
7/3/22,Israel,31.046051,34.851612,4377578,0,10977,4366601
7/4/22,Israel,31.046051,34.851612,4391275,0,10984,4380291
7/5/22,Israel,31.046051,34.851612,4404214,0,10984,4393230
7/6/22,Israel,31.046051,34.851612,4415063,0,11042,4404021
7/7/22,Israel,31.046051,34.851612,4425323,0,11056,4414267
7/8/22,Israel,31.046051,34.851612,4435991,0,11056,4424935
7/9/22,Israel,31.046051,34.851612,4442277,0,11067,4431210
7/10/22,Israel,31.046051,34.851612,4449647,0,11068,4438579
7/11/22,Israel,31.046051,34.851612,4462295,0,11069,4451226
7/12/22,Israel,31.046051,34.851612,4472115,0,11101,4461014
7/13/22,Israel,31.046051,34.851612,4482086,0,11101,4470985
7/14/22,Israel,31.046051,34.851612,4489387,0,11101,4478286
7/15/22,Israel,31.046051,34.851612,4498027,0,11101,4486926
7/16/22,Israel,31.046051,34.851612,4498027,0,11101,4486926
7/17/22,Israel,31.046051,34.851612,4508457,0,11168,4497289
7/18/22,Israel,31.046051,34.851612,4518507,0,11181,4507326
7/19/22,Israel,31.046051,34.851612,4525442,0,11208,4514234
7/20/22,Israel,31.046051,34.851612,4531681,0,11208,4520473
7/21/22,Israel,31.046051,34.851612,4537898,0,11209,4526689
7/22/22,Israel,31.046051,34.851612,4543885,0,11209,4532676
7/23/22,Israel,31.046051,34.851612,4547404,0,11275,4536129
7/24/22,Israel,31.046051,34.851612,4551137,0,11291,4539846
7/25/22,Israel,31.046051,34.851612,4557774,0,11300,4546474
7/26/22,Israel,31.046051,34.851612,4563764,0,11334,4552430
7/27/22,Israel,31.046051,34.851612,4567884,0,11347,4556537
7/28/22,Israel,31.046051,34.851612,4571917,0,11349,4560568
7/29/22,Israel,31.046051,34.851612,4576191,0,11349,4564842
7/30/22,Israel,31.046051,34.851612,4578494,0,11356,4567138
7/31/22,Israel,31.046051,34.851612,4582056,0,11377,4570679
8/1/22,Israel,31.046051,34.851612,4585583,0,11391,4574192
8/2/22,Israel,31.046051,34.851612,4589285,0,11399,4577886
8/3/22,Israel,31.046051,34.851612,4592569,0,11399,4581170
8/4/22,Israel,31.046051,34.851612,4595648,0,11430,4584218
8/5/22,Israel,31.046051,34.851612,4598467,0,11433,4587034
8/6/22,Israel,31.046051,34.851612,4598467,0,11433,4587034
8/7/22,Israel,31.046051,34.851612,4600994,0,11436,4589558
8/8/22,Israel,31.046051,34.851612,4603321,0,11449,4591872
8/9/22,Israel,31.046051,34.851612,4606734,0,11470,4595264
8/10/22,Israel,31.046051,34.851612,4608836,0,11470,4597366
8/11/22,Israel,31.046051,34.851612,4610655,0,11483,4599172
8/12/22,Israel,31.046051,34.851612,4612451,0,11483,4600968
8/13/22,Israel,31.046051,34.851612,4613292,0,11483,4601809
8/14/22,Israel,31.046051,34.851612,4614404,0,11501,4602903
8/15/22,Israel,31.046051,34.851612,4616372,0,11503,4604869
8/16/22,Israel,31.046051,34.851612,4617926,0,11505,4606421
8/17/22,Israel,31.046051,34.851612,4619552,0,11524,4608028
8/18/22,Israel,31.046051,34.851612,4620627,0,11525,4609102
8/19/22,Israel,31.046051,34.851612,4622049,0,11525,4610524
8/20/22,Israel,31.046051,34.851612,4622661,0,11525,4611136
8/21/22,Israel,31.046051,34.851612,4623043,0,11525,4611518
8/22/22,Israel,31.046051,34.851612,4624804,0,11581,4613223
8/23/22,Israel,31.046051,34.851612,4626059,0,11580,4614479
8/24/22,Israel,31.046051,34.851612,4627109,0,11583,4615526
8/25/22,Israel,31.046051,34.851612,4628082,0,11589,4616493
8/26/22,Israel,31.046051,34.851612,4629050,0,11589,4617461
8/27/22,Israel,31.046051,34.851612,4629050,0,11589,4617461
8/28/22,Israel,31.046051,34.851612,4630021,0,11590,4618431
8/29/22,Israel,31.046051,34.851612,4631573,0,11603,4619970
8/30/22,Israel,31.046051,34.851612,4632100,0,11603,4620497
8/31/22,Israel,31.046051,34.851612,4633417,0,11620,4621797
9/1/22,Israel,31.046051,34.851612,4634242,0,11620,4622622
9/2/22,Israel,31.046051,34.851612,4635142,0,11620,4623522
9/3/22,Israel,31.046051,34.851612,4635142,0,11620,4623522
9/4/22,Israel,31.046051,34.851612,4636292,0,11620,4624672
9/5/22,Israel,31.046051,34.851612,4637433,0,11620,4625813
9/6/22,Israel,31.046051,34.851612,4638417,0,11643,4626774
9/7/22,Israel,31.046051,34.851612,4639332,0,11646,4627686
9/8/22,Israel,31.046051,34.851612,4640211,0,11648,4628563
9/9/22,Israel,31.046051,34.851612,4640211,0,11648,4628563
9/10/22,Israel,31.046051,34.851612,4641834,0,11648,4630186
9/11/22,Israel,31.046051,34.851612,4642521,0,11656,4630865
9/12/22,Israel,31.046051,34.851612,4643987,0,11657,4632330
9/13/22,Israel,31.046051,34.851612,4645165,0,11667,4633498
9/14/22,Israel,31.046051,34.851612,4646318,0,11667,4634651
9/15/22,Israel,31.046051,34.851612,4647508,0,11667,4635841
9/16/22,Israel,31.046051,34.851612,4648673,0,11676,4636997
9/17/22,Israel,31.046051,34.851612,4649319,0,11676,4637643
9/18/22,Israel,31.046051,34.851612,4650286,0,11681,4638605
9/19/22,Israel,31.046051,34.851612,4651768,0,11681,4640087
9/20/22,Israel,31.046051,34.851612,4653167,0,11681,4641486
9/21/22,Israel,31.046051,34.851612,4654317,0,11681,4642636
9/22/22,Israel,31.046051,34.851612,4655355,0,11687,4643668
9/23/22,Israel,31.046051,34.851612,4655355,0,11687,4643668
9/24/22,Israel,31.046051,34.851612,4655355,0,11687,4643668
9/25/22,Israel,31.046051,34.851612,4657756,0,11687,4646069
9/26/22,Israel,31.046051,34.851612,4657756,0,11687,4646069
9/27/22,Israel,31.046051,34.851612,4659133,0,11687,4647446
9/28/22,Israel,31.046051,34.851612,4659652,0,11693,4647959
9/29/22,Israel,31.046051,34.851612,4661087,0,11698,4649389
9/30/22,Israel,31.046051,34.851612,4662570,0,11698,4650872
10/1/22,Israel,31.046051,34.851612,4662570,0,11698,4650872
10/2/22,Israel,31.046051,34.851612,4663506,0,11698,4651808
10/3/22,Israel,31.046051,34.851612,4665267,0,11706,4653561
10/4/22,Israel,31.046051,34.851612,4666011,0,11706,4654305
10/5/22,Israel,31.046051,34.851612,4666156,0,11706,4654450
10/6/22,Israel,31.046051,34.851612,4666607,0,11710,4654897
10/7/22,Israel,31.046051,34.851612,4667278,0,11710,4655568
10/8/22,Israel,31.046051,34.851612,4667278,0,11710,4655568
10/9/22,Israel,31.046051,34.851612,4668642,0,11710,4656932
10/10/22,Israel,31.046051,34.851612,4668642,0,11710,4656932
10/11/22,Israel,31.046051,34.851612,4669740,0,11710,4658030
10/12/22,Israel,31.046051,34.851612,4670608,0,11712,4658896
10/13/22,Israel,31.046051,34.851612,4671334,0,11712,4659622
10/14/22,Israel,31.046051,34.851612,4672048,0,11712,4660336
10/15/22,Israel,31.046051,34.851612,4672492,0,11712,4660780
10/16/22,Israel,31.046051,34.851612,4672722,0,11712,4661010
10/17/22,Israel,31.046051,34.851612,4673402,0,11717,4661685
10/18/22,Israel,31.046051,34.851612,4674056,0,11728,4662328
10/19/22,Israel,31.046051,34.851612,4675027,0,11728,4663299
10/20/22,Israel,31.046051,34.851612,4675414,0,11728,4663686
10/21/22,Israel,31.046051,34.851612,4676493,0,11744,4664749
10/22/22,Israel,31.046051,34.851612,4677053,0,11744,4665309
10/23/22,Israel,31.046051,34.851612,4677921,0,11751,4666170
10/24/22,Israel,31.046051,34.851612,4678728,0,11752,4666976
10/25/22,Israel,31.046051,34.851612,4679547,0,11758,4667789
10/26/22,Israel,31.046051,34.851612,4680385,0,11758,4668627
10/27/22,Israel,31.046051,34.851612,4681217,0,11759,4669458
10/28/22,Israel,31.046051,34.851612,4681748,0,11759,4669989
10/29/22,Israel,31.046051,34.851612,4682577,0,11759,4670818
10/30/22,Israel,31.046051,34.851612,4683209,0,11763,4671446
10/31/22,Israel,31.046051,34.851612,4684451,0,11767,4672684
11/1/22,Israel,31.046051,34.851612,4685434,0,11767,4673667
11/2/22,Israel,31.046051,34.851612,4686060,0,11766,4674294
11/3/22,Israel,31.046051,34.851612,4687132,0,11767,4675365
11/4/22,Israel,31.046051,34.851612,4687132,0,11767,4675365
11/5/22,Israel,31.046051,34.851612,4688662,0,11767,4676895
11/6/22,Israel,31.046051,34.851612,4689152,0,11767,4677385
11/7/22,Israel,31.046051,34.851612,4689152,0,11767,4677385
11/8/22,Israel,31.046051,34.851612,4692154,0,11784,4680370
11/9/22,Israel,31.046051,34.851612,4693146,0,11788,4681358
11/10/22,Israel,31.046051,34.851612,4693662,0,11788,4681874
11/11/22,Israel,31.046051,34.851612,4694836,0,11788,4683048
11/12/22,Israel,31.046051,34.851612,4695853,0,11788,4684065
11/13/22,Israel,31.046051,34.851612,4695853,0,11788,4684065
11/14/22,Israel,31.046051,34.851612,4697694,0,11794,4685900
11/15/22,Israel,31.046051,34.851612,4699220,0,11801,4687419
11/16/22,Israel,31.046051,34.851612,4700690,0,11804,4688886
11/17/22,Israel,31.046051,34.851612,4701936,0,11810,4690126
11/18/22,Israel,31.046051,34.851612,4704009,0,11810,4692199
11/19/22,Israel,31.046051,34.851612,4704773,0,11810,4692963
11/20/22,Israel,31.046051,34.851612,4705778,0,11810,4693968
11/21/22,Israel,31.046051,34.851612,4707635,0,11818,4695817
11/22/22,Israel,31.046051,34.851612,4709796,0,11823,4697973
11/23/22,Israel,31.046051,34.851612,4709796,0,11823,4697973
11/24/22,Israel,31.046051,34.851612,4711855,0,11823,4700032
11/25/22,Israel,31.046051,34.851612,4713846,0,11828,4702018
11/26/22,Israel,31.046051,34.851612,4715087,0,11828,4703259
11/27/22,Israel,31.046051,34.851612,4716281,0,11834,4704447
11/28/22,Israel,31.046051,34.851612,4718364,0,11845,4706519
11/29/22,Israel,31.046051,34.851612,4718364,0,11845,4706519
11/30/22,Israel,31.046051,34.851612,4722410,0,11863,4710547
12/1/22,Israel,31.046051,34.851612,4723598,0,11865,4711733
12/2/22,Israel,31.046051,34.851612,4724500,0,11865,4712635
12/3/22,Israel,31.046051,34.851612,4725997,0,11866,4714131
12/4/22,Israel,31.046051,34.851612,4727313,0,11878,4715435
12/5/22,Israel,31.046051,34.851612,4729605,0,11882,4717723
12/6/22,Israel,31.046051,34.851612,4730493,0,11882,4718611
12/7/22,Israel,31.046051,34.851612,4733452,0,11905,4721547
12/8/22,Israel,31.046051,34.851612,4734792,0,11905,4722887
12/9/22,Israel,31.046051,34.851612,4736095,0,11906,4724189
12/10/22,Israel,31.046051,34.851612,4736539,0,11906,4724633
12/11/22,Israel,31.046051,34.851612,4738352,0,11906,4726446
12/12/22,Israel,31.046051,34.851612,4739407,0,11919,4727488
12/13/22,Israel,31.046051,34.851612,4741232,0,11920,4729312
12/14/22,Israel,31.046051,34.851612,4742934,0,11934,4731000
12/15/22,Israel,31.046051,34.851612,4745169,0,11954,4733215
12/16/22,Israel,31.046051,34.851612,4746698,0,11954,4734744
12/17/22,Israel,31.046051,34.851612,4747414,0,11954,4735460
1/1/22,Italy,41.87194,12.56738,6266939,0,137513,6129426
1/2/22,Italy,41.87194,12.56738,6328076,0,137646,6190430
1/3/22,Italy,41.87194,12.56738,6396110,0,137786,6258324
1/4/22,Italy,41.87194,12.56738,6566947,0,138045,6428902
1/5/22,Italy,41.87194,12.56738,6756035,0,138276,6617759
1/6/22,Italy,41.87194,12.56738,6975465,0,138474,6836991
1/7/22,Italy,41.87194,12.56738,7083762,0,138697,6945065
1/8/22,Italy,41.87194,12.56738,7281297,0,138881,7142416
1/9/22,Italy,41.87194,12.56738,7436939,0,139038,7297901
1/10/22,Italy,41.87194,12.56738,7554344,0,139265,7415079
1/11/22,Italy,41.87194,12.56738,7774863,0,139559,7635304
1/12/22,Italy,41.87194,12.56738,7971068,0,139872,7831196
1/13/22,Italy,41.87194,12.56738,8155645,0,140188,8015457
1/14/22,Italy,41.87194,12.56738,8356514,0,140548,8215966
1/15/22,Italy,41.87194,12.56738,8549450,0,140856,8408594
1/16/22,Italy,41.87194,12.56738,8706915,0,141104,8565811
1/17/22,Italy,41.87194,12.56738,8790302,0,141391,8648911
1/18/22,Italy,41.87194,12.56738,9018425,0,141825,8876600
1/19/22,Italy,41.87194,12.56738,9219391,0,142205,9077186
1/20/22,Italy,41.87194,12.56738,9418256,0,142590,9275666
1/21/22,Italy,41.87194,12.56738,9603856,0,142963,9460893
1/22/22,Italy,41.87194,12.56738,9781191,0,143296,9637895
1/23/22,Italy,41.87194,12.56738,9923678,0,143523,9780155
1/24/22,Italy,41.87194,12.56738,10001344,0,143875,9857469
1/25/22,Italy,41.87194,12.56738,10212621,0,144343,10068278
1/26/22,Italy,41.87194,12.56738,10383561,0,144770,10238791
1/27/22,Italy,41.87194,12.56738,10539601,0,145159,10394442
1/28/22,Italy,41.87194,12.56738,10683948,0,145537,10538411
1/29/22,Italy,41.87194,12.56738,10821375,0,145914,10675461
1/30/22,Italy,41.87194,12.56738,10925485,0,146149,10779336
1/31/22,Italy,41.87194,12.56738,10983116,0,146498,10836618
2/1/22,Italy,41.87194,12.56738,11116422,0,146925,10969497
2/2/22,Italy,41.87194,12.56738,11235745,0,147320,11088425
2/3/22,Italy,41.87194,12.56738,11348701,0,147734,11200967
2/4/22,Italy,41.87194,12.56738,11449601,0,148167,11301434
2/5/22,Italy,41.87194,12.56738,11542793,0,148542,11394251
2/6/22,Italy,41.87194,12.56738,11621736,0,148771,11472965
2/7/22,Italy,41.87194,12.56738,11663338,0,149097,11514241
2/8/22,Italy,41.87194,12.56738,11765767,0,149512,11616255
2/9/22,Italy,41.87194,12.56738,11847436,0,149896,11697540
2/10/22,Italy,41.87194,12.56738,11923631,0,150221,11773410
2/11/22,Italy,41.87194,12.56738,11991109,0,150555,11840554
2/12/22,Italy,41.87194,12.56738,12053330,0,150824,11902506
2/13/22,Italy,41.87194,12.56738,12105675,0,151015,11954660
2/14/22,Italy,41.87194,12.56738,12134451,0,151296,11983155
2/15/22,Italy,41.87194,12.56738,12205474,0,151684,12053790
2/16/22,Italy,41.87194,12.56738,12265343,0,151962,12113381
2/17/22,Italy,41.87194,12.56738,12323398,0,152282,12171116
2/18/22,Italy,41.87194,12.56738,12377098,0,152596,12224502
2/19/22,Italy,41.87194,12.56738,12427773,0,152848,12274925
2/20/22,Italy,41.87194,12.56738,12469975,0,152989,12316986
2/21/22,Italy,41.87194,12.56738,12494459,0,153190,12341269
2/22/22,Italy,41.87194,12.56738,12554596,0,153512,12401084
2/23/22,Italy,41.87194,12.56738,12603758,0,153764,12449994
2/24/22,Italy,41.87194,12.56738,12651251,0,154013,12497238
2/25/22,Italy,41.87194,12.56738,12693320,0,154206,12539114
2/26/22,Italy,41.87194,12.56738,12732680,0,154416,12578264
2/27/22,Italy,41.87194,12.56738,12764558,0,154560,12609998
2/28/22,Italy,41.87194,12.56738,12782836,0,154767,12628069
3/1/22,Italy,41.87194,12.56738,12829972,0,155000,12674972
3/2/22,Italy,41.87194,12.56738,12867918,0,155214,12712704
3/3/22,Italy,41.87194,12.56738,12910506,0,155399,12755107
3/4/22,Italy,41.87194,12.56738,12948859,0,155609,12793250
3/5/22,Italy,41.87194,12.56738,12990223,0,155782,12834441
3/6/22,Italy,41.87194,12.56738,13026112,0,155887,12870225
3/7/22,Italy,41.87194,12.56738,13048774,0,156017,12892757
3/8/22,Italy,41.87194,12.56738,13109527,0,156201,12953326
3/9/22,Italy,41.87194,12.56738,13159342,0,156357,13002985
3/10/22,Italy,41.87194,12.56738,13214498,0,156493,13058005
3/11/22,Italy,41.87194,12.56738,13268459,0,156649,13111810
3/12/22,Italy,41.87194,12.56738,13323179,0,156782,13166397
3/13/22,Italy,41.87194,12.56738,13373207,0,156868,13216339
3/14/22,Italy,41.87194,12.56738,13402905,0,156997,13245908
3/15/22,Italy,41.87194,12.56738,13489319,0,157177,13332142
3/16/22,Italy,41.87194,12.56738,13563466,0,157314,13406152
3/17/22,Italy,41.87194,12.56738,13645834,0,157442,13488392
3/18/22,Italy,41.87194,12.56738,13724411,0,157607,13566804
3/19/22,Italy,41.87194,12.56738,13800179,0,157692,13642487
3/20/22,Italy,41.87194,12.56738,13861743,0,157785,13703958
3/21/22,Italy,41.87194,12.56738,13895188,0,157904,13737284
3/22/22,Italy,41.87194,12.56738,13992092,0,158101,13833991
3/23/22,Italy,41.87194,12.56738,14070450,0,158254,13912196
3/24/22,Italy,41.87194,12.56738,14153098,0,158436,13994662
3/25/22,Italy,41.87194,12.56738,14229495,0,158582,14070913
3/26/22,Italy,41.87194,12.56738,14304111,0,158700,14145411
3/27/22,Italy,41.87194,12.56738,14364723,0,158782,14205941
3/28/22,Italy,41.87194,12.56738,14396283,0,158877,14237406
3/29/22,Italy,41.87194,12.56738,14496579,0,159054,14337525
3/30/22,Italy,41.87194,12.56738,14567990,0,159224,14408766
3/31/22,Italy,41.87194,12.56738,14642354,0,159383,14482971
4/1/22,Italy,41.87194,12.56738,14719394,0,159537,14559857
4/2/22,Italy,41.87194,12.56738,14790806,0,159666,14631140
4/3/22,Italy,41.87194,12.56738,14845815,0,159784,14686031
4/4/22,Italy,41.87194,12.56738,14877144,0,159909,14717235
4/5/22,Italy,41.87194,12.56738,14966058,0,160103,14805955
4/6/22,Italy,41.87194,12.56738,15035943,0,160253,14875690
4/7/22,Italy,41.87194,12.56738,15106066,0,160402,14945664
4/8/22,Italy,41.87194,12.56738,15173707,0,160546,15013161
4/9/22,Italy,41.87194,12.56738,15238128,0,160658,15077470
4/10/22,Italy,41.87194,12.56738,15292048,0,160748,15131300
4/11/22,Italy,41.87194,12.56738,15320753,0,160863,15159890
4/12/22,Italy,41.87194,12.56738,15404809,0,161032,15243777
4/13/22,Italy,41.87194,12.56738,15467395,0,161187,15306208
4/14/22,Italy,41.87194,12.56738,15533012,0,161336,15371676
4/15/22,Italy,41.87194,12.56738,15595302,0,161469,15433833
4/16/22,Italy,41.87194,12.56738,15659835,0,161602,15498233
4/17/22,Italy,41.87194,12.56738,15712088,0,161687,15550401
4/18/22,Italy,41.87194,12.56738,15730676,0,161766,15568910
4/19/22,Italy,41.87194,12.56738,15758002,0,161893,15596109
4/20/22,Italy,41.87194,12.56738,15858442,0,162098,15696344
4/21/22,Italy,41.87194,12.56738,15934437,0,162264,15772173
4/22/22,Italy,41.87194,12.56738,16008181,0,162466,15845715
4/23/22,Italy,41.87194,12.56738,16079209,0,162609,15916600
4/24/22,Italy,41.87194,12.56738,16136057,0,162688,15973369
4/25/22,Italy,41.87194,12.56738,16161339,0,162781,15998558
4/26/22,Italy,41.87194,12.56738,16191323,0,162927,16028396
4/27/22,Italy,41.87194,12.56738,16279754,0,163113,16116641
4/28/22,Italy,41.87194,12.56738,16349788,0,163244,16186544
4/29/22,Italy,41.87194,12.56738,16409183,0,163377,16245806
4/30/22,Italy,41.87194,12.56738,16463200,0,163507,16299693
5/1/22,Italy,41.87194,12.56738,16504791,0,163612,16341179
5/2/22,Italy,41.87194,12.56738,16523859,0,163736,16360123
5/3/22,Italy,41.87194,12.56738,16586268,0,163889,16422379
5/4/22,Italy,41.87194,12.56738,16633911,0,164041,16469870
5/5/22,Italy,41.87194,12.56738,16682626,0,164179,16518447
5/6/22,Italy,41.87194,12.56738,16726990,0,164304,16562686
5/7/22,Italy,41.87194,12.56738,16767773,0,164417,16603356
5/8/22,Italy,41.87194,12.56738,16798998,0,164489,16634509
5/9/22,Italy,41.87194,12.56738,16816419,0,164573,16651846
5/10/22,Italy,41.87194,12.56738,16872618,0,164731,16707887
5/11/22,Italy,41.87194,12.56738,16915301,0,164846,16750455
5/12/22,Italy,41.87194,12.56738,16954784,0,164976,16789808
5/13/22,Italy,41.87194,12.56738,16993813,0,165091,16828722
5/14/22,Italy,41.87194,12.56738,17030147,0,165182,16864965
5/15/22,Italy,41.87194,12.56738,17057873,0,165244,16892629
5/16/22,Italy,41.87194,12.56738,17071649,0,165346,16906303
5/17/22,Italy,41.87194,12.56738,17116550,0,165494,16951056
5/18/22,Italy,41.87194,12.56738,17147477,0,165630,16981847
5/19/22,Italy,41.87194,12.56738,17178199,0,165738,17012461
5/20/22,Italy,41.87194,12.56738,17205017,0,165827,17039190
5/21/22,Italy,41.87194,12.56738,17229263,0,165918,17063345
5/22/22,Italy,41.87194,12.56738,17247552,0,165952,17081600
5/23/22,Italy,41.87194,12.56738,17257573,0,166032,17091541
5/24/22,Italy,41.87194,12.56738,17288287,0,166127,17122160
5/25/22,Italy,41.87194,12.56738,17312432,0,166264,17146168
5/26/22,Italy,41.87194,12.56738,17333299,0,166358,17166941
5/27/22,Italy,41.87194,12.56738,17355119,0,166476,17188643
5/28/22,Italy,41.87194,12.56738,17373741,0,166542,17207199
5/29/22,Italy,41.87194,12.56738,17388877,0,166569,17222308
5/30/22,Italy,41.87194,12.56738,17396723,0,166631,17230092
5/31/22,Italy,41.87194,12.56738,17421410,0,166697,17254713
6/1/22,Italy,41.87194,12.56738,17440232,0,166756,17273476
6/2/22,Italy,41.87194,12.56738,17457950,0,166835,17291115
6/3/22,Italy,41.87194,12.56738,17467642,0,166875,17300767
6/4/22,Italy,41.87194,12.56738,17490451,0,166922,17323529
6/5/22,Italy,41.87194,12.56738,17505973,0,166949,17339024
6/6/22,Italy,41.87194,12.56738,17514589,0,167019,17347570
6/7/22,Italy,41.87194,12.56738,17543136,0,167089,17376047
6/8/22,Italy,41.87194,12.56738,17566061,0,167169,17398892
6/9/22,Italy,41.87194,12.56738,17589595,0,167253,17422342
6/10/22,Italy,41.87194,12.56738,17611607,0,167305,17444302
6/11/22,Italy,41.87194,12.56738,17634065,0,167365,17466700
6/12/22,Italy,41.87194,12.56738,17653375,0,167391,17485984
6/13/22,Italy,41.87194,12.56738,17664043,0,167432,17496611
6/14/22,Italy,41.87194,12.56738,17703887,0,167505,17536382
6/15/22,Italy,41.87194,12.56738,17736696,0,167553,17569143
6/16/22,Italy,41.87194,12.56738,17773764,0,167617,17606147
6/17/22,Italy,41.87194,12.56738,17809934,0,167658,17642276
6/18/22,Italy,41.87194,12.56738,17844905,0,167703,17677202
6/19/22,Italy,41.87194,12.56738,17879160,0,167721,17711439
6/20/22,Italy,41.87194,12.56738,17896065,0,167780,17728285
6/21/22,Italy,41.87194,12.56738,17959329,0,167842,17791487
6/22/22,Italy,41.87194,12.56738,18014202,0,167892,17846310
6/23/22,Italy,41.87194,12.56738,18071634,0,167967,17903667
6/24/22,Italy,41.87194,12.56738,18128044,0,168018,17960026
6/25/22,Italy,41.87194,12.56738,18184917,0,168058,18016859
6/26/22,Italy,41.87194,12.56738,18234242,0,168102,18066140
6/27/22,Italy,41.87194,12.56738,18259261,0,168165,18091096
6/28/22,Italy,41.87194,12.56738,18343422,0,168234,18175188
6/29/22,Italy,41.87194,12.56738,18438877,0,168294,18270583
6/30/22,Italy,41.87194,12.56738,18523111,0,168353,18354758
7/1/22,Italy,41.87194,12.56738,18610011,0,168425,18441586
7/2/22,Italy,41.87194,12.56738,18695954,0,168488,18527466
7/3/22,Italy,41.87194,12.56738,18768871,0,168545,18600326
7/4/22,Italy,41.87194,12.56738,18805756,0,168604,18637152
7/5/22,Italy,41.87194,12.56738,18938771,0,168698,18770073
7/6/22,Italy,41.87194,12.56738,19048788,0,168770,18880018
7/7/22,Italy,41.87194,12.56738,19157174,0,168864,18988310
7/8/22,Italy,41.87194,12.56738,19259037,0,168969,19090068
7/9/22,Italy,41.87194,12.56738,19357938,0,169062,19188876
7/10/22,Italy,41.87194,12.56738,19439501,0,169106,19270395
7/11/22,Italy,41.87194,12.56738,19523262,0,169233,19354029
7/12/22,Italy,41.87194,12.56738,19667320,0,169390,19497930
7/13/22,Italy,41.87194,12.56738,19778911,0,169496,19609415
7/14/22,Italy,41.87194,12.56738,19887543,0,169601,19717942
7/15/22,Italy,41.87194,12.56738,19985479,0,169735,19815744
7/16/22,Italy,41.87194,12.56738,20076863,0,169846,19907017
7/17/22,Italy,41.87194,12.56738,20145859,0,169925,19975934
7/18/22,Italy,41.87194,12.56738,20177910,0,170037,20007873
7/19/22,Italy,41.87194,12.56738,20299013,0,170213,20128800
7/20/22,Italy,41.87194,12.56738,20385814,0,170370,20215444
7/21/22,Italy,41.87194,12.56738,20467349,0,170527,20296822
7/22/22,Italy,41.87194,12.56738,20539016,0,170682,20368334
7/23/22,Italy,41.87194,12.56738,20608190,0,170798,20437392
7/24/22,Italy,41.87194,12.56738,20660065,0,170875,20489190
7/25/22,Italy,41.87194,12.56738,20684182,0,170979,20513203
7/26/22,Italy,41.87194,12.56738,20772833,0,171232,20601601
7/27/22,Italy,41.87194,12.56738,20837233,0,171439,20665794
7/28/22,Italy,41.87194,12.56738,20898059,0,171638,20726421
7/29/22,Italy,41.87194,12.56738,20952476,0,171882,20780594
7/30/22,Italy,41.87194,12.56738,21002773,0,172003,20830770
7/31/22,Italy,41.87194,12.56738,21040025,0,172086,20867939
8/1/22,Italy,41.87194,12.56738,21059545,0,172207,20887338
8/2/22,Italy,41.87194,12.56738,21124644,0,172397,20952247
8/3/22,Italy,41.87194,12.56738,21170600,0,172568,20998032
8/4/22,Italy,41.87194,12.56738,21213559,0,172729,21040830
8/5/22,Italy,41.87194,12.56738,21251774,0,172904,21078870
8/6/22,Italy,41.87194,12.56738,21286771,0,173062,21113709
8/7/22,Italy,41.87194,12.56738,21313427,0,173136,21140291
8/8/22,Italy,41.87194,12.56738,21325402,0,173249,21152153
8/9/22,Italy,41.87194,12.56738,21368480,0,173426,21195054
8/10/22,Italy,41.87194,12.56738,21400179,0,173571,21226608
8/11/22,Italy,41.87194,12.56738,21428602,0,173701,21254901
8/12/22,Italy,41.87194,12.56738,21455291,0,173853,21281438
8/13/22,Italy,41.87194,12.56738,21480076,0,173982,21306094
8/14/22,Italy,41.87194,12.56738,21499531,0,174060,21325471
8/15/22,Italy,41.87194,12.56738,21509424,0,174102,21335322
8/16/22,Italy,41.87194,12.56738,21518365,0,174172,21344193
8/17/22,Italy,41.87194,12.56738,21554626,0,174300,21380326
8/18/22,Italy,41.87194,12.56738,21581917,0,174447,21407470
8/19/22,Italy,41.87194,12.56738,21606606,0,174571,21432035
8/20/22,Italy,41.87194,12.56738,21630998,0,174659,21456339
8/21/22,Italy,41.87194,12.56738,21650468,0,174722,21475746
8/22/22,Italy,41.87194,12.56738,21660885,0,174797,21486088
8/23/22,Italy,41.87194,12.56738,21696242,0,174931,21521311
8/24/22,Italy,41.87194,12.56738,21721630,0,175043,21546587
8/25/22,Italy,41.87194,12.56738,21745065,0,175127,21569938
8/26/22,Italy,41.87194,12.56738,21767060,0,175226,21591834
8/27/22,Italy,41.87194,12.56738,21788862,0,175306,21613556
8/28/22,Italy,41.87194,12.56738,21806509,0,175347,21631162
8/29/22,Italy,41.87194,12.56738,21814856,0,175407,21639449
8/30/22,Italy,41.87194,12.56738,21845943,0,175505,21670438
8/31/22,Italy,41.87194,12.56738,21867757,0,175595,21692162
9/1/22,Italy,41.87194,12.56738,21888255,0,175663,21712592
9/2/22,Italy,41.87194,12.56738,21907413,0,175754,21731659
9/3/22,Italy,41.87194,12.56738,21925073,0,175802,21749271
9/4/22,Italy,41.87194,12.56738,21938269,0,175832,21762437
9/5/22,Italy,41.87194,12.56738,21944877,0,175872,21769005
9/6/22,Italy,41.87194,12.56738,21969725,0,175952,21793773
9/7/22,Italy,41.87194,12.56738,21987295,0,176009,21811286
9/8/22,Italy,41.87194,12.56738,22004612,0,176098,21828514
9/9/22,Italy,41.87194,12.56738,22020154,0,176157,21843997
9/10/22,Italy,41.87194,12.56738,22035291,0,176204,21859087
9/11/22,Italy,41.87194,12.56738,22047192,0,176238,21870954
9/12/22,Italy,41.87194,12.56738,22054443,0,176242,21878201
9/13/22,Italy,41.87194,12.56738,22077601,0,176335,21901266
9/14/22,Italy,41.87194,12.56738,22096450,0,176404,21920046
9/15/22,Italy,41.87194,12.56738,22114423,0,176464,21937959
9/16/22,Italy,41.87194,12.56738,22131785,0,176508,21955277
9/17/22,Italy,41.87194,12.56738,22148935,0,176546,21972389
9/18/22,Italy,41.87194,12.56738,22161016,0,176578,21984438
9/19/22,Italy,41.87194,12.56738,22169273,0,176609,21992664
9/20/22,Italy,41.87194,12.56738,22197658,0,176669,22020989
9/21/22,Italy,41.87194,12.56738,22218846,0,176715,22042131
9/22/22,Italy,41.87194,12.56738,22241369,0,176775,22064594
9/23/22,Italy,41.87194,12.56738,22262452,0,176824,22085628
9/24/22,Italy,41.87194,12.56738,22284812,0,176867,22107945
9/25/22,Italy,41.87194,12.56738,22303606,0,176880,22126726
9/26/22,Italy,41.87194,12.56738,22313612,0,176912,22136700
9/27/22,Italy,41.87194,12.56738,22358487,0,176976,22181511
9/28/22,Italy,41.87194,12.56738,22395282,0,177024,22218258
9/29/22,Italy,41.87194,12.56738,22432803,0,177054,22255749
9/30/22,Italy,41.87194,12.56738,22467278,0,177092,22290186
10/1/22,Italy,41.87194,12.56738,22500346,0,177130,22323216
10/2/22,Italy,41.87194,12.56738,22529252,0,177150,22352102
10/3/22,Italy,41.87194,12.56738,22542568,0,177197,22365371
10/4/22,Italy,41.87194,12.56738,22602840,0,177257,22425583
10/5/22,Italy,41.87194,12.56738,22648063,0,177300,22470763
10/6/22,Italy,41.87194,12.56738,22692912,0,177356,22515556
10/7/22,Italy,41.87194,12.56738,22737577,0,177418,22560159
10/8/22,Italy,41.87194,12.56738,22781293,0,177478,22603815
10/9/22,Italy,41.87194,12.56738,22815736,0,177519,22638217
10/10/22,Italy,41.87194,12.56738,22830825,0,177570,22653255
10/11/22,Italy,41.87194,12.56738,22896742,0,177650,22719092
10/12/22,Italy,41.87194,12.56738,22944496,0,177719,22766777
10/13/22,Italy,41.87194,12.56738,22990201,0,177785,22812416
10/14/22,Italy,41.87194,12.56738,23030777,0,177883,22852894
10/15/22,Italy,41.87194,12.56738,23069745,0,177956,22891789
10/16/22,Italy,41.87194,12.56738,23099983,0,177988,22921995
10/17/22,Italy,41.87194,12.56738,23114013,0,178081,22935932
10/18/22,Italy,41.87194,12.56738,23172370,0,178194,22994176
10/19/22,Italy,41.87194,12.56738,23214073,0,178275,23035798
10/20/22,Italy,41.87194,12.56738,23254633,0,178359,23076274
10/21/22,Italy,41.87194,12.56738,23290747,0,178450,23112297
10/22/22,Italy,41.87194,12.56738,23322522,0,178542,23143980
10/23/22,Italy,41.87194,12.56738,23348075,0,178594,23169481
10/24/22,Italy,41.87194,12.56738,23359680,0,178633,23181047
10/25/22,Italy,41.87194,12.56738,23408393,0,178753,23229640
10/26/22,Italy,41.87194,12.56738,23443429,0,178846,23264583
10/27/22,Italy,41.87194,12.56738,23475187,0,178940,23296247
10/28/22,Italy,41.87194,12.56738,23504224,0,179025,23325199
10/29/22,Italy,41.87194,12.56738,23531023,0,179101,23351922
10/30/22,Italy,41.87194,12.56738,23531023,0,179101,23351922
10/31/22,Italy,41.87194,12.56738,23531023,0,179101,23351922
11/1/22,Italy,41.87194,12.56738,23531023,0,179101,23351922
11/2/22,Italy,41.87194,12.56738,23531023,0,179101,23351922
11/3/22,Italy,41.87194,12.56738,23531023,0,179101,23351922
11/4/22,Italy,41.87194,12.56738,23642011,0,179436,23462575
11/5/22,Italy,41.87194,12.56738,23642011,0,179436,23462575
11/6/22,Italy,41.87194,12.56738,23642011,0,179436,23462575
11/7/22,Italy,41.87194,12.56738,23642011,0,179436,23462575
11/8/22,Italy,41.87194,12.56738,23642011,0,179436,23462575
11/9/22,Italy,41.87194,12.56738,23642011,0,179436,23462575
11/10/22,Italy,41.87194,12.56738,23642011,0,179436,23462575
11/11/22,Italy,41.87194,12.56738,23823192,0,179985,23643207
11/12/22,Italy,41.87194,12.56738,23823192,0,179985,23643207
11/13/22,Italy,41.87194,12.56738,23823192,0,179985,23643207
11/14/22,Italy,41.87194,12.56738,23823192,0,179985,23643207
11/15/22,Italy,41.87194,12.56738,23823192,0,179985,23643207
11/16/22,Italy,41.87194,12.56738,23823192,0,179985,23643207
11/17/22,Italy,41.87194,12.56738,23823192,0,179985,23643207
11/18/22,Italy,41.87194,12.56738,24031538,0,180518,23851020
11/19/22,Italy,41.87194,12.56738,24031538,0,180518,23851020
11/20/22,Italy,41.87194,12.56738,24031538,0,180518,23851020
11/21/22,Italy,41.87194,12.56738,24031538,0,180518,23851020
11/22/22,Italy,41.87194,12.56738,24031538,0,180518,23851020
11/23/22,Italy,41.87194,12.56738,24031538,0,180518,23851020
11/24/22,Italy,41.87194,12.56738,24031538,0,180518,23851020
11/25/22,Italy,41.87194,12.56738,24260660,0,181098,24079562
11/26/22,Italy,41.87194,12.56738,24260660,0,181098,24079562
11/27/22,Italy,41.87194,12.56738,24260660,0,181098,24079562
11/28/22,Italy,41.87194,12.56738,24260660,0,181098,24079562
11/29/22,Italy,41.87194,12.56738,24260660,0,181098,24079562
11/30/22,Italy,41.87194,12.56738,24260660,0,181098,24079562
12/1/22,Italy,41.87194,12.56738,24260660,0,181098,24079562
12/2/22,Italy,41.87194,12.56738,24488080,0,181733,24306347
12/3/22,Italy,41.87194,12.56738,24488080,0,181733,24306347
12/4/22,Italy,41.87194,12.56738,24488080,0,181733,24306347
12/5/22,Italy,41.87194,12.56738,24488080,0,181733,24306347
12/6/22,Italy,41.87194,12.56738,24488080,0,181733,24306347
12/7/22,Italy,41.87194,12.56738,24488080,0,181733,24306347
12/8/22,Italy,41.87194,12.56738,24488080,0,181733,24306347
12/9/22,Italy,41.87194,12.56738,24709404,0,182419,24526985
12/10/22,Italy,41.87194,12.56738,24709404,0,182419,24526985
12/11/22,Italy,41.87194,12.56738,24709404,0,182419,24526985
12/12/22,Italy,41.87194,12.56738,24709404,0,182419,24526985
12/13/22,Italy,41.87194,12.56738,24709404,0,182419,24526985
12/14/22,Italy,41.87194,12.56738,24709404,0,182419,24526985
12/15/22,Italy,41.87194,12.56738,24709404,0,182419,24526985
12/16/22,Italy,41.87194,12.56738,24884034,0,183138,24700896
12/17/22,Italy,41.87194,12.56738,24884034,0,183138,24700896
1/1/22,Jamaica,18.1096,-77.2975,94649,0,2476,92173
1/2/22,Jamaica,18.1096,-77.2975,95177,0,2476,92701
1/3/22,Jamaica,18.1096,-77.2975,95946,0,2477,93469
1/4/22,Jamaica,18.1096,-77.2975,96331,0,2479,93852
1/5/22,Jamaica,18.1096,-77.2975,97066,0,2483,94583
1/6/22,Jamaica,18.1096,-77.2975,98194,0,2486,95708
1/7/22,Jamaica,18.1096,-77.2975,99463,0,2489,96974
1/8/22,Jamaica,18.1096,-77.2975,101056,0,2495,98561
1/9/22,Jamaica,18.1096,-77.2975,102505,0,2499,100006
1/10/22,Jamaica,18.1096,-77.2975,103458,0,2501,100957
1/11/22,Jamaica,18.1096,-77.2975,105172,0,2502,102670
1/12/22,Jamaica,18.1096,-77.2975,106379,0,2506,103873
1/13/22,Jamaica,18.1096,-77.2975,107721,0,2514,105207
1/14/22,Jamaica,18.1096,-77.2975,108983,0,2517,106466
1/15/22,Jamaica,18.1096,-77.2975,110250,0,2522,107728
1/16/22,Jamaica,18.1096,-77.2975,112218,0,2530,109688
1/17/22,Jamaica,18.1096,-77.2975,113438,0,2536,110902
1/18/22,Jamaica,18.1096,-77.2975,114986,0,2551,112435
1/19/22,Jamaica,18.1096,-77.2975,116084,0,2555,113529
1/20/22,Jamaica,18.1096,-77.2975,116944,0,2561,114383
1/21/22,Jamaica,18.1096,-77.2975,117717,0,2568,115149
1/22/22,Jamaica,18.1096,-77.2975,118727,0,2572,116155
1/23/22,Jamaica,18.1096,-77.2975,119565,0,2594,116971
1/24/22,Jamaica,18.1096,-77.2975,120682,0,2599,118083
1/25/22,Jamaica,18.1096,-77.2975,121436,0,2609,118827
1/26/22,Jamaica,18.1096,-77.2975,121963,0,2615,119348
1/27/22,Jamaica,18.1096,-77.2975,122463,0,2617,119846
1/28/22,Jamaica,18.1096,-77.2975,123047,0,2635,120412
1/29/22,Jamaica,18.1096,-77.2975,123047,0,2635,120412
1/30/22,Jamaica,18.1096,-77.2975,124102,0,2650,121452
1/31/22,Jamaica,18.1096,-77.2975,124512,0,2658,121854
2/1/22,Jamaica,18.1096,-77.2975,124806,0,2663,122143
2/2/22,Jamaica,18.1096,-77.2975,124967,0,2675,122292
2/3/22,Jamaica,18.1096,-77.2975,125250,0,2677,122573
2/4/22,Jamaica,18.1096,-77.2975,125517,0,2687,122830
2/5/22,Jamaica,18.1096,-77.2975,125781,0,2691,123090
2/6/22,Jamaica,18.1096,-77.2975,125993,0,2694,123299
2/7/22,Jamaica,18.1096,-77.2975,126222,0,2698,123524
2/8/22,Jamaica,18.1096,-77.2975,126350,0,2699,123651
2/9/22,Jamaica,18.1096,-77.2975,126437,0,2706,123731
2/10/22,Jamaica,18.1096,-77.2975,126589,0,2708,123881
2/11/22,Jamaica,18.1096,-77.2975,126732,0,2720,124012
2/12/22,Jamaica,18.1096,-77.2975,126886,0,2738,124148
2/13/22,Jamaica,18.1096,-77.2975,127054,0,2739,124315
2/14/22,Jamaica,18.1096,-77.2975,127163,0,2750,124413
2/15/22,Jamaica,18.1096,-77.2975,127233,0,2750,124483
2/16/22,Jamaica,18.1096,-77.2975,127294,0,2755,124539
2/17/22,Jamaica,18.1096,-77.2975,127377,0,2769,124608
2/18/22,Jamaica,18.1096,-77.2975,127436,0,2771,124665
2/19/22,Jamaica,18.1096,-77.2975,127516,0,2779,124737
2/20/22,Jamaica,18.1096,-77.2975,127610,0,2784,124826
2/21/22,Jamaica,18.1096,-77.2975,127665,0,2787,124878
2/22/22,Jamaica,18.1096,-77.2975,127706,0,2795,124911
2/23/22,Jamaica,18.1096,-77.2975,127741,0,2798,124943
2/24/22,Jamaica,18.1096,-77.2975,127799,0,2808,124991
2/25/22,Jamaica,18.1096,-77.2975,127856,0,2810,125046
2/26/22,Jamaica,18.1096,-77.2975,127916,0,2811,125105
2/27/22,Jamaica,18.1096,-77.2975,127961,0,2813,125148
2/28/22,Jamaica,18.1096,-77.2975,127986,0,2813,125173
3/1/22,Jamaica,18.1096,-77.2975,128053,0,2814,125239
3/2/22,Jamaica,18.1096,-77.2975,128079,0,2814,125265
3/3/22,Jamaica,18.1096,-77.2975,128108,0,2815,125293
3/4/22,Jamaica,18.1096,-77.2975,128142,0,2825,125317
3/5/22,Jamaica,18.1096,-77.2975,128166,0,2825,125341
3/6/22,Jamaica,18.1096,-77.2975,128179,0,2827,125352
3/7/22,Jamaica,18.1096,-77.2975,128213,0,2830,125383
3/8/22,Jamaica,18.1096,-77.2975,128228,0,2831,125397
3/9/22,Jamaica,18.1096,-77.2975,128246,0,2835,125411
3/10/22,Jamaica,18.1096,-77.2975,128273,0,2837,125436
3/11/22,Jamaica,18.1096,-77.2975,128318,0,2839,125479
3/12/22,Jamaica,18.1096,-77.2975,128354,0,2844,125510
3/13/22,Jamaica,18.1096,-77.2975,128379,0,2845,125534
3/14/22,Jamaica,18.1096,-77.2975,128400,0,2850,125550
3/15/22,Jamaica,18.1096,-77.2975,128418,0,2851,125567
3/16/22,Jamaica,18.1096,-77.2975,128426,0,2855,125571
3/17/22,Jamaica,18.1096,-77.2975,128456,0,2857,125599
3/18/22,Jamaica,18.1096,-77.2975,128477,0,2858,125619
3/19/22,Jamaica,18.1096,-77.2975,128500,0,2863,125637
3/20/22,Jamaica,18.1096,-77.2975,128539,0,2867,125672
3/21/22,Jamaica,18.1096,-77.2975,128565,0,2869,125696
3/22/22,Jamaica,18.1096,-77.2975,128565,0,2869,125696
3/23/22,Jamaica,18.1096,-77.2975,128594,0,2872,125722
3/24/22,Jamaica,18.1096,-77.2975,128607,0,2874,125733
3/25/22,Jamaica,18.1096,-77.2975,128628,0,2875,125753
3/26/22,Jamaica,18.1096,-77.2975,128628,0,2875,125753
3/27/22,Jamaica,18.1096,-77.2975,128679,0,2879,125800
3/28/22,Jamaica,18.1096,-77.2975,128704,0,2881,125823
3/29/22,Jamaica,18.1096,-77.2975,128727,0,2882,125845
3/30/22,Jamaica,18.1096,-77.2975,128735,0,2884,125851
3/31/22,Jamaica,18.1096,-77.2975,128757,0,2888,125869
4/1/22,Jamaica,18.1096,-77.2975,128786,0,2889,125897
4/2/22,Jamaica,18.1096,-77.2975,128811,0,2893,125918
4/3/22,Jamaica,18.1096,-77.2975,128811,0,2893,125918
4/4/22,Jamaica,18.1096,-77.2975,128869,0,2897,125972
4/5/22,Jamaica,18.1096,-77.2975,128869,0,2897,125972
4/6/22,Jamaica,18.1096,-77.2975,128924,0,2899,126025
4/7/22,Jamaica,18.1096,-77.2975,128950,0,2901,126049
4/8/22,Jamaica,18.1096,-77.2975,128972,0,2902,126070
4/9/22,Jamaica,18.1096,-77.2975,128972,0,2902,126070
4/10/22,Jamaica,18.1096,-77.2975,128972,0,2902,126070
4/11/22,Jamaica,18.1096,-77.2975,129050,0,2916,126134
4/12/22,Jamaica,18.1096,-77.2975,129093,0,2917,126176
4/13/22,Jamaica,18.1096,-77.2975,129108,0,2919,126189
4/14/22,Jamaica,18.1096,-77.2975,129133,0,2921,126212
4/15/22,Jamaica,18.1096,-77.2975,129168,0,2924,126244
4/16/22,Jamaica,18.1096,-77.2975,129203,0,2926,126277
4/17/22,Jamaica,18.1096,-77.2975,129238,0,2929,126309
4/18/22,Jamaica,18.1096,-77.2975,129281,0,2931,126350
4/19/22,Jamaica,18.1096,-77.2975,129312,0,2932,126380
4/20/22,Jamaica,18.1096,-77.2975,129347,0,2936,126411
4/21/22,Jamaica,18.1096,-77.2975,129373,0,2937,126436
4/22/22,Jamaica,18.1096,-77.2975,129441,0,2941,126500
4/23/22,Jamaica,18.1096,-77.2975,129489,0,2943,126546
4/24/22,Jamaica,18.1096,-77.2975,129489,0,2943,126546
4/25/22,Jamaica,18.1096,-77.2975,129632,0,2948,126684
4/26/22,Jamaica,18.1096,-77.2975,129681,0,2949,126732
4/27/22,Jamaica,18.1096,-77.2975,129747,0,2954,126793
4/28/22,Jamaica,18.1096,-77.2975,129862,0,2955,126907
4/29/22,Jamaica,18.1096,-77.2975,129978,0,2962,127016
4/30/22,Jamaica,18.1096,-77.2975,129978,0,2962,127016
5/1/22,Jamaica,18.1096,-77.2975,129978,0,2962,127016
5/2/22,Jamaica,18.1096,-77.2975,130299,0,2967,127332
5/3/22,Jamaica,18.1096,-77.2975,130388,0,2969,127419
5/4/22,Jamaica,18.1096,-77.2975,130473,0,2970,127503
5/5/22,Jamaica,18.1096,-77.2975,130596,0,2972,127624
5/6/22,Jamaica,18.1096,-77.2975,130787,0,2973,127814
5/7/22,Jamaica,18.1096,-77.2975,130787,0,2973,127814
5/8/22,Jamaica,18.1096,-77.2975,131161,0,2977,128184
5/9/22,Jamaica,18.1096,-77.2975,131327,0,2980,128347
5/10/22,Jamaica,18.1096,-77.2975,131327,0,2980,128347
5/11/22,Jamaica,18.1096,-77.2975,131544,0,2987,128557
5/12/22,Jamaica,18.1096,-77.2975,131704,0,2991,128713
5/13/22,Jamaica,18.1096,-77.2975,131980,0,2995,128985
5/14/22,Jamaica,18.1096,-77.2975,131980,0,2995,128985
5/15/22,Jamaica,18.1096,-77.2975,131980,0,2995,128985
5/16/22,Jamaica,18.1096,-77.2975,132909,0,3011,129898
5/17/22,Jamaica,18.1096,-77.2975,133103,0,3011,130092
5/18/22,Jamaica,18.1096,-77.2975,133250,0,3013,130237
5/19/22,Jamaica,18.1096,-77.2975,133538,0,3018,130520
5/20/22,Jamaica,18.1096,-77.2975,133904,0,3021,130883
5/21/22,Jamaica,18.1096,-77.2975,133904,0,3021,130883
5/22/22,Jamaica,18.1096,-77.2975,134660,0,3032,131628
5/23/22,Jamaica,18.1096,-77.2975,134660,0,3032,131628
5/24/22,Jamaica,18.1096,-77.2975,135331,0,3039,132292
5/25/22,Jamaica,18.1096,-77.2975,135462,0,3042,132420
5/26/22,Jamaica,18.1096,-77.2975,135663,0,3044,132619
5/27/22,Jamaica,18.1096,-77.2975,135663,0,3044,132619
5/28/22,Jamaica,18.1096,-77.2975,135663,0,3044,132619
5/29/22,Jamaica,18.1096,-77.2975,136313,0,3049,133264
5/30/22,Jamaica,18.1096,-77.2975,137076,0,3056,134020
5/31/22,Jamaica,18.1096,-77.2975,137266,0,3056,134210
6/1/22,Jamaica,18.1096,-77.2975,137396,0,3059,134337
6/2/22,Jamaica,18.1096,-77.2975,137724,0,3069,134655
6/3/22,Jamaica,18.1096,-77.2975,138110,0,3069,135041
6/4/22,Jamaica,18.1096,-77.2975,138110,0,3069,135041
6/5/22,Jamaica,18.1096,-77.2975,138110,0,3069,135041
6/6/22,Jamaica,18.1096,-77.2975,139029,0,3074,135955
6/7/22,Jamaica,18.1096,-77.2975,139203,0,3076,136127
6/8/22,Jamaica,18.1096,-77.2975,139456,0,3079,136377
6/9/22,Jamaica,18.1096,-77.2975,139456,0,3079,136377
6/10/22,Jamaica,18.1096,-77.2975,139918,0,3080,136838
6/11/22,Jamaica,18.1096,-77.2975,140203,0,3082,137121
6/12/22,Jamaica,18.1096,-77.2975,140463,0,3083,137380
6/13/22,Jamaica,18.1096,-77.2975,140670,0,3084,137586
6/14/22,Jamaica,18.1096,-77.2975,140754,0,3091,137663
6/15/22,Jamaica,18.1096,-77.2975,140874,0,3091,137783
6/16/22,Jamaica,18.1096,-77.2975,141026,0,3093,137933
6/17/22,Jamaica,18.1096,-77.2975,141306,0,3093,138213
6/18/22,Jamaica,18.1096,-77.2975,141306,0,3093,138213
6/19/22,Jamaica,18.1096,-77.2975,141306,0,3093,138213
6/20/22,Jamaica,18.1096,-77.2975,141720,0,3098,138622
6/21/22,Jamaica,18.1096,-77.2975,141781,0,3098,138683
6/22/22,Jamaica,18.1096,-77.2975,141873,0,3106,138767
6/23/22,Jamaica,18.1096,-77.2975,142011,0,3107,138904
6/24/22,Jamaica,18.1096,-77.2975,142161,0,3112,139049
6/25/22,Jamaica,18.1096,-77.2975,142161,0,3112,139049
6/26/22,Jamaica,18.1096,-77.2975,142440,0,3119,139321
6/27/22,Jamaica,18.1096,-77.2975,142558,0,3120,139438
6/28/22,Jamaica,18.1096,-77.2975,142626,0,3121,139505
6/29/22,Jamaica,18.1096,-77.2975,142683,0,3124,139559
6/30/22,Jamaica,18.1096,-77.2975,142804,0,3128,139676
7/1/22,Jamaica,18.1096,-77.2975,142912,0,3130,139782
7/2/22,Jamaica,18.1096,-77.2975,143097,0,3134,139963
7/3/22,Jamaica,18.1096,-77.2975,143240,0,3140,140100
7/4/22,Jamaica,18.1096,-77.2975,143347,0,3144,140203
7/5/22,Jamaica,18.1096,-77.2975,143408,0,3145,140263
7/6/22,Jamaica,18.1096,-77.2975,143408,0,3145,140263
7/7/22,Jamaica,18.1096,-77.2975,143476,0,3147,140329
7/8/22,Jamaica,18.1096,-77.2975,143610,0,3148,140462
7/9/22,Jamaica,18.1096,-77.2975,143865,0,3155,140710
7/10/22,Jamaica,18.1096,-77.2975,143982,0,3157,140825
7/11/22,Jamaica,18.1096,-77.2975,144092,0,3158,140934
7/12/22,Jamaica,18.1096,-77.2975,144138,0,3158,140980
7/13/22,Jamaica,18.1096,-77.2975,144213,0,3161,141052
7/14/22,Jamaica,18.1096,-77.2975,144349,0,3164,141185
7/15/22,Jamaica,18.1096,-77.2975,144489,0,3166,141323
7/16/22,Jamaica,18.1096,-77.2975,144617,0,3170,141447
7/17/22,Jamaica,18.1096,-77.2975,144767,0,3171,141596
7/18/22,Jamaica,18.1096,-77.2975,144881,0,3171,141710
7/19/22,Jamaica,18.1096,-77.2975,144932,0,3173,141759
7/20/22,Jamaica,18.1096,-77.2975,144997,0,3174,141823
7/21/22,Jamaica,18.1096,-77.2975,145157,0,3176,141981
7/22/22,Jamaica,18.1096,-77.2975,145345,0,3181,142164
7/23/22,Jamaica,18.1096,-77.2975,145497,0,3181,142316
7/24/22,Jamaica,18.1096,-77.2975,145633,0,3182,142451
7/25/22,Jamaica,18.1096,-77.2975,145738,0,3184,142554
7/26/22,Jamaica,18.1096,-77.2975,145803,0,3186,142617
7/27/22,Jamaica,18.1096,-77.2975,145803,0,3186,142617
7/28/22,Jamaica,18.1096,-77.2975,145983,0,3187,142796
7/29/22,Jamaica,18.1096,-77.2975,146114,0,3191,142923
7/30/22,Jamaica,18.1096,-77.2975,146241,0,3193,143048
7/31/22,Jamaica,18.1096,-77.2975,146372,0,3194,143178
8/1/22,Jamaica,18.1096,-77.2975,146468,0,3194,143274
8/2/22,Jamaica,18.1096,-77.2975,146541,0,3195,143346
8/3/22,Jamaica,18.1096,-77.2975,146608,0,3198,143410
8/4/22,Jamaica,18.1096,-77.2975,146695,0,3199,143496
8/5/22,Jamaica,18.1096,-77.2975,146843,0,3201,143642
8/6/22,Jamaica,18.1096,-77.2975,147006,0,3206,143800
8/7/22,Jamaica,18.1096,-77.2975,147189,0,3207,143982
8/8/22,Jamaica,18.1096,-77.2975,147316,0,3207,144109
8/9/22,Jamaica,18.1096,-77.2975,147344,0,3207,144137
8/10/22,Jamaica,18.1096,-77.2975,147344,0,3207,144137
8/11/22,Jamaica,18.1096,-77.2975,147567,0,3216,144351
8/12/22,Jamaica,18.1096,-77.2975,147725,0,3219,144506
8/13/22,Jamaica,18.1096,-77.2975,147908,0,3221,144687
8/14/22,Jamaica,18.1096,-77.2975,148048,0,3221,144827
8/15/22,Jamaica,18.1096,-77.2975,148184,0,3224,144960
8/16/22,Jamaica,18.1096,-77.2975,148226,0,3226,145000
8/17/22,Jamaica,18.1096,-77.2975,148322,0,3230,145092
8/18/22,Jamaica,18.1096,-77.2975,148450,0,3230,145220
8/19/22,Jamaica,18.1096,-77.2975,148627,0,3235,145392
8/20/22,Jamaica,18.1096,-77.2975,148737,0,3237,145500
8/21/22,Jamaica,18.1096,-77.2975,148824,0,3237,145587
8/22/22,Jamaica,18.1096,-77.2975,148952,0,3237,145715
8/23/22,Jamaica,18.1096,-77.2975,148996,0,3239,145757
8/24/22,Jamaica,18.1096,-77.2975,149092,0,3239,145853
8/25/22,Jamaica,18.1096,-77.2975,149218,0,3239,145979
8/26/22,Jamaica,18.1096,-77.2975,149327,0,3241,146086
8/27/22,Jamaica,18.1096,-77.2975,149420,0,3250,146170
8/28/22,Jamaica,18.1096,-77.2975,149596,0,3250,146346
8/29/22,Jamaica,18.1096,-77.2975,149714,0,3252,146462
8/30/22,Jamaica,18.1096,-77.2975,149763,0,3254,146509
8/31/22,Jamaica,18.1096,-77.2975,149798,0,3254,146544
9/1/22,Jamaica,18.1096,-77.2975,149911,0,3254,146657
9/2/22,Jamaica,18.1096,-77.2975,150018,0,3262,146756
9/3/22,Jamaica,18.1096,-77.2975,150101,0,3262,146839
9/4/22,Jamaica,18.1096,-77.2975,150180,0,3267,146913
9/5/22,Jamaica,18.1096,-77.2975,150307,0,3268,147039
9/6/22,Jamaica,18.1096,-77.2975,150358,0,3269,147089
9/7/22,Jamaica,18.1096,-77.2975,150401,0,3269,147132
9/8/22,Jamaica,18.1096,-77.2975,150401,0,3269,147132
9/9/22,Jamaica,18.1096,-77.2975,150590,0,3277,147313
9/10/22,Jamaica,18.1096,-77.2975,150663,0,3283,147380
9/11/22,Jamaica,18.1096,-77.2975,150752,0,3284,147468
9/12/22,Jamaica,18.1096,-77.2975,150844,0,3284,147560
9/13/22,Jamaica,18.1096,-77.2975,150909,0,3286,147623
9/14/22,Jamaica,18.1096,-77.2975,150921,0,3288,147633
9/15/22,Jamaica,18.1096,-77.2975,151016,0,3288,147728
9/16/22,Jamaica,18.1096,-77.2975,151130,0,3289,147841
9/17/22,Jamaica,18.1096,-77.2975,151221,0,3290,147931
9/18/22,Jamaica,18.1096,-77.2975,151269,0,3294,147975
9/19/22,Jamaica,18.1096,-77.2975,151340,0,3296,148044
9/20/22,Jamaica,18.1096,-77.2975,151375,0,3298,148077
9/21/22,Jamaica,18.1096,-77.2975,151405,0,3299,148106
9/22/22,Jamaica,18.1096,-77.2975,151506,0,3301,148205
9/23/22,Jamaica,18.1096,-77.2975,151542,0,3304,148238
9/24/22,Jamaica,18.1096,-77.2975,151594,0,3306,148288
9/25/22,Jamaica,18.1096,-77.2975,151650,0,3310,148340
9/26/22,Jamaica,18.1096,-77.2975,151706,0,3311,148395
9/27/22,Jamaica,18.1096,-77.2975,151752,0,3312,148440
9/28/22,Jamaica,18.1096,-77.2975,151791,0,3314,148477
9/29/22,Jamaica,18.1096,-77.2975,151829,0,3317,148512
9/30/22,Jamaica,18.1096,-77.2975,151829,0,3317,148512
10/1/22,Jamaica,18.1096,-77.2975,151931,0,3320,148611
10/2/22,Jamaica,18.1096,-77.2975,151931,0,3320,148611
10/3/22,Jamaica,18.1096,-77.2975,151931,0,3320,148611
10/4/22,Jamaica,18.1096,-77.2975,151931,0,3320,148611
10/5/22,Jamaica,18.1096,-77.2975,151931,0,3320,148611
10/6/22,Jamaica,18.1096,-77.2975,151931,0,3320,148611
10/7/22,Jamaica,18.1096,-77.2975,151931,0,3320,148611
10/8/22,Jamaica,18.1096,-77.2975,151931,0,3320,148611
10/9/22,Jamaica,18.1096,-77.2975,151931,0,3320,148611
10/10/22,Jamaica,18.1096,-77.2975,151931,0,3320,148611
10/11/22,Jamaica,18.1096,-77.2975,151931,0,3320,148611
10/12/22,Jamaica,18.1096,-77.2975,151931,0,3320,148611
10/13/22,Jamaica,18.1096,-77.2975,151931,0,3320,148611
10/14/22,Jamaica,18.1096,-77.2975,151931,0,3320,148611
10/15/22,Jamaica,18.1096,-77.2975,151931,0,3320,148611
10/16/22,Jamaica,18.1096,-77.2975,151931,0,3320,148611
10/17/22,Jamaica,18.1096,-77.2975,151931,0,3320,148611
10/18/22,Jamaica,18.1096,-77.2975,151931,0,3320,148611
10/19/22,Jamaica,18.1096,-77.2975,151931,0,3320,148611
10/20/22,Jamaica,18.1096,-77.2975,151931,0,3320,148611
10/21/22,Jamaica,18.1096,-77.2975,151931,0,3320,148611
10/22/22,Jamaica,18.1096,-77.2975,151931,0,3320,148611
10/23/22,Jamaica,18.1096,-77.2975,151931,0,3320,148611
10/24/22,Jamaica,18.1096,-77.2975,151931,0,3320,148611
10/25/22,Jamaica,18.1096,-77.2975,151931,0,3320,148611
10/26/22,Jamaica,18.1096,-77.2975,151931,0,3320,148611
10/27/22,Jamaica,18.1096,-77.2975,151931,0,3320,148611
10/28/22,Jamaica,18.1096,-77.2975,151931,0,3320,148611
10/29/22,Jamaica,18.1096,-77.2975,151931,0,3320,148611
10/30/22,Jamaica,18.1096,-77.2975,151931,0,3320,148611
10/31/22,Jamaica,18.1096,-77.2975,151931,0,3320,148611
11/1/22,Jamaica,18.1096,-77.2975,151931,0,3320,148611
11/2/22,Jamaica,18.1096,-77.2975,151931,0,3320,148611
11/3/22,Jamaica,18.1096,-77.2975,151931,0,3320,148611
11/4/22,Jamaica,18.1096,-77.2975,151931,0,3320,148611
11/5/22,Jamaica,18.1096,-77.2975,151931,0,3320,148611
11/6/22,Jamaica,18.1096,-77.2975,151931,0,3320,148611
11/7/22,Jamaica,18.1096,-77.2975,152236,0,3349,148887
11/8/22,Jamaica,18.1096,-77.2975,152306,0,3350,148956
11/9/22,Jamaica,18.1096,-77.2975,152306,0,3350,148956
11/10/22,Jamaica,18.1096,-77.2975,152306,0,3350,148956
11/11/22,Jamaica,18.1096,-77.2975,152306,0,3350,148956
11/12/22,Jamaica,18.1096,-77.2975,152306,0,3350,148956
11/13/22,Jamaica,18.1096,-77.2975,152306,0,3350,148956
11/14/22,Jamaica,18.1096,-77.2975,152306,0,3350,148956
11/15/22,Jamaica,18.1096,-77.2975,152381,0,3351,149030
11/16/22,Jamaica,18.1096,-77.2975,152381,0,3351,149030
11/17/22,Jamaica,18.1096,-77.2975,152381,0,3351,149030
11/18/22,Jamaica,18.1096,-77.2975,152381,0,3351,149030
11/19/22,Jamaica,18.1096,-77.2975,152381,0,3351,149030
11/20/22,Jamaica,18.1096,-77.2975,152381,0,3351,149030
11/21/22,Jamaica,18.1096,-77.2975,152381,0,3351,149030
11/22/22,Jamaica,18.1096,-77.2975,152517,0,3399,149118
11/23/22,Jamaica,18.1096,-77.2975,152517,0,3399,149118
11/24/22,Jamaica,18.1096,-77.2975,152517,0,3399,149118
11/25/22,Jamaica,18.1096,-77.2975,152517,0,3399,149118
11/26/22,Jamaica,18.1096,-77.2975,152517,0,3399,149118
11/27/22,Jamaica,18.1096,-77.2975,152517,0,3399,149118
11/28/22,Jamaica,18.1096,-77.2975,152517,0,3399,149118
11/29/22,Jamaica,18.1096,-77.2975,152517,0,3399,149118
11/30/22,Jamaica,18.1096,-77.2975,152517,0,3399,149118
12/1/22,Jamaica,18.1096,-77.2975,152517,0,3399,149118
12/2/22,Jamaica,18.1096,-77.2975,152517,0,3399,149118
12/3/22,Jamaica,18.1096,-77.2975,152517,0,3399,149118
12/4/22,Jamaica,18.1096,-77.2975,152517,0,3399,149118
12/5/22,Jamaica,18.1096,-77.2975,152517,0,3399,149118
12/6/22,Jamaica,18.1096,-77.2975,152517,0,3399,149118
12/7/22,Jamaica,18.1096,-77.2975,152624,0,3433,149191
12/8/22,Jamaica,18.1096,-77.2975,152624,0,3433,149191
12/9/22,Jamaica,18.1096,-77.2975,152669,0,3433,149236
12/10/22,Jamaica,18.1096,-77.2975,152669,0,3433,149236
12/11/22,Jamaica,18.1096,-77.2975,152669,0,3433,149236
12/12/22,Jamaica,18.1096,-77.2975,152669,0,3433,149236
12/13/22,Jamaica,18.1096,-77.2975,152669,0,3433,149236
12/14/22,Jamaica,18.1096,-77.2975,152669,0,3433,149236
12/15/22,Jamaica,18.1096,-77.2975,152669,0,3447,149222
12/16/22,Jamaica,18.1096,-77.2975,152669,0,3447,149222
12/17/22,Jamaica,18.1096,-77.2975,152669,0,3447,149222
1/1/22,Japan,36.204824,138.252924,1733835,0,18392,1715443
1/2/22,Japan,36.204824,138.252924,1734463,0,18394,1716069
1/3/22,Japan,36.204824,138.252924,1735244,0,18395,1716849
1/4/22,Japan,36.204824,138.252924,1736510,0,18396,1718114
1/5/22,Japan,36.204824,138.252924,1738998,0,18397,1720601
1/6/22,Japan,36.204824,138.252924,1743442,0,18398,1725044
1/7/22,Japan,36.204824,138.252924,1749686,0,18399,1731287
1/8/22,Japan,36.204824,138.252924,1758297,0,18401,1739896
1/9/22,Japan,36.204824,138.252924,1766539,0,18402,1748137
1/10/22,Japan,36.204824,138.252924,1772969,0,18404,1754565
1/11/22,Japan,36.204824,138.252924,1779343,0,18406,1760937
1/12/22,Japan,36.204824,138.252924,1792578,0,18411,1774167
1/13/22,Japan,36.204824,138.252924,1811255,0,18415,1792840
1/14/22,Japan,36.204824,138.252924,1833475,0,18426,1815049
1/15/22,Japan,36.204824,138.252924,1859208,0,18432,1840776
1/16/22,Japan,36.204824,138.252924,1884687,0,18432,1866255
1/17/22,Japan,36.204824,138.252924,1905685,0,18436,1887249
1/18/22,Japan,36.204824,138.252924,1938027,0,18446,1919581
1/19/22,Japan,36.204824,138.252924,1979505,0,18461,1961044
1/20/22,Japan,36.204824,138.252924,2025683,0,18470,2007213
1/21/22,Japan,36.204824,138.252924,2075528,0,18479,2057049
1/22/22,Japan,36.204824,138.252924,2129939,0,18496,2111443
1/23/22,Japan,36.204824,138.252924,2179922,0,18510,2161412
1/24/22,Japan,36.204824,138.252924,2224761,0,18527,2206234
1/25/22,Japan,36.204824,138.252924,2287375,0,18570,2268805
1/26/22,Japan,36.204824,138.252924,2358972,0,18604,2340368
1/27/22,Japan,36.204824,138.252924,2437984,0,18651,2419333
1/28/22,Japan,36.204824,138.252924,2519772,0,18695,2501077
1/29/22,Japan,36.204824,138.252924,2604661,0,18737,2585924
1/30/22,Japan,36.204824,138.252924,2682767,0,18767,2664000
1/31/22,Japan,36.204824,138.252924,2743726,0,18815,2724911
2/1/22,Japan,36.204824,138.252924,2825414,0,18885,2806529
2/2/22,Japan,36.204824,138.252924,2920300,0,18967,2901333
2/3/22,Japan,36.204824,138.252924,3024742,0,19057,3005685
2/4/22,Japan,36.204824,138.252924,3122919,0,19160,3103759
2/5/22,Japan,36.204824,138.252924,3225194,0,19276,3205918
2/6/22,Japan,36.204824,138.252924,3315180,0,19344,3295836
2/7/22,Japan,36.204824,138.252924,3383184,0,19457,3363727
2/8/22,Japan,36.204824,138.252924,3484368,0,19616,3464752
2/9/22,Japan,36.204824,138.252924,3582167,0,19778,3562389
2/10/22,Japan,36.204824,138.252924,3681890,0,19942,3661948
2/11/22,Japan,36.204824,138.252924,3780239,0,20092,3760147
2/12/22,Japan,36.204824,138.252924,3848672,0,20237,3828435
2/13/22,Japan,36.204824,138.252924,3926107,0,20374,3905733
2/14/22,Japan,36.204824,138.252924,3986217,0,20523,3965694
2/15/22,Japan,36.204824,138.252924,4070412,0,20759,4049653
2/16/22,Japan,36.204824,138.252924,4161342,0,20989,4140353
2/17/22,Japan,36.204824,138.252924,4256522,0,21260,4235262
2/18/22,Japan,36.204824,138.252924,4344220,0,21470,4322750
2/19/22,Japan,36.204824,138.252924,4425739,0,21688,4404051
2/20/22,Japan,36.204824,138.252924,4497233,0,21847,4475386
2/21/22,Japan,36.204824,138.252924,4549142,0,22020,4527122
2/22/22,Japan,36.204824,138.252924,4618759,0,22342,4596417
2/23/22,Japan,36.204824,138.252924,4699110,0,22588,4676522
2/24/22,Japan,36.204824,138.252924,4760332,0,22794,4737538
2/25/22,Japan,36.204824,138.252924,4825972,0,23072,4802900
2/26/22,Japan,36.204824,138.252924,4898120,0,23328,4874792
2/27/22,Japan,36.204824,138.252924,4961816,0,23472,4938344
2/28/22,Japan,36.204824,138.252924,5012908,0,23670,4989238
3/1/22,Japan,36.204824,138.252924,5078276,0,23908,5054368
3/2/22,Japan,36.204824,138.252924,5150876,0,24143,5126733
3/3/22,Japan,36.204824,138.252924,5221144,0,24401,5196743
3/4/22,Japan,36.204824,138.252924,5284831,0,24635,5260196
3/5/22,Japan,36.204824,138.252924,5348422,0,24819,5323603
3/6/22,Japan,36.204824,138.252924,5402455,0,24951,5377504
3/7/22,Japan,36.204824,138.252924,5439457,0,25071,5414386
3/8/22,Japan,36.204824,138.252924,5493395,0,25320,5468075
3/9/22,Japan,36.204824,138.252924,5557262,0,25533,5531729
3/10/22,Japan,36.204824,138.252924,5618325,0,25721,5592604
3/11/22,Japan,36.204824,138.252924,5674311,0,25930,5648381
3/12/22,Japan,36.204824,138.252924,5729537,0,26071,5703466
3/13/22,Japan,36.204824,138.252924,5780484,0,26161,5754323
3/14/22,Japan,36.204824,138.252924,5812843,0,26277,5786566
3/15/22,Japan,36.204824,138.252924,5863778,0,26465,5837313
3/16/22,Japan,36.204824,138.252924,5921690,0,26628,5895062
3/17/22,Japan,36.204824,138.252924,5975168,0,26799,5948369
3/18/22,Japan,36.204824,138.252924,6024350,0,26955,5997395
3/19/22,Japan,36.204824,138.252924,6068943,0,27059,6041884
3/20/22,Japan,36.204824,138.252924,6108503,0,27125,6081378
3/21/22,Japan,36.204824,138.252924,6136069,0,27183,6108886
3/22/22,Japan,36.204824,138.252924,6156221,0,27254,6128967
3/23/22,Japan,36.204824,138.252924,6197583,0,27376,6170207
3/24/22,Japan,36.204824,138.252924,6247334,0,27502,6219832
3/25/22,Japan,36.204824,138.252924,6294771,0,27617,6267154
3/26/22,Japan,36.204824,138.252924,6342100,0,27718,6314382
3/27/22,Japan,36.204824,138.252924,6385448,0,27779,6357669
3/28/22,Japan,36.204824,138.252924,6415168,0,27844,6387324
3/29/22,Japan,36.204824,138.252924,6459761,0,27926,6431835
3/30/22,Japan,36.204824,138.252924,6513370,0,28022,6485348
3/31/22,Japan,36.204824,138.252924,6565019,0,28124,6536895
4/1/22,Japan,36.204824,138.252924,6614278,0,28202,6586076
4/2/22,Japan,36.204824,138.252924,6663087,0,28257,6634830
4/3/22,Japan,36.204824,138.252924,6710303,0,28291,6682012
4/4/22,Japan,36.204824,138.252924,6740558,0,28336,6712222
4/5/22,Japan,36.204824,138.252924,6786356,0,28400,6757956
4/6/22,Japan,36.204824,138.252924,6841117,0,28466,6812651
4/7/22,Japan,36.204824,138.252924,6895996,0,28535,6867461
4/8/22,Japan,36.204824,138.252924,6948130,0,28604,6919526
4/9/22,Japan,36.204824,138.252924,7000759,0,28653,6972106
4/10/22,Japan,36.204824,138.252924,7049807,0,28692,7021115
4/11/22,Japan,36.204824,138.252924,7082903,0,28726,7054177
4/12/22,Japan,36.204824,138.252924,7132975,0,28773,7104202
4/13/22,Japan,36.204824,138.252924,7190641,0,28840,7161801
4/14/22,Japan,36.204824,138.252924,7245842,0,28892,7216950
4/15/22,Japan,36.204824,138.252924,7295539,0,28954,7266585
4/16/22,Japan,36.204824,138.252924,7343063,0,29002,7314061
4/17/22,Japan,36.204824,138.252924,7382268,0,29029,7353239
4/18/22,Japan,36.204824,138.252924,7406848,0,29056,7377792
4/19/22,Japan,36.204824,138.252924,7447674,0,29108,7418566
4/20/22,Japan,36.204824,138.252924,7495555,0,29157,7466398
4/21/22,Japan,36.204824,138.252924,7542666,0,29209,7513457
4/22/22,Japan,36.204824,138.252924,7585564,0,29260,7556304
4/23/22,Japan,36.204824,138.252924,7629456,0,29294,7600162
4/24/22,Japan,36.204824,138.252924,7668131,0,29309,7638822
4/25/22,Japan,36.204824,138.252924,7692973,0,29348,7663625
4/26/22,Japan,36.204824,138.252924,7733523,0,29413,7704110
4/27/22,Japan,36.204824,138.252924,7779777,0,29473,7750304
4/28/22,Japan,36.204824,138.252924,7821448,0,29512,7791936
4/29/22,Japan,36.204824,138.252924,7858117,0,29557,7828560
4/30/22,Japan,36.204824,138.252924,7883149,0,29571,7853578
5/1/22,Japan,36.204824,138.252924,7910179,0,29605,7880574
5/2/22,Japan,36.204824,138.252924,7929437,0,29635,7899802
5/3/22,Japan,36.204824,138.252924,7959950,0,29690,7930260
5/4/22,Japan,36.204824,138.252924,7986412,0,29710,7956702
5/5/22,Japan,36.204824,138.252924,8007124,0,29728,7977396
5/6/22,Japan,36.204824,138.252924,8028779,0,29765,7999014
5/7/22,Japan,36.204824,138.252924,8068007,0,29792,8038215
5/8/22,Japan,36.204824,138.252924,8110413,0,29818,8080595
5/9/22,Japan,36.204824,138.252924,8138766,0,29851,8108915
5/10/22,Japan,36.204824,138.252924,8180756,0,29902,8150854
5/11/22,Japan,36.204824,138.252924,8227154,0,29943,8197211
5/12/22,Japan,36.204824,138.252924,8268802,0,29975,8238827
5/13/22,Japan,36.204824,138.252924,8308372,0,30010,8278362
5/14/22,Japan,36.204824,138.252924,8347702,0,30040,8317662
5/15/22,Japan,36.204824,138.252924,8382913,0,30065,8352848
5/16/22,Japan,36.204824,138.252924,8404699,0,30091,8374608
5/17/22,Japan,36.204824,138.252924,8441494,0,30130,8411364
5/18/22,Japan,36.204824,138.252924,8483562,0,30180,8453382
5/19/22,Japan,36.204824,138.252924,8523132,0,30216,8492916
5/20/22,Japan,36.204824,138.252924,8560475,0,30260,8530215
5/21/22,Japan,36.204824,138.252924,8596323,0,30291,8566032
5/22/22,Japan,36.204824,138.252924,8628164,0,30309,8597855
5/23/22,Japan,36.204824,138.252924,8646671,0,30340,8616331
5/24/22,Japan,36.204824,138.252924,8679163,0,30382,8648781
5/25/22,Japan,36.204824,138.252924,8714263,0,30425,8683838
5/26/22,Japan,36.204824,138.252924,8745175,0,30467,8714708
5/27/22,Japan,36.204824,138.252924,8772867,0,30505,8742362
5/28/22,Japan,36.204824,138.252924,8798523,0,30541,8767982
5/29/22,Japan,36.204824,138.252924,8819323,0,30560,8788763
5/30/22,Japan,36.204824,138.252924,8831651,0,30584,8801067
5/31/22,Japan,36.204824,138.252924,8853455,0,30623,8822832
6/1/22,Japan,36.204824,138.252924,8876113,0,30659,8845454
6/2/22,Japan,36.204824,138.252924,8896430,0,30682,8865748
6/3/22,Japan,36.204824,138.252924,8915687,0,30714,8884973
6/4/22,Japan,36.204824,138.252924,8933945,0,30737,8903208
6/5/22,Japan,36.204824,138.252924,8949039,0,30753,8918286
6/6/22,Japan,36.204824,138.252924,8958140,0,30777,8927363
6/7/22,Japan,36.204824,138.252924,8975161,0,30803,8944358
6/8/22,Japan,36.204824,138.252924,8993568,0,30824,8962744
6/9/22,Japan,36.204824,138.252924,9010356,0,30847,8979509
6/10/22,Japan,36.204824,138.252924,9025940,0,30868,8995072
6/11/22,Japan,36.204824,138.252924,9041278,0,30883,9010395
6/12/22,Japan,36.204824,138.252924,9054719,0,30892,9023827
6/13/22,Japan,36.204824,138.252924,9062661,0,30913,9031748
6/14/22,Japan,36.204824,138.252924,9077975,0,30942,9047033
6/15/22,Japan,36.204824,138.252924,9094519,0,30965,9063554
6/16/22,Japan,36.204824,138.252924,9110063,0,30985,9079078
6/17/22,Japan,36.204824,138.252924,9124760,0,31003,9093757
6/18/22,Japan,36.204824,138.252924,9139597,0,31023,9108574
6/19/22,Japan,36.204824,138.252924,9152738,0,31033,9121705
6/20/22,Japan,36.204824,138.252924,9160533,0,31046,9129487
6/21/22,Japan,36.204824,138.252924,9175927,0,31063,9144864
6/22/22,Japan,36.204824,138.252924,9193205,0,31078,9162127
6/23/22,Japan,36.204824,138.252924,9209862,0,31093,9178769
6/24/22,Japan,36.204824,138.252924,9225840,0,31108,9194732
6/25/22,Japan,36.204824,138.252924,9242413,0,31117,9211296
6/26/22,Japan,36.204824,138.252924,9256660,0,31129,9225531
6/27/22,Japan,36.204824,138.252924,9266214,0,31142,9235072
6/28/22,Japan,36.204824,138.252924,9285592,0,31250,9254342
6/29/22,Japan,36.204824,138.252924,9308916,0,31267,9277649
6/30/22,Japan,36.204824,138.252924,9332302,0,31281,9301021
7/1/22,Japan,36.204824,138.252924,9355427,0,31302,9324125
7/2/22,Japan,36.204824,138.252924,9380327,0,31313,9349014
7/3/22,Japan,36.204824,138.252924,9403613,0,31318,9372295
7/4/22,Japan,36.204824,138.252924,9420398,0,31332,9389066
7/5/22,Japan,36.204824,138.252924,9456631,0,31352,9425279
7/6/22,Japan,36.204824,138.252924,9502425,0,31364,9471061
7/7/22,Japan,36.204824,138.252924,9550392,0,31379,9519013
7/8/22,Japan,36.204824,138.252924,9600360,0,31408,9568952
7/9/22,Japan,36.204824,138.252924,9655344,0,31420,9623924
7/10/22,Japan,36.204824,138.252924,9709429,0,31432,9677997
7/11/22,Japan,36.204824,138.252924,9746584,0,31447,9715137
7/12/22,Japan,36.204824,138.252924,9822578,0,31470,9791108
7/13/22,Japan,36.204824,138.252924,9917058,0,31501,9885557
7/14/22,Japan,36.204824,138.252924,10014835,0,31534,9983301
7/15/22,Japan,36.204824,138.252924,10118147,0,31565,10086582
7/16/22,Japan,36.204824,138.252924,10228794,0,31585,10197209
7/17/22,Japan,36.204824,138.252924,10334366,0,31602,10302764
7/18/22,Japan,36.204824,138.252924,10410516,0,31621,10378895
7/19/22,Japan,36.204824,138.252924,10477208,0,31649,10445559
7/20/22,Japan,36.204824,138.252924,10629729,0,31702,10598027
7/21/22,Japan,36.204824,138.252924,10815963,0,31750,10784213
7/22/22,Japan,36.204824,138.252924,11011053,0,31802,10979251
7/23/22,Japan,36.204824,138.252924,11211985,0,31877,11180108
7/24/22,Japan,36.204824,138.252924,11388477,0,31902,11356575
7/25/22,Japan,36.204824,138.252924,11514977,0,31950,11483027
7/26/22,Japan,36.204824,138.252924,11711379,0,32065,11679314
7/27/22,Japan,36.204824,138.252924,11920979,0,32194,11888785
7/28/22,Japan,36.204824,138.252924,12154082,0,32308,12121774
7/29/22,Japan,36.204824,138.252924,12375380,0,32430,12342950
7/30/22,Japan,36.204824,138.252924,12597610,0,32531,12565079
7/31/22,Japan,36.204824,138.252924,12795382,0,32613,12762769
8/1/22,Japan,36.204824,138.252924,12935010,0,32707,12902303
8/2/22,Japan,36.204824,138.252924,13145926,0,32850,13113076
8/3/22,Japan,36.204824,138.252924,13395634,0,33019,13362615
8/4/22,Japan,36.204824,138.252924,13634335,0,33180,13601155
8/5/22,Japan,36.204824,138.252924,13868027,0,33394,13834633
8/6/22,Japan,36.204824,138.252924,14095507,0,33546,14061961
8/7/22,Japan,36.204824,138.252924,14301928,0,33698,14268230
8/8/22,Japan,36.204824,138.252924,14439709,0,33848,14405861
8/9/22,Japan,36.204824,138.252924,14652175,0,34126,14618049
8/10/22,Japan,36.204824,138.252924,14902463,0,34377,14868086
8/11/22,Japan,36.204824,138.252924,15142572,0,34583,15107989
8/12/22,Japan,36.204824,138.252924,15311290,0,34793,15276497
8/13/22,Japan,36.204824,138.252924,15494932,0,35049,15459883
8/14/22,Japan,36.204824,138.252924,15673273,0,35202,15638071
8/15/22,Japan,36.204824,138.252924,15811748,0,35406,15776342
8/16/22,Japan,36.204824,138.252924,15977877,0,35712,15942165
8/17/22,Japan,36.204824,138.252924,16209238,0,36002,16173236
8/18/22,Japan,36.204824,138.252924,16464723,0,36289,16428434
8/19/22,Japan,36.204824,138.252924,16725722,0,36583,16689139
8/20/22,Japan,36.204824,138.252924,16978914,0,36837,16942077
8/21/22,Japan,36.204824,138.252924,17205062,0,37063,17167999
8/22/22,Japan,36.204824,138.252924,17345982,0,37308,17308674
8/23/22,Japan,36.204824,138.252924,17554433,0,37651,17516782
8/24/22,Japan,36.204824,138.252924,17797923,0,37952,17759971
8/25/22,Japan,36.204824,138.252924,18018770,0,38248,17980522
8/26/22,Japan,36.204824,138.252924,18211113,0,38569,18172544
8/27/22,Japan,36.204824,138.252924,18391173,0,38830,18352343
8/28/22,Japan,36.204824,138.252924,18548929,0,39051,18509878
8/29/22,Japan,36.204824,138.252924,18644758,0,39285,18605473
8/30/22,Japan,36.204824,138.252924,18797340,0,39604,18757736
8/31/22,Japan,36.204824,138.252924,18966848,0,39942,18926906
9/1/22,Japan,36.204824,138.252924,19116684,0,40245,19076439
9/2/22,Japan,36.204824,138.252924,19246866,0,40595,19206271
9/3/22,Japan,36.204824,138.252924,19369978,0,40883,19329095
9/4/22,Japan,36.204824,138.252924,19477797,0,41099,19436698
9/5/22,Japan,36.204824,138.252924,19545759,0,41320,19504439
9/6/22,Japan,36.204824,138.252924,19657900,0,41640,19616260
9/7/22,Japan,36.204824,138.252924,19787682,0,41887,19745795
9/8/22,Japan,36.204824,138.252924,19900027,0,42114,19857913
9/9/22,Japan,36.204824,138.252924,19999466,0,42350,19957116
9/10/22,Japan,36.204824,138.252924,20092165,0,42558,20049607
9/11/22,Japan,36.204824,138.252924,20173655,0,42662,20130993
9/12/22,Japan,36.204824,138.252924,20226491,0,42807,20183684
9/13/22,Japan,36.204824,138.252924,20314059,0,43027,20271032
9/14/22,Japan,36.204824,138.252924,20414288,0,43211,20371077
9/15/22,Japan,36.204824,138.252924,20500172,0,43382,20456790
9/16/22,Japan,36.204824,138.252924,20576128,0,43559,20532569
9/17/22,Japan,36.204824,138.252924,20647079,0,43697,20603382
9/18/22,Japan,36.204824,138.252924,20711125,0,43769,20667356
9/19/22,Japan,36.204824,138.252924,20749162,0,43846,20705316
9/20/22,Japan,36.204824,138.252924,20780883,0,43973,20736910
9/21/22,Japan,36.204824,138.252924,20850696,0,44099,20806597
9/22/22,Japan,36.204824,138.252924,20928069,0,44201,20883868
9/23/22,Japan,36.204824,138.252924,20991907,0,44288,20947619
9/24/22,Japan,36.204824,138.252924,21031120,0,44356,20986764
9/25/22,Japan,36.204824,138.252924,21077882,0,44405,21033477
9/26/22,Japan,36.204824,138.252924,21121413,0,44479,21076934
9/27/22,Japan,36.204824,138.252924,21165123,0,44584,21120539
9/28/22,Japan,36.204824,138.252924,21215102,0,44680,21170422
9/29/22,Japan,36.204824,138.252924,21257275,0,44807,21212468
9/30/22,Japan,36.204824,138.252924,21293921,0,44918,21249003
10/1/22,Japan,36.204824,138.252924,21329519,0,45023,21284496
10/2/22,Japan,36.204824,138.252924,21358831,0,45094,21313737
10/3/22,Japan,36.204824,138.252924,21373998,0,45147,21328851
10/4/22,Japan,36.204824,138.252924,21413721,0,45212,21368509
10/5/22,Japan,36.204824,138.252924,21455079,0,45286,21409793
10/6/22,Japan,36.204824,138.252924,21488519,0,45377,21443142
10/7/22,Japan,36.204824,138.252924,21517962,0,45450,21472512
10/8/22,Japan,36.204824,138.252924,21544747,0,45533,21499214
10/9/22,Japan,36.204824,138.252924,21567543,0,45590,21521953
10/10/22,Japan,36.204824,138.252924,21580581,0,45640,21534941
10/11/22,Japan,36.204824,138.252924,21593704,0,45667,21548037
10/12/22,Japan,36.204824,138.252924,21639209,0,45721,21593488
10/13/22,Japan,36.204824,138.252924,21684899,0,45799,21639100
10/14/22,Japan,36.204824,138.252924,21721504,0,45862,21675642
10/15/22,Japan,36.204824,138.252924,21756642,0,45929,21710713
10/16/22,Japan,36.204824,138.252924,21786304,0,45976,21740328
10/17/22,Japan,36.204824,138.252924,21801676,0,45996,21755680
10/18/22,Japan,36.204824,138.252924,21843970,0,46052,21797918
10/19/22,Japan,36.204824,138.252924,21887525,0,46120,21841405
10/20/22,Japan,36.204824,138.252924,21923635,0,46191,21877444
10/21/22,Japan,36.204824,138.252924,21955228,0,46258,21908970
10/22/22,Japan,36.204824,138.252924,21989401,0,46336,21943065
10/23/22,Japan,36.204824,138.252924,22020274,0,46380,21973894
10/24/22,Japan,36.204824,138.252924,22037126,0,46415,21990711
10/25/22,Japan,36.204824,138.252924,22084832,0,46453,22038379
10/26/22,Japan,36.204824,138.252924,22135126,0,46520,22088606
10/27/22,Japan,36.204824,138.252924,22177863,0,46591,22131272
10/28/22,Japan,36.204824,138.252924,22217117,0,46642,22170475
10/29/22,Japan,36.204824,138.252924,22261640,0,46700,22214940
10/30/22,Japan,36.204824,138.252924,22302251,0,46742,22255509
10/31/22,Japan,36.204824,138.252924,22324592,0,46765,22277827
11/1/22,Japan,36.204824,138.252924,22389872,0,46817,22343055
11/2/22,Japan,36.204824,138.252924,22460268,0,46887,22413381
11/3/22,Japan,36.204824,138.252924,22527741,0,46956,22480785
11/4/22,Japan,36.204824,138.252924,22561805,0,47015,22514790
11/5/22,Japan,36.204824,138.252924,22635975,0,47087,22588888
11/6/22,Japan,36.204824,138.252924,22702372,0,47133,22655239
11/7/22,Japan,36.204824,138.252924,22733994,0,47175,22686819
11/8/22,Japan,36.204824,138.252924,22815395,0,47245,22768150
11/9/22,Japan,36.204824,138.252924,22902805,0,47342,22855463
11/10/22,Japan,36.204824,138.252924,22981382,0,47442,22933940
11/11/22,Japan,36.204824,138.252924,23055475,0,47523,23007952
11/12/22,Japan,36.204824,138.252924,23134961,0,47618,23087343
11/13/22,Japan,36.204824,138.252924,23203855,0,47685,23156170
11/14/22,Japan,36.204824,138.252924,23241410,0,47733,23193677
11/15/22,Japan,36.204824,138.252924,23341236,0,47723,23293513
11/16/22,Japan,36.204824,138.252924,23448938,0,47834,23401104
11/17/22,Japan,36.204824,138.252924,23540544,0,47974,23492570
11/18/22,Japan,36.204824,138.252924,23626318,0,48066,23578252
11/19/22,Japan,36.204824,138.252924,23716205,0,48167,23668038
11/20/22,Japan,36.204824,138.252924,23793927,0,48289,23745638
11/21/22,Japan,36.204824,138.252924,23836351,0,48346,23788005
11/22/22,Japan,36.204824,138.252924,23957587,0,48490,23909097
11/23/22,Japan,36.204824,138.252924,24090948,0,48650,24042298
11/24/22,Japan,36.204824,138.252924,24151056,0,48780,24102276
11/25/22,Japan,36.204824,138.252924,24268896,0,48880,24220016
11/26/22,Japan,36.204824,138.252924,24394223,0,49044,24345179
11/27/22,Japan,36.204824,138.252924,24492699,0,49186,24443513
11/28/22,Japan,36.204824,138.252924,24541816,0,49289,24492527
11/29/22,Japan,36.204824,138.252924,24676912,0,49442,24627470
11/30/22,Japan,36.204824,138.252924,24815308,0,49652,24765656
12/1/22,Japan,36.204824,138.252924,24933509,0,49834,24883675
12/2/22,Japan,36.204824,138.252924,25043437,0,50021,24993416
12/3/22,Japan,36.204824,138.252924,25153028,0,50201,25102827
12/4/22,Japan,36.204824,138.252924,25242594,0,50352,25192242
12/5/22,Japan,36.204824,138.252924,25290215,0,50469,25239746
12/6/22,Japan,36.204824,138.252924,25427492,0,50616,25376876
12/7/22,Japan,36.204824,138.252924,25576875,0,50827,25526048
12/8/22,Japan,36.204824,138.252924,25709940,0,51070,25658870
12/9/22,Japan,36.204824,138.252924,25837030,0,51298,25785732
12/10/22,Japan,36.204824,138.252924,25972791,0,51520,25921271
12/11/22,Japan,36.204824,138.252924,26091965,0,51710,26040255
12/12/22,Japan,36.204824,138.252924,26154301,0,51837,26102464
12/13/22,Japan,36.204824,138.252924,26331295,0,52051,26279244
12/14/22,Japan,36.204824,138.252924,26521902,0,52295,26469607
12/15/22,Japan,36.204824,138.252924,26690393,0,52572,26637821
12/16/22,Japan,36.204824,138.252924,26843995,0,52831,26791164
12/17/22,Japan,36.204824,138.252924,27002378,0,53095,26949283
1/1/22,Jordan,31.24,36.51,1064277,0,12684,1051593
1/2/22,Jordan,31.24,36.51,1065571,0,12710,1052861
1/3/22,Jordan,31.24,36.51,1067253,0,12742,1054511
1/4/22,Jordan,31.24,36.51,1069549,0,12765,1056784
1/5/22,Jordan,31.24,36.51,1071837,0,12791,1059046
1/6/22,Jordan,31.24,36.51,1074007,0,12810,1061197
1/7/22,Jordan,31.24,36.51,1076040,0,12831,1063209
1/8/22,Jordan,31.24,36.51,1077432,0,12856,1064576
1/9/22,Jordan,31.24,36.51,1079781,0,12876,1066905
1/10/22,Jordan,31.24,36.51,1082570,0,12893,1069677
1/11/22,Jordan,31.24,36.51,1085500,0,12909,1072591
1/12/22,Jordan,31.24,36.51,1088329,0,12932,1075397
1/13/22,Jordan,31.24,36.51,1091691,0,12945,1078746
1/14/22,Jordan,31.24,36.51,1095087,0,12959,1082128
1/15/22,Jordan,31.24,36.51,1097474,0,12974,1084500
1/16/22,Jordan,31.24,36.51,1100967,0,12986,1087981
1/17/22,Jordan,31.24,36.51,1106006,0,13004,1093002
1/18/22,Jordan,31.24,36.51,1111181,0,13014,1098167
1/19/22,Jordan,31.24,36.51,1117397,0,13028,1104369
1/20/22,Jordan,31.24,36.51,1123686,0,13043,1110643
1/21/22,Jordan,31.24,36.51,1129995,0,13049,1116946
1/22/22,Jordan,31.24,36.51,1134097,0,13062,1121035
1/23/22,Jordan,31.24,36.51,1141048,0,13073,1127975
1/24/22,Jordan,31.24,36.51,1152526,0,13088,1139438
1/25/22,Jordan,31.24,36.51,1164339,0,13102,1151237
1/26/22,Jordan,31.24,36.51,1177165,0,13124,1164041
1/27/22,Jordan,31.24,36.51,1184856,0,13142,1171714
1/28/22,Jordan,31.24,36.51,1189080,0,13157,1175923
1/29/22,Jordan,31.24,36.51,1197250,0,13174,1184076
1/30/22,Jordan,31.24,36.51,1209083,0,13193,1195890
1/31/22,Jordan,31.24,36.51,1225309,0,13217,1212092
2/1/22,Jordan,31.24,36.51,1243090,0,13235,1229855
2/2/22,Jordan,31.24,36.51,1260983,0,13248,1247735
2/3/22,Jordan,31.24,36.51,1280106,0,13271,1266835
2/4/22,Jordan,31.24,36.51,1301492,0,13288,1288204
2/5/22,Jordan,31.24,36.51,1314243,0,13300,1300943
2/6/22,Jordan,31.24,36.51,1330107,0,13320,1316787
2/7/22,Jordan,31.24,36.51,1351733,0,13347,1338386
2/8/22,Jordan,31.24,36.51,1374453,0,13382,1361071
2/9/22,Jordan,31.24,36.51,1396430,0,13409,1383021
2/10/22,Jordan,31.24,36.51,1417890,0,13431,1404459
2/11/22,Jordan,31.24,36.51,1436762,0,13456,1423306
2/12/22,Jordan,31.24,36.51,1450810,0,13477,1437333
2/13/22,Jordan,31.24,36.51,1468360,0,13508,1454852
2/14/22,Jordan,31.24,36.51,1490473,0,13532,1476941
2/15/22,Jordan,31.24,36.51,1508950,0,13554,1495396
2/16/22,Jordan,31.24,36.51,1526272,0,13585,1512687
2/17/22,Jordan,31.24,36.51,1541379,0,13608,1527771
2/18/22,Jordan,31.24,36.51,1553758,0,13629,1540129
2/19/22,Jordan,31.24,36.51,1560822,0,13657,1547165
2/20/22,Jordan,31.24,36.51,1570907,0,13682,1557225
2/21/22,Jordan,31.24,36.51,1582161,0,13713,1568448
2/22/22,Jordan,31.24,36.51,1591278,0,13731,1577547
2/23/22,Jordan,31.24,36.51,1599422,0,13751,1585671
2/24/22,Jordan,31.24,36.51,1606837,0,13767,1593070
2/25/22,Jordan,31.24,36.51,1614698,0,13785,1600913
2/26/22,Jordan,31.24,36.51,1617178,0,13798,1603380
2/27/22,Jordan,31.24,36.51,1623474,0,13814,1609660
2/28/22,Jordan,31.24,36.51,1631708,0,13835,1617873
3/1/22,Jordan,31.24,36.51,1638228,0,13849,1624379
3/2/22,Jordan,31.24,36.51,1638228,0,13849,1624379
3/3/22,Jordan,31.24,36.51,1638228,0,13849,1624379
3/4/22,Jordan,31.24,36.51,1638228,0,13849,1624379
3/5/22,Jordan,31.24,36.51,1638228,0,13849,1624379
3/6/22,Jordan,31.24,36.51,1638228,0,13849,1624379
3/7/22,Jordan,31.24,36.51,1654677,0,13882,1640795
3/8/22,Jordan,31.24,36.51,1654677,0,13882,1640795
3/9/22,Jordan,31.24,36.51,1654677,0,13882,1640795
3/10/22,Jordan,31.24,36.51,1654677,0,13882,1640795
3/11/22,Jordan,31.24,36.51,1654677,0,13882,1640795
3/12/22,Jordan,31.24,36.51,1654677,0,13882,1640795
3/13/22,Jordan,31.24,36.51,1654677,0,13882,1640795
3/14/22,Jordan,31.24,36.51,1680179,0,13959,1666220
3/15/22,Jordan,31.24,36.51,1680179,0,13959,1666220
3/16/22,Jordan,31.24,36.51,1680179,0,13959,1666220
3/17/22,Jordan,31.24,36.51,1680179,0,13959,1666220
3/18/22,Jordan,31.24,36.51,1680179,0,13959,1666220
3/19/22,Jordan,31.24,36.51,1680179,0,13959,1666220
3/20/22,Jordan,31.24,36.51,1680179,0,13959,1666220
3/21/22,Jordan,31.24,36.51,1689314,0,14003,1675311
3/22/22,Jordan,31.24,36.51,1689314,0,14003,1675311
3/23/22,Jordan,31.24,36.51,1689314,0,14003,1675311
3/24/22,Jordan,31.24,36.51,1689314,0,14003,1675311
3/25/22,Jordan,31.24,36.51,1689314,0,14003,1675311
3/26/22,Jordan,31.24,36.51,1689314,0,14003,1675311
3/27/22,Jordan,31.24,36.51,1689314,0,14003,1675311
3/28/22,Jordan,31.24,36.51,1692485,0,14031,1678454
3/29/22,Jordan,31.24,36.51,1692485,0,14031,1678454
3/30/22,Jordan,31.24,36.51,1692485,0,14031,1678454
3/31/22,Jordan,31.24,36.51,1692485,0,14031,1678454
4/1/22,Jordan,31.24,36.51,1692485,0,14031,1678454
4/2/22,Jordan,31.24,36.51,1692485,0,14031,1678454
4/3/22,Jordan,31.24,36.51,1692485,0,14031,1678454
4/4/22,Jordan,31.24,36.51,1694216,0,14048,1680168
4/5/22,Jordan,31.24,36.51,1694216,0,14048,1680168
4/6/22,Jordan,31.24,36.51,1694216,0,14048,1680168
4/7/22,Jordan,31.24,36.51,1694216,0,14048,1680168
4/8/22,Jordan,31.24,36.51,1694216,0,14048,1680168
4/9/22,Jordan,31.24,36.51,1694216,0,14048,1680168
4/10/22,Jordan,31.24,36.51,1694216,0,14048,1680168
4/11/22,Jordan,31.24,36.51,1694957,0,14055,1680902
4/12/22,Jordan,31.24,36.51,1694957,0,14055,1680902
4/13/22,Jordan,31.24,36.51,1694957,0,14055,1680902
4/14/22,Jordan,31.24,36.51,1694957,0,14055,1680902
4/15/22,Jordan,31.24,36.51,1694957,0,14055,1680902
4/16/22,Jordan,31.24,36.51,1694957,0,14055,1680902
4/17/22,Jordan,31.24,36.51,1694957,0,14055,1680902
4/18/22,Jordan,31.24,36.51,1694957,0,14055,1680902
4/19/22,Jordan,31.24,36.51,1695432,0,14059,1681373
4/20/22,Jordan,31.24,36.51,1695432,0,14059,1681373
4/21/22,Jordan,31.24,36.51,1695432,0,14059,1681373
4/22/22,Jordan,31.24,36.51,1695432,0,14059,1681373
4/23/22,Jordan,31.24,36.51,1695432,0,14059,1681373
4/24/22,Jordan,31.24,36.51,1695432,0,14059,1681373
4/25/22,Jordan,31.24,36.51,1695432,0,14059,1681373
4/26/22,Jordan,31.24,36.51,1695745,0,14064,1681681
4/27/22,Jordan,31.24,36.51,1695745,0,14064,1681681
4/28/22,Jordan,31.24,36.51,1695745,0,14064,1681681
4/29/22,Jordan,31.24,36.51,1695745,0,14064,1681681
4/30/22,Jordan,31.24,36.51,1695745,0,14064,1681681
5/1/22,Jordan,31.24,36.51,1695745,0,14064,1681681
5/2/22,Jordan,31.24,36.51,1695745,0,14064,1681681
5/3/22,Jordan,31.24,36.51,1695745,0,14064,1681681
5/4/22,Jordan,31.24,36.51,1695970,0,14066,1681904
5/5/22,Jordan,31.24,36.51,1695970,0,14066,1681904
5/6/22,Jordan,31.24,36.51,1695970,0,14066,1681904
5/7/22,Jordan,31.24,36.51,1695970,0,14066,1681904
5/8/22,Jordan,31.24,36.51,1695970,0,14066,1681904
5/9/22,Jordan,31.24,36.51,1695970,0,14066,1681904
5/10/22,Jordan,31.24,36.51,1696054,0,14066,1681988
5/11/22,Jordan,31.24,36.51,1696054,0,14066,1681988
5/12/22,Jordan,31.24,36.51,1696054,0,14066,1681988
5/13/22,Jordan,31.24,36.51,1696054,0,14066,1681988
5/14/22,Jordan,31.24,36.51,1696054,0,14066,1681988
5/15/22,Jordan,31.24,36.51,1696054,0,14066,1681988
5/16/22,Jordan,31.24,36.51,1696359,0,14066,1682293
5/17/22,Jordan,31.24,36.51,1696359,0,14066,1682293
5/18/22,Jordan,31.24,36.51,1696359,0,14066,1682293
5/19/22,Jordan,31.24,36.51,1696359,0,14066,1682293
5/20/22,Jordan,31.24,36.51,1696359,0,14066,1682293
5/21/22,Jordan,31.24,36.51,1696359,0,14066,1682293
5/22/22,Jordan,31.24,36.51,1696359,0,14066,1682293
5/23/22,Jordan,31.24,36.51,1696668,0,14066,1682602
5/24/22,Jordan,31.24,36.51,1696668,0,14066,1682602
5/25/22,Jordan,31.24,36.51,1696668,0,14066,1682602
5/26/22,Jordan,31.24,36.51,1696668,0,14066,1682602
5/27/22,Jordan,31.24,36.51,1696668,0,14066,1682602
5/28/22,Jordan,31.24,36.51,1696668,0,14066,1682602
5/29/22,Jordan,31.24,36.51,1696668,0,14066,1682602
5/30/22,Jordan,31.24,36.51,1696937,0,14066,1682871
5/31/22,Jordan,31.24,36.51,1696937,0,14066,1682871
6/1/22,Jordan,31.24,36.51,1696937,0,14066,1682871
6/2/22,Jordan,31.24,36.51,1696937,0,14066,1682871
6/3/22,Jordan,31.24,36.51,1696937,0,14066,1682871
6/4/22,Jordan,31.24,36.51,1696937,0,14066,1682871
6/5/22,Jordan,31.24,36.51,1696937,0,14066,1682871
6/6/22,Jordan,31.24,36.51,1697271,0,14068,1683203
6/7/22,Jordan,31.24,36.51,1697271,0,14068,1683203
6/8/22,Jordan,31.24,36.51,1697271,0,14068,1683203
6/9/22,Jordan,31.24,36.51,1697271,0,14068,1683203
6/10/22,Jordan,31.24,36.51,1697271,0,14068,1683203
6/11/22,Jordan,31.24,36.51,1697271,0,14068,1683203
6/12/22,Jordan,31.24,36.51,1697271,0,14068,1683203
6/13/22,Jordan,31.24,36.51,1697271,0,14068,1683203
6/14/22,Jordan,31.24,36.51,1697673,0,14068,1683605
6/15/22,Jordan,31.24,36.51,1697673,0,14068,1683605
6/16/22,Jordan,31.24,36.51,1697673,0,14068,1683605
6/17/22,Jordan,31.24,36.51,1697673,0,14068,1683605
6/18/22,Jordan,31.24,36.51,1697673,0,14068,1683605
6/19/22,Jordan,31.24,36.51,1697673,0,14068,1683605
6/20/22,Jordan,31.24,36.51,1698316,0,14068,1684248
6/21/22,Jordan,31.24,36.51,1698316,0,14068,1684248
6/22/22,Jordan,31.24,36.51,1698316,0,14068,1684248
6/23/22,Jordan,31.24,36.51,1698316,0,14068,1684248
6/24/22,Jordan,31.24,36.51,1698316,0,14068,1684248
6/25/22,Jordan,31.24,36.51,1698316,0,14068,1684248
6/26/22,Jordan,31.24,36.51,1698316,0,14068,1684248
6/27/22,Jordan,31.24,36.51,1699197,0,14068,1685129
6/28/22,Jordan,31.24,36.51,1699197,0,14068,1685129
6/29/22,Jordan,31.24,36.51,1699197,0,14068,1685129
6/30/22,Jordan,31.24,36.51,1699197,0,14068,1685129
7/1/22,Jordan,31.24,36.51,1699197,0,14068,1685129
7/2/22,Jordan,31.24,36.51,1699197,0,14068,1685129
7/3/22,Jordan,31.24,36.51,1700526,0,14068,1686458
7/4/22,Jordan,31.24,36.51,1700526,0,14068,1686458
7/5/22,Jordan,31.24,36.51,1700526,0,14068,1686458
7/6/22,Jordan,31.24,36.51,1700526,0,14068,1686458
7/7/22,Jordan,31.24,36.51,1700526,0,14068,1686458
7/8/22,Jordan,31.24,36.51,1700526,0,14068,1686458
7/9/22,Jordan,31.24,36.51,1700526,0,14068,1686458
7/10/22,Jordan,31.24,36.51,1700526,0,14068,1686458
7/11/22,Jordan,31.24,36.51,1700526,0,14068,1686458
7/12/22,Jordan,31.24,36.51,1702661,0,14069,1688592
7/13/22,Jordan,31.24,36.51,1702661,0,14069,1688592
7/14/22,Jordan,31.24,36.51,1702661,0,14069,1688592
7/15/22,Jordan,31.24,36.51,1702661,0,14069,1688592
7/16/22,Jordan,31.24,36.51,1702661,0,14069,1688592
7/17/22,Jordan,31.24,36.51,1702661,0,14069,1688592
7/18/22,Jordan,31.24,36.51,1705116,0,14070,1691046
7/19/22,Jordan,31.24,36.51,1705116,0,14070,1691046
7/20/22,Jordan,31.24,36.51,1705116,0,14070,1691046
7/21/22,Jordan,31.24,36.51,1705116,0,14070,1691046
7/22/22,Jordan,31.24,36.51,1705116,0,14070,1691046
7/23/22,Jordan,31.24,36.51,1705116,0,14070,1691046
7/24/22,Jordan,31.24,36.51,1705116,0,14070,1691046
7/25/22,Jordan,31.24,36.51,1709879,0,14074,1695805
7/26/22,Jordan,31.24,36.51,1709879,0,14074,1695805
7/27/22,Jordan,31.24,36.51,1709879,0,14074,1695805
7/28/22,Jordan,31.24,36.51,1709879,0,14074,1695805
7/29/22,Jordan,31.24,36.51,1709879,0,14074,1695805
7/30/22,Jordan,31.24,36.51,1709879,0,14074,1695805
7/31/22,Jordan,31.24,36.51,1709879,0,14074,1695805
8/1/22,Jordan,31.24,36.51,1715296,0,14083,1701213
8/2/22,Jordan,31.24,36.51,1715296,0,14083,1701213
8/3/22,Jordan,31.24,36.51,1715296,0,14083,1701213
8/4/22,Jordan,31.24,36.51,1715296,0,14083,1701213
8/5/22,Jordan,31.24,36.51,1715296,0,14083,1701213
8/6/22,Jordan,31.24,36.51,1715296,0,14083,1701213
8/7/22,Jordan,31.24,36.51,1715296,0,14083,1701213
8/8/22,Jordan,31.24,36.51,1720778,0,14090,1706688
8/9/22,Jordan,31.24,36.51,1720778,0,14090,1706688
8/10/22,Jordan,31.24,36.51,1720778,0,14090,1706688
8/11/22,Jordan,31.24,36.51,1720778,0,14090,1706688
8/12/22,Jordan,31.24,36.51,1720778,0,14090,1706688
8/13/22,Jordan,31.24,36.51,1720778,0,14090,1706688
8/14/22,Jordan,31.24,36.51,1720778,0,14090,1706688
8/15/22,Jordan,31.24,36.51,1726717,0,14095,1712622
8/16/22,Jordan,31.24,36.51,1726717,0,14095,1712622
8/17/22,Jordan,31.24,36.51,1726717,0,14095,1712622
8/18/22,Jordan,31.24,36.51,1726717,0,14095,1712622
8/19/22,Jordan,31.24,36.51,1726717,0,14095,1712622
8/20/22,Jordan,31.24,36.51,1726717,0,14095,1712622
8/21/22,Jordan,31.24,36.51,1731549,0,14105,1717444
8/22/22,Jordan,31.24,36.51,1731549,0,14105,1717444
8/23/22,Jordan,31.24,36.51,1731549,0,14105,1717444
8/24/22,Jordan,31.24,36.51,1731549,0,14105,1717444
8/25/22,Jordan,31.24,36.51,1731549,0,14105,1717444
8/26/22,Jordan,31.24,36.51,1731549,0,14105,1717444
8/27/22,Jordan,31.24,36.51,1731549,0,14105,1717444
8/28/22,Jordan,31.24,36.51,1735495,0,14110,1721385
8/29/22,Jordan,31.24,36.51,1735495,0,14110,1721385
8/30/22,Jordan,31.24,36.51,1735495,0,14110,1721385
8/31/22,Jordan,31.24,36.51,1735495,0,14110,1721385
9/1/22,Jordan,31.24,36.51,1735495,0,14110,1721385
9/2/22,Jordan,31.24,36.51,1735495,0,14110,1721385
9/3/22,Jordan,31.24,36.51,1735495,0,14110,1721385
9/4/22,Jordan,31.24,36.51,1735495,0,14110,1721385
9/5/22,Jordan,31.24,36.51,1738867,0,14114,1724753
9/6/22,Jordan,31.24,36.51,1738867,0,14114,1724753
9/7/22,Jordan,31.24,36.51,1738867,0,14114,1724753
9/8/22,Jordan,31.24,36.51,1738867,0,14114,1724753
9/9/22,Jordan,31.24,36.51,1738867,0,14114,1724753
9/10/22,Jordan,31.24,36.51,1738867,0,14114,1724753
9/11/22,Jordan,31.24,36.51,1738867,0,14114,1724753
9/12/22,Jordan,31.24,36.51,1742256,0,14114,1728142
9/13/22,Jordan,31.24,36.51,1742256,0,14114,1728142
9/14/22,Jordan,31.24,36.51,1742256,0,14114,1728142
9/15/22,Jordan,31.24,36.51,1742256,0,14114,1728142
9/16/22,Jordan,31.24,36.51,1742256,0,14114,1728142
9/17/22,Jordan,31.24,36.51,1742256,0,14114,1728142
9/18/22,Jordan,31.24,36.51,1745032,0,14116,1730916
9/19/22,Jordan,31.24,36.51,1745032,0,14116,1730916
9/20/22,Jordan,31.24,36.51,1745032,0,14116,1730916
9/21/22,Jordan,31.24,36.51,1745032,0,14116,1730916
9/22/22,Jordan,31.24,36.51,1745032,0,14116,1730916
9/23/22,Jordan,31.24,36.51,1745032,0,14116,1730916
9/24/22,Jordan,31.24,36.51,1745032,0,14116,1730916
9/25/22,Jordan,31.24,36.51,1746997,0,14122,1732875
9/26/22,Jordan,31.24,36.51,1746997,0,14122,1732875
9/27/22,Jordan,31.24,36.51,1746997,0,14122,1732875
9/28/22,Jordan,31.24,36.51,1746997,0,14122,1732875
9/29/22,Jordan,31.24,36.51,1746997,0,14122,1732875
9/30/22,Jordan,31.24,36.51,1746997,0,14122,1732875
10/1/22,Jordan,31.24,36.51,1746997,0,14122,1732875
10/2/22,Jordan,31.24,36.51,1746997,0,14122,1732875
10/3/22,Jordan,31.24,36.51,1746997,0,14122,1732875
10/4/22,Jordan,31.24,36.51,1746997,0,14122,1732875
10/5/22,Jordan,31.24,36.51,1746997,0,14122,1732875
10/6/22,Jordan,31.24,36.51,1746997,0,14122,1732875
10/7/22,Jordan,31.24,36.51,1746997,0,14122,1732875
10/8/22,Jordan,31.24,36.51,1746997,0,14122,1732875
10/9/22,Jordan,31.24,36.51,1746997,0,14122,1732875
10/10/22,Jordan,31.24,36.51,1746997,0,14122,1732875
10/11/22,Jordan,31.24,36.51,1746997,0,14122,1732875
10/12/22,Jordan,31.24,36.51,1746997,0,14122,1732875
10/13/22,Jordan,31.24,36.51,1746997,0,14122,1732875
10/14/22,Jordan,31.24,36.51,1746997,0,14122,1732875
10/15/22,Jordan,31.24,36.51,1746997,0,14122,1732875
10/16/22,Jordan,31.24,36.51,1746997,0,14122,1732875
10/17/22,Jordan,31.24,36.51,1746997,0,14122,1732875
10/18/22,Jordan,31.24,36.51,1746997,0,14122,1732875
10/19/22,Jordan,31.24,36.51,1746997,0,14122,1732875
10/20/22,Jordan,31.24,36.51,1746997,0,14122,1732875
10/21/22,Jordan,31.24,36.51,1746997,0,14122,1732875
10/22/22,Jordan,31.24,36.51,1746997,0,14122,1732875
10/23/22,Jordan,31.24,36.51,1746997,0,14122,1732875
10/24/22,Jordan,31.24,36.51,1746997,0,14122,1732875
10/25/22,Jordan,31.24,36.51,1746997,0,14122,1732875
10/26/22,Jordan,31.24,36.51,1746997,0,14122,1732875
10/27/22,Jordan,31.24,36.51,1746997,0,14122,1732875
10/28/22,Jordan,31.24,36.51,1746997,0,14122,1732875
10/29/22,Jordan,31.24,36.51,1746997,0,14122,1732875
10/30/22,Jordan,31.24,36.51,1746997,0,14122,1732875
10/31/22,Jordan,31.24,36.51,1746997,0,14122,1732875
11/1/22,Jordan,31.24,36.51,1746997,0,14122,1732875
11/2/22,Jordan,31.24,36.51,1746997,0,14122,1732875
11/3/22,Jordan,31.24,36.51,1746997,0,14122,1732875
11/4/22,Jordan,31.24,36.51,1746997,0,14122,1732875
11/5/22,Jordan,31.24,36.51,1746997,0,14122,1732875
11/6/22,Jordan,31.24,36.51,1746997,0,14122,1732875
11/7/22,Jordan,31.24,36.51,1746997,0,14122,1732875
11/8/22,Jordan,31.24,36.51,1746997,0,14122,1732875
11/9/22,Jordan,31.24,36.51,1746997,0,14122,1732875
11/10/22,Jordan,31.24,36.51,1746997,0,14122,1732875
11/11/22,Jordan,31.24,36.51,1746997,0,14122,1732875
11/12/22,Jordan,31.24,36.51,1746997,0,14122,1732875
11/13/22,Jordan,31.24,36.51,1746997,0,14122,1732875
11/14/22,Jordan,31.24,36.51,1746997,0,14122,1732875
11/15/22,Jordan,31.24,36.51,1746997,0,14122,1732875
11/16/22,Jordan,31.24,36.51,1746997,0,14122,1732875
11/17/22,Jordan,31.24,36.51,1746997,0,14122,1732875
11/18/22,Jordan,31.24,36.51,1746997,0,14122,1732875
11/19/22,Jordan,31.24,36.51,1746997,0,14122,1732875
11/20/22,Jordan,31.24,36.51,1746997,0,14122,1732875
11/21/22,Jordan,31.24,36.51,1746997,0,14122,1732875
11/22/22,Jordan,31.24,36.51,1746997,0,14122,1732875
11/23/22,Jordan,31.24,36.51,1746997,0,14122,1732875
11/24/22,Jordan,31.24,36.51,1746997,0,14122,1732875
11/25/22,Jordan,31.24,36.51,1746997,0,14122,1732875
11/26/22,Jordan,31.24,36.51,1746997,0,14122,1732875
11/27/22,Jordan,31.24,36.51,1746997,0,14122,1732875
11/28/22,Jordan,31.24,36.51,1746997,0,14122,1732875
11/29/22,Jordan,31.24,36.51,1746997,0,14122,1732875
11/30/22,Jordan,31.24,36.51,1746997,0,14122,1732875
12/1/22,Jordan,31.24,36.51,1746997,0,14122,1732875
12/2/22,Jordan,31.24,36.51,1746997,0,14122,1732875
12/3/22,Jordan,31.24,36.51,1746997,0,14122,1732875
12/4/22,Jordan,31.24,36.51,1746997,0,14122,1732875
12/5/22,Jordan,31.24,36.51,1746997,0,14122,1732875
12/6/22,Jordan,31.24,36.51,1746997,0,14122,1732875
12/7/22,Jordan,31.24,36.51,1746997,0,14122,1732875
12/8/22,Jordan,31.24,36.51,1746997,0,14122,1732875
12/9/22,Jordan,31.24,36.51,1746997,0,14122,1732875
12/10/22,Jordan,31.24,36.51,1746997,0,14122,1732875
12/11/22,Jordan,31.24,36.51,1746997,0,14122,1732875
12/12/22,Jordan,31.24,36.51,1746997,0,14122,1732875
12/13/22,Jordan,31.24,36.51,1746997,0,14122,1732875
12/14/22,Jordan,31.24,36.51,1746997,0,14122,1732875
12/15/22,Jordan,31.24,36.51,1746997,0,14122,1732875
12/16/22,Jordan,31.24,36.51,1746997,0,14122,1732875
12/17/22,Jordan,31.24,36.51,1746997,0,14122,1732875
1/1/22,Kazakhstan,48.0196,66.9237,1072999,0,18211,1054788
1/2/22,Kazakhstan,48.0196,66.9237,1072999,0,18211,1054788
1/3/22,Kazakhstan,48.0196,66.9237,1073786,0,18211,1055575
1/4/22,Kazakhstan,48.0196,66.9237,1073789,0,18256,1055533
1/5/22,Kazakhstan,48.0196,66.9237,1074283,0,18267,1056016
1/6/22,Kazakhstan,48.0196,66.9237,1074283,0,18267,1056016
1/7/22,Kazakhstan,48.0196,66.9237,1074283,0,18274,1056009
1/8/22,Kazakhstan,48.0196,66.9237,1079671,0,18274,1061397
1/9/22,Kazakhstan,48.0196,66.9237,1081758,0,18274,1063484
1/10/22,Kazakhstan,48.0196,66.9237,1083988,0,18284,1065704
1/11/22,Kazakhstan,48.0196,66.9237,1088877,0,18286,1070591
1/12/22,Kazakhstan,48.0196,66.9237,1098060,0,18288,1079772
1/13/22,Kazakhstan,48.0196,66.9237,1108567,0,18291,1090276
1/14/22,Kazakhstan,48.0196,66.9237,1120948,0,18293,1102655
1/15/22,Kazakhstan,48.0196,66.9237,1134598,0,18293,1116305
1/16/22,Kazakhstan,48.0196,66.9237,1146165,0,18293,1127872
1/17/22,Kazakhstan,48.0196,66.9237,1155871,0,18318,1137553
1/18/22,Kazakhstan,48.0196,66.9237,1169932,0,18326,1151606
1/19/22,Kazakhstan,48.0196,66.9237,1185928,0,18338,1167590
1/20/22,Kazakhstan,48.0196,66.9237,1202369,0,18350,1184019
1/21/22,Kazakhstan,48.0196,66.9237,1217538,0,18357,1199181
1/22/22,Kazakhstan,48.0196,66.9237,1231856,0,18357,1213499
1/23/22,Kazakhstan,48.0196,66.9237,1243220,0,18357,1224863
1/24/22,Kazakhstan,48.0196,66.9237,1252265,0,18391,1233874
1/25/22,Kazakhstan,48.0196,66.9237,1264299,0,18403,1245896
1/26/22,Kazakhstan,48.0196,66.9237,1278057,0,18415,1259642
1/27/22,Kazakhstan,48.0196,66.9237,1290763,0,18430,1272333
1/28/22,Kazakhstan,48.0196,66.9237,1302516,0,18454,1284062
1/29/22,Kazakhstan,48.0196,66.9237,1312308,0,18454,1293854
1/30/22,Kazakhstan,48.0196,66.9237,1319814,0,18454,1301360
1/31/22,Kazakhstan,48.0196,66.9237,1325293,0,18508,1306785
2/1/22,Kazakhstan,48.0196,66.9237,1332643,0,18528,1314115
2/2/22,Kazakhstan,48.0196,66.9237,1340410,0,18547,1321863
2/3/22,Kazakhstan,48.0196,66.9237,1347183,0,18570,1328613
2/4/22,Kazakhstan,48.0196,66.9237,1353048,0,18600,1334448
2/5/22,Kazakhstan,48.0196,66.9237,1353048,0,18600,1334448
2/6/22,Kazakhstan,48.0196,66.9237,1361663,0,18600,1343063
2/7/22,Kazakhstan,48.0196,66.9237,1363682,0,18660,1345022
2/8/22,Kazakhstan,48.0196,66.9237,1367054,0,18672,1348382
2/9/22,Kazakhstan,48.0196,66.9237,1370466,0,18693,1351773
2/10/22,Kazakhstan,48.0196,66.9237,1373047,0,18716,1354331
2/11/22,Kazakhstan,48.0196,66.9237,1375330,0,18736,1356594
2/12/22,Kazakhstan,48.0196,66.9237,1377390,0,18736,1358654
2/13/22,Kazakhstan,48.0196,66.9237,1378771,0,18736,1360035
2/14/22,Kazakhstan,48.0196,66.9237,1379972,0,18781,1361191
2/15/22,Kazakhstan,48.0196,66.9237,1381558,0,18796,1362762
2/16/22,Kazakhstan,48.0196,66.9237,1382966,0,18807,1364159
2/17/22,Kazakhstan,48.0196,66.9237,1384317,0,18836,1365481
2/18/22,Kazakhstan,48.0196,66.9237,1384317,0,18851,1365466
2/19/22,Kazakhstan,48.0196,66.9237,1386291,0,18851,1367440
2/20/22,Kazakhstan,48.0196,66.9237,1386963,0,18851,1368112
2/21/22,Kazakhstan,48.0196,66.9237,1387446,0,18867,1368579
2/22/22,Kazakhstan,48.0196,66.9237,1388101,0,18872,1369229
2/23/22,Kazakhstan,48.0196,66.9237,1388713,0,18882,1369831
2/24/22,Kazakhstan,48.0196,66.9237,1389288,0,18893,1370395
2/25/22,Kazakhstan,48.0196,66.9237,1389288,0,18906,1370382
2/26/22,Kazakhstan,48.0196,66.9237,1389784,0,18906,1370878
2/27/22,Kazakhstan,48.0196,66.9237,1390441,0,18906,1371535
2/28/22,Kazakhstan,48.0196,66.9237,1390670,0,18937,1371733
3/1/22,Kazakhstan,48.0196,66.9237,1390966,0,18947,1372019
3/2/22,Kazakhstan,48.0196,66.9237,1391277,0,18958,1372319
3/3/22,Kazakhstan,48.0196,66.9237,1391277,0,18963,1372314
3/4/22,Kazakhstan,48.0196,66.9237,1391813,0,18967,1372846
3/5/22,Kazakhstan,48.0196,66.9237,1391984,0,18967,1373017
3/6/22,Kazakhstan,48.0196,66.9237,1392011,0,18967,1373044
3/7/22,Kazakhstan,48.0196,66.9237,1392169,0,18979,1373190
3/8/22,Kazakhstan,48.0196,66.9237,1392338,0,18980,1373358
3/9/22,Kazakhstan,48.0196,66.9237,1392427,0,18983,1373444
3/10/22,Kazakhstan,48.0196,66.9237,1392590,0,18988,1373602
3/11/22,Kazakhstan,48.0196,66.9237,1392590,0,18989,1373601
3/12/22,Kazakhstan,48.0196,66.9237,1392812,0,18989,1373823
3/13/22,Kazakhstan,48.0196,66.9237,1392812,0,18989,1373823
3/14/22,Kazakhstan,48.0196,66.9237,1392982,0,18995,1373987
3/15/22,Kazakhstan,48.0196,66.9237,1392982,0,18995,1373987
3/16/22,Kazakhstan,48.0196,66.9237,1393206,0,18997,1374209
3/17/22,Kazakhstan,48.0196,66.9237,1393286,0,18999,1374287
3/18/22,Kazakhstan,48.0196,66.9237,1393337,0,19001,1374336
3/19/22,Kazakhstan,48.0196,66.9237,1393369,0,19001,1374368
3/20/22,Kazakhstan,48.0196,66.9237,1393427,0,19001,1374426
3/21/22,Kazakhstan,48.0196,66.9237,1393456,0,19004,1374452
3/22/22,Kazakhstan,48.0196,66.9237,1393492,0,19005,1374487
3/23/22,Kazakhstan,48.0196,66.9237,1393522,0,19006,1374516
3/24/22,Kazakhstan,48.0196,66.9237,1393546,0,19006,1374540
3/25/22,Kazakhstan,48.0196,66.9237,1393546,0,19008,1374538
3/26/22,Kazakhstan,48.0196,66.9237,1393598,0,19008,1374590
3/27/22,Kazakhstan,48.0196,66.9237,1393643,0,19008,1374635
3/28/22,Kazakhstan,48.0196,66.9237,1393689,0,19010,1374679
3/29/22,Kazakhstan,48.0196,66.9237,1393689,0,19011,1374678
3/30/22,Kazakhstan,48.0196,66.9237,1393786,0,19011,1374775
3/31/22,Kazakhstan,48.0196,66.9237,1393802,0,19011,1374791
4/1/22,Kazakhstan,48.0196,66.9237,1393820,0,19012,1374808
4/2/22,Kazakhstan,48.0196,66.9237,1393839,0,19012,1374827
4/3/22,Kazakhstan,48.0196,66.9237,1393904,0,19012,1374892
4/4/22,Kazakhstan,48.0196,66.9237,1393919,0,19012,1374907
4/5/22,Kazakhstan,48.0196,66.9237,1393954,0,19013,1374941
4/6/22,Kazakhstan,48.0196,66.9237,1393984,0,19013,1374971
4/7/22,Kazakhstan,48.0196,66.9237,1394004,0,19013,1374991
4/8/22,Kazakhstan,48.0196,66.9237,1394014,0,19013,1375001
4/9/22,Kazakhstan,48.0196,66.9237,1394044,0,19013,1375031
4/10/22,Kazakhstan,48.0196,66.9237,1394057,0,19013,1375044
4/11/22,Kazakhstan,48.0196,66.9237,1394093,0,19013,1375080
4/12/22,Kazakhstan,48.0196,66.9237,1394093,0,19013,1375080
4/13/22,Kazakhstan,48.0196,66.9237,1394143,0,19013,1375130
4/14/22,Kazakhstan,48.0196,66.9237,1394170,0,19013,1375157
4/15/22,Kazakhstan,48.0196,66.9237,1394190,0,19013,1375177
4/16/22,Kazakhstan,48.0196,66.9237,1394190,0,19013,1375177
4/17/22,Kazakhstan,48.0196,66.9237,1394233,0,19013,1375220
4/18/22,Kazakhstan,48.0196,66.9237,1394243,0,19013,1375230
4/19/22,Kazakhstan,48.0196,66.9237,1394243,0,19013,1375230
4/20/22,Kazakhstan,48.0196,66.9237,1394267,0,19013,1375254
4/21/22,Kazakhstan,48.0196,66.9237,1394290,0,19013,1375277
4/22/22,Kazakhstan,48.0196,66.9237,1394330,0,19013,1375317
4/23/22,Kazakhstan,48.0196,66.9237,1394330,0,19013,1375317
4/24/22,Kazakhstan,48.0196,66.9237,1394359,0,19013,1375346
4/25/22,Kazakhstan,48.0196,66.9237,1394367,0,19013,1375354
4/26/22,Kazakhstan,48.0196,66.9237,1394367,0,19013,1375354
4/27/22,Kazakhstan,48.0196,66.9237,1394416,0,19013,1375403
4/28/22,Kazakhstan,48.0196,66.9237,1394431,0,19013,1375418
4/29/22,Kazakhstan,48.0196,66.9237,1394473,0,19013,1375460
4/30/22,Kazakhstan,48.0196,66.9237,1394493,0,19013,1375480
5/1/22,Kazakhstan,48.0196,66.9237,1394523,0,19013,1375510
5/2/22,Kazakhstan,48.0196,66.9237,1394530,0,19013,1375517
5/3/22,Kazakhstan,48.0196,66.9237,1394536,0,19013,1375523
5/4/22,Kazakhstan,48.0196,66.9237,1394545,0,19013,1375532
5/5/22,Kazakhstan,48.0196,66.9237,1394591,0,19013,1375578
5/6/22,Kazakhstan,48.0196,66.9237,1394613,0,19014,1375599
5/7/22,Kazakhstan,48.0196,66.9237,1394613,0,19014,1375599
5/8/22,Kazakhstan,48.0196,66.9237,1394632,0,19014,1375618
5/9/22,Kazakhstan,48.0196,66.9237,1394632,0,19014,1375618
5/10/22,Kazakhstan,48.0196,66.9237,1394644,0,19014,1375630
5/11/22,Kazakhstan,48.0196,66.9237,1394649,0,19014,1375635
5/12/22,Kazakhstan,48.0196,66.9237,1394663,0,19015,1375648
5/13/22,Kazakhstan,48.0196,66.9237,1394683,0,19015,1375668
5/14/22,Kazakhstan,48.0196,66.9237,1394696,0,19015,1375681
5/15/22,Kazakhstan,48.0196,66.9237,1394710,0,19015,1375695
5/16/22,Kazakhstan,48.0196,66.9237,1394715,0,19015,1375700
5/17/22,Kazakhstan,48.0196,66.9237,1394721,0,19015,1375706
5/18/22,Kazakhstan,48.0196,66.9237,1394737,0,19015,1375722
5/19/22,Kazakhstan,48.0196,66.9237,1394752,0,19015,1375737
5/20/22,Kazakhstan,48.0196,66.9237,1394778,0,19015,1375763
5/21/22,Kazakhstan,48.0196,66.9237,1394786,0,19015,1375771
5/22/22,Kazakhstan,48.0196,66.9237,1394797,0,19015,1375782
5/23/22,Kazakhstan,48.0196,66.9237,1394803,0,19015,1375788
5/24/22,Kazakhstan,48.0196,66.9237,1394808,0,19015,1375793
5/25/22,Kazakhstan,48.0196,66.9237,1394823,0,19015,1375808
5/26/22,Kazakhstan,48.0196,66.9237,1394834,0,19015,1375819
5/27/22,Kazakhstan,48.0196,66.9237,1394849,0,19015,1375834
5/28/22,Kazakhstan,48.0196,66.9237,1394867,0,19015,1375852
5/29/22,Kazakhstan,48.0196,66.9237,1394867,0,19015,1375852
5/30/22,Kazakhstan,48.0196,66.9237,1394867,0,19015,1375852
5/31/22,Kazakhstan,48.0196,66.9237,1394867,0,19015,1375852
6/1/22,Kazakhstan,48.0196,66.9237,1394918,0,19016,1375902
6/2/22,Kazakhstan,48.0196,66.9237,1394918,0,19016,1375902
6/3/22,Kazakhstan,48.0196,66.9237,1394935,0,19016,1375919
6/4/22,Kazakhstan,48.0196,66.9237,1394944,0,19016,1375928
6/5/22,Kazakhstan,48.0196,66.9237,1394944,0,19016,1375928
6/6/22,Kazakhstan,48.0196,66.9237,1394964,0,19016,1375948
6/7/22,Kazakhstan,48.0196,66.9237,1394997,0,19016,1375981
6/8/22,Kazakhstan,48.0196,66.9237,1394997,0,19016,1375981
6/9/22,Kazakhstan,48.0196,66.9237,1395013,0,19016,1375997
6/10/22,Kazakhstan,48.0196,66.9237,1395027,0,19016,1376011
6/11/22,Kazakhstan,48.0196,66.9237,1395039,0,19016,1376023
6/12/22,Kazakhstan,48.0196,66.9237,1395055,0,19016,1376039
6/13/22,Kazakhstan,48.0196,66.9237,1395061,0,19017,1376044
6/14/22,Kazakhstan,48.0196,66.9237,1395068,0,19017,1376051
6/15/22,Kazakhstan,48.0196,66.9237,1395085,0,19017,1376068
6/16/22,Kazakhstan,48.0196,66.9237,1395102,0,19017,1376085
6/17/22,Kazakhstan,48.0196,66.9237,1395123,0,19017,1376106
6/18/22,Kazakhstan,48.0196,66.9237,1395148,0,19017,1376131
6/19/22,Kazakhstan,48.0196,66.9237,1395167,0,19017,1376150
6/20/22,Kazakhstan,48.0196,66.9237,1395200,0,19017,1376183
6/21/22,Kazakhstan,48.0196,66.9237,1395200,0,19017,1376183
6/22/22,Kazakhstan,48.0196,66.9237,1395236,0,19017,1376219
6/23/22,Kazakhstan,48.0196,66.9237,1395281,0,19018,1376263
6/24/22,Kazakhstan,48.0196,66.9237,1395337,0,19018,1376319
6/25/22,Kazakhstan,48.0196,66.9237,1395399,0,19018,1376381
6/26/22,Kazakhstan,48.0196,66.9237,1395466,0,19018,1376448
6/27/22,Kazakhstan,48.0196,66.9237,1395533,0,19018,1376515
6/28/22,Kazakhstan,48.0196,66.9237,1395594,0,19018,1376576
6/29/22,Kazakhstan,48.0196,66.9237,1395849,0,19018,1376831
6/30/22,Kazakhstan,48.0196,66.9237,1395849,0,19018,1376831
7/1/22,Kazakhstan,48.0196,66.9237,1396044,0,19018,1377026
7/2/22,Kazakhstan,48.0196,66.9237,1396044,0,19018,1377026
7/3/22,Kazakhstan,48.0196,66.9237,1396425,0,19018,1377407
7/4/22,Kazakhstan,48.0196,66.9237,1396425,0,19018,1377407
7/5/22,Kazakhstan,48.0196,66.9237,1396584,0,19018,1377566
7/6/22,Kazakhstan,48.0196,66.9237,1397138,0,19018,1378120
7/7/22,Kazakhstan,48.0196,66.9237,1397478,0,19018,1378460
7/8/22,Kazakhstan,48.0196,66.9237,1397812,0,19018,1378794
7/9/22,Kazakhstan,48.0196,66.9237,1398235,0,19018,1379217
7/10/22,Kazakhstan,48.0196,66.9237,1398718,0,19018,1379700
7/11/22,Kazakhstan,48.0196,66.9237,1399173,0,19018,1380155
7/12/22,Kazakhstan,48.0196,66.9237,1399656,0,19018,1380638
7/13/22,Kazakhstan,48.0196,66.9237,1400476,0,19019,1381457
7/14/22,Kazakhstan,48.0196,66.9237,1401600,0,19019,1382581
7/15/22,Kazakhstan,48.0196,66.9237,1402871,0,19020,1383851
7/16/22,Kazakhstan,48.0196,66.9237,1404346,0,19020,1385326
7/17/22,Kazakhstan,48.0196,66.9237,1407386,0,19020,1388366
7/18/22,Kazakhstan,48.0196,66.9237,1407386,0,19020,1388366
7/19/22,Kazakhstan,48.0196,66.9237,1411836,0,19020,1392816
7/20/22,Kazakhstan,48.0196,66.9237,1410812,0,19020,1391792
7/21/22,Kazakhstan,48.0196,66.9237,1413079,0,19020,1394059
7/22/22,Kazakhstan,48.0196,66.9237,1415572,0,19020,1396552
7/23/22,Kazakhstan,48.0196,66.9237,1418241,0,19020,1399221
7/24/22,Kazakhstan,48.0196,66.9237,1422966,0,19020,1403946
7/25/22,Kazakhstan,48.0196,66.9237,1422966,0,19021,1403945
7/26/22,Kazakhstan,48.0196,66.9237,1427536,0,19021,1408515
7/27/22,Kazakhstan,48.0196,66.9237,1427536,0,19022,1408514
7/28/22,Kazakhstan,48.0196,66.9237,1433859,0,19022,1414837
7/29/22,Kazakhstan,48.0196,66.9237,1433859,0,19022,1414837
7/30/22,Kazakhstan,48.0196,66.9237,1433859,0,19022,1414837
7/31/22,Kazakhstan,48.0196,66.9237,1439725,0,19022,1420703
8/1/22,Kazakhstan,48.0196,66.9237,1442145,0,19022,1423123
8/2/22,Kazakhstan,48.0196,66.9237,1444167,0,19023,1425144
8/3/22,Kazakhstan,48.0196,66.9237,1449679,0,19025,1430654
8/4/22,Kazakhstan,48.0196,66.9237,1449679,0,19025,1430654
8/5/22,Kazakhstan,48.0196,66.9237,1452283,0,19025,1433258
8/6/22,Kazakhstan,48.0196,66.9237,1454520,0,19025,1435495
8/7/22,Kazakhstan,48.0196,66.9237,1456527,0,19025,1437502
8/8/22,Kazakhstan,48.0196,66.9237,1457904,0,19026,1438878
8/9/22,Kazakhstan,48.0196,66.9237,1459033,0,19028,1440005
8/10/22,Kazakhstan,48.0196,66.9237,1460713,0,19029,1441684
8/11/22,Kazakhstan,48.0196,66.9237,1462380,0,19029,1443351
8/12/22,Kazakhstan,48.0196,66.9237,1464041,0,19030,1445011
8/13/22,Kazakhstan,48.0196,66.9237,1465506,0,19030,1446476
8/14/22,Kazakhstan,48.0196,66.9237,1466760,0,19030,1447730
8/15/22,Kazakhstan,48.0196,66.9237,1467691,0,19030,1448661
8/16/22,Kazakhstan,48.0196,66.9237,1469601,0,19030,1450571
8/17/22,Kazakhstan,48.0196,66.9237,1469601,0,19030,1450571
8/18/22,Kazakhstan,48.0196,66.9237,1470777,0,19030,1451747
8/19/22,Kazakhstan,48.0196,66.9237,1471733,0,19032,1452701
8/20/22,Kazakhstan,48.0196,66.9237,1472642,0,19032,1453610
8/21/22,Kazakhstan,48.0196,66.9237,1472642,0,19032,1453610
8/22/22,Kazakhstan,48.0196,66.9237,1474198,0,19036,1455162
8/23/22,Kazakhstan,48.0196,66.9237,1474198,0,19038,1455160
8/24/22,Kazakhstan,48.0196,66.9237,1474876,0,19039,1455837
8/25/22,Kazakhstan,48.0196,66.9237,1475615,0,19040,1456575
8/26/22,Kazakhstan,48.0196,66.9237,1476288,0,19040,1457248
8/27/22,Kazakhstan,48.0196,66.9237,1476926,0,19040,1457886
8/28/22,Kazakhstan,48.0196,66.9237,1476926,0,19040,1457886
8/29/22,Kazakhstan,48.0196,66.9237,1477490,0,19040,1458450
8/30/22,Kazakhstan,48.0196,66.9237,1478163,0,19041,1459122
8/31/22,Kazakhstan,48.0196,66.9237,1478394,0,19041,1459353
9/1/22,Kazakhstan,48.0196,66.9237,1478605,0,19041,1459564
9/2/22,Kazakhstan,48.0196,66.9237,1479046,0,19041,1460005
9/3/22,Kazakhstan,48.0196,66.9237,1479475,0,19041,1460434
9/4/22,Kazakhstan,48.0196,66.9237,1479848,0,19041,1460807
9/5/22,Kazakhstan,48.0196,66.9237,1480046,0,19041,1461005
9/6/22,Kazakhstan,48.0196,66.9237,1480201,0,19041,1461160
9/7/22,Kazakhstan,48.0196,66.9237,1480862,0,19043,1461819
9/8/22,Kazakhstan,48.0196,66.9237,1480862,0,19043,1461819
9/9/22,Kazakhstan,48.0196,66.9237,1481122,0,19043,1462079
9/10/22,Kazakhstan,48.0196,66.9237,1481339,0,19043,1462296
9/11/22,Kazakhstan,48.0196,66.9237,1481525,0,19043,1462482
9/12/22,Kazakhstan,48.0196,66.9237,1481621,0,19046,1462575
9/13/22,Kazakhstan,48.0196,66.9237,1481908,0,19047,1462861
9/14/22,Kazakhstan,48.0196,66.9237,1481913,0,19047,1462866
9/15/22,Kazakhstan,48.0196,66.9237,1482094,0,19047,1463047
9/16/22,Kazakhstan,48.0196,66.9237,1482250,0,19048,1463202
9/17/22,Kazakhstan,48.0196,66.9237,1482250,0,19048,1463202
9/18/22,Kazakhstan,48.0196,66.9237,1482564,0,19048,1463516
9/19/22,Kazakhstan,48.0196,66.9237,1482564,0,19048,1463516
9/20/22,Kazakhstan,48.0196,66.9237,1482628,0,19048,1463580
9/21/22,Kazakhstan,48.0196,66.9237,1482749,0,19048,1463701
9/22/22,Kazakhstan,48.0196,66.9237,1482903,0,19048,1463855
9/23/22,Kazakhstan,48.0196,66.9237,1483024,0,19048,1463976
9/24/22,Kazakhstan,48.0196,66.9237,1483024,0,19048,1463976
9/25/22,Kazakhstan,48.0196,66.9237,1483024,0,19048,1463976
9/26/22,Kazakhstan,48.0196,66.9237,1483245,0,19048,1464197
9/27/22,Kazakhstan,48.0196,66.9237,1483313,0,19049,1464264
9/28/22,Kazakhstan,48.0196,66.9237,1483411,0,19049,1464362
9/29/22,Kazakhstan,48.0196,66.9237,1483512,0,19050,1464462
9/30/22,Kazakhstan,48.0196,66.9237,1483609,0,19050,1464559
10/1/22,Kazakhstan,48.0196,66.9237,1483609,0,19050,1464559
10/2/22,Kazakhstan,48.0196,66.9237,1483609,0,19050,1464559
10/3/22,Kazakhstan,48.0196,66.9237,1483764,0,19050,1464714
10/4/22,Kazakhstan,48.0196,66.9237,1483793,0,19052,1464741
10/5/22,Kazakhstan,48.0196,66.9237,1483859,0,19052,1464807
10/6/22,Kazakhstan,48.0196,66.9237,1483923,0,19052,1464871
10/7/22,Kazakhstan,48.0196,66.9237,1483973,0,19052,1464921
10/8/22,Kazakhstan,48.0196,66.9237,1483973,0,19052,1464921
10/9/22,Kazakhstan,48.0196,66.9237,1483973,0,19052,1464921
10/10/22,Kazakhstan,48.0196,66.9237,1484100,0,19052,1465048
10/11/22,Kazakhstan,48.0196,66.9237,1484126,0,19052,1465074
10/12/22,Kazakhstan,48.0196,66.9237,1484126,0,19052,1465074
10/13/22,Kazakhstan,48.0196,66.9237,1484126,0,19052,1465074
10/14/22,Kazakhstan,48.0196,66.9237,1484126,0,19052,1465074
10/15/22,Kazakhstan,48.0196,66.9237,1484126,0,19052,1465074
10/16/22,Kazakhstan,48.0196,66.9237,1484126,0,19052,1465074
10/17/22,Kazakhstan,48.0196,66.9237,1484126,0,19052,1465074
10/18/22,Kazakhstan,48.0196,66.9237,1484400,0,19052,1465348
10/19/22,Kazakhstan,48.0196,66.9237,1484400,0,19052,1465348
10/20/22,Kazakhstan,48.0196,66.9237,1484504,0,19052,1465452
10/21/22,Kazakhstan,48.0196,66.9237,1484591,0,19052,1465539
10/22/22,Kazakhstan,48.0196,66.9237,1484591,0,19052,1465539
10/23/22,Kazakhstan,48.0196,66.9237,1484591,0,19052,1465539
10/24/22,Kazakhstan,48.0196,66.9237,1484591,0,19052,1465539
10/25/22,Kazakhstan,48.0196,66.9237,1484591,0,19052,1465539
10/26/22,Kazakhstan,48.0196,66.9237,1484591,0,19052,1465539
10/27/22,Kazakhstan,48.0196,66.9237,1484734,0,19052,1465682
10/28/22,Kazakhstan,48.0196,66.9237,1484734,0,19052,1465682
10/29/22,Kazakhstan,48.0196,66.9237,1484734,0,19052,1465682
10/30/22,Kazakhstan,48.0196,66.9237,1484734,0,19052,1465682
10/31/22,Kazakhstan,48.0196,66.9237,1484932,0,19052,1465880
11/1/22,Kazakhstan,48.0196,66.9237,1484932,0,19052,1465880
11/2/22,Kazakhstan,48.0196,66.9237,1484932,0,19052,1465880
11/3/22,Kazakhstan,48.0196,66.9237,1484932,0,19052,1465880
11/4/22,Kazakhstan,48.0196,66.9237,1484932,0,19052,1465880
11/5/22,Kazakhstan,48.0196,66.9237,1484932,0,19052,1465880
11/6/22,Kazakhstan,48.0196,66.9237,1484932,0,19052,1465880
11/7/22,Kazakhstan,48.0196,66.9237,1485203,0,19052,1466151
11/8/22,Kazakhstan,48.0196,66.9237,1485203,0,19053,1466150
11/9/22,Kazakhstan,48.0196,66.9237,1485203,0,19053,1466150
11/10/22,Kazakhstan,48.0196,66.9237,1485203,0,19053,1466150
11/11/22,Kazakhstan,48.0196,66.9237,1485203,0,19053,1466150
11/12/22,Kazakhstan,48.0196,66.9237,1485203,0,19053,1466150
11/13/22,Kazakhstan,48.0196,66.9237,1485203,0,19053,1466150
11/14/22,Kazakhstan,48.0196,66.9237,1485635,0,19053,1466582
11/15/22,Kazakhstan,48.0196,66.9237,1485635,0,19053,1466582
11/16/22,Kazakhstan,48.0196,66.9237,1485635,0,19053,1466582
11/17/22,Kazakhstan,48.0196,66.9237,1485635,0,19053,1466582
11/18/22,Kazakhstan,48.0196,66.9237,1485635,0,19053,1466582
11/19/22,Kazakhstan,48.0196,66.9237,1485635,0,19053,1466582
11/20/22,Kazakhstan,48.0196,66.9237,1485635,0,19053,1466582
11/21/22,Kazakhstan,48.0196,66.9237,1485635,0,19053,1466582
11/22/22,Kazakhstan,48.0196,66.9237,1485635,0,19053,1466582
11/23/22,Kazakhstan,48.0196,66.9237,1485635,0,19053,1466582
11/24/22,Kazakhstan,48.0196,66.9237,1485635,0,19053,1466582
11/25/22,Kazakhstan,48.0196,66.9237,1485635,0,19053,1466582
11/26/22,Kazakhstan,48.0196,66.9237,1485635,0,19053,1466582
11/27/22,Kazakhstan,48.0196,66.9237,1485635,0,19053,1466582
11/28/22,Kazakhstan,48.0196,66.9237,1485635,0,19053,1466582
11/29/22,Kazakhstan,48.0196,66.9237,1485635,0,19053,1466582
11/30/22,Kazakhstan,48.0196,66.9237,1485635,0,19053,1466582
12/1/22,Kazakhstan,48.0196,66.9237,1487167,0,19053,1468114
12/2/22,Kazakhstan,48.0196,66.9237,1487167,0,19053,1468114
12/3/22,Kazakhstan,48.0196,66.9237,1487167,0,19053,1468114
12/4/22,Kazakhstan,48.0196,66.9237,1487167,0,19053,1468114
12/5/22,Kazakhstan,48.0196,66.9237,1487167,0,19054,1468113
12/6/22,Kazakhstan,48.0196,66.9237,1487167,0,19054,1468113
12/7/22,Kazakhstan,48.0196,66.9237,1487167,0,19054,1468113
12/8/22,Kazakhstan,48.0196,66.9237,1488306,0,19054,1469252
12/9/22,Kazakhstan,48.0196,66.9237,1488306,0,19054,1469252
12/10/22,Kazakhstan,48.0196,66.9237,1488306,0,19054,1469252
12/11/22,Kazakhstan,48.0196,66.9237,1488306,0,19054,1469252
12/12/22,Kazakhstan,48.0196,66.9237,1488306,0,19056,1469250
12/13/22,Kazakhstan,48.0196,66.9237,1488306,0,19056,1469250
12/14/22,Kazakhstan,48.0196,66.9237,1488306,0,19056,1469250
12/15/22,Kazakhstan,48.0196,66.9237,1488306,0,19057,1469249
12/16/22,Kazakhstan,48.0196,66.9237,1488306,0,19057,1469249
12/17/22,Kazakhstan,48.0196,66.9237,1488306,0,19057,1469249
1/1/22,Kenya,-0.0236,37.9062,297155,0,5381,291774
1/2/22,Kenya,-0.0236,37.9062,298509,0,5384,293125
1/3/22,Kenya,-0.0236,37.9062,299732,0,5394,294338
1/4/22,Kenya,-0.0236,37.9062,302134,0,5401,296733
1/5/22,Kenya,-0.0236,37.9062,304350,0,5404,298946
1/6/22,Kenya,-0.0236,37.9062,306686,0,5411,301275
1/7/22,Kenya,-0.0236,37.9062,309130,0,5425,303705
1/8/22,Kenya,-0.0236,37.9062,310797,0,5425,305372
1/9/22,Kenya,-0.0236,37.9062,311538,0,5446,306092
1/10/22,Kenya,-0.0236,37.9062,312572,0,5454,307118
1/11/22,Kenya,-0.0236,37.9062,313677,0,5462,308215
1/12/22,Kenya,-0.0236,37.9062,314490,0,5469,309021
1/13/22,Kenya,-0.0236,37.9062,315665,0,5472,310193
1/14/22,Kenya,-0.0236,37.9062,316700,0,5482,311218
1/15/22,Kenya,-0.0236,37.9062,317324,0,5488,311836
1/16/22,Kenya,-0.0236,37.9062,317634,0,5488,312146
1/17/22,Kenya,-0.0236,37.9062,317857,0,5499,312358
1/18/22,Kenya,-0.0236,37.9062,318249,0,5504,312745
1/19/22,Kenya,-0.0236,37.9062,319011,0,5520,313491
1/20/22,Kenya,-0.0236,37.9062,319379,0,5520,313859
1/21/22,Kenya,-0.0236,37.9062,319838,0,5528,314310
1/22/22,Kenya,-0.0236,37.9062,320138,0,5531,314607
1/23/22,Kenya,-0.0236,37.9062,320229,0,5554,314675
1/24/22,Kenya,-0.0236,37.9062,320399,0,5558,314841
1/25/22,Kenya,-0.0236,37.9062,320584,0,5562,315022
1/26/22,Kenya,-0.0236,37.9062,320766,0,5565,315201
1/27/22,Kenya,-0.0236,37.9062,320918,0,5567,315351
1/28/22,Kenya,-0.0236,37.9062,321111,0,5578,315533
1/29/22,Kenya,-0.0236,37.9062,321234,0,5578,315656
1/30/22,Kenya,-0.0236,37.9062,321335,0,5580,315755
1/31/22,Kenya,-0.0236,37.9062,321381,0,5583,315798
2/1/22,Kenya,-0.0236,37.9062,321552,0,5587,315965
2/2/22,Kenya,-0.0236,37.9062,321671,0,5593,316078
2/3/22,Kenya,-0.0236,37.9062,321764,0,5604,316160
2/4/22,Kenya,-0.0236,37.9062,321922,0,5604,316318
2/5/22,Kenya,-0.0236,37.9062,322043,0,5607,316436
2/6/22,Kenya,-0.0236,37.9062,322096,0,5621,316475
2/7/22,Kenya,-0.0236,37.9062,322151,0,5621,316530
2/8/22,Kenya,-0.0236,37.9062,322214,0,5621,316593
2/9/22,Kenya,-0.0236,37.9062,322274,0,5622,316652
2/10/22,Kenya,-0.0236,37.9062,322334,0,5626,316708
2/11/22,Kenya,-0.0236,37.9062,322388,0,5626,316762
2/12/22,Kenya,-0.0236,37.9062,322436,0,5629,316807
2/13/22,Kenya,-0.0236,37.9062,322473,0,5631,316842
2/14/22,Kenya,-0.0236,37.9062,322497,0,5632,316865
2/15/22,Kenya,-0.0236,37.9062,322517,0,5632,316885
2/16/22,Kenya,-0.0236,37.9062,322545,0,5633,316912
2/17/22,Kenya,-0.0236,37.9062,322614,0,5633,316981
2/18/22,Kenya,-0.0236,37.9062,322640,0,5633,317007
2/19/22,Kenya,-0.0236,37.9062,322669,0,5635,317034
2/20/22,Kenya,-0.0236,37.9062,322696,0,5635,317061
2/21/22,Kenya,-0.0236,37.9062,322702,0,5638,317064
2/22/22,Kenya,-0.0236,37.9062,322736,0,5638,317098
2/23/22,Kenya,-0.0236,37.9062,322781,0,5638,317143
2/24/22,Kenya,-0.0236,37.9062,322822,0,5638,317184
2/25/22,Kenya,-0.0236,37.9062,322869,0,5638,317231
2/26/22,Kenya,-0.0236,37.9062,322906,0,5639,317267
2/27/22,Kenya,-0.0236,37.9062,322930,0,5639,317291
2/28/22,Kenya,-0.0236,37.9062,322946,0,5639,317307
3/1/22,Kenya,-0.0236,37.9062,322978,0,5639,317339
3/2/22,Kenya,-0.0236,37.9062,323002,0,5640,317362
3/3/22,Kenya,-0.0236,37.9062,323025,0,5640,317385
3/4/22,Kenya,-0.0236,37.9062,323057,0,5640,317417
3/5/22,Kenya,-0.0236,37.9062,323071,0,5640,317431
3/6/22,Kenya,-0.0236,37.9062,323075,0,5641,317434
3/7/22,Kenya,-0.0236,37.9062,323094,0,5641,317453
3/8/22,Kenya,-0.0236,37.9062,323115,0,5641,317474
3/9/22,Kenya,-0.0236,37.9062,323129,0,5641,317488
3/10/22,Kenya,-0.0236,37.9062,323140,0,5644,317496
3/11/22,Kenya,-0.0236,37.9062,323160,0,5644,317516
3/12/22,Kenya,-0.0236,37.9062,323171,0,5644,317527
3/13/22,Kenya,-0.0236,37.9062,323183,0,5645,317538
3/14/22,Kenya,-0.0236,37.9062,323195,0,5646,317549
3/15/22,Kenya,-0.0236,37.9062,323204,0,5647,317557
3/16/22,Kenya,-0.0236,37.9062,323219,0,5647,317572
3/17/22,Kenya,-0.0236,37.9062,323237,0,5647,317590
3/18/22,Kenya,-0.0236,37.9062,323255,0,5647,317608
3/19/22,Kenya,-0.0236,37.9062,323272,0,5647,317625
3/20/22,Kenya,-0.0236,37.9062,323281,0,5647,317634
3/21/22,Kenya,-0.0236,37.9062,323289,0,5647,317642
3/22/22,Kenya,-0.0236,37.9062,323306,0,5647,317659
3/23/22,Kenya,-0.0236,37.9062,323319,0,5647,317672
3/24/22,Kenya,-0.0236,37.9062,323333,0,5647,317686
3/25/22,Kenya,-0.0236,37.9062,323350,0,5647,317703
3/26/22,Kenya,-0.0236,37.9062,323365,0,5647,317718
3/27/22,Kenya,-0.0236,37.9062,323374,0,5647,317727
3/28/22,Kenya,-0.0236,37.9062,323383,0,5647,317736
3/29/22,Kenya,-0.0236,37.9062,323395,0,5648,317747
3/30/22,Kenya,-0.0236,37.9062,323402,0,5648,317754
3/31/22,Kenya,-0.0236,37.9062,323423,0,5648,317775
4/1/22,Kenya,-0.0236,37.9062,323436,0,5648,317788
4/2/22,Kenya,-0.0236,37.9062,323450,0,5648,317802
4/3/22,Kenya,-0.0236,37.9062,323454,0,5648,317806
4/4/22,Kenya,-0.0236,37.9062,323468,0,5648,317820
4/5/22,Kenya,-0.0236,37.9062,323479,0,5648,317831
4/6/22,Kenya,-0.0236,37.9062,323515,0,5648,317867
4/7/22,Kenya,-0.0236,37.9062,323524,0,5648,317876
4/8/22,Kenya,-0.0236,37.9062,323524,0,5648,317876
4/9/22,Kenya,-0.0236,37.9062,323531,0,5648,317883
4/10/22,Kenya,-0.0236,37.9062,323541,0,5648,317893
4/11/22,Kenya,-0.0236,37.9062,323557,0,5648,317909
4/12/22,Kenya,-0.0236,37.9062,323583,0,5649,317934
4/13/22,Kenya,-0.0236,37.9062,323588,0,5649,317939
4/14/22,Kenya,-0.0236,37.9062,323595,0,5649,317946
4/15/22,Kenya,-0.0236,37.9062,323605,0,5649,317956
4/16/22,Kenya,-0.0236,37.9062,323609,0,5649,317960
4/17/22,Kenya,-0.0236,37.9062,323614,0,5649,317965
4/18/22,Kenya,-0.0236,37.9062,323618,0,5649,317969
4/19/22,Kenya,-0.0236,37.9062,323630,0,5649,317981
4/20/22,Kenya,-0.0236,37.9062,323646,0,5649,317997
4/21/22,Kenya,-0.0236,37.9062,323646,0,5649,317997
4/22/22,Kenya,-0.0236,37.9062,323688,0,5649,318039
4/23/22,Kenya,-0.0236,37.9062,323696,0,5649,318047
4/24/22,Kenya,-0.0236,37.9062,323709,0,5649,318060
4/25/22,Kenya,-0.0236,37.9062,323718,0,5649,318069
4/26/22,Kenya,-0.0236,37.9062,323723,0,5649,318074
4/27/22,Kenya,-0.0236,37.9062,323724,0,5649,318075
4/28/22,Kenya,-0.0236,37.9062,323745,0,5649,318096
4/29/22,Kenya,-0.0236,37.9062,323760,0,5649,318111
4/30/22,Kenya,-0.0236,37.9062,323773,0,5649,318124
5/1/22,Kenya,-0.0236,37.9062,323786,0,5649,318137
5/2/22,Kenya,-0.0236,37.9062,323792,0,5649,318143
5/3/22,Kenya,-0.0236,37.9062,323796,0,5649,318147
5/4/22,Kenya,-0.0236,37.9062,323806,0,5649,318157
5/5/22,Kenya,-0.0236,37.9062,323818,0,5649,318169
5/6/22,Kenya,-0.0236,37.9062,323846,0,5649,318197
5/7/22,Kenya,-0.0236,37.9062,323868,0,5649,318219
5/8/22,Kenya,-0.0236,37.9062,323881,0,5649,318232
5/9/22,Kenya,-0.0236,37.9062,323900,0,5649,318251
5/10/22,Kenya,-0.0236,37.9062,323921,0,5649,318272
5/11/22,Kenya,-0.0236,37.9062,323939,0,5649,318290
5/12/22,Kenya,-0.0236,37.9062,323952,0,5649,318303
5/13/22,Kenya,-0.0236,37.9062,323975,0,5649,318326
5/14/22,Kenya,-0.0236,37.9062,324011,0,5649,318362
5/15/22,Kenya,-0.0236,37.9062,324026,0,5649,318377
5/16/22,Kenya,-0.0236,37.9062,324046,0,5649,318397
5/17/22,Kenya,-0.0236,37.9062,324071,0,5649,318422
5/18/22,Kenya,-0.0236,37.9062,324097,0,5649,318448
5/19/22,Kenya,-0.0236,37.9062,324129,0,5649,318480
5/20/22,Kenya,-0.0236,37.9062,324175,0,5649,318526
5/21/22,Kenya,-0.0236,37.9062,324222,0,5649,318573
5/22/22,Kenya,-0.0236,37.9062,324242,0,5651,318591
5/23/22,Kenya,-0.0236,37.9062,324274,0,5651,318623
5/24/22,Kenya,-0.0236,37.9062,324349,0,5651,318698
5/25/22,Kenya,-0.0236,37.9062,324406,0,5651,318755
5/26/22,Kenya,-0.0236,37.9062,324469,0,5651,318818
5/27/22,Kenya,-0.0236,37.9062,324558,0,5651,318907
5/28/22,Kenya,-0.0236,37.9062,324686,0,5651,319035
5/29/22,Kenya,-0.0236,37.9062,324768,0,5651,319117
5/30/22,Kenya,-0.0236,37.9062,324859,0,5651,319208
5/31/22,Kenya,-0.0236,37.9062,324976,0,5651,319325
6/1/22,Kenya,-0.0236,37.9062,325070,0,5651,319419
6/2/22,Kenya,-0.0236,37.9062,325170,0,5651,319519
6/3/22,Kenya,-0.0236,37.9062,325320,0,5651,319669
6/4/22,Kenya,-0.0236,37.9062,325442,0,5651,319791
6/5/22,Kenya,-0.0236,37.9062,325554,0,5651,319903
6/6/22,Kenya,-0.0236,37.9062,325634,0,5651,319983
6/7/22,Kenya,-0.0236,37.9062,325797,0,5651,320146
6/8/22,Kenya,-0.0236,37.9062,326015,0,5651,320364
6/9/22,Kenya,-0.0236,37.9062,326217,0,5651,320566
6/10/22,Kenya,-0.0236,37.9062,326449,0,5651,320798
6/11/22,Kenya,-0.0236,37.9062,326737,0,5651,321086
6/12/22,Kenya,-0.0236,37.9062,326932,0,5651,321281
6/13/22,Kenya,-0.0236,37.9062,327145,0,5651,321494
6/14/22,Kenya,-0.0236,37.9062,327425,0,5651,321774
6/15/22,Kenya,-0.0236,37.9062,327892,0,5651,322241
6/16/22,Kenya,-0.0236,37.9062,328319,0,5651,322668
6/17/22,Kenya,-0.0236,37.9062,328709,0,5651,323058
6/18/22,Kenya,-0.0236,37.9062,329107,0,5651,323456
6/19/22,Kenya,-0.0236,37.9062,329353,0,5651,323702
6/20/22,Kenya,-0.0236,37.9062,329605,0,5651,323954
6/21/22,Kenya,-0.0236,37.9062,330024,0,5651,324373
6/22/22,Kenya,-0.0236,37.9062,330478,0,5651,324827
6/23/22,Kenya,-0.0236,37.9062,331037,0,5651,325386
6/24/22,Kenya,-0.0236,37.9062,331539,0,5651,325888
6/25/22,Kenya,-0.0236,37.9062,331966,0,5651,326315
6/26/22,Kenya,-0.0236,37.9062,332227,0,5652,326575
6/27/22,Kenya,-0.0236,37.9062,332459,0,5652,326807
6/28/22,Kenya,-0.0236,37.9062,332898,0,5652,327246
6/29/22,Kenya,-0.0236,37.9062,333290,0,5652,327638
6/30/22,Kenya,-0.0236,37.9062,333694,0,5652,328042
7/1/22,Kenya,-0.0236,37.9062,333952,0,5653,328299
7/2/22,Kenya,-0.0236,37.9062,334249,0,5655,328594
7/3/22,Kenya,-0.0236,37.9062,334249,0,5655,328594
7/4/22,Kenya,-0.0236,37.9062,334551,0,5656,328895
7/5/22,Kenya,-0.0236,37.9062,334800,0,5657,329143
7/6/22,Kenya,-0.0236,37.9062,335092,0,5659,329433
7/7/22,Kenya,-0.0236,37.9062,335341,0,5660,329681
7/8/22,Kenya,-0.0236,37.9062,335569,0,5660,329909
7/9/22,Kenya,-0.0236,37.9062,335773,0,5663,330110
7/10/22,Kenya,-0.0236,37.9062,335861,0,5667,330194
7/11/22,Kenya,-0.0236,37.9062,335929,0,5668,330261
7/12/22,Kenya,-0.0236,37.9062,336053,0,5668,330385
7/13/22,Kenya,-0.0236,37.9062,336292,0,5668,330624
7/14/22,Kenya,-0.0236,37.9062,336445,0,5668,330777
7/15/22,Kenya,-0.0236,37.9062,336578,0,5668,330910
7/16/22,Kenya,-0.0236,37.9062,336690,0,5668,331022
7/17/22,Kenya,-0.0236,37.9062,336740,0,5668,331072
7/18/22,Kenya,-0.0236,37.9062,336798,0,5668,331130
7/19/22,Kenya,-0.0236,37.9062,336904,0,5668,331236
7/20/22,Kenya,-0.0236,37.9062,337005,0,5670,331335
7/21/22,Kenya,-0.0236,37.9062,337085,0,5670,331415
7/22/22,Kenya,-0.0236,37.9062,337161,0,5670,331491
7/23/22,Kenya,-0.0236,37.9062,337242,0,5670,331572
7/24/22,Kenya,-0.0236,37.9062,337297,0,5670,331627
7/25/22,Kenya,-0.0236,37.9062,337339,0,5670,331669
7/26/22,Kenya,-0.0236,37.9062,337389,0,5672,331717
7/27/22,Kenya,-0.0236,37.9062,337456,0,5672,331784
7/28/22,Kenya,-0.0236,37.9062,337500,0,5672,331828
7/29/22,Kenya,-0.0236,37.9062,337550,0,5672,331878
7/30/22,Kenya,-0.0236,37.9062,337599,0,5672,331927
7/31/22,Kenya,-0.0236,37.9062,337622,0,5672,331950
8/1/22,Kenya,-0.0236,37.9062,337639,0,5672,331967
8/2/22,Kenya,-0.0236,37.9062,337689,0,5672,332017
8/3/22,Kenya,-0.0236,37.9062,337734,0,5672,332062
8/4/22,Kenya,-0.0236,37.9062,337768,0,5672,332096
8/5/22,Kenya,-0.0236,37.9062,337808,0,5672,332136
8/6/22,Kenya,-0.0236,37.9062,337833,0,5672,332161
8/7/22,Kenya,-0.0236,37.9062,337853,0,5672,332181
8/8/22,Kenya,-0.0236,37.9062,337874,0,5672,332202
8/9/22,Kenya,-0.0236,37.9062,337884,0,5672,332212
8/10/22,Kenya,-0.0236,37.9062,337894,0,5673,332221
8/11/22,Kenya,-0.0236,37.9062,337912,0,5673,332239
8/12/22,Kenya,-0.0236,37.9062,337921,0,5673,332248
8/13/22,Kenya,-0.0236,37.9062,337938,0,5673,332265
8/14/22,Kenya,-0.0236,37.9062,337950,0,5673,332277
8/15/22,Kenya,-0.0236,37.9062,337961,0,5673,332288
8/16/22,Kenya,-0.0236,37.9062,337966,0,5673,332293
8/17/22,Kenya,-0.0236,37.9062,337985,0,5673,332312
8/18/22,Kenya,-0.0236,37.9062,338009,0,5673,332336
8/19/22,Kenya,-0.0236,37.9062,338022,0,5673,332349
8/20/22,Kenya,-0.0236,37.9062,338042,0,5673,332369
8/21/22,Kenya,-0.0236,37.9062,338047,0,5673,332374
8/22/22,Kenya,-0.0236,37.9062,338053,0,5673,332380
8/23/22,Kenya,-0.0236,37.9062,338061,0,5673,332388
8/24/22,Kenya,-0.0236,37.9062,338088,0,5673,332415
8/25/22,Kenya,-0.0236,37.9062,338093,0,5673,332420
8/26/22,Kenya,-0.0236,37.9062,338105,0,5673,332432
8/27/22,Kenya,-0.0236,37.9062,338153,0,5673,332480
8/28/22,Kenya,-0.0236,37.9062,338161,0,5674,332487
8/29/22,Kenya,-0.0236,37.9062,338165,0,5674,332491
8/30/22,Kenya,-0.0236,37.9062,338170,0,5674,332496
8/31/22,Kenya,-0.0236,37.9062,338183,0,5674,332509
9/1/22,Kenya,-0.0236,37.9062,338210,0,5674,332536
9/2/22,Kenya,-0.0236,37.9062,338214,0,5674,332540
9/3/22,Kenya,-0.0236,37.9062,338234,0,5674,332560
9/4/22,Kenya,-0.0236,37.9062,338235,0,5674,332561
9/5/22,Kenya,-0.0236,37.9062,338237,0,5674,332563
9/6/22,Kenya,-0.0236,37.9062,338243,0,5674,332569
9/7/22,Kenya,-0.0236,37.9062,338259,0,5674,332585
9/8/22,Kenya,-0.0236,37.9062,338271,0,5674,332597
9/9/22,Kenya,-0.0236,37.9062,338280,0,5674,332606
9/10/22,Kenya,-0.0236,37.9062,338290,0,5674,332616
9/11/22,Kenya,-0.0236,37.9062,338295,0,5674,332621
9/12/22,Kenya,-0.0236,37.9062,338301,0,5674,332627
9/13/22,Kenya,-0.0236,37.9062,338307,0,5675,332632
9/14/22,Kenya,-0.0236,37.9062,338308,0,5675,332633
9/15/22,Kenya,-0.0236,37.9062,338315,0,5675,332640
9/16/22,Kenya,-0.0236,37.9062,338324,0,5675,332649
9/17/22,Kenya,-0.0236,37.9062,338332,0,5675,332657
9/18/22,Kenya,-0.0236,37.9062,338341,0,5675,332666
9/19/22,Kenya,-0.0236,37.9062,338347,0,5675,332672
9/20/22,Kenya,-0.0236,37.9062,338365,0,5675,332690
9/21/22,Kenya,-0.0236,37.9062,338371,0,5675,332696
9/22/22,Kenya,-0.0236,37.9062,338379,0,5675,332704
9/23/22,Kenya,-0.0236,37.9062,338379,0,5675,332704
9/24/22,Kenya,-0.0236,37.9062,338389,0,5675,332714
9/25/22,Kenya,-0.0236,37.9062,338390,0,5675,332715
9/26/22,Kenya,-0.0236,37.9062,338390,0,5675,332715
9/27/22,Kenya,-0.0236,37.9062,338404,0,5675,332729
9/28/22,Kenya,-0.0236,37.9062,338420,0,5678,332742
9/29/22,Kenya,-0.0236,37.9062,338420,0,5678,332742
9/30/22,Kenya,-0.0236,37.9062,338434,0,5678,332756
10/1/22,Kenya,-0.0236,37.9062,338439,0,5678,332761
10/2/22,Kenya,-0.0236,37.9062,338445,0,5678,332767
10/3/22,Kenya,-0.0236,37.9062,338449,0,5678,332771
10/4/22,Kenya,-0.0236,37.9062,338455,0,5678,332777
10/5/22,Kenya,-0.0236,37.9062,338463,0,5678,332785
10/6/22,Kenya,-0.0236,37.9062,338474,0,5678,332796
10/7/22,Kenya,-0.0236,37.9062,338484,0,5678,332806
10/8/22,Kenya,-0.0236,37.9062,338484,0,5678,332806
10/9/22,Kenya,-0.0236,37.9062,338499,0,5678,332821
10/10/22,Kenya,-0.0236,37.9062,338506,0,5678,332828
10/11/22,Kenya,-0.0236,37.9062,338518,0,5678,332840
10/12/22,Kenya,-0.0236,37.9062,338528,0,5678,332850
10/13/22,Kenya,-0.0236,37.9062,338538,0,5678,332860
10/14/22,Kenya,-0.0236,37.9062,338568,0,5678,332890
10/15/22,Kenya,-0.0236,37.9062,338571,0,5678,332893
10/16/22,Kenya,-0.0236,37.9062,338578,0,5678,332900
10/17/22,Kenya,-0.0236,37.9062,338599,0,5678,332921
10/18/22,Kenya,-0.0236,37.9062,338647,0,5678,332969
10/19/22,Kenya,-0.0236,37.9062,338678,0,5678,333000
10/20/22,Kenya,-0.0236,37.9062,338703,0,5678,333025
10/21/22,Kenya,-0.0236,37.9062,338728,0,5678,333050
10/22/22,Kenya,-0.0236,37.9062,338728,0,5678,333050
10/23/22,Kenya,-0.0236,37.9062,338749,0,5678,333071
10/24/22,Kenya,-0.0236,37.9062,338749,0,5678,333071
10/25/22,Kenya,-0.0236,37.9062,338749,0,5678,333071
10/26/22,Kenya,-0.0236,37.9062,338908,0,5678,333230
10/27/22,Kenya,-0.0236,37.9062,338970,0,5678,333292
10/28/22,Kenya,-0.0236,37.9062,339036,0,5678,333358
10/29/22,Kenya,-0.0236,37.9062,339078,0,5678,333400
10/30/22,Kenya,-0.0236,37.9062,339113,0,5678,333435
10/31/22,Kenya,-0.0236,37.9062,339147,0,5678,333469
11/1/22,Kenya,-0.0236,37.9062,339253,0,5678,333575
11/2/22,Kenya,-0.0236,37.9062,339350,0,5678,333672
11/3/22,Kenya,-0.0236,37.9062,339350,0,5678,333672
11/4/22,Kenya,-0.0236,37.9062,339552,0,5678,333874
11/5/22,Kenya,-0.0236,37.9062,339671,0,5678,333993
11/6/22,Kenya,-0.0236,37.9062,339756,0,5678,334078
11/7/22,Kenya,-0.0236,37.9062,339788,0,5678,334110
11/8/22,Kenya,-0.0236,37.9062,339788,0,5678,334110
11/9/22,Kenya,-0.0236,37.9062,339987,0,5678,334309
11/10/22,Kenya,-0.0236,37.9062,340114,0,5678,334436
11/11/22,Kenya,-0.0236,37.9062,340209,0,5678,334531
11/12/22,Kenya,-0.0236,37.9062,340371,0,5678,334693
11/13/22,Kenya,-0.0236,37.9062,340431,0,5680,334751
11/14/22,Kenya,-0.0236,37.9062,340431,0,5680,334751
11/15/22,Kenya,-0.0236,37.9062,340600,0,5680,334920
11/16/22,Kenya,-0.0236,37.9062,340690,0,5684,335006
11/17/22,Kenya,-0.0236,37.9062,340784,0,5684,335100
11/18/22,Kenya,-0.0236,37.9062,340888,0,5684,335204
11/19/22,Kenya,-0.0236,37.9062,340975,0,5684,335291
11/20/22,Kenya,-0.0236,37.9062,341030,0,5684,335346
11/21/22,Kenya,-0.0236,37.9062,341043,0,5684,335359
11/22/22,Kenya,-0.0236,37.9062,341116,0,5684,335432
11/23/22,Kenya,-0.0236,37.9062,341235,0,5684,335551
11/24/22,Kenya,-0.0236,37.9062,341319,0,5684,335635
11/25/22,Kenya,-0.0236,37.9062,341361,0,5684,335677
11/26/22,Kenya,-0.0236,37.9062,341460,0,5684,335776
11/27/22,Kenya,-0.0236,37.9062,341496,0,5684,335812
11/28/22,Kenya,-0.0236,37.9062,341515,0,5684,335831
11/29/22,Kenya,-0.0236,37.9062,341573,0,5684,335889
11/30/22,Kenya,-0.0236,37.9062,341636,0,5684,335952
12/1/22,Kenya,-0.0236,37.9062,341696,0,5684,336012
12/2/22,Kenya,-0.0236,37.9062,341804,0,5684,336120
12/3/22,Kenya,-0.0236,37.9062,341886,0,5684,336202
12/4/22,Kenya,-0.0236,37.9062,341924,0,5684,336240
12/5/22,Kenya,-0.0236,37.9062,341933,0,5684,336249
12/6/22,Kenya,-0.0236,37.9062,341977,0,5684,336293
12/7/22,Kenya,-0.0236,37.9062,342026,0,5684,336342
12/8/22,Kenya,-0.0236,37.9062,342083,0,5684,336399
12/9/22,Kenya,-0.0236,37.9062,342093,0,5684,336409
12/10/22,Kenya,-0.0236,37.9062,342093,0,5684,336409
12/11/22,Kenya,-0.0236,37.9062,342107,0,5684,336423
12/12/22,Kenya,-0.0236,37.9062,342120,0,5684,336436
12/13/22,Kenya,-0.0236,37.9062,342155,0,5684,336471
12/14/22,Kenya,-0.0236,37.9062,342209,0,5684,336525
12/15/22,Kenya,-0.0236,37.9062,342248,0,5684,336564
12/16/22,Kenya,-0.0236,37.9062,342294,0,5684,336610
12/17/22,Kenya,-0.0236,37.9062,342320,0,5684,336636
1/1/22,Kiribati,-3.3704,-168.734,2,0,0,2
1/2/22,Kiribati,-3.3704,-168.734,2,0,0,2
1/3/22,Kiribati,-3.3704,-168.734,2,0,0,2
1/4/22,Kiribati,-3.3704,-168.734,2,0,0,2
1/5/22,Kiribati,-3.3704,-168.734,2,0,0,2
1/6/22,Kiribati,-3.3704,-168.734,2,0,0,2
1/7/22,Kiribati,-3.3704,-168.734,2,0,0,2
1/8/22,Kiribati,-3.3704,-168.734,2,0,0,2
1/9/22,Kiribati,-3.3704,-168.734,2,0,0,2
1/10/22,Kiribati,-3.3704,-168.734,2,0,0,2
1/11/22,Kiribati,-3.3704,-168.734,2,0,0,2
1/12/22,Kiribati,-3.3704,-168.734,2,0,0,2
1/13/22,Kiribati,-3.3704,-168.734,2,0,0,2
1/14/22,Kiribati,-3.3704,-168.734,2,0,0,2
1/15/22,Kiribati,-3.3704,-168.734,2,0,0,2
1/16/22,Kiribati,-3.3704,-168.734,2,0,0,2
1/17/22,Kiribati,-3.3704,-168.734,2,0,0,2
1/18/22,Kiribati,-3.3704,-168.734,2,0,0,2
1/19/22,Kiribati,-3.3704,-168.734,37,0,0,37
1/20/22,Kiribati,-3.3704,-168.734,37,0,0,37
1/21/22,Kiribati,-3.3704,-168.734,39,0,0,39
1/22/22,Kiribati,-3.3704,-168.734,39,0,0,39
1/23/22,Kiribati,-3.3704,-168.734,39,0,0,39
1/24/22,Kiribati,-3.3704,-168.734,59,0,0,59
1/25/22,Kiribati,-3.3704,-168.734,66,0,0,66
1/26/22,Kiribati,-3.3704,-168.734,116,0,0,116
1/27/22,Kiribati,-3.3704,-168.734,181,0,0,181
1/28/22,Kiribati,-3.3704,-168.734,201,0,0,201
1/29/22,Kiribati,-3.3704,-168.734,266,0,0,266
1/30/22,Kiribati,-3.3704,-168.734,364,0,0,364
1/31/22,Kiribati,-3.3704,-168.734,460,0,0,460
2/1/22,Kiribati,-3.3704,-168.734,629,0,0,629
2/2/22,Kiribati,-3.3704,-168.734,767,0,0,767
2/3/22,Kiribati,-3.3704,-168.734,913,0,0,913
2/4/22,Kiribati,-3.3704,-168.734,1037,0,0,1037
2/5/22,Kiribati,-3.3704,-168.734,1387,0,0,1387
2/6/22,Kiribati,-3.3704,-168.734,1543,0,0,1543
2/7/22,Kiribati,-3.3704,-168.734,1744,0,0,1744
2/8/22,Kiribati,-3.3704,-168.734,1951,0,0,1951
2/9/22,Kiribati,-3.3704,-168.734,2173,0,1,2172
2/10/22,Kiribati,-3.3704,-168.734,2235,0,1,2234
2/11/22,Kiribati,-3.3704,-168.734,2316,0,3,2313
2/12/22,Kiribati,-3.3704,-168.734,2451,0,3,2448
2/13/22,Kiribati,-3.3704,-168.734,2548,0,3,2545
2/14/22,Kiribati,-3.3704,-168.734,2582,0,3,2579
2/15/22,Kiribati,-3.3704,-168.734,2665,0,8,2657
2/16/22,Kiribati,-3.3704,-168.734,2665,0,8,2657
2/17/22,Kiribati,-3.3704,-168.734,2757,0,9,2748
2/18/22,Kiribati,-3.3704,-168.734,2810,0,9,2801
2/19/22,Kiribati,-3.3704,-168.734,2823,0,9,2814
2/20/22,Kiribati,-3.3704,-168.734,2833,0,11,2822
2/21/22,Kiribati,-3.3704,-168.734,2833,0,11,2822
2/22/22,Kiribati,-3.3704,-168.734,2861,0,11,2850
2/23/22,Kiribati,-3.3704,-168.734,2867,0,11,2856
2/24/22,Kiribati,-3.3704,-168.734,2883,0,11,2872
2/25/22,Kiribati,-3.3704,-168.734,2892,0,11,2881
2/26/22,Kiribati,-3.3704,-168.734,2904,0,11,2893
2/27/22,Kiribati,-3.3704,-168.734,2914,0,11,2903
2/28/22,Kiribati,-3.3704,-168.734,2914,0,11,2903
3/1/22,Kiribati,-3.3704,-168.734,2940,0,11,2929
3/2/22,Kiribati,-3.3704,-168.734,2953,0,11,2942
3/3/22,Kiribati,-3.3704,-168.734,2964,0,11,2953
3/4/22,Kiribati,-3.3704,-168.734,2974,0,11,2963
3/5/22,Kiribati,-3.3704,-168.734,2985,0,11,2974
3/6/22,Kiribati,-3.3704,-168.734,2986,0,11,2975
3/7/22,Kiribati,-3.3704,-168.734,2991,0,12,2979
3/8/22,Kiribati,-3.3704,-168.734,3000,0,13,2987
3/9/22,Kiribati,-3.3704,-168.734,3006,0,13,2993
3/10/22,Kiribati,-3.3704,-168.734,3010,0,13,2997
3/11/22,Kiribati,-3.3704,-168.734,3019,0,13,3006
3/12/22,Kiribati,-3.3704,-168.734,3022,0,13,3009
3/13/22,Kiribati,-3.3704,-168.734,3027,0,13,3014
3/14/22,Kiribati,-3.3704,-168.734,3033,0,13,3020
3/15/22,Kiribati,-3.3704,-168.734,3038,0,13,3025
3/16/22,Kiribati,-3.3704,-168.734,3041,0,13,3028
3/17/22,Kiribati,-3.3704,-168.734,3041,0,13,3028
3/18/22,Kiribati,-3.3704,-168.734,3042,0,13,3029
3/19/22,Kiribati,-3.3704,-168.734,3049,0,13,3036
3/20/22,Kiribati,-3.3704,-168.734,3049,0,13,3036
3/21/22,Kiribati,-3.3704,-168.734,3061,0,13,3048
3/22/22,Kiribati,-3.3704,-168.734,3057,0,13,3044
3/23/22,Kiribati,-3.3704,-168.734,3060,0,13,3047
3/24/22,Kiribati,-3.3704,-168.734,3061,0,13,3048
3/25/22,Kiribati,-3.3704,-168.734,3062,0,13,3049
3/26/22,Kiribati,-3.3704,-168.734,3065,0,13,3052
3/27/22,Kiribati,-3.3704,-168.734,3065,0,13,3052
3/28/22,Kiribati,-3.3704,-168.734,3065,0,13,3052
3/29/22,Kiribati,-3.3704,-168.734,3065,0,13,3052
3/30/22,Kiribati,-3.3704,-168.734,3065,0,13,3052
3/31/22,Kiribati,-3.3704,-168.734,3066,0,13,3053
4/1/22,Kiribati,-3.3704,-168.734,3066,0,13,3053
4/2/22,Kiribati,-3.3704,-168.734,3066,0,13,3053
4/3/22,Kiribati,-3.3704,-168.734,3067,0,13,3054
4/4/22,Kiribati,-3.3704,-168.734,3067,0,13,3054
4/5/22,Kiribati,-3.3704,-168.734,3067,0,13,3054
4/6/22,Kiribati,-3.3704,-168.734,3068,0,13,3055
4/7/22,Kiribati,-3.3704,-168.734,3068,0,13,3055
4/8/22,Kiribati,-3.3704,-168.734,3069,0,13,3056
4/9/22,Kiribati,-3.3704,-168.734,3069,0,13,3056
4/10/22,Kiribati,-3.3704,-168.734,3069,0,13,3056
4/11/22,Kiribati,-3.3704,-168.734,3069,0,13,3056
4/12/22,Kiribati,-3.3704,-168.734,3069,0,13,3056
4/13/22,Kiribati,-3.3704,-168.734,3069,0,13,3056
4/14/22,Kiribati,-3.3704,-168.734,3069,0,13,3056
4/15/22,Kiribati,-3.3704,-168.734,3071,0,13,3058
4/16/22,Kiribati,-3.3704,-168.734,3071,0,13,3058
4/17/22,Kiribati,-3.3704,-168.734,3074,0,13,3061
4/18/22,Kiribati,-3.3704,-168.734,3075,0,13,3062
4/19/22,Kiribati,-3.3704,-168.734,3076,0,13,3063
4/20/22,Kiribati,-3.3704,-168.734,3076,0,13,3063
4/21/22,Kiribati,-3.3704,-168.734,3076,0,13,3063
4/22/22,Kiribati,-3.3704,-168.734,3076,0,13,3063
4/23/22,Kiribati,-3.3704,-168.734,3076,0,13,3063
4/24/22,Kiribati,-3.3704,-168.734,3076,0,13,3063
4/25/22,Kiribati,-3.3704,-168.734,3080,0,13,3067
4/26/22,Kiribati,-3.3704,-168.734,3080,0,13,3067
4/27/22,Kiribati,-3.3704,-168.734,3080,0,13,3067
4/28/22,Kiribati,-3.3704,-168.734,3080,0,13,3067
4/29/22,Kiribati,-3.3704,-168.734,3081,0,13,3068
4/30/22,Kiribati,-3.3704,-168.734,3081,0,13,3068
5/1/22,Kiribati,-3.3704,-168.734,3084,0,13,3071
5/2/22,Kiribati,-3.3704,-168.734,3084,0,13,3071
5/3/22,Kiribati,-3.3704,-168.734,3084,0,13,3071
5/4/22,Kiribati,-3.3704,-168.734,3089,0,13,3076
5/5/22,Kiribati,-3.3704,-168.734,3089,0,13,3076
5/6/22,Kiribati,-3.3704,-168.734,3089,0,13,3076
5/7/22,Kiribati,-3.3704,-168.734,3089,0,13,3076
5/8/22,Kiribati,-3.3704,-168.734,3093,0,13,3080
5/9/22,Kiribati,-3.3704,-168.734,3093,0,13,3080
5/10/22,Kiribati,-3.3704,-168.734,3093,0,13,3080
5/11/22,Kiribati,-3.3704,-168.734,3093,0,13,3080
5/12/22,Kiribati,-3.3704,-168.734,3093,0,13,3080
5/13/22,Kiribati,-3.3704,-168.734,3093,0,13,3080
5/14/22,Kiribati,-3.3704,-168.734,3093,0,13,3080
5/15/22,Kiribati,-3.3704,-168.734,3093,0,13,3080
5/16/22,Kiribati,-3.3704,-168.734,3093,0,13,3080
5/17/22,Kiribati,-3.3704,-168.734,3094,0,13,3081
5/18/22,Kiribati,-3.3704,-168.734,3098,0,13,3085
5/19/22,Kiribati,-3.3704,-168.734,3098,0,13,3085
5/20/22,Kiribati,-3.3704,-168.734,3098,0,13,3085
5/21/22,Kiribati,-3.3704,-168.734,3098,0,13,3085
5/22/22,Kiribati,-3.3704,-168.734,3098,0,13,3085
5/23/22,Kiribati,-3.3704,-168.734,3098,0,13,3085
5/24/22,Kiribati,-3.3704,-168.734,3098,0,13,3085
5/25/22,Kiribati,-3.3704,-168.734,3098,0,13,3085
5/26/22,Kiribati,-3.3704,-168.734,3098,0,13,3085
5/27/22,Kiribati,-3.3704,-168.734,3098,0,13,3085
5/28/22,Kiribati,-3.3704,-168.734,3098,0,13,3085
5/29/22,Kiribati,-3.3704,-168.734,3098,0,13,3085
5/30/22,Kiribati,-3.3704,-168.734,3098,0,13,3085
5/31/22,Kiribati,-3.3704,-168.734,3098,0,13,3085
6/1/22,Kiribati,-3.3704,-168.734,3098,0,13,3085
6/2/22,Kiribati,-3.3704,-168.734,3098,0,13,3085
6/3/22,Kiribati,-3.3704,-168.734,3098,0,13,3085
6/4/22,Kiribati,-3.3704,-168.734,3098,0,13,3085
6/5/22,Kiribati,-3.3704,-168.734,3161,0,13,3148
6/6/22,Kiribati,-3.3704,-168.734,3161,0,13,3148
6/7/22,Kiribati,-3.3704,-168.734,3183,0,13,3170
6/8/22,Kiribati,-3.3704,-168.734,3183,0,13,3170
6/9/22,Kiribati,-3.3704,-168.734,3183,0,13,3170
6/10/22,Kiribati,-3.3704,-168.734,3204,0,13,3191
6/11/22,Kiribati,-3.3704,-168.734,3204,0,13,3191
6/12/22,Kiribati,-3.3704,-168.734,3204,0,13,3191
6/13/22,Kiribati,-3.3704,-168.734,3209,0,13,3196
6/14/22,Kiribati,-3.3704,-168.734,3215,0,13,3202
6/15/22,Kiribati,-3.3704,-168.734,3215,0,13,3202
6/16/22,Kiribati,-3.3704,-168.734,3215,0,13,3202
6/17/22,Kiribati,-3.3704,-168.734,3215,0,13,3202
6/18/22,Kiribati,-3.3704,-168.734,3215,0,13,3202
6/19/22,Kiribati,-3.3704,-168.734,3215,0,13,3202
6/20/22,Kiribati,-3.3704,-168.734,3215,0,13,3202
6/21/22,Kiribati,-3.3704,-168.734,3215,0,13,3202
6/22/22,Kiribati,-3.3704,-168.734,3215,0,13,3202
6/23/22,Kiribati,-3.3704,-168.734,3215,0,13,3202
6/24/22,Kiribati,-3.3704,-168.734,3236,0,13,3223
6/25/22,Kiribati,-3.3704,-168.734,3236,0,13,3223
6/26/22,Kiribati,-3.3704,-168.734,3236,0,13,3223
6/27/22,Kiribati,-3.3704,-168.734,3236,0,13,3223
6/28/22,Kiribati,-3.3704,-168.734,3236,0,13,3223
6/29/22,Kiribati,-3.3704,-168.734,3236,0,13,3223
6/30/22,Kiribati,-3.3704,-168.734,3236,0,13,3223
7/1/22,Kiribati,-3.3704,-168.734,3236,0,13,3223
7/2/22,Kiribati,-3.3704,-168.734,3236,0,13,3223
7/3/22,Kiribati,-3.3704,-168.734,3236,0,13,3223
7/4/22,Kiribati,-3.3704,-168.734,3236,0,13,3223
7/5/22,Kiribati,-3.3704,-168.734,3236,0,13,3223
7/6/22,Kiribati,-3.3704,-168.734,3236,0,13,3223
7/7/22,Kiribati,-3.3704,-168.734,3236,0,13,3223
7/8/22,Kiribati,-3.3704,-168.734,3236,0,13,3223
7/9/22,Kiribati,-3.3704,-168.734,3236,0,13,3223
7/10/22,Kiribati,-3.3704,-168.734,3236,0,13,3223
7/11/22,Kiribati,-3.3704,-168.734,3236,0,13,3223
7/12/22,Kiribati,-3.3704,-168.734,3236,0,13,3223
7/13/22,Kiribati,-3.3704,-168.734,3236,0,13,3223
7/14/22,Kiribati,-3.3704,-168.734,3236,0,13,3223
7/15/22,Kiribati,-3.3704,-168.734,3236,0,13,3223
7/16/22,Kiribati,-3.3704,-168.734,3236,0,13,3223
7/17/22,Kiribati,-3.3704,-168.734,3236,0,13,3223
7/18/22,Kiribati,-3.3704,-168.734,3236,0,13,3223
7/19/22,Kiribati,-3.3704,-168.734,3236,0,13,3223
7/20/22,Kiribati,-3.3704,-168.734,3236,0,13,3223
7/21/22,Kiribati,-3.3704,-168.734,3348,0,13,3335
7/22/22,Kiribati,-3.3704,-168.734,3348,0,13,3335
7/23/22,Kiribati,-3.3704,-168.734,3348,0,13,3335
7/24/22,Kiribati,-3.3704,-168.734,3430,0,13,3417
7/25/22,Kiribati,-3.3704,-168.734,3430,0,13,3417
7/26/22,Kiribati,-3.3704,-168.734,3430,0,13,3417
7/27/22,Kiribati,-3.3704,-168.734,3430,0,13,3417
7/28/22,Kiribati,-3.3704,-168.734,3430,0,13,3417
7/29/22,Kiribati,-3.3704,-168.734,3430,0,13,3417
7/30/22,Kiribati,-3.3704,-168.734,3430,0,13,3417
7/31/22,Kiribati,-3.3704,-168.734,3430,0,13,3417
8/1/22,Kiribati,-3.3704,-168.734,3430,0,13,3417
8/2/22,Kiribati,-3.3704,-168.734,3430,0,13,3417
8/3/22,Kiribati,-3.3704,-168.734,3430,0,13,3417
8/4/22,Kiribati,-3.3704,-168.734,3430,0,13,3417
8/5/22,Kiribati,-3.3704,-168.734,3430,0,13,3417
8/6/22,Kiribati,-3.3704,-168.734,3430,0,13,3417
8/7/22,Kiribati,-3.3704,-168.734,3430,0,13,3417
8/8/22,Kiribati,-3.3704,-168.734,3430,0,13,3417
8/9/22,Kiribati,-3.3704,-168.734,3430,0,13,3417
8/10/22,Kiribati,-3.3704,-168.734,3430,0,13,3417
8/11/22,Kiribati,-3.3704,-168.734,3430,0,13,3417
8/12/22,Kiribati,-3.3704,-168.734,3430,0,13,3417
8/13/22,Kiribati,-3.3704,-168.734,3430,0,13,3417
8/14/22,Kiribati,-3.3704,-168.734,3430,0,13,3417
8/15/22,Kiribati,-3.3704,-168.734,3430,0,13,3417
8/16/22,Kiribati,-3.3704,-168.734,3430,0,13,3417
8/17/22,Kiribati,-3.3704,-168.734,3430,0,13,3417
8/18/22,Kiribati,-3.3704,-168.734,3430,0,13,3417
8/19/22,Kiribati,-3.3704,-168.734,3430,0,13,3417
8/20/22,Kiribati,-3.3704,-168.734,3430,0,13,3417
8/21/22,Kiribati,-3.3704,-168.734,3430,0,13,3417
8/22/22,Kiribati,-3.3704,-168.734,3430,0,13,3417
8/23/22,Kiribati,-3.3704,-168.734,3430,0,13,3417
8/24/22,Kiribati,-3.3704,-168.734,3430,0,13,3417
8/25/22,Kiribati,-3.3704,-168.734,3430,0,13,3417
8/26/22,Kiribati,-3.3704,-168.734,3430,0,13,3417
8/27/22,Kiribati,-3.3704,-168.734,3430,0,13,3417
8/28/22,Kiribati,-3.3704,-168.734,3430,0,13,3417
8/29/22,Kiribati,-3.3704,-168.734,3430,0,13,3417
8/30/22,Kiribati,-3.3704,-168.734,3430,0,13,3417
8/31/22,Kiribati,-3.3704,-168.734,3430,0,13,3417
9/1/22,Kiribati,-3.3704,-168.734,3430,0,13,3417
9/2/22,Kiribati,-3.3704,-168.734,3430,0,13,3417
9/3/22,Kiribati,-3.3704,-168.734,3430,0,13,3417
9/4/22,Kiribati,-3.3704,-168.734,3430,0,13,3417
9/5/22,Kiribati,-3.3704,-168.734,3430,0,13,3417
9/6/22,Kiribati,-3.3704,-168.734,3430,0,13,3417
9/7/22,Kiribati,-3.3704,-168.734,3430,0,13,3417
9/8/22,Kiribati,-3.3704,-168.734,3430,0,13,3417
9/9/22,Kiribati,-3.3704,-168.734,3430,0,13,3417
9/10/22,Kiribati,-3.3704,-168.734,3430,0,13,3417
9/11/22,Kiribati,-3.3704,-168.734,3430,0,13,3417
9/12/22,Kiribati,-3.3704,-168.734,3430,0,13,3417
9/13/22,Kiribati,-3.3704,-168.734,3430,0,13,3417
9/14/22,Kiribati,-3.3704,-168.734,3430,0,13,3417
9/15/22,Kiribati,-3.3704,-168.734,3430,0,13,3417
9/16/22,Kiribati,-3.3704,-168.734,3430,0,13,3417
9/17/22,Kiribati,-3.3704,-168.734,3430,0,13,3417
9/18/22,Kiribati,-3.3704,-168.734,3430,0,13,3417
9/19/22,Kiribati,-3.3704,-168.734,3430,0,13,3417
9/20/22,Kiribati,-3.3704,-168.734,3430,0,13,3417
9/21/22,Kiribati,-3.3704,-168.734,3430,0,13,3417
9/22/22,Kiribati,-3.3704,-168.734,3430,0,13,3417
9/23/22,Kiribati,-3.3704,-168.734,3430,0,13,3417
9/24/22,Kiribati,-3.3704,-168.734,3430,0,13,3417
9/25/22,Kiribati,-3.3704,-168.734,3430,0,13,3417
9/26/22,Kiribati,-3.3704,-168.734,3430,0,13,3417
9/27/22,Kiribati,-3.3704,-168.734,3430,0,13,3417
9/28/22,Kiribati,-3.3704,-168.734,3430,0,13,3417
9/29/22,Kiribati,-3.3704,-168.734,3430,0,13,3417
9/30/22,Kiribati,-3.3704,-168.734,3430,0,13,3417
10/1/22,Kiribati,-3.3704,-168.734,3430,0,13,3417
10/2/22,Kiribati,-3.3704,-168.734,3430,0,13,3417
10/3/22,Kiribati,-3.3704,-168.734,3430,0,13,3417
10/4/22,Kiribati,-3.3704,-168.734,3430,0,13,3417
10/5/22,Kiribati,-3.3704,-168.734,3430,0,13,3417
10/6/22,Kiribati,-3.3704,-168.734,3430,0,13,3417
10/7/22,Kiribati,-3.3704,-168.734,3430,0,13,3417
10/8/22,Kiribati,-3.3704,-168.734,3430,0,13,3417
10/9/22,Kiribati,-3.3704,-168.734,3430,0,13,3417
10/10/22,Kiribati,-3.3704,-168.734,3430,0,13,3417
10/11/22,Kiribati,-3.3704,-168.734,3430,0,13,3417
10/12/22,Kiribati,-3.3704,-168.734,3430,0,13,3417
10/13/22,Kiribati,-3.3704,-168.734,3430,0,13,3417
10/14/22,Kiribati,-3.3704,-168.734,3430,0,13,3417
10/15/22,Kiribati,-3.3704,-168.734,3430,0,13,3417
10/16/22,Kiribati,-3.3704,-168.734,3430,0,13,3417
10/17/22,Kiribati,-3.3704,-168.734,3430,0,13,3417
10/18/22,Kiribati,-3.3704,-168.734,3430,0,13,3417
10/19/22,Kiribati,-3.3704,-168.734,3430,0,13,3417
10/20/22,Kiribati,-3.3704,-168.734,3430,0,13,3417
10/21/22,Kiribati,-3.3704,-168.734,3430,0,13,3417
10/22/22,Kiribati,-3.3704,-168.734,3430,0,13,3417
10/23/22,Kiribati,-3.3704,-168.734,3430,0,13,3417
10/24/22,Kiribati,-3.3704,-168.734,3430,0,13,3417
10/25/22,Kiribati,-3.3704,-168.734,3430,0,13,3417
10/26/22,Kiribati,-3.3704,-168.734,3430,0,13,3417
10/27/22,Kiribati,-3.3704,-168.734,3430,0,13,3417
10/28/22,Kiribati,-3.3704,-168.734,3430,0,13,3417
10/29/22,Kiribati,-3.3704,-168.734,3430,0,13,3417
10/30/22,Kiribati,-3.3704,-168.734,3430,0,13,3417
10/31/22,Kiribati,-3.3704,-168.734,3430,0,13,3417
11/1/22,Kiribati,-3.3704,-168.734,3430,0,13,3417
11/2/22,Kiribati,-3.3704,-168.734,3430,0,13,3417
11/3/22,Kiribati,-3.3704,-168.734,3430,0,13,3417
11/4/22,Kiribati,-3.3704,-168.734,3430,0,13,3417
11/5/22,Kiribati,-3.3704,-168.734,3430,0,13,3417
11/6/22,Kiribati,-3.3704,-168.734,3430,0,13,3417
11/7/22,Kiribati,-3.3704,-168.734,3430,0,13,3417
11/8/22,Kiribati,-3.3704,-168.734,3430,0,13,3417
11/9/22,Kiribati,-3.3704,-168.734,3430,0,13,3417
11/10/22,Kiribati,-3.3704,-168.734,3430,0,13,3417
11/11/22,Kiribati,-3.3704,-168.734,3430,0,13,3417
11/12/22,Kiribati,-3.3704,-168.734,3430,0,13,3417
11/13/22,Kiribati,-3.3704,-168.734,3430,0,13,3417
11/14/22,Kiribati,-3.3704,-168.734,3430,0,13,3417
11/15/22,Kiribati,-3.3704,-168.734,3430,0,13,3417
11/16/22,Kiribati,-3.3704,-168.734,3430,0,13,3417
11/17/22,Kiribati,-3.3704,-168.734,3430,0,13,3417
11/18/22,Kiribati,-3.3704,-168.734,3430,0,13,3417
11/19/22,Kiribati,-3.3704,-168.734,3430,0,13,3417
11/20/22,Kiribati,-3.3704,-168.734,3430,0,13,3417
11/21/22,Kiribati,-3.3704,-168.734,3430,0,13,3417
11/22/22,Kiribati,-3.3704,-168.734,3430,0,13,3417
11/23/22,Kiribati,-3.3704,-168.734,3430,0,13,3417
11/24/22,Kiribati,-3.3704,-168.734,3430,0,13,3417
11/25/22,Kiribati,-3.3704,-168.734,3430,0,13,3417
11/26/22,Kiribati,-3.3704,-168.734,3430,0,13,3417
11/27/22,Kiribati,-3.3704,-168.734,3430,0,13,3417
11/28/22,Kiribati,-3.3704,-168.734,3430,0,13,3417
11/29/22,Kiribati,-3.3704,-168.734,3430,0,13,3417
11/30/22,Kiribati,-3.3704,-168.734,3430,0,13,3417
12/1/22,Kiribati,-3.3704,-168.734,3430,0,13,3417
12/2/22,Kiribati,-3.3704,-168.734,3430,0,13,3417
12/3/22,Kiribati,-3.3704,-168.734,3430,0,13,3417
12/4/22,Kiribati,-3.3704,-168.734,3430,0,13,3417
12/5/22,Kiribati,-3.3704,-168.734,3430,0,13,3417
12/6/22,Kiribati,-3.3704,-168.734,3430,0,13,3417
12/7/22,Kiribati,-3.3704,-168.734,3430,0,13,3417
12/8/22,Kiribati,-3.3704,-168.734,3430,0,13,3417
12/9/22,Kiribati,-3.3704,-168.734,3430,0,13,3417
12/10/22,Kiribati,-3.3704,-168.734,3430,0,13,3417
12/11/22,Kiribati,-3.3704,-168.734,3430,0,13,3417
12/12/22,Kiribati,-3.3704,-168.734,3430,0,13,3417
12/13/22,Kiribati,-3.3704,-168.734,3430,0,13,3417
12/14/22,Kiribati,-3.3704,-168.734,3430,0,13,3417
12/15/22,Kiribati,-3.3704,-168.734,3430,0,13,3417
12/16/22,Kiribati,-3.3704,-168.734,3430,0,13,3417
12/17/22,Kiribati,-3.3704,-168.734,3430,0,13,3417
1/1/22,"Korea, North",40.3399,127.5101,0,0,0,0
1/2/22,"Korea, North",40.3399,127.5101,0,0,0,0
1/3/22,"Korea, North",40.3399,127.5101,0,0,0,0
1/4/22,"Korea, North",40.3399,127.5101,0,0,0,0
1/5/22,"Korea, North",40.3399,127.5101,0,0,0,0
1/6/22,"Korea, North",40.3399,127.5101,0,0,0,0
1/7/22,"Korea, North",40.3399,127.5101,0,0,0,0
1/8/22,"Korea, North",40.3399,127.5101,0,0,0,0
1/9/22,"Korea, North",40.3399,127.5101,0,0,0,0
1/10/22,"Korea, North",40.3399,127.5101,0,0,0,0
1/11/22,"Korea, North",40.3399,127.5101,0,0,0,0
1/12/22,"Korea, North",40.3399,127.5101,0,0,0,0
1/13/22,"Korea, North",40.3399,127.5101,0,0,0,0
1/14/22,"Korea, North",40.3399,127.5101,0,0,0,0
1/15/22,"Korea, North",40.3399,127.5101,0,0,0,0
1/16/22,"Korea, North",40.3399,127.5101,0,0,0,0
1/17/22,"Korea, North",40.3399,127.5101,0,0,0,0
1/18/22,"Korea, North",40.3399,127.5101,0,0,0,0
1/19/22,"Korea, North",40.3399,127.5101,0,0,0,0
1/20/22,"Korea, North",40.3399,127.5101,0,0,0,0
1/21/22,"Korea, North",40.3399,127.5101,0,0,0,0
1/22/22,"Korea, North",40.3399,127.5101,0,0,0,0
1/23/22,"Korea, North",40.3399,127.5101,0,0,0,0
1/24/22,"Korea, North",40.3399,127.5101,0,0,0,0
1/25/22,"Korea, North",40.3399,127.5101,0,0,0,0
1/26/22,"Korea, North",40.3399,127.5101,0,0,0,0
1/27/22,"Korea, North",40.3399,127.5101,0,0,0,0
1/28/22,"Korea, North",40.3399,127.5101,0,0,0,0
1/29/22,"Korea, North",40.3399,127.5101,0,0,0,0
1/30/22,"Korea, North",40.3399,127.5101,0,0,0,0
1/31/22,"Korea, North",40.3399,127.5101,0,0,0,0
2/1/22,"Korea, North",40.3399,127.5101,0,0,0,0
2/2/22,"Korea, North",40.3399,127.5101,0,0,0,0
2/3/22,"Korea, North",40.3399,127.5101,0,0,0,0
2/4/22,"Korea, North",40.3399,127.5101,0,0,0,0
2/5/22,"Korea, North",40.3399,127.5101,0,0,0,0
2/6/22,"Korea, North",40.3399,127.5101,0,0,0,0
2/7/22,"Korea, North",40.3399,127.5101,0,0,0,0
2/8/22,"Korea, North",40.3399,127.5101,0,0,0,0
2/9/22,"Korea, North",40.3399,127.5101,0,0,0,0
2/10/22,"Korea, North",40.3399,127.5101,0,0,0,0
2/11/22,"Korea, North",40.3399,127.5101,0,0,0,0
2/12/22,"Korea, North",40.3399,127.5101,0,0,0,0
2/13/22,"Korea, North",40.3399,127.5101,0,0,0,0
2/14/22,"Korea, North",40.3399,127.5101,0,0,0,0
2/15/22,"Korea, North",40.3399,127.5101,0,0,0,0
2/16/22,"Korea, North",40.3399,127.5101,0,0,0,0
2/17/22,"Korea, North",40.3399,127.5101,0,0,0,0
2/18/22,"Korea, North",40.3399,127.5101,0,0,0,0
2/19/22,"Korea, North",40.3399,127.5101,0,0,0,0
2/20/22,"Korea, North",40.3399,127.5101,0,0,0,0
2/21/22,"Korea, North",40.3399,127.5101,0,0,0,0
2/22/22,"Korea, North",40.3399,127.5101,0,0,0,0
2/23/22,"Korea, North",40.3399,127.5101,0,0,0,0
2/24/22,"Korea, North",40.3399,127.5101,0,0,0,0
2/25/22,"Korea, North",40.3399,127.5101,0,0,0,0
2/26/22,"Korea, North",40.3399,127.5101,0,0,0,0
2/27/22,"Korea, North",40.3399,127.5101,0,0,0,0
2/28/22,"Korea, North",40.3399,127.5101,0,0,0,0
3/1/22,"Korea, North",40.3399,127.5101,0,0,0,0
3/2/22,"Korea, North",40.3399,127.5101,0,0,0,0
3/3/22,"Korea, North",40.3399,127.5101,0,0,0,0
3/4/22,"Korea, North",40.3399,127.5101,0,0,0,0
3/5/22,"Korea, North",40.3399,127.5101,0,0,0,0
3/6/22,"Korea, North",40.3399,127.5101,0,0,0,0
3/7/22,"Korea, North",40.3399,127.5101,0,0,0,0
3/8/22,"Korea, North",40.3399,127.5101,0,0,0,0
3/9/22,"Korea, North",40.3399,127.5101,0,0,0,0
3/10/22,"Korea, North",40.3399,127.5101,0,0,0,0
3/11/22,"Korea, North",40.3399,127.5101,0,0,0,0
3/12/22,"Korea, North",40.3399,127.5101,0,0,0,0
3/13/22,"Korea, North",40.3399,127.5101,0,0,0,0
3/14/22,"Korea, North",40.3399,127.5101,0,0,0,0
3/15/22,"Korea, North",40.3399,127.5101,0,0,0,0
3/16/22,"Korea, North",40.3399,127.5101,0,0,0,0
3/17/22,"Korea, North",40.3399,127.5101,0,0,0,0
3/18/22,"Korea, North",40.3399,127.5101,0,0,0,0
3/19/22,"Korea, North",40.3399,127.5101,0,0,0,0
3/20/22,"Korea, North",40.3399,127.5101,0,0,0,0
3/21/22,"Korea, North",40.3399,127.5101,0,0,0,0
3/22/22,"Korea, North",40.3399,127.5101,0,0,0,0
3/23/22,"Korea, North",40.3399,127.5101,0,0,0,0
3/24/22,"Korea, North",40.3399,127.5101,0,0,0,0
3/25/22,"Korea, North",40.3399,127.5101,0,0,0,0
3/26/22,"Korea, North",40.3399,127.5101,0,0,0,0
3/27/22,"Korea, North",40.3399,127.5101,0,0,0,0
3/28/22,"Korea, North",40.3399,127.5101,0,0,0,0
3/29/22,"Korea, North",40.3399,127.5101,0,0,0,0
3/30/22,"Korea, North",40.3399,127.5101,0,0,0,0
3/31/22,"Korea, North",40.3399,127.5101,0,0,0,0
4/1/22,"Korea, North",40.3399,127.5101,0,0,0,0
4/2/22,"Korea, North",40.3399,127.5101,0,0,0,0
4/3/22,"Korea, North",40.3399,127.5101,0,0,0,0
4/4/22,"Korea, North",40.3399,127.5101,0,0,0,0
4/5/22,"Korea, North",40.3399,127.5101,0,0,0,0
4/6/22,"Korea, North",40.3399,127.5101,0,0,0,0
4/7/22,"Korea, North",40.3399,127.5101,0,0,0,0
4/8/22,"Korea, North",40.3399,127.5101,0,0,0,0
4/9/22,"Korea, North",40.3399,127.5101,0,0,0,0
4/10/22,"Korea, North",40.3399,127.5101,0,0,0,0
4/11/22,"Korea, North",40.3399,127.5101,0,0,0,0
4/12/22,"Korea, North",40.3399,127.5101,0,0,0,0
4/13/22,"Korea, North",40.3399,127.5101,0,0,0,0
4/14/22,"Korea, North",40.3399,127.5101,0,0,0,0
4/15/22,"Korea, North",40.3399,127.5101,0,0,0,0
4/16/22,"Korea, North",40.3399,127.5101,0,0,0,0
4/17/22,"Korea, North",40.3399,127.5101,0,0,0,0
4/18/22,"Korea, North",40.3399,127.5101,0,0,0,0
4/19/22,"Korea, North",40.3399,127.5101,0,0,0,0
4/20/22,"Korea, North",40.3399,127.5101,0,0,0,0
4/21/22,"Korea, North",40.3399,127.5101,0,0,0,0
4/22/22,"Korea, North",40.3399,127.5101,0,0,0,0
4/23/22,"Korea, North",40.3399,127.5101,0,0,0,0
4/24/22,"Korea, North",40.3399,127.5101,0,0,0,0
4/25/22,"Korea, North",40.3399,127.5101,0,0,0,0
4/26/22,"Korea, North",40.3399,127.5101,0,0,0,0
4/27/22,"Korea, North",40.3399,127.5101,0,0,0,0
4/28/22,"Korea, North",40.3399,127.5101,0,0,0,0
4/29/22,"Korea, North",40.3399,127.5101,0,0,0,0
4/30/22,"Korea, North",40.3399,127.5101,0,0,0,0
5/1/22,"Korea, North",40.3399,127.5101,0,0,0,0
5/2/22,"Korea, North",40.3399,127.5101,0,0,0,0
5/3/22,"Korea, North",40.3399,127.5101,0,0,0,0
5/4/22,"Korea, North",40.3399,127.5101,0,0,0,0
5/5/22,"Korea, North",40.3399,127.5101,0,0,0,0
5/6/22,"Korea, North",40.3399,127.5101,0,0,0,0
5/7/22,"Korea, North",40.3399,127.5101,0,0,0,0
5/8/22,"Korea, North",40.3399,127.5101,0,0,0,0
5/9/22,"Korea, North",40.3399,127.5101,0,0,0,0
5/10/22,"Korea, North",40.3399,127.5101,0,0,0,0
5/11/22,"Korea, North",40.3399,127.5101,0,0,0,0
5/12/22,"Korea, North",40.3399,127.5101,0,0,0,0
5/13/22,"Korea, North",40.3399,127.5101,0,0,0,0
5/14/22,"Korea, North",40.3399,127.5101,1,0,6,-5
5/15/22,"Korea, North",40.3399,127.5101,1,0,6,-5
5/16/22,"Korea, North",40.3399,127.5101,1,0,6,-5
5/17/22,"Korea, North",40.3399,127.5101,1,0,6,-5
5/18/22,"Korea, North",40.3399,127.5101,1,0,6,-5
5/19/22,"Korea, North",40.3399,127.5101,1,0,6,-5
5/20/22,"Korea, North",40.3399,127.5101,1,0,6,-5
5/21/22,"Korea, North",40.3399,127.5101,1,0,6,-5
5/22/22,"Korea, North",40.3399,127.5101,1,0,6,-5
5/23/22,"Korea, North",40.3399,127.5101,1,0,6,-5
5/24/22,"Korea, North",40.3399,127.5101,1,0,6,-5
5/25/22,"Korea, North",40.3399,127.5101,1,0,6,-5
5/26/22,"Korea, North",40.3399,127.5101,1,0,6,-5
5/27/22,"Korea, North",40.3399,127.5101,1,0,6,-5
5/28/22,"Korea, North",40.3399,127.5101,1,0,6,-5
5/29/22,"Korea, North",40.3399,127.5101,1,0,6,-5
5/30/22,"Korea, North",40.3399,127.5101,1,0,6,-5
5/31/22,"Korea, North",40.3399,127.5101,1,0,6,-5
6/1/22,"Korea, North",40.3399,127.5101,1,0,6,-5
6/2/22,"Korea, North",40.3399,127.5101,1,0,6,-5
6/3/22,"Korea, North",40.3399,127.5101,1,0,6,-5
6/4/22,"Korea, North",40.3399,127.5101,1,0,6,-5
6/5/22,"Korea, North",40.3399,127.5101,1,0,6,-5
6/6/22,"Korea, North",40.3399,127.5101,1,0,6,-5
6/7/22,"Korea, North",40.3399,127.5101,1,0,6,-5
6/8/22,"Korea, North",40.3399,127.5101,1,0,6,-5
6/9/22,"Korea, North",40.3399,127.5101,1,0,6,-5
6/10/22,"Korea, North",40.3399,127.5101,1,0,6,-5
6/11/22,"Korea, North",40.3399,127.5101,1,0,6,-5
6/12/22,"Korea, North",40.3399,127.5101,1,0,6,-5
6/13/22,"Korea, North",40.3399,127.5101,1,0,6,-5
6/14/22,"Korea, North",40.3399,127.5101,1,0,6,-5
6/15/22,"Korea, North",40.3399,127.5101,1,0,6,-5
6/16/22,"Korea, North",40.3399,127.5101,1,0,6,-5
6/17/22,"Korea, North",40.3399,127.5101,1,0,6,-5
6/18/22,"Korea, North",40.3399,127.5101,1,0,6,-5
6/19/22,"Korea, North",40.3399,127.5101,1,0,6,-5
6/20/22,"Korea, North",40.3399,127.5101,1,0,6,-5
6/21/22,"Korea, North",40.3399,127.5101,1,0,6,-5
6/22/22,"Korea, North",40.3399,127.5101,1,0,6,-5
6/23/22,"Korea, North",40.3399,127.5101,1,0,6,-5
6/24/22,"Korea, North",40.3399,127.5101,1,0,6,-5
6/25/22,"Korea, North",40.3399,127.5101,1,0,6,-5
6/26/22,"Korea, North",40.3399,127.5101,1,0,6,-5
6/27/22,"Korea, North",40.3399,127.5101,1,0,6,-5
6/28/22,"Korea, North",40.3399,127.5101,1,0,6,-5
6/29/22,"Korea, North",40.3399,127.5101,1,0,6,-5
6/30/22,"Korea, North",40.3399,127.5101,1,0,6,-5
7/1/22,"Korea, North",40.3399,127.5101,1,0,6,-5
7/2/22,"Korea, North",40.3399,127.5101,1,0,6,-5
7/3/22,"Korea, North",40.3399,127.5101,1,0,6,-5
7/4/22,"Korea, North",40.3399,127.5101,1,0,6,-5
7/5/22,"Korea, North",40.3399,127.5101,1,0,6,-5
7/6/22,"Korea, North",40.3399,127.5101,1,0,6,-5
7/7/22,"Korea, North",40.3399,127.5101,1,0,6,-5
7/8/22,"Korea, North",40.3399,127.5101,1,0,6,-5
7/9/22,"Korea, North",40.3399,127.5101,1,0,6,-5
7/10/22,"Korea, North",40.3399,127.5101,1,0,6,-5
7/11/22,"Korea, North",40.3399,127.5101,1,0,6,-5
7/12/22,"Korea, North",40.3399,127.5101,1,0,6,-5
7/13/22,"Korea, North",40.3399,127.5101,1,0,6,-5
7/14/22,"Korea, North",40.3399,127.5101,1,0,6,-5
7/15/22,"Korea, North",40.3399,127.5101,1,0,6,-5
7/16/22,"Korea, North",40.3399,127.5101,1,0,6,-5
7/17/22,"Korea, North",40.3399,127.5101,1,0,6,-5
7/18/22,"Korea, North",40.3399,127.5101,1,0,6,-5
7/19/22,"Korea, North",40.3399,127.5101,1,0,6,-5
7/20/22,"Korea, North",40.3399,127.5101,1,0,6,-5
7/21/22,"Korea, North",40.3399,127.5101,1,0,6,-5
7/22/22,"Korea, North",40.3399,127.5101,1,0,6,-5
7/23/22,"Korea, North",40.3399,127.5101,1,0,6,-5
7/24/22,"Korea, North",40.3399,127.5101,1,0,6,-5
7/25/22,"Korea, North",40.3399,127.5101,1,0,6,-5
7/26/22,"Korea, North",40.3399,127.5101,1,0,6,-5
7/27/22,"Korea, North",40.3399,127.5101,1,0,6,-5
7/28/22,"Korea, North",40.3399,127.5101,1,0,6,-5
7/29/22,"Korea, North",40.3399,127.5101,1,0,6,-5
7/30/22,"Korea, North",40.3399,127.5101,1,0,6,-5
7/31/22,"Korea, North",40.3399,127.5101,1,0,6,-5
8/1/22,"Korea, North",40.3399,127.5101,1,0,6,-5
8/2/22,"Korea, North",40.3399,127.5101,1,0,6,-5
8/3/22,"Korea, North",40.3399,127.5101,1,0,6,-5
8/4/22,"Korea, North",40.3399,127.5101,1,0,6,-5
8/5/22,"Korea, North",40.3399,127.5101,1,0,6,-5
8/6/22,"Korea, North",40.3399,127.5101,1,0,6,-5
8/7/22,"Korea, North",40.3399,127.5101,1,0,6,-5
8/8/22,"Korea, North",40.3399,127.5101,1,0,6,-5
8/9/22,"Korea, North",40.3399,127.5101,1,0,6,-5
8/10/22,"Korea, North",40.3399,127.5101,1,0,6,-5
8/11/22,"Korea, North",40.3399,127.5101,1,0,6,-5
8/12/22,"Korea, North",40.3399,127.5101,1,0,6,-5
8/13/22,"Korea, North",40.3399,127.5101,1,0,6,-5
8/14/22,"Korea, North",40.3399,127.5101,1,0,6,-5
8/15/22,"Korea, North",40.3399,127.5101,1,0,6,-5
8/16/22,"Korea, North",40.3399,127.5101,1,0,6,-5
8/17/22,"Korea, North",40.3399,127.5101,1,0,6,-5
8/18/22,"Korea, North",40.3399,127.5101,1,0,6,-5
8/19/22,"Korea, North",40.3399,127.5101,1,0,6,-5
8/20/22,"Korea, North",40.3399,127.5101,1,0,6,-5
8/21/22,"Korea, North",40.3399,127.5101,1,0,6,-5
8/22/22,"Korea, North",40.3399,127.5101,1,0,6,-5
8/23/22,"Korea, North",40.3399,127.5101,1,0,6,-5
8/24/22,"Korea, North",40.3399,127.5101,1,0,6,-5
8/25/22,"Korea, North",40.3399,127.5101,1,0,6,-5
8/26/22,"Korea, North",40.3399,127.5101,1,0,6,-5
8/27/22,"Korea, North",40.3399,127.5101,1,0,6,-5
8/28/22,"Korea, North",40.3399,127.5101,1,0,6,-5
8/29/22,"Korea, North",40.3399,127.5101,1,0,6,-5
8/30/22,"Korea, North",40.3399,127.5101,1,0,6,-5
8/31/22,"Korea, North",40.3399,127.5101,1,0,6,-5
9/1/22,"Korea, North",40.3399,127.5101,1,0,6,-5
9/2/22,"Korea, North",40.3399,127.5101,1,0,6,-5
9/3/22,"Korea, North",40.3399,127.5101,1,0,6,-5
9/4/22,"Korea, North",40.3399,127.5101,1,0,6,-5
9/5/22,"Korea, North",40.3399,127.5101,1,0,6,-5
9/6/22,"Korea, North",40.3399,127.5101,1,0,6,-5
9/7/22,"Korea, North",40.3399,127.5101,1,0,6,-5
9/8/22,"Korea, North",40.3399,127.5101,1,0,6,-5
9/9/22,"Korea, North",40.3399,127.5101,1,0,6,-5
9/10/22,"Korea, North",40.3399,127.5101,1,0,6,-5
9/11/22,"Korea, North",40.3399,127.5101,1,0,6,-5
9/12/22,"Korea, North",40.3399,127.5101,1,0,6,-5
9/13/22,"Korea, North",40.3399,127.5101,1,0,6,-5
9/14/22,"Korea, North",40.3399,127.5101,1,0,6,-5
9/15/22,"Korea, North",40.3399,127.5101,1,0,6,-5
9/16/22,"Korea, North",40.3399,127.5101,1,0,6,-5
9/17/22,"Korea, North",40.3399,127.5101,1,0,6,-5
9/18/22,"Korea, North",40.3399,127.5101,1,0,6,-5
9/19/22,"Korea, North",40.3399,127.5101,1,0,6,-5
9/20/22,"Korea, North",40.3399,127.5101,1,0,6,-5
9/21/22,"Korea, North",40.3399,127.5101,1,0,6,-5
9/22/22,"Korea, North",40.3399,127.5101,1,0,6,-5
9/23/22,"Korea, North",40.3399,127.5101,1,0,6,-5
9/24/22,"Korea, North",40.3399,127.5101,1,0,6,-5
9/25/22,"Korea, North",40.3399,127.5101,1,0,6,-5
9/26/22,"Korea, North",40.3399,127.5101,1,0,6,-5
9/27/22,"Korea, North",40.3399,127.5101,1,0,6,-5
9/28/22,"Korea, North",40.3399,127.5101,1,0,6,-5
9/29/22,"Korea, North",40.3399,127.5101,1,0,6,-5
9/30/22,"Korea, North",40.3399,127.5101,1,0,6,-5
10/1/22,"Korea, North",40.3399,127.5101,1,0,6,-5
10/2/22,"Korea, North",40.3399,127.5101,1,0,6,-5
10/3/22,"Korea, North",40.3399,127.5101,1,0,6,-5
10/4/22,"Korea, North",40.3399,127.5101,1,0,6,-5
10/5/22,"Korea, North",40.3399,127.5101,1,0,6,-5
10/6/22,"Korea, North",40.3399,127.5101,1,0,6,-5
10/7/22,"Korea, North",40.3399,127.5101,1,0,6,-5
10/8/22,"Korea, North",40.3399,127.5101,1,0,6,-5
10/9/22,"Korea, North",40.3399,127.5101,1,0,6,-5
10/10/22,"Korea, North",40.3399,127.5101,1,0,6,-5
10/11/22,"Korea, North",40.3399,127.5101,1,0,6,-5
10/12/22,"Korea, North",40.3399,127.5101,1,0,6,-5
10/13/22,"Korea, North",40.3399,127.5101,1,0,6,-5
10/14/22,"Korea, North",40.3399,127.5101,1,0,6,-5
10/15/22,"Korea, North",40.3399,127.5101,1,0,6,-5
10/16/22,"Korea, North",40.3399,127.5101,1,0,6,-5
10/17/22,"Korea, North",40.3399,127.5101,1,0,6,-5
10/18/22,"Korea, North",40.3399,127.5101,1,0,6,-5
10/19/22,"Korea, North",40.3399,127.5101,1,0,6,-5
10/20/22,"Korea, North",40.3399,127.5101,1,0,6,-5
10/21/22,"Korea, North",40.3399,127.5101,1,0,6,-5
10/22/22,"Korea, North",40.3399,127.5101,1,0,6,-5
10/23/22,"Korea, North",40.3399,127.5101,1,0,6,-5
10/24/22,"Korea, North",40.3399,127.5101,1,0,6,-5
10/25/22,"Korea, North",40.3399,127.5101,1,0,6,-5
10/26/22,"Korea, North",40.3399,127.5101,1,0,6,-5
10/27/22,"Korea, North",40.3399,127.5101,1,0,6,-5
10/28/22,"Korea, North",40.3399,127.5101,1,0,6,-5
10/29/22,"Korea, North",40.3399,127.5101,1,0,6,-5
10/30/22,"Korea, North",40.3399,127.5101,1,0,6,-5
10/31/22,"Korea, North",40.3399,127.5101,1,0,6,-5
11/1/22,"Korea, North",40.3399,127.5101,1,0,6,-5
11/2/22,"Korea, North",40.3399,127.5101,1,0,6,-5
11/3/22,"Korea, North",40.3399,127.5101,1,0,6,-5
11/4/22,"Korea, North",40.3399,127.5101,1,0,6,-5
11/5/22,"Korea, North",40.3399,127.5101,1,0,6,-5
11/6/22,"Korea, North",40.3399,127.5101,1,0,6,-5
11/7/22,"Korea, North",40.3399,127.5101,1,0,6,-5
11/8/22,"Korea, North",40.3399,127.5101,1,0,6,-5
11/9/22,"Korea, North",40.3399,127.5101,1,0,6,-5
11/10/22,"Korea, North",40.3399,127.5101,1,0,6,-5
11/11/22,"Korea, North",40.3399,127.5101,1,0,6,-5
11/12/22,"Korea, North",40.3399,127.5101,1,0,6,-5
11/13/22,"Korea, North",40.3399,127.5101,1,0,6,-5
11/14/22,"Korea, North",40.3399,127.5101,1,0,6,-5
11/15/22,"Korea, North",40.3399,127.5101,1,0,6,-5
11/16/22,"Korea, North",40.3399,127.5101,1,0,6,-5
11/17/22,"Korea, North",40.3399,127.5101,1,0,6,-5
11/18/22,"Korea, North",40.3399,127.5101,1,0,6,-5
11/19/22,"Korea, North",40.3399,127.5101,1,0,6,-5
11/20/22,"Korea, North",40.3399,127.5101,1,0,6,-5
11/21/22,"Korea, North",40.3399,127.5101,1,0,6,-5
11/22/22,"Korea, North",40.3399,127.5101,1,0,6,-5
11/23/22,"Korea, North",40.3399,127.5101,1,0,6,-5
11/24/22,"Korea, North",40.3399,127.5101,1,0,6,-5
11/25/22,"Korea, North",40.3399,127.5101,1,0,6,-5
11/26/22,"Korea, North",40.3399,127.5101,1,0,6,-5
11/27/22,"Korea, North",40.3399,127.5101,1,0,6,-5
11/28/22,"Korea, North",40.3399,127.5101,1,0,6,-5
11/29/22,"Korea, North",40.3399,127.5101,1,0,6,-5
11/30/22,"Korea, North",40.3399,127.5101,1,0,6,-5
12/1/22,"Korea, North",40.3399,127.5101,1,0,6,-5
12/2/22,"Korea, North",40.3399,127.5101,1,0,6,-5
12/3/22,"Korea, North",40.3399,127.5101,1,0,6,-5
12/4/22,"Korea, North",40.3399,127.5101,1,0,6,-5
12/5/22,"Korea, North",40.3399,127.5101,1,0,6,-5
12/6/22,"Korea, North",40.3399,127.5101,1,0,6,-5
12/7/22,"Korea, North",40.3399,127.5101,1,0,6,-5
12/8/22,"Korea, North",40.3399,127.5101,1,0,6,-5
12/9/22,"Korea, North",40.3399,127.5101,1,0,6,-5
12/10/22,"Korea, North",40.3399,127.5101,1,0,6,-5
12/11/22,"Korea, North",40.3399,127.5101,1,0,6,-5
12/12/22,"Korea, North",40.3399,127.5101,1,0,6,-5
12/13/22,"Korea, North",40.3399,127.5101,1,0,6,-5
12/14/22,"Korea, North",40.3399,127.5101,1,0,6,-5
12/15/22,"Korea, North",40.3399,127.5101,1,0,6,-5
12/16/22,"Korea, North",40.3399,127.5101,1,0,6,-5
12/17/22,"Korea, North",40.3399,127.5101,1,0,6,-5
1/1/22,Kosovo,42.602636,20.902977,161531,0,2991,158540
1/2/22,Kosovo,42.602636,20.902977,161560,0,2991,158569
1/3/22,Kosovo,42.602636,20.902977,161598,0,2991,158607
1/4/22,Kosovo,42.602636,20.902977,161706,0,2991,158715
1/5/22,Kosovo,42.602636,20.902977,161813,0,2991,158822
1/6/22,Kosovo,42.602636,20.902977,161965,0,2991,158974
1/7/22,Kosovo,42.602636,20.902977,162109,0,2991,159118
1/8/22,Kosovo,42.602636,20.902977,162373,0,2991,159382
1/9/22,Kosovo,42.602636,20.902977,162677,0,2991,159686
1/10/22,Kosovo,42.602636,20.902977,162913,0,2991,159922
1/11/22,Kosovo,42.602636,20.902977,163269,0,2991,160278
1/12/22,Kosovo,42.602636,20.902977,163693,0,2992,160701
1/13/22,Kosovo,42.602636,20.902977,164120,0,2994,161126
1/14/22,Kosovo,42.602636,20.902977,164705,0,2994,161711
1/15/22,Kosovo,42.602636,20.902977,165363,0,2994,162369
1/16/22,Kosovo,42.602636,20.902977,166134,0,2994,163140
1/17/22,Kosovo,42.602636,20.902977,166862,0,2994,163868
1/18/22,Kosovo,42.602636,20.902977,167582,0,2995,164587
1/19/22,Kosovo,42.602636,20.902977,169632,0,2995,166637
1/20/22,Kosovo,42.602636,20.902977,172340,0,2996,169344
1/21/22,Kosovo,42.602636,20.902977,175283,0,2997,172286
1/22/22,Kosovo,42.602636,20.902977,178489,0,2997,175492
1/23/22,Kosovo,42.602636,20.902977,181446,0,2998,178448
1/24/22,Kosovo,42.602636,20.902977,183689,0,3000,180689
1/25/22,Kosovo,42.602636,20.902977,186396,0,3002,183394
1/26/22,Kosovo,42.602636,20.902977,190793,0,3002,187791
1/27/22,Kosovo,42.602636,20.902977,194710,0,3008,191702
1/28/22,Kosovo,42.602636,20.902977,198327,0,3012,195315
1/29/22,Kosovo,42.602636,20.902977,201955,0,3012,198943
1/30/22,Kosovo,42.602636,20.902977,204345,0,3012,201333
1/31/22,Kosovo,42.602636,20.902977,205938,0,3015,202923
2/1/22,Kosovo,42.602636,20.902977,207971,0,3021,204950
2/2/22,Kosovo,42.602636,20.902977,210561,0,3027,207534
2/3/22,Kosovo,42.602636,20.902977,212671,0,3032,209639
2/4/22,Kosovo,42.602636,20.902977,214524,0,3033,211491
2/5/22,Kosovo,42.602636,20.902977,216245,0,3037,213208
2/6/22,Kosovo,42.602636,20.902977,217528,0,3043,214485
2/7/22,Kosovo,42.602636,20.902977,218282,0,3051,215231
2/8/22,Kosovo,42.602636,20.902977,219069,0,3053,216016
2/9/22,Kosovo,42.602636,20.902977,220209,0,3058,217151
2/10/22,Kosovo,42.602636,20.902977,220926,0,3062,217864
2/11/22,Kosovo,42.602636,20.902977,221696,0,3064,218632
2/12/22,Kosovo,42.602636,20.902977,222339,0,3068,219271
2/13/22,Kosovo,42.602636,20.902977,222941,0,3074,219867
2/14/22,Kosovo,42.602636,20.902977,223188,0,3076,220112
2/15/22,Kosovo,42.602636,20.902977,223561,0,3078,220483
2/16/22,Kosovo,42.602636,20.902977,224069,0,3081,220988
2/17/22,Kosovo,42.602636,20.902977,224480,0,3086,221394
2/18/22,Kosovo,42.602636,20.902977,224716,0,3090,221626
2/19/22,Kosovo,42.602636,20.902977,224965,0,3098,221867
2/20/22,Kosovo,42.602636,20.902977,225148,0,3100,222048
2/21/22,Kosovo,42.602636,20.902977,225249,0,3101,222148
2/22/22,Kosovo,42.602636,20.902977,225407,0,3102,222305
2/23/22,Kosovo,42.602636,20.902977,225664,0,3105,222559
2/24/22,Kosovo,42.602636,20.902977,225853,0,3108,222745
2/25/22,Kosovo,42.602636,20.902977,225993,0,3111,222882
2/26/22,Kosovo,42.602636,20.902977,226112,0,3112,223000
2/27/22,Kosovo,42.602636,20.902977,226193,0,3113,223080
2/28/22,Kosovo,42.602636,20.902977,226248,0,3114,223134
3/1/22,Kosovo,42.602636,20.902977,226309,0,3115,223194
3/2/22,Kosovo,42.602636,20.902977,226392,0,3116,223276
3/3/22,Kosovo,42.602636,20.902977,226461,0,3116,223345
3/4/22,Kosovo,42.602636,20.902977,226513,0,3117,223396
3/5/22,Kosovo,42.602636,20.902977,226579,0,3117,223462
3/6/22,Kosovo,42.602636,20.902977,226625,0,3118,223507
3/7/22,Kosovo,42.602636,20.902977,226648,0,3119,223529
3/8/22,Kosovo,42.602636,20.902977,226680,0,3120,223560
3/9/22,Kosovo,42.602636,20.902977,226729,0,3122,223607
3/10/22,Kosovo,42.602636,20.902977,226766,0,3123,223643
3/11/22,Kosovo,42.602636,20.902977,226813,0,3124,223689
3/12/22,Kosovo,42.602636,20.902977,226845,0,3124,223721
3/13/22,Kosovo,42.602636,20.902977,226877,0,3126,223751
3/14/22,Kosovo,42.602636,20.902977,226895,0,3126,223769
3/15/22,Kosovo,42.602636,20.902977,226917,0,3126,223791
3/16/22,Kosovo,42.602636,20.902977,226968,0,3127,223841
3/17/22,Kosovo,42.602636,20.902977,227001,0,3127,223874
3/18/22,Kosovo,42.602636,20.902977,227057,0,3127,223930
3/19/22,Kosovo,42.602636,20.902977,227093,0,3127,223966
3/20/22,Kosovo,42.602636,20.902977,227124,0,3127,223997
3/21/22,Kosovo,42.602636,20.902977,227150,0,3127,224023
3/22/22,Kosovo,42.602636,20.902977,227191,0,3130,224061
3/23/22,Kosovo,42.602636,20.902977,227231,0,3130,224101
3/24/22,Kosovo,42.602636,20.902977,227265,0,3130,224135
3/25/22,Kosovo,42.602636,20.902977,227296,0,3130,224166
3/26/22,Kosovo,42.602636,20.902977,227324,0,3130,224194
3/27/22,Kosovo,42.602636,20.902977,227361,0,3130,224231
3/28/22,Kosovo,42.602636,20.902977,227377,0,3132,224245
3/29/22,Kosovo,42.602636,20.902977,227409,0,3132,224277
3/30/22,Kosovo,42.602636,20.902977,227439,0,3132,224307
3/31/22,Kosovo,42.602636,20.902977,227471,0,3134,224337
4/1/22,Kosovo,42.602636,20.902977,227497,0,3135,224362
4/2/22,Kosovo,42.602636,20.902977,227533,0,3136,224397
4/3/22,Kosovo,42.602636,20.902977,227533,0,3136,224397
4/4/22,Kosovo,42.602636,20.902977,227579,0,3137,224442
4/5/22,Kosovo,42.602636,20.902977,227599,0,3137,224462
4/6/22,Kosovo,42.602636,20.902977,227628,0,3137,224491
4/7/22,Kosovo,42.602636,20.902977,227655,0,3137,224518
4/8/22,Kosovo,42.602636,20.902977,227681,0,3137,224544
4/9/22,Kosovo,42.602636,20.902977,227709,0,3138,224571
4/10/22,Kosovo,42.602636,20.902977,227743,0,3138,224605
4/11/22,Kosovo,42.602636,20.902977,227757,0,3138,224619
4/12/22,Kosovo,42.602636,20.902977,227766,0,3138,224628
4/13/22,Kosovo,42.602636,20.902977,227789,0,3138,224651
4/14/22,Kosovo,42.602636,20.902977,227803,0,3138,224665
4/15/22,Kosovo,42.602636,20.902977,227825,0,3138,224687
4/16/22,Kosovo,42.602636,20.902977,227838,0,3138,224700
4/17/22,Kosovo,42.602636,20.902977,227861,0,3138,224723
4/18/22,Kosovo,42.602636,20.902977,227877,0,3138,224739
4/19/22,Kosovo,42.602636,20.902977,227880,0,3138,224742
4/20/22,Kosovo,42.602636,20.902977,227902,0,3138,224764
4/21/22,Kosovo,42.602636,20.902977,227921,0,3138,224783
4/22/22,Kosovo,42.602636,20.902977,227935,0,3138,224797
4/23/22,Kosovo,42.602636,20.902977,227953,0,3138,224815
4/24/22,Kosovo,42.602636,20.902977,227976,0,3138,224838
4/25/22,Kosovo,42.602636,20.902977,227984,0,3138,224846
4/26/22,Kosovo,42.602636,20.902977,227991,0,3138,224853
4/27/22,Kosovo,42.602636,20.902977,228004,0,3138,224866
4/28/22,Kosovo,42.602636,20.902977,228023,0,3138,224885
4/29/22,Kosovo,42.602636,20.902977,228052,0,3138,224914
4/30/22,Kosovo,42.602636,20.902977,228073,0,3138,224935
5/1/22,Kosovo,42.602636,20.902977,228083,0,3138,224945
5/2/22,Kosovo,42.602636,20.902977,228094,0,3138,224956
5/3/22,Kosovo,42.602636,20.902977,228098,0,3138,224960
5/4/22,Kosovo,42.602636,20.902977,228101,0,3138,224963
5/5/22,Kosovo,42.602636,20.902977,228117,0,3138,224979
5/6/22,Kosovo,42.602636,20.902977,228128,0,3138,224990
5/7/22,Kosovo,42.602636,20.902977,228138,0,3138,225000
5/8/22,Kosovo,42.602636,20.902977,228144,0,3138,225006
5/9/22,Kosovo,42.602636,20.902977,228146,0,3138,225008
5/10/22,Kosovo,42.602636,20.902977,228150,0,3138,225012
5/11/22,Kosovo,42.602636,20.902977,228164,0,3139,225025
5/12/22,Kosovo,42.602636,20.902977,228186,0,3139,225047
5/13/22,Kosovo,42.602636,20.902977,228207,0,3139,225068
5/14/22,Kosovo,42.602636,20.902977,228218,0,3139,225079
5/15/22,Kosovo,42.602636,20.902977,228234,0,3139,225095
5/16/22,Kosovo,42.602636,20.902977,228241,0,3139,225102
5/17/22,Kosovo,42.602636,20.902977,228245,0,3139,225106
5/18/22,Kosovo,42.602636,20.902977,228261,0,3139,225122
5/19/22,Kosovo,42.602636,20.902977,228273,0,3139,225134
5/20/22,Kosovo,42.602636,20.902977,228287,0,3139,225148
5/21/22,Kosovo,42.602636,20.902977,228299,0,3139,225160
5/22/22,Kosovo,42.602636,20.902977,228308,0,3139,225169
5/23/22,Kosovo,42.602636,20.902977,228309,0,3139,225170
5/24/22,Kosovo,42.602636,20.902977,228321,0,3139,225182
5/25/22,Kosovo,42.602636,20.902977,228329,0,3139,225190
5/26/22,Kosovo,42.602636,20.902977,228338,0,3139,225199
5/27/22,Kosovo,42.602636,20.902977,228342,0,3139,225203
5/28/22,Kosovo,42.602636,20.902977,228348,0,3139,225209
5/29/22,Kosovo,42.602636,20.902977,228348,0,3139,225209
5/30/22,Kosovo,42.602636,20.902977,228353,0,3139,225214
5/31/22,Kosovo,42.602636,20.902977,228359,0,3139,225220
6/1/22,Kosovo,42.602636,20.902977,228373,0,3139,225234
6/2/22,Kosovo,42.602636,20.902977,228378,0,3139,225239
6/3/22,Kosovo,42.602636,20.902977,228387,0,3139,225248
6/4/22,Kosovo,42.602636,20.902977,228393,0,3139,225254
6/5/22,Kosovo,42.602636,20.902977,228397,0,3139,225258
6/6/22,Kosovo,42.602636,20.902977,228397,0,3139,225258
6/7/22,Kosovo,42.602636,20.902977,228397,0,3139,225258
6/8/22,Kosovo,42.602636,20.902977,228407,0,3139,225268
6/9/22,Kosovo,42.602636,20.902977,228412,0,3139,225273
6/10/22,Kosovo,42.602636,20.902977,228420,0,3139,225281
6/11/22,Kosovo,42.602636,20.902977,228430,0,3139,225291
6/12/22,Kosovo,42.602636,20.902977,228438,0,3139,225299
6/13/22,Kosovo,42.602636,20.902977,228442,0,3139,225303
6/14/22,Kosovo,42.602636,20.902977,228450,0,3139,225311
6/15/22,Kosovo,42.602636,20.902977,228465,0,3139,225326
6/16/22,Kosovo,42.602636,20.902977,228482,0,3139,225343
6/17/22,Kosovo,42.602636,20.902977,228507,0,3139,225368
6/18/22,Kosovo,42.602636,20.902977,228523,0,3140,225383
6/19/22,Kosovo,42.602636,20.902977,228540,0,3140,225400
6/20/22,Kosovo,42.602636,20.902977,228550,0,3140,225410
6/21/22,Kosovo,42.602636,20.902977,228563,0,3140,225423
6/22/22,Kosovo,42.602636,20.902977,228606,0,3140,225466
6/23/22,Kosovo,42.602636,20.902977,228635,0,3140,225495
6/24/22,Kosovo,42.602636,20.902977,228673,0,3140,225533
6/25/22,Kosovo,42.602636,20.902977,228673,0,3140,225533
6/26/22,Kosovo,42.602636,20.902977,228673,0,3140,225533
6/27/22,Kosovo,42.602636,20.902977,228809,0,3140,225669
6/28/22,Kosovo,42.602636,20.902977,228873,0,3140,225733
6/29/22,Kosovo,42.602636,20.902977,229050,0,3140,225910
6/30/22,Kosovo,42.602636,20.902977,229199,0,3140,226059
7/1/22,Kosovo,42.602636,20.902977,229366,0,3140,226226
7/2/22,Kosovo,42.602636,20.902977,229571,0,3140,226431
7/3/22,Kosovo,42.602636,20.902977,229571,0,3140,226431
7/4/22,Kosovo,42.602636,20.902977,229841,0,3140,226701
7/5/22,Kosovo,42.602636,20.902977,230054,0,3140,226914
7/6/22,Kosovo,42.602636,20.902977,230395,0,3140,227255
7/7/22,Kosovo,42.602636,20.902977,230653,0,3140,227513
7/8/22,Kosovo,42.602636,20.902977,231060,0,3140,227920
7/9/22,Kosovo,42.602636,20.902977,231060,0,3140,227920
7/10/22,Kosovo,42.602636,20.902977,231742,0,3143,228599
7/11/22,Kosovo,42.602636,20.902977,231852,0,3143,228709
7/12/22,Kosovo,42.602636,20.902977,232027,0,3145,228882
7/13/22,Kosovo,42.602636,20.902977,232790,0,3146,229644
7/14/22,Kosovo,42.602636,20.902977,233661,0,3146,230515
7/15/22,Kosovo,42.602636,20.902977,234880,0,3146,231734
7/16/22,Kosovo,42.602636,20.902977,235964,0,3147,232817
7/17/22,Kosovo,42.602636,20.902977,236816,0,3148,233668
7/18/22,Kosovo,42.602636,20.902977,237431,0,3150,234281
7/19/22,Kosovo,42.602636,20.902977,238273,0,3151,235122
7/20/22,Kosovo,42.602636,20.902977,240066,0,3153,236913
7/21/22,Kosovo,42.602636,20.902977,241506,0,3155,238351
7/22/22,Kosovo,42.602636,20.902977,242896,0,3156,239740
7/23/22,Kosovo,42.602636,20.902977,244297,0,3160,241137
7/24/22,Kosovo,42.602636,20.902977,245275,0,3163,242112
7/25/22,Kosovo,42.602636,20.902977,245857,0,3164,242693
7/26/22,Kosovo,42.602636,20.902977,247044,0,3164,243880
7/27/22,Kosovo,42.602636,20.902977,248897,0,3167,245730
7/28/22,Kosovo,42.602636,20.902977,250500,0,3169,247331
7/29/22,Kosovo,42.602636,20.902977,251980,0,3169,248811
7/30/22,Kosovo,42.602636,20.902977,253312,0,3170,250142
7/31/22,Kosovo,42.602636,20.902977,254230,0,3171,251059
8/1/22,Kosovo,42.602636,20.902977,254743,0,3171,251572
8/2/22,Kosovo,42.602636,20.902977,255773,0,3171,252602
8/3/22,Kosovo,42.602636,20.902977,257335,0,3173,254162
8/4/22,Kosovo,42.602636,20.902977,258490,0,3174,255316
8/5/22,Kosovo,42.602636,20.902977,259756,0,3174,256582
8/6/22,Kosovo,42.602636,20.902977,260686,0,3175,257511
8/7/22,Kosovo,42.602636,20.902977,261304,0,3176,258128
8/8/22,Kosovo,42.602636,20.902977,261635,0,3178,258457
8/9/22,Kosovo,42.602636,20.902977,262587,0,3180,259407
8/10/22,Kosovo,42.602636,20.902977,263784,0,3180,260604
8/11/22,Kosovo,42.602636,20.902977,264564,0,3181,261383
8/12/22,Kosovo,42.602636,20.902977,265424,0,3182,262242
8/13/22,Kosovo,42.602636,20.902977,266293,0,3184,263109
8/14/22,Kosovo,42.602636,20.902977,266686,0,3184,263502
8/15/22,Kosovo,42.602636,20.902977,266960,0,3184,263776
8/16/22,Kosovo,42.602636,20.902977,267373,0,3184,264189
8/17/22,Kosovo,42.602636,20.902977,268156,0,3186,264970
8/18/22,Kosovo,42.602636,20.902977,268639,0,3187,265452
8/19/22,Kosovo,42.602636,20.902977,269158,0,3188,265970
8/20/22,Kosovo,42.602636,20.902977,269461,0,3189,266272
8/21/22,Kosovo,42.602636,20.902977,269685,0,3191,266494
8/22/22,Kosovo,42.602636,20.902977,269888,0,3191,266697
8/23/22,Kosovo,42.602636,20.902977,270143,0,3191,266952
8/24/22,Kosovo,42.602636,20.902977,270506,0,3191,267315
8/25/22,Kosovo,42.602636,20.902977,270709,0,3191,267518
8/26/22,Kosovo,42.602636,20.902977,270897,0,3191,267706
8/27/22,Kosovo,42.602636,20.902977,271063,0,3192,267871
8/28/22,Kosovo,42.602636,20.902977,271152,0,3194,267958
8/29/22,Kosovo,42.602636,20.902977,271194,0,3194,268000
8/30/22,Kosovo,42.602636,20.902977,271285,0,3194,268091
8/31/22,Kosovo,42.602636,20.902977,271476,0,3196,268280
9/1/22,Kosovo,42.602636,20.902977,271540,0,3197,268343
9/2/22,Kosovo,42.602636,20.902977,271607,0,3197,268410
9/3/22,Kosovo,42.602636,20.902977,271680,0,3198,268482
9/4/22,Kosovo,42.602636,20.902977,271729,0,3198,268531
9/5/22,Kosovo,42.602636,20.902977,271750,0,3199,268551
9/6/22,Kosovo,42.602636,20.902977,271750,0,3199,268551
9/7/22,Kosovo,42.602636,20.902977,271830,0,3199,268631
9/8/22,Kosovo,42.602636,20.902977,271855,0,3199,268656
9/9/22,Kosovo,42.602636,20.902977,271897,0,3199,268698
9/10/22,Kosovo,42.602636,20.902977,271922,0,3199,268723
9/11/22,Kosovo,42.602636,20.902977,271928,0,3199,268729
9/12/22,Kosovo,42.602636,20.902977,271932,0,3199,268733
9/13/22,Kosovo,42.602636,20.902977,271945,0,3199,268746
9/14/22,Kosovo,42.602636,20.902977,271964,0,3199,268765
9/15/22,Kosovo,42.602636,20.902977,271974,0,3199,268775
9/16/22,Kosovo,42.602636,20.902977,271989,0,3199,268790
9/17/22,Kosovo,42.602636,20.902977,271991,0,3199,268792
9/18/22,Kosovo,42.602636,20.902977,271998,0,3199,268799
9/19/22,Kosovo,42.602636,20.902977,272001,0,3199,268802
9/20/22,Kosovo,42.602636,20.902977,272005,0,3199,268806
9/21/22,Kosovo,42.602636,20.902977,272015,0,3199,268816
9/22/22,Kosovo,42.602636,20.902977,272025,0,3199,268826
9/23/22,Kosovo,42.602636,20.902977,272040,0,3199,268841
9/24/22,Kosovo,42.602636,20.902977,272043,0,3199,268844
9/25/22,Kosovo,42.602636,20.902977,272044,0,3199,268845
9/26/22,Kosovo,42.602636,20.902977,272045,0,3199,268846
9/27/22,Kosovo,42.602636,20.902977,272051,0,3199,268852
9/28/22,Kosovo,42.602636,20.902977,272052,0,3199,268853
9/29/22,Kosovo,42.602636,20.902977,272058,0,3199,268859
9/30/22,Kosovo,42.602636,20.902977,272067,0,3199,268868
10/1/22,Kosovo,42.602636,20.902977,272075,0,3199,268876
10/2/22,Kosovo,42.602636,20.902977,272078,0,3199,268879
10/3/22,Kosovo,42.602636,20.902977,272078,0,3200,268878
10/4/22,Kosovo,42.602636,20.902977,272079,0,3200,268879
10/5/22,Kosovo,42.602636,20.902977,272083,0,3200,268883
10/6/22,Kosovo,42.602636,20.902977,272086,0,3200,268886
10/7/22,Kosovo,42.602636,20.902977,272088,0,3200,268888
10/8/22,Kosovo,42.602636,20.902977,272089,0,3200,268889
10/9/22,Kosovo,42.602636,20.902977,272093,0,3200,268893
10/10/22,Kosovo,42.602636,20.902977,272097,0,3200,268897
10/11/22,Kosovo,42.602636,20.902977,272100,0,3200,268900
10/12/22,Kosovo,42.602636,20.902977,272108,0,3200,268908
10/13/22,Kosovo,42.602636,20.902977,272113,0,3200,268913
10/14/22,Kosovo,42.602636,20.902977,272117,0,3200,268917
10/15/22,Kosovo,42.602636,20.902977,272119,0,3200,268919
10/16/22,Kosovo,42.602636,20.902977,272120,0,3200,268920
10/17/22,Kosovo,42.602636,20.902977,272124,0,3201,268923
10/18/22,Kosovo,42.602636,20.902977,272125,0,3201,268924
10/19/22,Kosovo,42.602636,20.902977,272129,0,3201,268928
10/20/22,Kosovo,42.602636,20.902977,272131,0,3201,268930
10/21/22,Kosovo,42.602636,20.902977,272136,0,3201,268935
10/22/22,Kosovo,42.602636,20.902977,272138,0,3201,268937
10/23/22,Kosovo,42.602636,20.902977,272139,0,3201,268938
10/24/22,Kosovo,42.602636,20.902977,272143,0,3201,268942
10/25/22,Kosovo,42.602636,20.902977,272149,0,3202,268947
10/26/22,Kosovo,42.602636,20.902977,272152,0,3202,268950
10/27/22,Kosovo,42.602636,20.902977,272153,0,3202,268951
10/28/22,Kosovo,42.602636,20.902977,272156,0,3202,268954
10/29/22,Kosovo,42.602636,20.902977,272160,0,3202,268958
10/30/22,Kosovo,42.602636,20.902977,272160,0,3202,268958
10/31/22,Kosovo,42.602636,20.902977,272161,0,3202,268959
11/1/22,Kosovo,42.602636,20.902977,272162,0,3202,268960
11/2/22,Kosovo,42.602636,20.902977,272167,0,3202,268965
11/3/22,Kosovo,42.602636,20.902977,272174,0,3202,268972
11/4/22,Kosovo,42.602636,20.902977,272174,0,3202,268972
11/5/22,Kosovo,42.602636,20.902977,272179,0,3202,268977
11/6/22,Kosovo,42.602636,20.902977,272180,0,3202,268978
11/7/22,Kosovo,42.602636,20.902977,272183,0,3202,268981
11/8/22,Kosovo,42.602636,20.902977,272183,0,3202,268981
11/9/22,Kosovo,42.602636,20.902977,272186,0,3202,268984
11/10/22,Kosovo,42.602636,20.902977,272189,0,3202,268987
11/11/22,Kosovo,42.602636,20.902977,272192,0,3202,268990
11/12/22,Kosovo,42.602636,20.902977,272194,0,3202,268992
11/13/22,Kosovo,42.602636,20.902977,272195,0,3202,268993
11/14/22,Kosovo,42.602636,20.902977,272195,0,3202,268993
11/15/22,Kosovo,42.602636,20.902977,272195,0,3202,268993
11/16/22,Kosovo,42.602636,20.902977,272195,0,3202,268993
11/17/22,Kosovo,42.602636,20.902977,272195,0,3202,268993
11/18/22,Kosovo,42.602636,20.902977,272196,0,3202,268994
11/19/22,Kosovo,42.602636,20.902977,272197,0,3202,268995
11/20/22,Kosovo,42.602636,20.902977,272197,0,3202,268995
11/21/22,Kosovo,42.602636,20.902977,272197,0,3202,268995
11/22/22,Kosovo,42.602636,20.902977,272198,0,3202,268996
11/23/22,Kosovo,42.602636,20.902977,272203,0,3202,269001
11/24/22,Kosovo,42.602636,20.902977,272204,0,3202,269002
11/25/22,Kosovo,42.602636,20.902977,272206,0,3202,269004
11/26/22,Kosovo,42.602636,20.902977,272206,0,3202,269004
11/27/22,Kosovo,42.602636,20.902977,272208,0,3202,269006
11/28/22,Kosovo,42.602636,20.902977,272208,0,3202,269006
11/29/22,Kosovo,42.602636,20.902977,272209,0,3202,269007
11/30/22,Kosovo,42.602636,20.902977,272209,0,3202,269007
12/1/22,Kosovo,42.602636,20.902977,272209,0,3202,269007
12/2/22,Kosovo,42.602636,20.902977,272211,0,3202,269009
12/3/22,Kosovo,42.602636,20.902977,272213,0,3202,269011
12/4/22,Kosovo,42.602636,20.902977,272213,0,3202,269011
12/5/22,Kosovo,42.602636,20.902977,272214,0,3202,269012
12/6/22,Kosovo,42.602636,20.902977,272214,0,3202,269012
12/7/22,Kosovo,42.602636,20.902977,272216,0,3202,269014
12/8/22,Kosovo,42.602636,20.902977,272216,0,3202,269014
12/9/22,Kosovo,42.602636,20.902977,272216,0,3202,269014
12/10/22,Kosovo,42.602636,20.902977,272217,0,3202,269015
12/11/22,Kosovo,42.602636,20.902977,272218,0,3202,269016
12/12/22,Kosovo,42.602636,20.902977,272219,0,3202,269017
12/13/22,Kosovo,42.602636,20.902977,272219,0,3202,269017
12/14/22,Kosovo,42.602636,20.902977,272222,0,3202,269020
12/15/22,Kosovo,42.602636,20.902977,272226,0,3202,269024
12/16/22,Kosovo,42.602636,20.902977,272228,0,3202,269026
12/17/22,Kosovo,42.602636,20.902977,272230,0,3202,269028
1/1/22,Kuwait,29.31166,47.481766,417723,0,2468,415255
1/2/22,Kuwait,29.31166,47.481766,418332,0,2468,415864
1/3/22,Kuwait,29.31166,47.481766,419314,0,2468,416846
1/4/22,Kuwait,29.31166,47.481766,420796,0,2468,418328
1/5/22,Kuwait,29.31166,47.481766,423042,0,2469,420573
1/6/22,Kuwait,29.31166,47.481766,425455,0,2469,422986
1/7/22,Kuwait,29.31166,47.481766,428100,0,2469,425631
1/8/22,Kuwait,29.31166,47.481766,430920,0,2471,428449
1/9/22,Kuwait,29.31166,47.481766,433919,0,2471,431448
1/10/22,Kuwait,29.31166,47.481766,437602,0,2472,435130
1/11/22,Kuwait,29.31166,47.481766,441999,0,2473,439526
1/12/22,Kuwait,29.31166,47.481766,446547,0,2473,444074
1/13/22,Kuwait,29.31166,47.481766,451430,0,2474,448956
1/14/22,Kuwait,29.31166,47.481766,456311,0,2474,453837
1/15/22,Kuwait,29.31166,47.481766,460828,0,2475,458353
1/16/22,Kuwait,29.31166,47.481766,465331,0,2476,462855
1/17/22,Kuwait,29.31166,47.481766,470478,0,2477,468001
1/18/22,Kuwait,29.31166,47.481766,475303,0,2479,472824
1/19/22,Kuwait,29.31166,47.481766,479640,0,2480,477160
1/20/22,Kuwait,29.31166,47.481766,484150,0,2482,481668
1/21/22,Kuwait,29.31166,47.481766,488959,0,2483,486476
1/22/22,Kuwait,29.31166,47.481766,493107,0,2485,490622
1/23/22,Kuwait,29.31166,47.481766,497454,0,2486,494968
1/24/22,Kuwait,29.31166,47.481766,502630,0,2487,500143
1/25/22,Kuwait,29.31166,47.481766,508372,0,2488,505884
1/26/22,Kuwait,29.31166,47.481766,514826,0,2489,512337
1/27/22,Kuwait,29.31166,47.481766,521341,0,2490,518851
1/28/22,Kuwait,29.31166,47.481766,528254,0,2492,525762
1/29/22,Kuwait,29.31166,47.481766,534062,0,2494,531568
1/30/22,Kuwait,29.31166,47.481766,539654,0,2496,537158
1/31/22,Kuwait,29.31166,47.481766,545717,0,2497,543220
2/1/22,Kuwait,29.31166,47.481766,552153,0,2499,549654
2/2/22,Kuwait,29.31166,47.481766,558745,0,2501,556244
2/3/22,Kuwait,29.31166,47.481766,564735,0,2503,562232
2/4/22,Kuwait,29.31166,47.481766,570142,0,2505,567637
2/5/22,Kuwait,29.31166,47.481766,574587,0,2508,572079
2/6/22,Kuwait,29.31166,47.481766,578819,0,2510,576309
2/7/22,Kuwait,29.31166,47.481766,583113,0,2511,580602
2/8/22,Kuwait,29.31166,47.481766,587102,0,2513,584589
2/9/22,Kuwait,29.31166,47.481766,590565,0,2514,588051
2/10/22,Kuwait,29.31166,47.481766,593889,0,2517,591372
2/11/22,Kuwait,29.31166,47.481766,596785,0,2518,594267
2/12/22,Kuwait,29.31166,47.481766,599039,0,2519,596520
2/13/22,Kuwait,29.31166,47.481766,601307,0,2520,598787
2/14/22,Kuwait,29.31166,47.481766,603869,0,2521,601348
2/15/22,Kuwait,29.31166,47.481766,606035,0,2522,603513
2/16/22,Kuwait,29.31166,47.481766,607952,0,2524,605428
2/17/22,Kuwait,29.31166,47.481766,609453,0,2525,606928
2/18/22,Kuwait,29.31166,47.481766,610801,0,2527,608274
2/19/22,Kuwait,29.31166,47.481766,611820,0,2528,609292
2/20/22,Kuwait,29.31166,47.481766,613015,0,2529,610486
2/21/22,Kuwait,29.31166,47.481766,614344,0,2530,611814
2/22/22,Kuwait,29.31166,47.481766,615397,0,2531,612866
2/23/22,Kuwait,29.31166,47.481766,616409,0,2533,613876
2/24/22,Kuwait,29.31166,47.481766,617275,0,2534,614741
2/25/22,Kuwait,29.31166,47.481766,618121,0,2535,615586
2/26/22,Kuwait,29.31166,47.481766,618703,0,2536,616167
2/27/22,Kuwait,29.31166,47.481766,619310,0,2537,616773
2/28/22,Kuwait,29.31166,47.481766,619894,0,2538,617356
3/1/22,Kuwait,29.31166,47.481766,620452,0,2539,617913
3/2/22,Kuwait,29.31166,47.481766,620980,0,2540,618440
3/3/22,Kuwait,29.31166,47.481766,621466,0,2541,618925
3/4/22,Kuwait,29.31166,47.481766,621965,0,2543,619422
3/5/22,Kuwait,29.31166,47.481766,622489,0,2544,619945
3/6/22,Kuwait,29.31166,47.481766,623159,0,2545,620614
3/7/22,Kuwait,29.31166,47.481766,623769,0,2546,621223
3/8/22,Kuwait,29.31166,47.481766,624205,0,2548,621657
3/9/22,Kuwait,29.31166,47.481766,624573,0,2549,622024
3/10/22,Kuwait,29.31166,47.481766,624922,0,2549,622373
3/11/22,Kuwait,29.31166,47.481766,625202,0,2549,622653
3/12/22,Kuwait,29.31166,47.481766,625461,0,2550,622911
3/13/22,Kuwait,29.31166,47.481766,625461,0,2550,622911
3/14/22,Kuwait,29.31166,47.481766,626114,0,2552,623562
3/15/22,Kuwait,29.31166,47.481766,626384,0,2552,623832
3/16/22,Kuwait,29.31166,47.481766,626609,0,2552,624057
3/17/22,Kuwait,29.31166,47.481766,626609,0,2552,624057
3/18/22,Kuwait,29.31166,47.481766,626993,0,2553,624440
3/19/22,Kuwait,29.31166,47.481766,627143,0,2553,624590
3/20/22,Kuwait,29.31166,47.481766,627342,0,2553,624789
3/21/22,Kuwait,29.31166,47.481766,627584,0,2553,625031
3/22/22,Kuwait,29.31166,47.481766,627753,0,2553,625200
3/23/22,Kuwait,29.31166,47.481766,627753,0,2553,625200
3/24/22,Kuwait,29.31166,47.481766,628130,0,2553,625577
3/25/22,Kuwait,29.31166,47.481766,628130,0,2553,625577
3/26/22,Kuwait,29.31166,47.481766,628130,0,2553,625577
3/27/22,Kuwait,29.31166,47.481766,628130,0,2553,625577
3/28/22,Kuwait,29.31166,47.481766,628460,0,2553,625907
3/29/22,Kuwait,29.31166,47.481766,628978,0,2554,626424
3/30/22,Kuwait,29.31166,47.481766,628978,0,2554,626424
3/31/22,Kuwait,29.31166,47.481766,628978,0,2554,626424
4/1/22,Kuwait,29.31166,47.481766,628978,0,2554,626424
4/2/22,Kuwait,29.31166,47.481766,628978,0,2554,626424
4/3/22,Kuwait,29.31166,47.481766,629525,0,2554,626971
4/4/22,Kuwait,29.31166,47.481766,629525,0,2554,626971
4/5/22,Kuwait,29.31166,47.481766,629525,0,2554,626971
4/6/22,Kuwait,29.31166,47.481766,629525,0,2554,626971
4/7/22,Kuwait,29.31166,47.481766,629912,0,2555,627357
4/8/22,Kuwait,29.31166,47.481766,630252,0,2555,627697
4/9/22,Kuwait,29.31166,47.481766,630252,0,2555,627697
4/10/22,Kuwait,29.31166,47.481766,630252,0,2555,627697
4/11/22,Kuwait,29.31166,47.481766,630252,0,2555,627697
4/12/22,Kuwait,29.31166,47.481766,630641,0,2555,628086
4/13/22,Kuwait,29.31166,47.481766,630641,0,2555,628086
4/14/22,Kuwait,29.31166,47.481766,630641,0,2555,628086
4/15/22,Kuwait,29.31166,47.481766,630641,0,2555,628086
4/16/22,Kuwait,29.31166,47.481766,630888,0,2555,628333
4/17/22,Kuwait,29.31166,47.481766,630888,0,2555,628333
4/18/22,Kuwait,29.31166,47.481766,630888,0,2555,628333
4/19/22,Kuwait,29.31166,47.481766,631058,0,2555,628503
4/20/22,Kuwait,29.31166,47.481766,631076,0,2555,628521
4/21/22,Kuwait,29.31166,47.481766,631076,0,2555,628521
4/22/22,Kuwait,29.31166,47.481766,631076,0,2555,628521
4/23/22,Kuwait,29.31166,47.481766,631294,0,2555,628739
4/24/22,Kuwait,29.31166,47.481766,631294,0,2555,628739
4/25/22,Kuwait,29.31166,47.481766,631294,0,2555,628739
4/26/22,Kuwait,29.31166,47.481766,631409,0,2555,628854
4/27/22,Kuwait,29.31166,47.481766,631409,0,2555,628854
4/28/22,Kuwait,29.31166,47.481766,631409,0,2555,628854
4/29/22,Kuwait,29.31166,47.481766,631409,0,2555,628854
4/30/22,Kuwait,29.31166,47.481766,631409,0,2555,628854
5/1/22,Kuwait,29.31166,47.481766,631409,0,2555,628854
5/2/22,Kuwait,29.31166,47.481766,631409,0,2555,628854
5/3/22,Kuwait,29.31166,47.481766,631409,0,2555,628854
5/4/22,Kuwait,29.31166,47.481766,631409,0,2555,628854
5/5/22,Kuwait,29.31166,47.481766,631409,0,2555,628854
5/6/22,Kuwait,29.31166,47.481766,631701,0,2555,629146
5/7/22,Kuwait,29.31166,47.481766,631701,0,2555,629146
5/8/22,Kuwait,29.31166,47.481766,631898,0,2555,629343
5/9/22,Kuwait,29.31166,47.481766,631898,0,2555,629343
5/10/22,Kuwait,29.31166,47.481766,631898,0,2555,629343
5/11/22,Kuwait,29.31166,47.481766,632074,0,2555,629519
5/12/22,Kuwait,29.31166,47.481766,632074,0,2555,629519
5/13/22,Kuwait,29.31166,47.481766,632074,0,2555,629519
5/14/22,Kuwait,29.31166,47.481766,632074,0,2555,629519
5/15/22,Kuwait,29.31166,47.481766,632074,0,2555,629519
5/16/22,Kuwait,29.31166,47.481766,632074,0,2555,629519
5/17/22,Kuwait,29.31166,47.481766,632074,0,2555,629519
5/18/22,Kuwait,29.31166,47.481766,632474,0,2555,629919
5/19/22,Kuwait,29.31166,47.481766,632474,0,2555,629919
5/20/22,Kuwait,29.31166,47.481766,632474,0,2555,629919
5/21/22,Kuwait,29.31166,47.481766,632474,0,2555,629919
5/22/22,Kuwait,29.31166,47.481766,632781,0,2555,630226
5/23/22,Kuwait,29.31166,47.481766,632781,0,2555,630226
5/24/22,Kuwait,29.31166,47.481766,632781,0,2555,630226
5/25/22,Kuwait,29.31166,47.481766,632781,0,2555,630226
5/26/22,Kuwait,29.31166,47.481766,632781,0,2555,630226
5/27/22,Kuwait,29.31166,47.481766,632781,0,2555,630226
5/28/22,Kuwait,29.31166,47.481766,632781,0,2555,630226
5/29/22,Kuwait,29.31166,47.481766,632781,0,2555,630226
5/30/22,Kuwait,29.31166,47.481766,633225,0,2555,630670
5/31/22,Kuwait,29.31166,47.481766,633225,0,2555,630670
6/1/22,Kuwait,29.31166,47.481766,633225,0,2555,630670
6/2/22,Kuwait,29.31166,47.481766,633225,0,2555,630670
6/3/22,Kuwait,29.31166,47.481766,633225,0,2555,630670
6/4/22,Kuwait,29.31166,47.481766,633225,0,2555,630670
6/5/22,Kuwait,29.31166,47.481766,634067,0,2555,631512
6/6/22,Kuwait,29.31166,47.481766,634067,0,2555,631512
6/7/22,Kuwait,29.31166,47.481766,634537,0,2555,631982
6/8/22,Kuwait,29.31166,47.481766,634537,0,2555,631982
6/9/22,Kuwait,29.31166,47.481766,635045,0,2555,632490
6/10/22,Kuwait,29.31166,47.481766,635045,0,2555,632490
6/11/22,Kuwait,29.31166,47.481766,635868,0,2555,633313
6/12/22,Kuwait,29.31166,47.481766,636240,0,2555,633685
6/13/22,Kuwait,29.31166,47.481766,636240,0,2555,633685
6/14/22,Kuwait,29.31166,47.481766,637061,0,2555,634506
6/15/22,Kuwait,29.31166,47.481766,637470,0,2555,634915
6/16/22,Kuwait,29.31166,47.481766,637470,0,2555,634915
6/17/22,Kuwait,29.31166,47.481766,638327,0,2555,635772
6/18/22,Kuwait,29.31166,47.481766,638708,0,2555,636153
6/19/22,Kuwait,29.31166,47.481766,638708,0,2555,636153
6/20/22,Kuwait,29.31166,47.481766,639290,0,2555,636735
6/21/22,Kuwait,29.31166,47.481766,639290,0,2555,636735
6/22/22,Kuwait,29.31166,47.481766,640857,0,2555,638302
6/23/22,Kuwait,29.31166,47.481766,640857,0,2555,638302
6/24/22,Kuwait,29.31166,47.481766,641678,0,2555,639123
6/25/22,Kuwait,29.31166,47.481766,641985,0,2555,639430
6/26/22,Kuwait,29.31166,47.481766,641985,0,2555,639430
6/27/22,Kuwait,29.31166,47.481766,643004,0,2555,640449
6/28/22,Kuwait,29.31166,47.481766,643004,0,2555,640449
6/29/22,Kuwait,29.31166,47.481766,643004,0,2555,640449
6/30/22,Kuwait,29.31166,47.481766,643004,0,2555,640449
7/1/22,Kuwait,29.31166,47.481766,644451,0,2555,641896
7/2/22,Kuwait,29.31166,47.481766,644451,0,2555,641896
7/3/22,Kuwait,29.31166,47.481766,644451,0,2555,641896
7/4/22,Kuwait,29.31166,47.481766,644451,0,2555,641896
7/5/22,Kuwait,29.31166,47.481766,646098,0,2556,643542
7/6/22,Kuwait,29.31166,47.481766,646098,0,2556,643542
7/7/22,Kuwait,29.31166,47.481766,646098,0,2556,643542
7/8/22,Kuwait,29.31166,47.481766,646098,0,2556,643542
7/9/22,Kuwait,29.31166,47.481766,646098,0,2556,643542
7/10/22,Kuwait,29.31166,47.481766,648216,0,2556,645660
7/11/22,Kuwait,29.31166,47.481766,648216,0,2556,645660
7/12/22,Kuwait,29.31166,47.481766,648216,0,2556,645660
7/13/22,Kuwait,29.31166,47.481766,648216,0,2556,645660
7/14/22,Kuwait,29.31166,47.481766,648216,0,2556,645660
7/15/22,Kuwait,29.31166,47.481766,648216,0,2556,645660
7/16/22,Kuwait,29.31166,47.481766,648216,0,2556,645660
7/17/22,Kuwait,29.31166,47.481766,648216,0,2556,645660
7/18/22,Kuwait,29.31166,47.481766,648216,0,2556,645660
7/19/22,Kuwait,29.31166,47.481766,648216,0,2556,645660
7/20/22,Kuwait,29.31166,47.481766,648216,0,2556,645660
7/21/22,Kuwait,29.31166,47.481766,648216,0,2556,645660
7/22/22,Kuwait,29.31166,47.481766,652541,0,2559,649982
7/23/22,Kuwait,29.31166,47.481766,653020,0,2559,650461
7/24/22,Kuwait,29.31166,47.481766,653020,0,2559,650461
7/25/22,Kuwait,29.31166,47.481766,653020,0,2559,650461
7/26/22,Kuwait,29.31166,47.481766,653730,0,2559,651171
7/27/22,Kuwait,29.31166,47.481766,653730,0,2559,651171
7/28/22,Kuwait,29.31166,47.481766,653730,0,2559,651171
7/29/22,Kuwait,29.31166,47.481766,653730,0,2559,651171
7/30/22,Kuwait,29.31166,47.481766,653730,0,2559,651171
7/31/22,Kuwait,29.31166,47.481766,653730,0,2559,651171
8/1/22,Kuwait,29.31166,47.481766,653730,0,2559,651171
8/2/22,Kuwait,29.31166,47.481766,653730,0,2559,651171
8/3/22,Kuwait,29.31166,47.481766,653730,0,2559,651171
8/4/22,Kuwait,29.31166,47.481766,653730,0,2559,651171
8/5/22,Kuwait,29.31166,47.481766,653730,0,2559,651171
8/6/22,Kuwait,29.31166,47.481766,654814,0,2562,652252
8/7/22,Kuwait,29.31166,47.481766,655854,0,2562,653292
8/8/22,Kuwait,29.31166,47.481766,655854,0,2562,653292
8/9/22,Kuwait,29.31166,47.481766,655854,0,2562,653292
8/10/22,Kuwait,29.31166,47.481766,655854,0,2562,653292
8/11/22,Kuwait,29.31166,47.481766,655854,0,2562,653292
8/12/22,Kuwait,29.31166,47.481766,655854,0,2562,653292
8/13/22,Kuwait,29.31166,47.481766,655854,0,2562,653292
8/14/22,Kuwait,29.31166,47.481766,656393,0,2562,653831
8/15/22,Kuwait,29.31166,47.481766,656393,0,2562,653831
8/16/22,Kuwait,29.31166,47.481766,656393,0,2562,653831
8/17/22,Kuwait,29.31166,47.481766,656393,0,2562,653831
8/18/22,Kuwait,29.31166,47.481766,656393,0,2562,653831
8/19/22,Kuwait,29.31166,47.481766,656393,0,2562,653831
8/20/22,Kuwait,29.31166,47.481766,656393,0,2562,653831
8/21/22,Kuwait,29.31166,47.481766,657042,0,2563,654479
8/22/22,Kuwait,29.31166,47.481766,657042,0,2563,654479
8/23/22,Kuwait,29.31166,47.481766,657042,0,2563,654479
8/24/22,Kuwait,29.31166,47.481766,657042,0,2563,654479
8/25/22,Kuwait,29.31166,47.481766,657042,0,2563,654479
8/26/22,Kuwait,29.31166,47.481766,657042,0,2563,654479
8/27/22,Kuwait,29.31166,47.481766,657042,0,2563,654479
8/28/22,Kuwait,29.31166,47.481766,657042,0,2563,654479
8/29/22,Kuwait,29.31166,47.481766,657395,0,2563,654832
8/30/22,Kuwait,29.31166,47.481766,657395,0,2563,654832
8/31/22,Kuwait,29.31166,47.481766,657395,0,2563,654832
9/1/22,Kuwait,29.31166,47.481766,657395,0,2563,654832
9/2/22,Kuwait,29.31166,47.481766,657395,0,2563,654832
9/3/22,Kuwait,29.31166,47.481766,657395,0,2563,654832
9/4/22,Kuwait,29.31166,47.481766,657395,0,2563,654832
9/5/22,Kuwait,29.31166,47.481766,657395,0,2563,654832
9/6/22,Kuwait,29.31166,47.481766,657745,0,2563,655182
9/7/22,Kuwait,29.31166,47.481766,657745,0,2563,655182
9/8/22,Kuwait,29.31166,47.481766,657745,0,2563,655182
9/9/22,Kuwait,29.31166,47.481766,657745,0,2563,655182
9/10/22,Kuwait,29.31166,47.481766,657745,0,2563,655182
9/11/22,Kuwait,29.31166,47.481766,657745,0,2563,655182
9/12/22,Kuwait,29.31166,47.481766,657745,0,2563,655182
9/13/22,Kuwait,29.31166,47.481766,657745,0,2563,655182
9/14/22,Kuwait,29.31166,47.481766,657745,0,2563,655182
9/15/22,Kuwait,29.31166,47.481766,657745,0,2563,655182
9/16/22,Kuwait,29.31166,47.481766,657745,0,2563,655182
9/17/22,Kuwait,29.31166,47.481766,657745,0,2563,655182
9/18/22,Kuwait,29.31166,47.481766,657745,0,2563,655182
9/19/22,Kuwait,29.31166,47.481766,657745,0,2563,655182
9/20/22,Kuwait,29.31166,47.481766,657745,0,2563,655182
9/21/22,Kuwait,29.31166,47.481766,658520,0,2563,655957
9/22/22,Kuwait,29.31166,47.481766,658520,0,2563,655957
9/23/22,Kuwait,29.31166,47.481766,658520,0,2563,655957
9/24/22,Kuwait,29.31166,47.481766,658520,0,2563,655957
9/25/22,Kuwait,29.31166,47.481766,658520,0,2563,655957
9/26/22,Kuwait,29.31166,47.481766,658520,0,2563,655957
9/27/22,Kuwait,29.31166,47.481766,658520,0,2563,655957
9/28/22,Kuwait,29.31166,47.481766,658520,0,2563,655957
9/29/22,Kuwait,29.31166,47.481766,658520,0,2563,655957
9/30/22,Kuwait,29.31166,47.481766,658520,0,2563,655957
10/1/22,Kuwait,29.31166,47.481766,658520,0,2563,655957
10/2/22,Kuwait,29.31166,47.481766,658520,0,2563,655957
10/3/22,Kuwait,29.31166,47.481766,658520,0,2563,655957
10/4/22,Kuwait,29.31166,47.481766,658520,0,2563,655957
10/5/22,Kuwait,29.31166,47.481766,658520,0,2563,655957
10/6/22,Kuwait,29.31166,47.481766,658520,0,2563,655957
10/7/22,Kuwait,29.31166,47.481766,658520,0,2563,655957
10/8/22,Kuwait,29.31166,47.481766,658520,0,2563,655957
10/9/22,Kuwait,29.31166,47.481766,660667,0,2564,658103
10/10/22,Kuwait,29.31166,47.481766,660667,0,2564,658103
10/11/22,Kuwait,29.31166,47.481766,660667,0,2564,658103
10/12/22,Kuwait,29.31166,47.481766,660667,0,2564,658103
10/13/22,Kuwait,29.31166,47.481766,660667,0,2564,658103
10/14/22,Kuwait,29.31166,47.481766,660667,0,2564,658103
10/15/22,Kuwait,29.31166,47.481766,660667,0,2564,658103
10/16/22,Kuwait,29.31166,47.481766,660667,0,2564,658103
10/17/22,Kuwait,29.31166,47.481766,661335,0,2565,658770
10/18/22,Kuwait,29.31166,47.481766,661335,0,2565,658770
10/19/22,Kuwait,29.31166,47.481766,661335,0,2565,658770
10/20/22,Kuwait,29.31166,47.481766,661335,0,2565,658770
10/21/22,Kuwait,29.31166,47.481766,661335,0,2565,658770
10/22/22,Kuwait,29.31166,47.481766,661335,0,2565,658770
10/23/22,Kuwait,29.31166,47.481766,661787,0,2566,659221
10/24/22,Kuwait,29.31166,47.481766,661787,0,2566,659221
10/25/22,Kuwait,29.31166,47.481766,661787,0,2566,659221
10/26/22,Kuwait,29.31166,47.481766,661787,0,2566,659221
10/27/22,Kuwait,29.31166,47.481766,661787,0,2566,659221
10/28/22,Kuwait,29.31166,47.481766,661787,0,2566,659221
10/29/22,Kuwait,29.31166,47.481766,662073,0,2568,659505
10/30/22,Kuwait,29.31166,47.481766,662073,0,2568,659505
10/31/22,Kuwait,29.31166,47.481766,662073,0,2568,659505
11/1/22,Kuwait,29.31166,47.481766,662073,0,2568,659505
11/2/22,Kuwait,29.31166,47.481766,662073,0,2568,659505
11/3/22,Kuwait,29.31166,47.481766,662073,0,2568,659505
11/4/22,Kuwait,29.31166,47.481766,662073,0,2568,659505
11/5/22,Kuwait,29.31166,47.481766,662073,0,2568,659505
11/6/22,Kuwait,29.31166,47.481766,662073,0,2568,659505
11/7/22,Kuwait,29.31166,47.481766,662359,0,2569,659790
11/8/22,Kuwait,29.31166,47.481766,662359,0,2569,659790
11/9/22,Kuwait,29.31166,47.481766,662359,0,2569,659790
11/10/22,Kuwait,29.31166,47.481766,662359,0,2569,659790
11/11/22,Kuwait,29.31166,47.481766,662359,0,2569,659790
11/12/22,Kuwait,29.31166,47.481766,662359,0,2569,659790
11/13/22,Kuwait,29.31166,47.481766,662359,0,2569,659790
11/14/22,Kuwait,29.31166,47.481766,662510,0,2569,659941
11/15/22,Kuwait,29.31166,47.481766,662510,0,2569,659941
11/16/22,Kuwait,29.31166,47.481766,662510,0,2569,659941
11/17/22,Kuwait,29.31166,47.481766,662510,0,2569,659941
11/18/22,Kuwait,29.31166,47.481766,662510,0,2569,659941
11/19/22,Kuwait,29.31166,47.481766,662510,0,2569,659941
11/20/22,Kuwait,29.31166,47.481766,662510,0,2569,659941
11/21/22,Kuwait,29.31166,47.481766,662617,0,2569,660048
11/22/22,Kuwait,29.31166,47.481766,662617,0,2569,660048
11/23/22,Kuwait,29.31166,47.481766,662617,0,2569,660048
11/24/22,Kuwait,29.31166,47.481766,662617,0,2569,660048
11/25/22,Kuwait,29.31166,47.481766,662617,0,2569,660048
11/26/22,Kuwait,29.31166,47.481766,662672,0,2570,660102
11/27/22,Kuwait,29.31166,47.481766,662672,0,2570,660102
11/28/22,Kuwait,29.31166,47.481766,662672,0,2570,660102
11/29/22,Kuwait,29.31166,47.481766,662672,0,2570,660102
11/30/22,Kuwait,29.31166,47.481766,662672,0,2570,660102
12/1/22,Kuwait,29.31166,47.481766,662672,0,2570,660102
12/2/22,Kuwait,29.31166,47.481766,662672,0,2570,660102
12/3/22,Kuwait,29.31166,47.481766,662747,0,2570,660177
12/4/22,Kuwait,29.31166,47.481766,662747,0,2570,660177
12/5/22,Kuwait,29.31166,47.481766,662747,0,2570,660177
12/6/22,Kuwait,29.31166,47.481766,662747,0,2570,660177
12/7/22,Kuwait,29.31166,47.481766,662747,0,2570,660177
12/8/22,Kuwait,29.31166,47.481766,662747,0,2570,660177
12/9/22,Kuwait,29.31166,47.481766,662747,0,2570,660177
12/10/22,Kuwait,29.31166,47.481766,662747,0,2570,660177
12/11/22,Kuwait,29.31166,47.481766,662747,0,2570,660177
12/12/22,Kuwait,29.31166,47.481766,662747,0,2570,660177
12/13/22,Kuwait,29.31166,47.481766,662747,0,2570,660177
12/14/22,Kuwait,29.31166,47.481766,662747,0,2570,660177
12/15/22,Kuwait,29.31166,47.481766,662747,0,2570,660177
12/16/22,Kuwait,29.31166,47.481766,662747,0,2570,660177
12/17/22,Kuwait,29.31166,47.481766,662747,0,2570,660177
1/1/22,Kyrgyzstan,41.20438,74.766098,184748,0,2802,181946
1/2/22,Kyrgyzstan,41.20438,74.766098,184786,0,2804,181982
1/3/22,Kyrgyzstan,41.20438,74.766098,184827,0,2805,182022
1/4/22,Kyrgyzstan,41.20438,74.766098,184879,0,2807,182072
1/5/22,Kyrgyzstan,41.20438,74.766098,185031,0,2809,182222
1/6/22,Kyrgyzstan,41.20438,74.766098,185237,0,2811,182426
1/7/22,Kyrgyzstan,41.20438,74.766098,185484,0,2814,182670
1/8/22,Kyrgyzstan,41.20438,74.766098,185677,0,2816,182861
1/9/22,Kyrgyzstan,41.20438,74.766098,185867,0,2818,183049
1/10/22,Kyrgyzstan,41.20438,74.766098,186065,0,2819,183246
1/11/22,Kyrgyzstan,41.20438,74.766098,186878,0,2823,184055
1/12/22,Kyrgyzstan,41.20438,74.766098,187620,0,2826,184794
1/13/22,Kyrgyzstan,41.20438,74.766098,187620,0,2826,184794
1/14/22,Kyrgyzstan,41.20438,74.766098,188206,0,2827,185379
1/15/22,Kyrgyzstan,41.20438,74.766098,188813,0,2828,185985
1/16/22,Kyrgyzstan,41.20438,74.766098,189687,0,2830,186857
1/17/22,Kyrgyzstan,41.20438,74.766098,190468,0,2833,187635
1/18/22,Kyrgyzstan,41.20438,74.766098,191288,0,2836,188452
1/19/22,Kyrgyzstan,41.20438,74.766098,192158,0,2838,189320
1/20/22,Kyrgyzstan,41.20438,74.766098,193028,0,2842,190186
1/21/22,Kyrgyzstan,41.20438,74.766098,193816,0,2843,190973
1/22/22,Kyrgyzstan,41.20438,74.766098,194607,0,2846,191761
1/23/22,Kyrgyzstan,41.20438,74.766098,195394,0,2849,192545
1/24/22,Kyrgyzstan,41.20438,74.766098,195820,0,2851,192969
1/25/22,Kyrgyzstan,41.20438,74.766098,196232,0,2854,193378
1/26/22,Kyrgyzstan,41.20438,74.766098,196602,0,2858,193744
1/27/22,Kyrgyzstan,41.20438,74.766098,197081,0,2862,194219
1/28/22,Kyrgyzstan,41.20438,74.766098,197437,0,2867,194570
1/29/22,Kyrgyzstan,41.20438,74.766098,197437,0,2867,194570
1/30/22,Kyrgyzstan,41.20438,74.766098,198111,0,2876,195235
1/31/22,Kyrgyzstan,41.20438,74.766098,198316,0,2880,195436
2/1/22,Kyrgyzstan,41.20438,74.766098,198518,0,2884,195634
2/2/22,Kyrgyzstan,41.20438,74.766098,198719,0,2889,195830
2/3/22,Kyrgyzstan,41.20438,74.766098,199164,0,2896,196268
2/4/22,Kyrgyzstan,41.20438,74.766098,199164,0,2896,196268
2/5/22,Kyrgyzstan,41.20438,74.766098,199326,0,2899,196427
2/6/22,Kyrgyzstan,41.20438,74.766098,199436,0,2902,196534
2/7/22,Kyrgyzstan,41.20438,74.766098,199519,0,2905,196614
2/8/22,Kyrgyzstan,41.20438,74.766098,199617,0,2909,196708
2/9/22,Kyrgyzstan,41.20438,74.766098,199714,0,2913,196801
2/10/22,Kyrgyzstan,41.20438,74.766098,199821,0,2917,196904
2/11/22,Kyrgyzstan,41.20438,74.766098,199890,0,2920,196970
2/12/22,Kyrgyzstan,41.20438,74.766098,200020,0,2927,197093
2/13/22,Kyrgyzstan,41.20438,74.766098,200066,0,2930,197136
2/14/22,Kyrgyzstan,41.20438,74.766098,200066,0,2930,197136
2/15/22,Kyrgyzstan,41.20438,74.766098,200121,0,2932,197189
2/16/22,Kyrgyzstan,41.20438,74.766098,200175,0,2935,197240
2/17/22,Kyrgyzstan,41.20438,74.766098,200214,0,2937,197277
2/18/22,Kyrgyzstan,41.20438,74.766098,200287,0,2942,197345
2/19/22,Kyrgyzstan,41.20438,74.766098,200287,0,2942,197345
2/20/22,Kyrgyzstan,41.20438,74.766098,200322,0,2944,197378
2/21/22,Kyrgyzstan,41.20438,74.766098,200337,0,2946,197391
2/22/22,Kyrgyzstan,41.20438,74.766098,200368,0,2947,197421
2/23/22,Kyrgyzstan,41.20438,74.766098,200388,0,2948,197440
2/24/22,Kyrgyzstan,41.20438,74.766098,200402,0,2950,197452
2/25/22,Kyrgyzstan,41.20438,74.766098,200427,0,2952,197475
2/26/22,Kyrgyzstan,41.20438,74.766098,200458,0,2954,197504
2/27/22,Kyrgyzstan,41.20438,74.766098,200500,0,2957,197543
2/28/22,Kyrgyzstan,41.20438,74.766098,200527,0,2958,197569
3/1/22,Kyrgyzstan,41.20438,74.766098,200527,0,2958,197569
3/2/22,Kyrgyzstan,41.20438,74.766098,200556,0,2960,197596
3/3/22,Kyrgyzstan,41.20438,74.766098,200599,0,2962,197637
3/4/22,Kyrgyzstan,41.20438,74.766098,200599,0,2962,197637
3/5/22,Kyrgyzstan,41.20438,74.766098,200615,0,2963,197652
3/6/22,Kyrgyzstan,41.20438,74.766098,200641,0,2966,197675
3/7/22,Kyrgyzstan,41.20438,74.766098,200641,0,2966,197675
3/8/22,Kyrgyzstan,41.20438,74.766098,200658,0,2968,197690
3/9/22,Kyrgyzstan,41.20438,74.766098,200671,0,2969,197702
3/10/22,Kyrgyzstan,41.20438,74.766098,200707,0,2971,197736
3/11/22,Kyrgyzstan,41.20438,74.766098,200707,0,2971,197736
3/12/22,Kyrgyzstan,41.20438,74.766098,200720,0,2972,197748
3/13/22,Kyrgyzstan,41.20438,74.766098,200742,0,2973,197769
3/14/22,Kyrgyzstan,41.20438,74.766098,200758,0,2974,197784
3/15/22,Kyrgyzstan,41.20438,74.766098,200758,0,2974,197784
3/16/22,Kyrgyzstan,41.20438,74.766098,200763,0,2975,197788
3/17/22,Kyrgyzstan,41.20438,74.766098,200776,0,2976,197800
3/18/22,Kyrgyzstan,41.20438,74.766098,200787,0,2977,197810
3/19/22,Kyrgyzstan,41.20438,74.766098,200809,0,2979,197830
3/20/22,Kyrgyzstan,41.20438,74.766098,200818,0,2980,197838
3/21/22,Kyrgyzstan,41.20438,74.766098,200818,0,2980,197838
3/22/22,Kyrgyzstan,41.20438,74.766098,200826,0,2981,197845
3/23/22,Kyrgyzstan,41.20438,74.766098,200836,0,2982,197854
3/24/22,Kyrgyzstan,41.20438,74.766098,200847,0,2982,197865
3/25/22,Kyrgyzstan,41.20438,74.766098,200857,0,2983,197874
3/26/22,Kyrgyzstan,41.20438,74.766098,200868,0,2984,197884
3/27/22,Kyrgyzstan,41.20438,74.766098,200879,0,2984,197895
3/28/22,Kyrgyzstan,41.20438,74.766098,200892,0,2985,197907
3/29/22,Kyrgyzstan,41.20438,74.766098,200909,0,2986,197923
3/30/22,Kyrgyzstan,41.20438,74.766098,200923,0,2988,197935
3/31/22,Kyrgyzstan,41.20438,74.766098,200935,0,2988,197947
4/1/22,Kyrgyzstan,41.20438,74.766098,200946,0,2989,197957
4/2/22,Kyrgyzstan,41.20438,74.766098,200955,0,2990,197965
4/3/22,Kyrgyzstan,41.20438,74.766098,200968,0,2991,197977
4/4/22,Kyrgyzstan,41.20438,74.766098,200968,0,2991,197977
4/5/22,Kyrgyzstan,41.20438,74.766098,200968,0,2991,197977
4/6/22,Kyrgyzstan,41.20438,74.766098,200968,0,2991,197977
4/7/22,Kyrgyzstan,41.20438,74.766098,200968,0,2991,197977
4/8/22,Kyrgyzstan,41.20438,74.766098,200969,0,2991,197978
4/9/22,Kyrgyzstan,41.20438,74.766098,200969,0,2991,197978
4/10/22,Kyrgyzstan,41.20438,74.766098,200970,0,2991,197979
4/11/22,Kyrgyzstan,41.20438,74.766098,200970,0,2991,197979
4/12/22,Kyrgyzstan,41.20438,74.766098,200970,0,2991,197979
4/13/22,Kyrgyzstan,41.20438,74.766098,200973,0,2991,197982
4/14/22,Kyrgyzstan,41.20438,74.766098,200973,0,2991,197982
4/15/22,Kyrgyzstan,41.20438,74.766098,200980,0,2991,197989
4/16/22,Kyrgyzstan,41.20438,74.766098,200980,0,2991,197989
4/17/22,Kyrgyzstan,41.20438,74.766098,200980,0,2991,197989
4/18/22,Kyrgyzstan,41.20438,74.766098,200980,0,2991,197989
4/19/22,Kyrgyzstan,41.20438,74.766098,200982,0,2991,197991
4/20/22,Kyrgyzstan,41.20438,74.766098,200982,0,2991,197991
4/21/22,Kyrgyzstan,41.20438,74.766098,200983,0,2991,197992
4/22/22,Kyrgyzstan,41.20438,74.766098,200983,0,2991,197992
4/23/22,Kyrgyzstan,41.20438,74.766098,200983,0,2991,197992
4/24/22,Kyrgyzstan,41.20438,74.766098,200983,0,2991,197992
4/25/22,Kyrgyzstan,41.20438,74.766098,200990,0,2991,197999
4/26/22,Kyrgyzstan,41.20438,74.766098,200991,0,2991,198000
4/27/22,Kyrgyzstan,41.20438,74.766098,200991,0,2991,198000
4/28/22,Kyrgyzstan,41.20438,74.766098,200992,0,2991,198001
4/29/22,Kyrgyzstan,41.20438,74.766098,200992,0,2991,198001
4/30/22,Kyrgyzstan,41.20438,74.766098,200992,0,2991,198001
5/1/22,Kyrgyzstan,41.20438,74.766098,200993,0,2991,198002
5/2/22,Kyrgyzstan,41.20438,74.766098,200993,0,2991,198002
5/3/22,Kyrgyzstan,41.20438,74.766098,200993,0,2991,198002
5/4/22,Kyrgyzstan,41.20438,74.766098,200993,0,2991,198002
5/5/22,Kyrgyzstan,41.20438,74.766098,200993,0,2991,198002
5/6/22,Kyrgyzstan,41.20438,74.766098,200993,0,2991,198002
5/7/22,Kyrgyzstan,41.20438,74.766098,200993,0,2991,198002
5/8/22,Kyrgyzstan,41.20438,74.766098,200993,0,2991,198002
5/9/22,Kyrgyzstan,41.20438,74.766098,200993,0,2991,198002
5/10/22,Kyrgyzstan,41.20438,74.766098,200993,0,2991,198002
5/11/22,Kyrgyzstan,41.20438,74.766098,200993,0,2991,198002
5/12/22,Kyrgyzstan,41.20438,74.766098,200993,0,2991,198002
5/13/22,Kyrgyzstan,41.20438,74.766098,200993,0,2991,198002
5/14/22,Kyrgyzstan,41.20438,74.766098,200993,0,2991,198002
5/15/22,Kyrgyzstan,41.20438,74.766098,200993,0,2991,198002
5/16/22,Kyrgyzstan,41.20438,74.766098,200993,0,2991,198002
5/17/22,Kyrgyzstan,41.20438,74.766098,200993,0,2991,198002
5/18/22,Kyrgyzstan,41.20438,74.766098,200993,0,2991,198002
5/19/22,Kyrgyzstan,41.20438,74.766098,200993,0,2991,198002
5/20/22,Kyrgyzstan,41.20438,74.766098,200993,0,2991,198002
5/21/22,Kyrgyzstan,41.20438,74.766098,200993,0,2991,198002
5/22/22,Kyrgyzstan,41.20438,74.766098,200993,0,2991,198002
5/23/22,Kyrgyzstan,41.20438,74.766098,200993,0,2991,198002
5/24/22,Kyrgyzstan,41.20438,74.766098,200993,0,2991,198002
5/25/22,Kyrgyzstan,41.20438,74.766098,200993,0,2991,198002
5/26/22,Kyrgyzstan,41.20438,74.766098,200993,0,2991,198002
5/27/22,Kyrgyzstan,41.20438,74.766098,200993,0,2991,198002
5/28/22,Kyrgyzstan,41.20438,74.766098,200993,0,2991,198002
5/29/22,Kyrgyzstan,41.20438,74.766098,200993,0,2991,198002
5/30/22,Kyrgyzstan,41.20438,74.766098,200993,0,2991,198002
5/31/22,Kyrgyzstan,41.20438,74.766098,200993,0,2991,198002
6/1/22,Kyrgyzstan,41.20438,74.766098,200993,0,2991,198002
6/2/22,Kyrgyzstan,41.20438,74.766098,200993,0,2991,198002
6/3/22,Kyrgyzstan,41.20438,74.766098,200993,0,2991,198002
6/4/22,Kyrgyzstan,41.20438,74.766098,200993,0,2991,198002
6/5/22,Kyrgyzstan,41.20438,74.766098,200993,0,2991,198002
6/6/22,Kyrgyzstan,41.20438,74.766098,200993,0,2991,198002
6/7/22,Kyrgyzstan,41.20438,74.766098,200993,0,2991,198002
6/8/22,Kyrgyzstan,41.20438,74.766098,200993,0,2991,198002
6/9/22,Kyrgyzstan,41.20438,74.766098,200993,0,2991,198002
6/10/22,Kyrgyzstan,41.20438,74.766098,200993,0,2991,198002
6/11/22,Kyrgyzstan,41.20438,74.766098,200993,0,2991,198002
6/12/22,Kyrgyzstan,41.20438,74.766098,200993,0,2991,198002
6/13/22,Kyrgyzstan,41.20438,74.766098,200993,0,2991,198002
6/14/22,Kyrgyzstan,41.20438,74.766098,200993,0,2991,198002
6/15/22,Kyrgyzstan,41.20438,74.766098,201016,0,2991,198025
6/16/22,Kyrgyzstan,41.20438,74.766098,201016,0,2991,198025
6/17/22,Kyrgyzstan,41.20438,74.766098,201016,0,2991,198025
6/18/22,Kyrgyzstan,41.20438,74.766098,201016,0,2991,198025
6/19/22,Kyrgyzstan,41.20438,74.766098,201016,0,2991,198025
6/20/22,Kyrgyzstan,41.20438,74.766098,201016,0,2991,198025
6/21/22,Kyrgyzstan,41.20438,74.766098,201016,0,2991,198025
6/22/22,Kyrgyzstan,41.20438,74.766098,201024,0,2991,198033
6/23/22,Kyrgyzstan,41.20438,74.766098,201024,0,2991,198033
6/24/22,Kyrgyzstan,41.20438,74.766098,201024,0,2991,198033
6/25/22,Kyrgyzstan,41.20438,74.766098,201024,0,2991,198033
6/26/22,Kyrgyzstan,41.20438,74.766098,201024,0,2991,198033
6/27/22,Kyrgyzstan,41.20438,74.766098,201024,0,2991,198033
6/28/22,Kyrgyzstan,41.20438,74.766098,201053,0,2991,198062
6/29/22,Kyrgyzstan,41.20438,74.766098,201053,0,2991,198062
6/30/22,Kyrgyzstan,41.20438,74.766098,201053,0,2991,198062
7/1/22,Kyrgyzstan,41.20438,74.766098,201053,0,2991,198062
7/2/22,Kyrgyzstan,41.20438,74.766098,201053,0,2991,198062
7/3/22,Kyrgyzstan,41.20438,74.766098,201053,0,2991,198062
7/4/22,Kyrgyzstan,41.20438,74.766098,201101,0,2991,198110
7/5/22,Kyrgyzstan,41.20438,74.766098,201101,0,2991,198110
7/6/22,Kyrgyzstan,41.20438,74.766098,201101,0,2991,198110
7/7/22,Kyrgyzstan,41.20438,74.766098,201101,0,2991,198110
7/8/22,Kyrgyzstan,41.20438,74.766098,201131,0,2991,198140
7/9/22,Kyrgyzstan,41.20438,74.766098,201131,0,2991,198140
7/10/22,Kyrgyzstan,41.20438,74.766098,201131,0,2991,198140
7/11/22,Kyrgyzstan,41.20438,74.766098,201215,0,2991,198224
7/12/22,Kyrgyzstan,41.20438,74.766098,201243,0,2991,198252
7/13/22,Kyrgyzstan,41.20438,74.766098,201282,0,2991,198291
7/14/22,Kyrgyzstan,41.20438,74.766098,201329,0,2991,198338
7/15/22,Kyrgyzstan,41.20438,74.766098,201414,0,2991,198423
7/16/22,Kyrgyzstan,41.20438,74.766098,201414,0,2991,198423
7/17/22,Kyrgyzstan,41.20438,74.766098,201414,0,2991,198423
7/18/22,Kyrgyzstan,41.20438,74.766098,201704,0,2991,198713
7/19/22,Kyrgyzstan,41.20438,74.766098,201704,0,2991,198713
7/20/22,Kyrgyzstan,41.20438,74.766098,201704,0,2991,198713
7/21/22,Kyrgyzstan,41.20438,74.766098,201704,0,2991,198713
7/22/22,Kyrgyzstan,41.20438,74.766098,201704,0,2991,198713
7/23/22,Kyrgyzstan,41.20438,74.766098,201704,0,2991,198713
7/24/22,Kyrgyzstan,41.20438,74.766098,201704,0,2991,198713
7/25/22,Kyrgyzstan,41.20438,74.766098,201832,0,2991,198841
7/26/22,Kyrgyzstan,41.20438,74.766098,202685,0,2991,199694
7/27/22,Kyrgyzstan,41.20438,74.766098,202685,0,2991,199694
7/28/22,Kyrgyzstan,41.20438,74.766098,202685,0,2991,199694
7/29/22,Kyrgyzstan,41.20438,74.766098,202685,0,2991,199694
7/30/22,Kyrgyzstan,41.20438,74.766098,202685,0,2991,199694
7/31/22,Kyrgyzstan,41.20438,74.766098,202685,0,2991,199694
8/1/22,Kyrgyzstan,41.20438,74.766098,202685,0,2991,199694
8/2/22,Kyrgyzstan,41.20438,74.766098,203776,0,2991,200785
8/3/22,Kyrgyzstan,41.20438,74.766098,203776,0,2991,200785
8/4/22,Kyrgyzstan,41.20438,74.766098,203776,0,2991,200785
8/5/22,Kyrgyzstan,41.20438,74.766098,203776,0,2991,200785
8/6/22,Kyrgyzstan,41.20438,74.766098,203776,0,2991,200785
8/7/22,Kyrgyzstan,41.20438,74.766098,203776,0,2991,200785
8/8/22,Kyrgyzstan,41.20438,74.766098,204671,0,2991,201680
8/9/22,Kyrgyzstan,41.20438,74.766098,204671,0,2991,201680
8/10/22,Kyrgyzstan,41.20438,74.766098,204671,0,2991,201680
8/11/22,Kyrgyzstan,41.20438,74.766098,204671,0,2991,201680
8/12/22,Kyrgyzstan,41.20438,74.766098,204671,0,2991,201680
8/13/22,Kyrgyzstan,41.20438,74.766098,204671,0,2991,201680
8/14/22,Kyrgyzstan,41.20438,74.766098,204671,0,2991,201680
8/15/22,Kyrgyzstan,41.20438,74.766098,205198,0,2991,202207
8/16/22,Kyrgyzstan,41.20438,74.766098,205198,0,2991,202207
8/17/22,Kyrgyzstan,41.20438,74.766098,205198,0,2991,202207
8/18/22,Kyrgyzstan,41.20438,74.766098,205198,0,2991,202207
8/19/22,Kyrgyzstan,41.20438,74.766098,205198,0,2991,202207
8/20/22,Kyrgyzstan,41.20438,74.766098,205198,0,2991,202207
8/21/22,Kyrgyzstan,41.20438,74.766098,205198,0,2991,202207
8/22/22,Kyrgyzstan,41.20438,74.766098,205537,0,2991,202546
8/23/22,Kyrgyzstan,41.20438,74.766098,205537,0,2991,202546
8/24/22,Kyrgyzstan,41.20438,74.766098,205537,0,2991,202546
8/25/22,Kyrgyzstan,41.20438,74.766098,205537,0,2991,202546
8/26/22,Kyrgyzstan,41.20438,74.766098,205537,0,2991,202546
8/27/22,Kyrgyzstan,41.20438,74.766098,205537,0,2991,202546
8/28/22,Kyrgyzstan,41.20438,74.766098,205537,0,2991,202546
8/29/22,Kyrgyzstan,41.20438,74.766098,205537,0,2991,202546
8/30/22,Kyrgyzstan,41.20438,74.766098,205716,0,2991,202725
8/31/22,Kyrgyzstan,41.20438,74.766098,205716,0,2991,202725
9/1/22,Kyrgyzstan,41.20438,74.766098,205716,0,2991,202725
9/2/22,Kyrgyzstan,41.20438,74.766098,205716,0,2991,202725
9/3/22,Kyrgyzstan,41.20438,74.766098,205716,0,2991,202725
9/4/22,Kyrgyzstan,41.20438,74.766098,205716,0,2991,202725
9/5/22,Kyrgyzstan,41.20438,74.766098,205835,0,2991,202844
9/6/22,Kyrgyzstan,41.20438,74.766098,205835,0,2991,202844
9/7/22,Kyrgyzstan,41.20438,74.766098,205835,0,2991,202844
9/8/22,Kyrgyzstan,41.20438,74.766098,205835,0,2991,202844
9/9/22,Kyrgyzstan,41.20438,74.766098,205835,0,2991,202844
9/10/22,Kyrgyzstan,41.20438,74.766098,205835,0,2991,202844
9/11/22,Kyrgyzstan,41.20438,74.766098,205835,0,2991,202844
9/12/22,Kyrgyzstan,41.20438,74.766098,205920,0,2991,202929
9/13/22,Kyrgyzstan,41.20438,74.766098,205920,0,2991,202929
9/14/22,Kyrgyzstan,41.20438,74.766098,205920,0,2991,202929
9/15/22,Kyrgyzstan,41.20438,74.766098,205920,0,2991,202929
9/16/22,Kyrgyzstan,41.20438,74.766098,205920,0,2991,202929
9/17/22,Kyrgyzstan,41.20438,74.766098,205920,0,2991,202929
9/18/22,Kyrgyzstan,41.20438,74.766098,205920,0,2991,202929
9/19/22,Kyrgyzstan,41.20438,74.766098,205998,0,2991,203007
9/20/22,Kyrgyzstan,41.20438,74.766098,205998,0,2991,203007
9/21/22,Kyrgyzstan,41.20438,74.766098,205998,0,2991,203007
9/22/22,Kyrgyzstan,41.20438,74.766098,205998,0,2991,203007
9/23/22,Kyrgyzstan,41.20438,74.766098,205998,0,2991,203007
9/24/22,Kyrgyzstan,41.20438,74.766098,205998,0,2991,203007
9/25/22,Kyrgyzstan,41.20438,74.766098,205998,0,2991,203007
9/26/22,Kyrgyzstan,41.20438,74.766098,206083,0,2991,203092
9/27/22,Kyrgyzstan,41.20438,74.766098,206083,0,2991,203092
9/28/22,Kyrgyzstan,41.20438,74.766098,206083,0,2991,203092
9/29/22,Kyrgyzstan,41.20438,74.766098,206083,0,2991,203092
9/30/22,Kyrgyzstan,41.20438,74.766098,206083,0,2991,203092
10/1/22,Kyrgyzstan,41.20438,74.766098,206083,0,2991,203092
10/2/22,Kyrgyzstan,41.20438,74.766098,206083,0,2991,203092
10/3/22,Kyrgyzstan,41.20438,74.766098,206160,0,2991,203169
10/4/22,Kyrgyzstan,41.20438,74.766098,206160,0,2991,203169
10/5/22,Kyrgyzstan,41.20438,74.766098,206160,0,2991,203169
10/6/22,Kyrgyzstan,41.20438,74.766098,206160,0,2991,203169
10/7/22,Kyrgyzstan,41.20438,74.766098,206160,0,2991,203169
10/8/22,Kyrgyzstan,41.20438,74.766098,206160,0,2991,203169
10/9/22,Kyrgyzstan,41.20438,74.766098,206160,0,2991,203169
10/10/22,Kyrgyzstan,41.20438,74.766098,206250,0,2991,203259
10/11/22,Kyrgyzstan,41.20438,74.766098,206250,0,2991,203259
10/12/22,Kyrgyzstan,41.20438,74.766098,206250,0,2991,203259
10/13/22,Kyrgyzstan,41.20438,74.766098,206250,0,2991,203259
10/14/22,Kyrgyzstan,41.20438,74.766098,206250,0,2991,203259
10/15/22,Kyrgyzstan,41.20438,74.766098,206250,0,2991,203259
10/16/22,Kyrgyzstan,41.20438,74.766098,206250,0,2991,203259
10/17/22,Kyrgyzstan,41.20438,74.766098,206334,0,2991,203343
10/18/22,Kyrgyzstan,41.20438,74.766098,206334,0,2991,203343
10/19/22,Kyrgyzstan,41.20438,74.766098,206334,0,2991,203343
10/20/22,Kyrgyzstan,41.20438,74.766098,206334,0,2991,203343
10/21/22,Kyrgyzstan,41.20438,74.766098,206334,0,2991,203343
10/22/22,Kyrgyzstan,41.20438,74.766098,206334,0,2991,203343
10/23/22,Kyrgyzstan,41.20438,74.766098,206334,0,2991,203343
10/24/22,Kyrgyzstan,41.20438,74.766098,206399,0,2991,203408
10/25/22,Kyrgyzstan,41.20438,74.766098,206399,0,2991,203408
10/26/22,Kyrgyzstan,41.20438,74.766098,206399,0,2991,203408
10/27/22,Kyrgyzstan,41.20438,74.766098,206399,0,2991,203408
10/28/22,Kyrgyzstan,41.20438,74.766098,206399,0,2991,203408
10/29/22,Kyrgyzstan,41.20438,74.766098,206399,0,2991,203408
10/30/22,Kyrgyzstan,41.20438,74.766098,206399,0,2991,203408
10/31/22,Kyrgyzstan,41.20438,74.766098,206452,0,2991,203461
11/1/22,Kyrgyzstan,41.20438,74.766098,206452,0,2991,203461
11/2/22,Kyrgyzstan,41.20438,74.766098,206452,0,2991,203461
11/3/22,Kyrgyzstan,41.20438,74.766098,206452,0,2991,203461
11/4/22,Kyrgyzstan,41.20438,74.766098,206452,0,2991,203461
11/5/22,Kyrgyzstan,41.20438,74.766098,206452,0,2991,203461
11/6/22,Kyrgyzstan,41.20438,74.766098,206452,0,2991,203461
11/7/22,Kyrgyzstan,41.20438,74.766098,206464,0,2991,203473
11/8/22,Kyrgyzstan,41.20438,74.766098,206464,0,2991,203473
11/9/22,Kyrgyzstan,41.20438,74.766098,206464,0,2991,203473
11/10/22,Kyrgyzstan,41.20438,74.766098,206464,0,2991,203473
11/11/22,Kyrgyzstan,41.20438,74.766098,206464,0,2991,203473
11/12/22,Kyrgyzstan,41.20438,74.766098,206464,0,2991,203473
11/13/22,Kyrgyzstan,41.20438,74.766098,206464,0,2991,203473
11/14/22,Kyrgyzstan,41.20438,74.766098,206483,0,2991,203492
11/15/22,Kyrgyzstan,41.20438,74.766098,206483,0,2991,203492
11/16/22,Kyrgyzstan,41.20438,74.766098,206483,0,2991,203492
11/17/22,Kyrgyzstan,41.20438,74.766098,206483,0,2991,203492
11/18/22,Kyrgyzstan,41.20438,74.766098,206483,0,2991,203492
11/19/22,Kyrgyzstan,41.20438,74.766098,206483,0,2991,203492
11/20/22,Kyrgyzstan,41.20438,74.766098,206483,0,2991,203492
11/21/22,Kyrgyzstan,41.20438,74.766098,206511,0,2991,203520
11/22/22,Kyrgyzstan,41.20438,74.766098,206511,0,2991,203520
11/23/22,Kyrgyzstan,41.20438,74.766098,206511,0,2991,203520
11/24/22,Kyrgyzstan,41.20438,74.766098,206511,0,2991,203520
11/25/22,Kyrgyzstan,41.20438,74.766098,206511,0,2991,203520
11/26/22,Kyrgyzstan,41.20438,74.766098,206511,0,2991,203520
11/27/22,Kyrgyzstan,41.20438,74.766098,206511,0,2991,203520
11/28/22,Kyrgyzstan,41.20438,74.766098,206530,0,2991,203539
11/29/22,Kyrgyzstan,41.20438,74.766098,206530,0,2991,203539
11/30/22,Kyrgyzstan,41.20438,74.766098,206530,0,2991,203539
12/1/22,Kyrgyzstan,41.20438,74.766098,206530,0,2991,203539
12/2/22,Kyrgyzstan,41.20438,74.766098,206530,0,2991,203539
12/3/22,Kyrgyzstan,41.20438,74.766098,206530,0,2991,203539
12/4/22,Kyrgyzstan,41.20438,74.766098,206530,0,2991,203539
12/5/22,Kyrgyzstan,41.20438,74.766098,206543,0,2991,203552
12/6/22,Kyrgyzstan,41.20438,74.766098,206543,0,2991,203552
12/7/22,Kyrgyzstan,41.20438,74.766098,206543,0,2991,203552
12/8/22,Kyrgyzstan,41.20438,74.766098,206543,0,2991,203552
12/9/22,Kyrgyzstan,41.20438,74.766098,206543,0,2991,203552
12/10/22,Kyrgyzstan,41.20438,74.766098,206543,0,2991,203552
12/11/22,Kyrgyzstan,41.20438,74.766098,206543,0,2991,203552
12/12/22,Kyrgyzstan,41.20438,74.766098,206553,0,2991,203562
12/13/22,Kyrgyzstan,41.20438,74.766098,206553,0,2991,203562
12/14/22,Kyrgyzstan,41.20438,74.766098,206553,0,2991,203562
12/15/22,Kyrgyzstan,41.20438,74.766098,206553,0,2991,203562
12/16/22,Kyrgyzstan,41.20438,74.766098,206553,0,2991,203562
12/17/22,Kyrgyzstan,41.20438,74.766098,206553,0,2991,203562
1/1/22,Laos,19.85627,102.495496,112083,0,374,111709
1/2/22,Laos,19.85627,102.495496,112767,0,380,112387
1/3/22,Laos,19.85627,102.495496,113432,0,391,113041
1/4/22,Laos,19.85627,102.495496,113951,0,403,113548
1/5/22,Laos,19.85627,102.495496,114787,0,409,114378
1/6/22,Laos,19.85627,102.495496,114787,0,409,114378
1/7/22,Laos,19.85627,102.495496,116890,0,421,116469
1/8/22,Laos,19.85627,102.495496,117956,0,430,117526
1/9/22,Laos,19.85627,102.495496,118880,0,437,118443
1/10/22,Laos,19.85627,102.495496,119521,0,448,119073
1/11/22,Laos,19.85627,102.495496,120520,0,457,120063
1/12/22,Laos,19.85627,102.495496,121436,0,464,120972
1/13/22,Laos,19.85627,102.495496,122241,0,471,121770
1/14/22,Laos,19.85627,102.495496,123293,0,476,122817
1/15/22,Laos,19.85627,102.495496,124193,0,488,123705
1/16/22,Laos,19.85627,102.495496,124731,0,495,124236
1/17/22,Laos,19.85627,102.495496,125333,0,497,124836
1/18/22,Laos,19.85627,102.495496,126066,0,500,125566
1/19/22,Laos,19.85627,102.495496,127347,0,507,126840
1/20/22,Laos,19.85627,102.495496,128248,0,508,127740
1/21/22,Laos,19.85627,102.495496,128924,0,518,128406
1/22/22,Laos,19.85627,102.495496,129536,0,524,129012
1/23/22,Laos,19.85627,102.495496,129953,0,526,129427
1/24/22,Laos,19.85627,102.495496,130293,0,527,129766
1/25/22,Laos,19.85627,102.495496,130853,0,529,130324
1/26/22,Laos,19.85627,102.495496,131432,0,533,130899
1/27/22,Laos,19.85627,102.495496,132130,0,534,131596
1/28/22,Laos,19.85627,102.495496,132681,0,538,132143
1/29/22,Laos,19.85627,102.495496,133218,0,538,132680
1/30/22,Laos,19.85627,102.495496,133524,0,544,132980
1/31/22,Laos,19.85627,102.495496,133853,0,547,133306
2/1/22,Laos,19.85627,102.495496,134438,0,551,133887
2/2/22,Laos,19.85627,102.495496,134901,0,553,134348
2/3/22,Laos,19.85627,102.495496,135301,0,558,134743
2/4/22,Laos,19.85627,102.495496,135660,0,562,135098
2/5/22,Laos,19.85627,102.495496,136148,0,565,135583
2/6/22,Laos,19.85627,102.495496,136438,0,569,135869
2/7/22,Laos,19.85627,102.495496,136720,0,574,136146
2/8/22,Laos,19.85627,102.495496,137103,0,577,136526
2/9/22,Laos,19.85627,102.495496,137557,0,583,136974
2/10/22,Laos,19.85627,102.495496,138007,0,584,137423
2/11/22,Laos,19.85627,102.495496,138431,0,588,137843
2/12/22,Laos,19.85627,102.495496,138765,0,591,138174
2/13/22,Laos,19.85627,102.495496,139028,0,594,138434
2/14/22,Laos,19.85627,102.495496,139244,0,597,138647
2/15/22,Laos,19.85627,102.495496,139685,0,598,139087
2/16/22,Laos,19.85627,102.495496,140030,0,602,139428
2/17/22,Laos,19.85627,102.495496,140353,0,602,139751
2/18/22,Laos,19.85627,102.495496,140604,0,605,139999
2/19/22,Laos,19.85627,102.495496,140889,0,608,140281
2/20/22,Laos,19.85627,102.495496,141083,0,610,140473
2/21/22,Laos,19.85627,102.495496,141301,0,612,140689
2/22/22,Laos,19.85627,102.495496,141441,0,613,140828
2/23/22,Laos,19.85627,102.495496,141694,0,616,141078
2/24/22,Laos,19.85627,102.495496,141933,0,617,141316
2/25/22,Laos,19.85627,102.495496,142237,0,619,141618
2/26/22,Laos,19.85627,102.495496,142474,0,621,141853
2/27/22,Laos,19.85627,102.495496,142609,0,621,141988
2/28/22,Laos,19.85627,102.495496,142743,0,621,142122
3/1/22,Laos,19.85627,102.495496,142967,0,623,142344
3/2/22,Laos,19.85627,102.495496,143240,0,623,142617
3/3/22,Laos,19.85627,102.495496,143486,0,626,142860
3/4/22,Laos,19.85627,102.495496,143710,0,628,143082
3/5/22,Laos,19.85627,102.495496,143969,0,628,143341
3/6/22,Laos,19.85627,102.495496,144155,0,628,143527
3/7/22,Laos,19.85627,102.495496,144320,0,632,143688
3/8/22,Laos,19.85627,102.495496,144551,0,633,143918
3/9/22,Laos,19.85627,102.495496,144759,0,634,144125
3/10/22,Laos,19.85627,102.495496,145094,0,637,144457
3/11/22,Laos,19.85627,102.495496,145507,0,640,144867
3/12/22,Laos,19.85627,102.495496,145934,0,641,145293
3/13/22,Laos,19.85627,102.495496,146328,0,641,145687
3/14/22,Laos,19.85627,102.495496,146687,0,641,146046
3/15/22,Laos,19.85627,102.495496,147409,0,643,146766
3/16/22,Laos,19.85627,102.495496,148257,0,643,147614
3/17/22,Laos,19.85627,102.495496,149131,0,643,148488
3/18/22,Laos,19.85627,102.495496,150639,0,645,149994
3/19/22,Laos,19.85627,102.495496,151956,0,645,151311
3/20/22,Laos,19.85627,102.495496,152957,0,645,152312
3/21/22,Laos,19.85627,102.495496,154094,0,649,153445
3/22/22,Laos,19.85627,102.495496,156422,0,651,155771
3/23/22,Laos,19.85627,102.495496,159047,0,653,158394
3/24/22,Laos,19.85627,102.495496,161866,0,652,161214
3/25/22,Laos,19.85627,102.495496,164078,0,654,163424
3/26/22,Laos,19.85627,102.495496,164078,0,654,163424
3/27/22,Laos,19.85627,102.495496,167993,0,660,167333
3/28/22,Laos,19.85627,102.495496,169256,0,661,168595
3/29/22,Laos,19.85627,102.495496,171439,0,663,170776
3/30/22,Laos,19.85627,102.495496,174136,0,664,173472
3/31/22,Laos,19.85627,102.495496,176898,0,665,176233
4/1/22,Laos,19.85627,102.495496,179563,0,669,178894
4/2/22,Laos,19.85627,102.495496,181967,0,673,181294
4/3/22,Laos,19.85627,102.495496,183560,0,679,182881
4/4/22,Laos,19.85627,102.495496,184598,0,682,183916
4/5/22,Laos,19.85627,102.495496,186870,0,682,186188
4/6/22,Laos,19.85627,102.495496,188985,0,684,188301
4/7/22,Laos,19.85627,102.495496,191017,0,687,190330
4/8/22,Laos,19.85627,102.495496,192860,0,690,192170
4/9/22,Laos,19.85627,102.495496,194541,0,692,193849
4/10/22,Laos,19.85627,102.495496,195465,0,698,194767
4/11/22,Laos,19.85627,102.495496,196127,0,700,195427
4/12/22,Laos,19.85627,102.495496,197417,0,702,196715
4/13/22,Laos,19.85627,102.495496,198318,0,707,197611
4/14/22,Laos,19.85627,102.495496,199008,0,709,198299
4/15/22,Laos,19.85627,102.495496,199434,0,712,198722
4/16/22,Laos,19.85627,102.495496,199868,0,714,199154
4/17/22,Laos,19.85627,102.495496,200190,0,718,199472
4/18/22,Laos,19.85627,102.495496,200502,0,722,199780
4/19/22,Laos,19.85627,102.495496,201460,0,727,200733
4/20/22,Laos,19.85627,102.495496,202542,0,730,201812
4/21/22,Laos,19.85627,102.495496,203545,0,730,202815
4/22/22,Laos,19.85627,102.495496,204274,0,730,203544
4/23/22,Laos,19.85627,102.495496,204893,0,732,204161
4/24/22,Laos,19.85627,102.495496,205975,0,732,205243
4/25/22,Laos,19.85627,102.495496,205975,0,732,205243
4/26/22,Laos,19.85627,102.495496,206042,0,736,205306
4/27/22,Laos,19.85627,102.495496,206512,0,737,205775
4/28/22,Laos,19.85627,102.495496,206881,0,739,206142
4/29/22,Laos,19.85627,102.495496,207196,0,743,206453
4/30/22,Laos,19.85627,102.495496,207469,0,744,206725
5/1/22,Laos,19.85627,102.495496,207469,0,744,206725
5/2/22,Laos,19.85627,102.495496,207714,0,744,206970
5/3/22,Laos,19.85627,102.495496,207867,0,745,207122
5/4/22,Laos,19.85627,102.495496,208111,0,746,207365
5/5/22,Laos,19.85627,102.495496,208368,0,748,207620
5/6/22,Laos,19.85627,102.495496,208368,0,748,207620
5/7/22,Laos,19.85627,102.495496,208535,0,749,207786
5/8/22,Laos,19.85627,102.495496,208535,0,749,207786
5/9/22,Laos,19.85627,102.495496,208759,0,751,208008
5/10/22,Laos,19.85627,102.495496,208939,0,752,208187
5/11/22,Laos,19.85627,102.495496,209028,0,752,208276
5/12/22,Laos,19.85627,102.495496,209243,0,752,208491
5/13/22,Laos,19.85627,102.495496,209321,0,754,208567
5/14/22,Laos,19.85627,102.495496,209386,0,754,208632
5/15/22,Laos,19.85627,102.495496,209386,0,754,208632
5/16/22,Laos,19.85627,102.495496,209434,0,754,208680
5/17/22,Laos,19.85627,102.495496,209502,0,754,208748
5/18/22,Laos,19.85627,102.495496,209553,0,754,208799
5/19/22,Laos,19.85627,102.495496,209607,0,754,208853
5/20/22,Laos,19.85627,102.495496,209698,0,754,208944
5/21/22,Laos,19.85627,102.495496,209699,0,754,208945
5/22/22,Laos,19.85627,102.495496,209728,0,754,208974
5/23/22,Laos,19.85627,102.495496,209744,0,754,208990
5/24/22,Laos,19.85627,102.495496,209823,0,756,209067
5/25/22,Laos,19.85627,102.495496,209861,0,756,209105
5/26/22,Laos,19.85627,102.495496,209888,0,756,209132
5/27/22,Laos,19.85627,102.495496,209922,0,756,209166
5/28/22,Laos,19.85627,102.495496,209950,0,756,209194
5/29/22,Laos,19.85627,102.495496,209965,0,756,209209
5/30/22,Laos,19.85627,102.495496,209975,0,756,209219
5/31/22,Laos,19.85627,102.495496,209989,0,756,209233
6/1/22,Laos,19.85627,102.495496,210026,0,756,209270
6/2/22,Laos,19.85627,102.495496,210045,0,756,209289
6/3/22,Laos,19.85627,102.495496,210061,0,756,209305
6/4/22,Laos,19.85627,102.495496,210069,0,756,209313
6/5/22,Laos,19.85627,102.495496,210081,0,756,209325
6/6/22,Laos,19.85627,102.495496,210083,0,756,209327
6/7/22,Laos,19.85627,102.495496,210098,0,756,209342
6/8/22,Laos,19.85627,102.495496,210108,0,756,209352
6/9/22,Laos,19.85627,102.495496,210129,0,756,209373
6/10/22,Laos,19.85627,102.495496,210138,0,757,209381
6/11/22,Laos,19.85627,102.495496,210136,0,757,209379
6/12/22,Laos,19.85627,102.495496,210147,0,757,209390
6/13/22,Laos,19.85627,102.495496,210158,0,757,209401
6/14/22,Laos,19.85627,102.495496,210164,0,757,209407
6/15/22,Laos,19.85627,102.495496,210173,0,757,209416
6/16/22,Laos,19.85627,102.495496,210173,0,757,209416
6/17/22,Laos,19.85627,102.495496,210180,0,757,209423
6/18/22,Laos,19.85627,102.495496,210194,0,757,209437
6/19/22,Laos,19.85627,102.495496,210194,0,757,209437
6/20/22,Laos,19.85627,102.495496,210208,0,757,209451
6/21/22,Laos,19.85627,102.495496,210214,0,757,209457
6/22/22,Laos,19.85627,102.495496,210214,0,757,209457
6/23/22,Laos,19.85627,102.495496,210222,0,757,209465
6/24/22,Laos,19.85627,102.495496,210233,0,757,209476
6/25/22,Laos,19.85627,102.495496,210238,0,757,209481
6/26/22,Laos,19.85627,102.495496,210247,0,757,209490
6/27/22,Laos,19.85627,102.495496,210251,0,757,209494
6/28/22,Laos,19.85627,102.495496,210258,0,757,209501
6/29/22,Laos,19.85627,102.495496,210278,0,757,209521
6/30/22,Laos,19.85627,102.495496,210292,0,757,209535
7/1/22,Laos,19.85627,102.495496,210297,0,757,209540
7/2/22,Laos,19.85627,102.495496,210306,0,757,209549
7/3/22,Laos,19.85627,102.495496,210307,0,757,209550
7/4/22,Laos,19.85627,102.495496,210313,0,757,209556
7/5/22,Laos,19.85627,102.495496,210324,0,757,209567
7/6/22,Laos,19.85627,102.495496,210331,0,757,209574
7/7/22,Laos,19.85627,102.495496,210341,0,757,209584
7/8/22,Laos,19.85627,102.495496,210348,0,757,209591
7/9/22,Laos,19.85627,102.495496,210348,0,757,209591
7/10/22,Laos,19.85627,102.495496,210366,0,757,209609
7/11/22,Laos,19.85627,102.495496,210375,0,757,209618
7/12/22,Laos,19.85627,102.495496,210386,0,757,209629
7/13/22,Laos,19.85627,102.495496,210401,0,757,209644
7/14/22,Laos,19.85627,102.495496,210433,0,757,209676
7/15/22,Laos,19.85627,102.495496,210462,0,757,209705
7/16/22,Laos,19.85627,102.495496,210510,0,757,209753
7/17/22,Laos,19.85627,102.495496,210528,0,757,209771
7/18/22,Laos,19.85627,102.495496,210546,0,757,209789
7/19/22,Laos,19.85627,102.495496,210592,0,757,209835
7/20/22,Laos,19.85627,102.495496,210638,0,757,209881
7/21/22,Laos,19.85627,102.495496,210676,0,757,209919
7/22/22,Laos,19.85627,102.495496,210719,0,757,209962
7/23/22,Laos,19.85627,102.495496,210766,0,757,210009
7/24/22,Laos,19.85627,102.495496,210789,0,757,210032
7/25/22,Laos,19.85627,102.495496,210815,0,757,210058
7/26/22,Laos,19.85627,102.495496,210877,0,757,210120
7/27/22,Laos,19.85627,102.495496,210963,0,757,210206
7/28/22,Laos,19.85627,102.495496,211052,0,757,210295
7/29/22,Laos,19.85627,102.495496,211135,0,757,210378
7/30/22,Laos,19.85627,102.495496,211192,0,757,210435
7/31/22,Laos,19.85627,102.495496,211239,0,757,210482
8/1/22,Laos,19.85627,102.495496,211271,0,757,210514
8/2/22,Laos,19.85627,102.495496,211375,0,757,210618
8/3/22,Laos,19.85627,102.495496,211441,0,757,210684
8/4/22,Laos,19.85627,102.495496,211537,0,757,210780
8/5/22,Laos,19.85627,102.495496,211643,0,757,210886
8/6/22,Laos,19.85627,102.495496,211711,0,757,210954
8/7/22,Laos,19.85627,102.495496,211842,0,757,211085
8/8/22,Laos,19.85627,102.495496,211842,0,757,211085
8/9/22,Laos,19.85627,102.495496,211942,0,757,211185
8/10/22,Laos,19.85627,102.495496,212027,0,757,211270
8/11/22,Laos,19.85627,102.495496,212124,0,757,211367
8/12/22,Laos,19.85627,102.495496,212214,0,757,211457
8/13/22,Laos,19.85627,102.495496,212323,0,757,211566
8/14/22,Laos,19.85627,102.495496,212356,0,757,211599
8/15/22,Laos,19.85627,102.495496,212443,0,757,211686
8/16/22,Laos,19.85627,102.495496,212571,0,757,211814
8/17/22,Laos,19.85627,102.495496,212761,0,757,212004
8/18/22,Laos,19.85627,102.495496,212920,0,757,212163
8/19/22,Laos,19.85627,102.495496,213072,0,757,212315
8/20/22,Laos,19.85627,102.495496,213157,0,757,212400
8/21/22,Laos,19.85627,102.495496,213209,0,757,212452
8/22/22,Laos,19.85627,102.495496,213264,0,757,212507
8/23/22,Laos,19.85627,102.495496,213370,0,757,212613
8/24/22,Laos,19.85627,102.495496,213502,0,757,212745
8/25/22,Laos,19.85627,102.495496,213591,0,757,212834
8/26/22,Laos,19.85627,102.495496,213691,0,757,212934
8/27/22,Laos,19.85627,102.495496,213738,0,757,212981
8/28/22,Laos,19.85627,102.495496,213824,0,757,213067
8/29/22,Laos,19.85627,102.495496,213824,0,757,213067
8/30/22,Laos,19.85627,102.495496,213925,0,757,213168
8/31/22,Laos,19.85627,102.495496,214039,0,757,213282
9/1/22,Laos,19.85627,102.495496,214169,0,757,213412
9/2/22,Laos,19.85627,102.495496,214273,0,757,213516
9/3/22,Laos,19.85627,102.495496,214407,0,757,213650
9/4/22,Laos,19.85627,102.495496,214407,0,757,213650
9/5/22,Laos,19.85627,102.495496,214455,0,757,213698
9/6/22,Laos,19.85627,102.495496,214563,0,757,213806
9/7/22,Laos,19.85627,102.495496,214649,0,757,213892
9/8/22,Laos,19.85627,102.495496,214835,0,757,214078
9/9/22,Laos,19.85627,102.495496,214897,0,757,214140
9/10/22,Laos,19.85627,102.495496,214897,0,757,214140
9/11/22,Laos,19.85627,102.495496,214982,0,757,214225
9/12/22,Laos,19.85627,102.495496,214982,0,757,214225
9/13/22,Laos,19.85627,102.495496,215157,0,757,214400
9/14/22,Laos,19.85627,102.495496,215272,0,757,214515
9/15/22,Laos,19.85627,102.495496,215322,0,757,214565
9/16/22,Laos,19.85627,102.495496,215322,0,757,214565
9/17/22,Laos,19.85627,102.495496,215391,0,757,214634
9/18/22,Laos,19.85627,102.495496,215448,0,757,214691
9/19/22,Laos,19.85627,102.495496,215505,0,758,214747
9/20/22,Laos,19.85627,102.495496,215555,0,758,214797
9/21/22,Laos,19.85627,102.495496,215615,0,758,214857
9/22/22,Laos,19.85627,102.495496,215654,0,758,214896
9/23/22,Laos,19.85627,102.495496,215691,0,758,214933
9/24/22,Laos,19.85627,102.495496,215714,0,758,214956
9/25/22,Laos,19.85627,102.495496,215751,0,758,214993
9/26/22,Laos,19.85627,102.495496,215799,0,758,215041
9/27/22,Laos,19.85627,102.495496,215821,0,758,215063
9/28/22,Laos,19.85627,102.495496,215821,0,758,215063
9/29/22,Laos,19.85627,102.495496,215843,0,758,215085
9/30/22,Laos,19.85627,102.495496,215860,0,758,215102
10/1/22,Laos,19.85627,102.495496,215876,0,758,215118
10/2/22,Laos,19.85627,102.495496,215880,0,758,215122
10/3/22,Laos,19.85627,102.495496,215909,0,758,215151
10/4/22,Laos,19.85627,102.495496,215926,0,758,215168
10/5/22,Laos,19.85627,102.495496,215952,0,758,215194
10/6/22,Laos,19.85627,102.495496,215971,0,758,215213
10/7/22,Laos,19.85627,102.495496,215993,0,758,215235
10/8/22,Laos,19.85627,102.495496,215995,0,758,215237
10/9/22,Laos,19.85627,102.495496,216002,0,758,215244
10/10/22,Laos,19.85627,102.495496,216008,0,758,215250
10/11/22,Laos,19.85627,102.495496,216027,0,758,215269
10/12/22,Laos,19.85627,102.495496,216047,0,758,215289
10/13/22,Laos,19.85627,102.495496,216068,0,758,215310
10/14/22,Laos,19.85627,102.495496,216088,0,758,215330
10/15/22,Laos,19.85627,102.495496,216098,0,758,215340
10/16/22,Laos,19.85627,102.495496,216101,0,758,215343
10/17/22,Laos,19.85627,102.495496,216101,0,758,215343
10/18/22,Laos,19.85627,102.495496,216116,0,758,215358
10/19/22,Laos,19.85627,102.495496,216158,0,758,215400
10/20/22,Laos,19.85627,102.495496,216158,0,758,215400
10/21/22,Laos,19.85627,102.495496,216173,0,758,215415
10/22/22,Laos,19.85627,102.495496,216177,0,758,215419
10/23/22,Laos,19.85627,102.495496,216177,0,758,215419
10/24/22,Laos,19.85627,102.495496,216198,0,758,215440
10/25/22,Laos,19.85627,102.495496,216205,0,758,215447
10/26/22,Laos,19.85627,102.495496,216212,0,758,215454
10/27/22,Laos,19.85627,102.495496,216223,0,758,215465
10/28/22,Laos,19.85627,102.495496,216229,0,758,215471
10/29/22,Laos,19.85627,102.495496,216229,0,758,215471
10/30/22,Laos,19.85627,102.495496,216236,0,758,215478
10/31/22,Laos,19.85627,102.495496,216243,0,758,215485
11/1/22,Laos,19.85627,102.495496,216243,0,758,215485
11/2/22,Laos,19.85627,102.495496,216260,0,758,215502
11/3/22,Laos,19.85627,102.495496,216265,0,758,215507
11/4/22,Laos,19.85627,102.495496,216277,0,758,215519
11/5/22,Laos,19.85627,102.495496,216277,0,758,215519
11/6/22,Laos,19.85627,102.495496,216286,0,758,215528
11/7/22,Laos,19.85627,102.495496,216295,0,758,215537
11/8/22,Laos,19.85627,102.495496,216303,0,758,215545
11/9/22,Laos,19.85627,102.495496,216323,0,758,215565
11/10/22,Laos,19.85627,102.495496,216335,0,758,215577
11/11/22,Laos,19.85627,102.495496,216355,0,758,215597
11/12/22,Laos,19.85627,102.495496,216357,0,758,215599
11/13/22,Laos,19.85627,102.495496,216363,0,758,215605
11/14/22,Laos,19.85627,102.495496,216381,0,758,215623
11/15/22,Laos,19.85627,102.495496,216397,0,758,215639
11/16/22,Laos,19.85627,102.495496,216431,0,758,215673
11/17/22,Laos,19.85627,102.495496,216444,0,758,215686
11/18/22,Laos,19.85627,102.495496,216460,0,758,215702
11/19/22,Laos,19.85627,102.495496,216460,0,758,215702
11/20/22,Laos,19.85627,102.495496,216468,0,758,215710
11/21/22,Laos,19.85627,102.495496,216492,0,758,215734
11/22/22,Laos,19.85627,102.495496,216529,0,758,215771
11/23/22,Laos,19.85627,102.495496,216554,0,758,215796
11/24/22,Laos,19.85627,102.495496,216568,0,758,215810
11/25/22,Laos,19.85627,102.495496,216592,0,758,215834
11/26/22,Laos,19.85627,102.495496,216611,0,758,215853
11/27/22,Laos,19.85627,102.495496,216624,0,758,215866
11/28/22,Laos,19.85627,102.495496,216660,0,758,215902
11/29/22,Laos,19.85627,102.495496,216693,0,758,215935
11/30/22,Laos,19.85627,102.495496,216744,0,758,215986
12/1/22,Laos,19.85627,102.495496,216780,0,758,216022
12/2/22,Laos,19.85627,102.495496,216810,0,758,216052
12/3/22,Laos,19.85627,102.495496,216824,0,758,216066
12/4/22,Laos,19.85627,102.495496,216843,0,758,216085
12/5/22,Laos,19.85627,102.495496,216919,0,758,216161
12/6/22,Laos,19.85627,102.495496,216988,0,758,216230
12/7/22,Laos,19.85627,102.495496,217026,0,758,216268
12/8/22,Laos,19.85627,102.495496,217099,0,758,216341
12/9/22,Laos,19.85627,102.495496,217145,0,758,216387
12/10/22,Laos,19.85627,102.495496,217161,0,758,216403
12/11/22,Laos,19.85627,102.495496,217161,0,758,216403
12/12/22,Laos,19.85627,102.495496,217237,0,758,216479
12/13/22,Laos,19.85627,102.495496,217289,0,758,216531
12/14/22,Laos,19.85627,102.495496,217332,0,758,216574
12/15/22,Laos,19.85627,102.495496,217373,0,758,216615
12/16/22,Laos,19.85627,102.495496,217373,0,758,216615
12/17/22,Laos,19.85627,102.495496,217430,0,758,216672
1/1/22,Latvia,56.8796,24.6032,276841,0,4577,272264
1/2/22,Latvia,56.8796,24.6032,277021,0,4579,272442
1/3/22,Latvia,56.8796,24.6032,277692,0,4594,273098
1/4/22,Latvia,56.8796,24.6032,279320,0,4600,274720
1/5/22,Latvia,56.8796,24.6032,281155,0,4613,276542
1/6/22,Latvia,56.8796,24.6032,283149,0,4625,278524
1/7/22,Latvia,56.8796,24.6032,285026,0,4642,280384
1/8/22,Latvia,56.8796,24.6032,286841,0,4650,282191
1/9/22,Latvia,56.8796,24.6032,287851,0,4658,283193
1/10/22,Latvia,56.8796,24.6032,288715,0,4661,284054
1/11/22,Latvia,56.8796,24.6032,290956,0,4668,286288
1/12/22,Latvia,56.8796,24.6032,293395,0,4690,288705
1/13/22,Latvia,56.8796,24.6032,295961,0,4700,291261
1/14/22,Latvia,56.8796,24.6032,298589,0,4712,293877
1/15/22,Latvia,56.8796,24.6032,301654,0,4726,296928
1/16/22,Latvia,56.8796,24.6032,303794,0,4730,299064
1/17/22,Latvia,56.8796,24.6032,305354,0,4734,300620
1/18/22,Latvia,56.8796,24.6032,309060,0,4742,304318
1/19/22,Latvia,56.8796,24.6032,314142,0,4759,309383
1/20/22,Latvia,56.8796,24.6032,319027,0,4773,314254
1/21/22,Latvia,56.8796,24.6032,324999,0,4773,320226
1/22/22,Latvia,56.8796,24.6032,330788,0,4793,325995
1/23/22,Latvia,56.8796,24.6032,335541,0,4795,330746
1/24/22,Latvia,56.8796,24.6032,339494,0,4799,334695
1/25/22,Latvia,56.8796,24.6032,345591,0,4814,340777
1/26/22,Latvia,56.8796,24.6032,354734,0,4828,349906
1/27/22,Latvia,56.8796,24.6032,363821,0,4846,358975
1/28/22,Latvia,56.8796,24.6032,372503,0,4855,367648
1/29/22,Latvia,56.8796,24.6032,382129,0,4862,377267
1/30/22,Latvia,56.8796,24.6032,388989,0,4868,384121
1/31/22,Latvia,56.8796,24.6032,392764,0,4873,387891
2/1/22,Latvia,56.8796,24.6032,401792,0,4888,396904
2/2/22,Latvia,56.8796,24.6032,412402,0,4911,407491
2/3/22,Latvia,56.8796,24.6032,422233,0,4923,417310
2/4/22,Latvia,56.8796,24.6032,432370,0,4934,427436
2/5/22,Latvia,56.8796,24.6032,442871,0,4945,437926
2/6/22,Latvia,56.8796,24.6032,450105,0,4951,445154
2/7/22,Latvia,56.8796,24.6032,453751,0,4960,448791
2/8/22,Latvia,56.8796,24.6032,464895,0,4969,459926
2/9/22,Latvia,56.8796,24.6032,476730,0,4978,471752
2/10/22,Latvia,56.8796,24.6032,488329,0,4987,483342
2/11/22,Latvia,56.8796,24.6032,500126,0,5007,495119
2/12/22,Latvia,56.8796,24.6032,510833,0,5020,505813
2/13/22,Latvia,56.8796,24.6032,518622,0,5024,513598
2/14/22,Latvia,56.8796,24.6032,522766,0,5029,517737
2/15/22,Latvia,56.8796,24.6032,533871,0,5041,528830
2/16/22,Latvia,56.8796,24.6032,545296,0,5061,540235
2/17/22,Latvia,56.8796,24.6032,556891,0,5073,551818
2/18/22,Latvia,56.8796,24.6032,567176,0,5093,562083
2/19/22,Latvia,56.8796,24.6032,579168,0,5099,574069
2/20/22,Latvia,56.8796,24.6032,585944,0,5108,580836
2/21/22,Latvia,56.8796,24.6032,589763,0,5113,584650
2/22/22,Latvia,56.8796,24.6032,601600,0,5130,596470
2/23/22,Latvia,56.8796,24.6032,612920,0,5145,607775
2/24/22,Latvia,56.8796,24.6032,624008,0,5159,618849
2/25/22,Latvia,56.8796,24.6032,633960,0,5191,628769
2/26/22,Latvia,56.8796,24.6032,644077,0,5223,638854
2/27/22,Latvia,56.8796,24.6032,649504,0,5230,644274
2/28/22,Latvia,56.8796,24.6032,653120,0,5239,647881
3/1/22,Latvia,56.8796,24.6032,662644,0,5256,657388
3/2/22,Latvia,56.8796,24.6032,673218,0,5284,667934
3/3/22,Latvia,56.8796,24.6032,682118,0,5299,676819
3/4/22,Latvia,56.8796,24.6032,689794,0,5323,684471
3/5/22,Latvia,56.8796,24.6032,697548,0,5348,692200
3/6/22,Latvia,56.8796,24.6032,701540,0,5351,696189
3/7/22,Latvia,56.8796,24.6032,704134,0,5360,698774
3/8/22,Latvia,56.8796,24.6032,712271,0,5369,706902
3/9/22,Latvia,56.8796,24.6032,719813,0,5384,714429
3/10/22,Latvia,56.8796,24.6032,726868,0,5397,721471
3/11/22,Latvia,56.8796,24.6032,733084,0,5411,727673
3/12/22,Latvia,56.8796,24.6032,739609,0,5434,734175
3/13/22,Latvia,56.8796,24.6032,742336,0,5436,736900
3/14/22,Latvia,56.8796,24.6032,744433,0,5444,738989
3/15/22,Latvia,56.8796,24.6032,750683,0,5450,745233
3/16/22,Latvia,56.8796,24.6032,755821,0,5470,750351
3/17/22,Latvia,56.8796,24.6032,761074,0,5484,755590
3/18/22,Latvia,56.8796,24.6032,765297,0,5494,759803
3/19/22,Latvia,56.8796,24.6032,769131,0,5507,763624
3/20/22,Latvia,56.8796,24.6032,771038,0,5511,765527
3/21/22,Latvia,56.8796,24.6032,772390,0,5514,766876
3/22/22,Latvia,56.8796,24.6032,777201,0,5525,771676
3/23/22,Latvia,56.8796,24.6032,780831,0,5538,775293
3/24/22,Latvia,56.8796,24.6032,784155,0,5559,778596
3/25/22,Latvia,56.8796,24.6032,786974,0,5569,781405
3/26/22,Latvia,56.8796,24.6032,789483,0,5572,783911
3/27/22,Latvia,56.8796,24.6032,790620,0,5575,785045
3/28/22,Latvia,56.8796,24.6032,791550,0,5577,785973
3/29/22,Latvia,56.8796,24.6032,794447,0,5596,788851
3/30/22,Latvia,56.8796,24.6032,796890,0,5608,791282
3/31/22,Latvia,56.8796,24.6032,798895,0,5616,793279
4/1/22,Latvia,56.8796,24.6032,800687,0,5632,795055
4/2/22,Latvia,56.8796,24.6032,802001,0,5639,796362
4/3/22,Latvia,56.8796,24.6032,802534,0,5643,796891
4/4/22,Latvia,56.8796,24.6032,802887,0,5648,797239
4/5/22,Latvia,56.8796,24.6032,804288,0,5657,798631
4/6/22,Latvia,56.8796,24.6032,805353,0,5667,799686
4/7/22,Latvia,56.8796,24.6032,806425,0,5670,800755
4/8/22,Latvia,56.8796,24.6032,807385,0,5673,801712
4/9/22,Latvia,56.8796,24.6032,808341,0,5678,802663
4/10/22,Latvia,56.8796,24.6032,808799,0,5679,803120
4/11/22,Latvia,56.8796,24.6032,808979,0,5684,803295
4/12/22,Latvia,56.8796,24.6032,809917,0,5687,804230
4/13/22,Latvia,56.8796,24.6032,811056,0,5695,805361
4/14/22,Latvia,56.8796,24.6032,811868,0,5705,806163
4/15/22,Latvia,56.8796,24.6032,812686,0,5711,806975
4/16/22,Latvia,56.8796,24.6032,812877,0,5714,807163
4/17/22,Latvia,56.8796,24.6032,813176,0,5715,807461
4/18/22,Latvia,56.8796,24.6032,813243,0,5715,807528
4/19/22,Latvia,56.8796,24.6032,813415,0,5716,807699
4/20/22,Latvia,56.8796,24.6032,814400,0,5724,808676
4/21/22,Latvia,56.8796,24.6032,815533,0,5735,809798
4/22/22,Latvia,56.8796,24.6032,816298,0,5739,810559
4/23/22,Latvia,56.8796,24.6032,816994,0,5743,811251
4/24/22,Latvia,56.8796,24.6032,817316,0,5743,811573
4/25/22,Latvia,56.8796,24.6032,817439,0,5744,811695
4/26/22,Latvia,56.8796,24.6032,818030,0,5755,812275
4/27/22,Latvia,56.8796,24.6032,818644,0,5766,812878
4/28/22,Latvia,56.8796,24.6032,821602,0,5759,815843
4/29/22,Latvia,56.8796,24.6032,822013,0,5760,816253
4/30/22,Latvia,56.8796,24.6032,822013,0,5760,816253
5/1/22,Latvia,56.8796,24.6032,822013,0,5760,816253
5/2/22,Latvia,56.8796,24.6032,822726,0,5770,816956
5/3/22,Latvia,56.8796,24.6032,823110,0,5777,817333
5/4/22,Latvia,56.8796,24.6032,823110,0,5777,817333
5/5/22,Latvia,56.8796,24.6032,823732,0,5780,817952
5/6/22,Latvia,56.8796,24.6032,824046,0,5789,818257
5/7/22,Latvia,56.8796,24.6032,824046,0,5789,818257
5/8/22,Latvia,56.8796,24.6032,824046,0,5789,818257
5/9/22,Latvia,56.8796,24.6032,824635,0,5790,818845
5/10/22,Latvia,56.8796,24.6032,824926,0,5792,819134
5/11/22,Latvia,56.8796,24.6032,825272,0,5794,819478
5/12/22,Latvia,56.8796,24.6032,825470,0,5796,819674
5/13/22,Latvia,56.8796,24.6032,825699,0,5798,819901
5/14/22,Latvia,56.8796,24.6032,825699,0,5798,819901
5/15/22,Latvia,56.8796,24.6032,825699,0,5798,819901
5/16/22,Latvia,56.8796,24.6032,826038,0,5803,820235
5/17/22,Latvia,56.8796,24.6032,826342,0,5804,820538
5/18/22,Latvia,56.8796,24.6032,826506,0,5811,820695
5/19/22,Latvia,56.8796,24.6032,826735,0,5813,820922
5/20/22,Latvia,56.8796,24.6032,826856,0,5813,821043
5/21/22,Latvia,56.8796,24.6032,826856,0,5813,821043
5/22/22,Latvia,56.8796,24.6032,826856,0,5813,821043
5/23/22,Latvia,56.8796,24.6032,827201,0,5815,821386
5/24/22,Latvia,56.8796,24.6032,827437,0,5817,821620
5/25/22,Latvia,56.8796,24.6032,827699,0,5818,821881
5/26/22,Latvia,56.8796,24.6032,827889,0,5820,822069
5/27/22,Latvia,56.8796,24.6032,828077,0,5823,822254
5/28/22,Latvia,56.8796,24.6032,828077,0,5823,822254
5/29/22,Latvia,56.8796,24.6032,828077,0,5823,822254
5/30/22,Latvia,56.8796,24.6032,828406,0,5823,822583
5/31/22,Latvia,56.8796,24.6032,828614,0,5824,822790
6/1/22,Latvia,56.8796,24.6032,828822,0,5826,822996
6/2/22,Latvia,56.8796,24.6032,828998,0,5828,823170
6/3/22,Latvia,56.8796,24.6032,829143,0,5828,823315
6/4/22,Latvia,56.8796,24.6032,829143,0,5828,823315
6/5/22,Latvia,56.8796,24.6032,829143,0,5828,823315
6/6/22,Latvia,56.8796,24.6032,829425,0,5830,823595
6/7/22,Latvia,56.8796,24.6032,829640,0,5834,823806
6/8/22,Latvia,56.8796,24.6032,829851,0,5836,824015
6/9/22,Latvia,56.8796,24.6032,830076,0,5837,824239
6/10/22,Latvia,56.8796,24.6032,830281,0,5837,824444
6/11/22,Latvia,56.8796,24.6032,830281,0,5837,824444
6/12/22,Latvia,56.8796,24.6032,830281,0,5837,824444
6/13/22,Latvia,56.8796,24.6032,830698,0,5839,824859
6/14/22,Latvia,56.8796,24.6032,830977,0,5841,825136
6/15/22,Latvia,56.8796,24.6032,831248,0,5841,825407
6/16/22,Latvia,56.8796,24.6032,831521,0,5842,825679
6/17/22,Latvia,56.8796,24.6032,831727,0,5844,825883
6/18/22,Latvia,56.8796,24.6032,831727,0,5844,825883
6/19/22,Latvia,56.8796,24.6032,831727,0,5844,825883
6/20/22,Latvia,56.8796,24.6032,832168,0,5846,826322
6/21/22,Latvia,56.8796,24.6032,832485,0,5851,826634
6/22/22,Latvia,56.8796,24.6032,832884,0,5855,827029
6/23/22,Latvia,56.8796,24.6032,832884,0,5855,827029
6/24/22,Latvia,56.8796,24.6032,832884,0,5855,827029
6/25/22,Latvia,56.8796,24.6032,832884,0,5855,827029
6/26/22,Latvia,56.8796,24.6032,832884,0,5855,827029
6/27/22,Latvia,56.8796,24.6032,833711,0,5855,827856
6/28/22,Latvia,56.8796,24.6032,834535,0,5858,828677
6/29/22,Latvia,56.8796,24.6032,835152,0,5860,829292
6/30/22,Latvia,56.8796,24.6032,835797,0,5860,829937
7/1/22,Latvia,56.8796,24.6032,836259,0,5860,830399
7/2/22,Latvia,56.8796,24.6032,836259,0,5860,830399
7/3/22,Latvia,56.8796,24.6032,836259,0,5860,830399
7/4/22,Latvia,56.8796,24.6032,837182,0,5860,831322
7/5/22,Latvia,56.8796,24.6032,837872,0,5862,832010
7/6/22,Latvia,56.8796,24.6032,838557,0,5866,832691
7/7/22,Latvia,56.8796,24.6032,839251,0,5869,833382
7/8/22,Latvia,56.8796,24.6032,839846,0,5869,833977
7/9/22,Latvia,56.8796,24.6032,839846,0,5869,833977
7/10/22,Latvia,56.8796,24.6032,839846,0,5869,833977
7/11/22,Latvia,56.8796,24.6032,841132,0,5871,835261
7/12/22,Latvia,56.8796,24.6032,842127,0,5871,836256
7/13/22,Latvia,56.8796,24.6032,843035,0,5871,837164
7/14/22,Latvia,56.8796,24.6032,844142,0,5873,838269
7/15/22,Latvia,56.8796,24.6032,844980,0,5875,839105
7/16/22,Latvia,56.8796,24.6032,844980,0,5875,839105
7/17/22,Latvia,56.8796,24.6032,844980,0,5875,839105
7/18/22,Latvia,56.8796,24.6032,846530,0,5875,840655
7/19/22,Latvia,56.8796,24.6032,847709,0,5878,841831
7/20/22,Latvia,56.8796,24.6032,849802,0,5879,843923
7/21/22,Latvia,56.8796,24.6032,851433,0,5879,845554
7/22/22,Latvia,56.8796,24.6032,852683,0,5879,846804
7/23/22,Latvia,56.8796,24.6032,852683,0,5879,846804
7/24/22,Latvia,56.8796,24.6032,852683,0,5879,846804
7/25/22,Latvia,56.8796,24.6032,855249,0,5879,849370
7/26/22,Latvia,56.8796,24.6032,856617,0,5884,850733
7/27/22,Latvia,56.8796,24.6032,858728,0,5887,852841
7/28/22,Latvia,56.8796,24.6032,860303,0,5890,854413
7/29/22,Latvia,56.8796,24.6032,861724,0,5892,855832
7/30/22,Latvia,56.8796,24.6032,861724,0,5892,855832
7/31/22,Latvia,56.8796,24.6032,861724,0,5892,855832
8/1/22,Latvia,56.8796,24.6032,864329,0,5896,858433
8/2/22,Latvia,56.8796,24.6032,866034,0,5899,860135
8/3/22,Latvia,56.8796,24.6032,867809,0,5900,861909
8/4/22,Latvia,56.8796,24.6032,869576,0,5900,863676
8/5/22,Latvia,56.8796,24.6032,871181,0,5901,865280
8/6/22,Latvia,56.8796,24.6032,871181,0,5901,865280
8/7/22,Latvia,56.8796,24.6032,871181,0,5901,865280
8/8/22,Latvia,56.8796,24.6032,874090,0,5901,868189
8/9/22,Latvia,56.8796,24.6032,875821,0,5905,869916
8/10/22,Latvia,56.8796,24.6032,877702,0,5908,871794
8/11/22,Latvia,56.8796,24.6032,879481,0,5908,873573
8/12/22,Latvia,56.8796,24.6032,881020,0,5909,875111
8/13/22,Latvia,56.8796,24.6032,881020,0,5909,875111
8/14/22,Latvia,56.8796,24.6032,881020,0,5909,875111
8/15/22,Latvia,56.8796,24.6032,883631,0,5909,877722
8/16/22,Latvia,56.8796,24.6032,885310,0,5913,879397
8/17/22,Latvia,56.8796,24.6032,887046,0,5918,881128
8/18/22,Latvia,56.8796,24.6032,888512,0,5919,882593
8/19/22,Latvia,56.8796,24.6032,889656,0,5920,883736
8/20/22,Latvia,56.8796,24.6032,889656,0,5920,883736
8/21/22,Latvia,56.8796,24.6032,889656,0,5920,883736
8/22/22,Latvia,56.8796,24.6032,891726,0,5924,885802
8/23/22,Latvia,56.8796,24.6032,892641,0,5928,886713
8/24/22,Latvia,56.8796,24.6032,893613,0,5934,887679
8/25/22,Latvia,56.8796,24.6032,894519,0,5935,888584
8/26/22,Latvia,56.8796,24.6032,895513,0,5937,889576
8/27/22,Latvia,56.8796,24.6032,895513,0,5937,889576
8/28/22,Latvia,56.8796,24.6032,895513,0,5937,889576
8/29/22,Latvia,56.8796,24.6032,897178,0,5941,891237
8/30/22,Latvia,56.8796,24.6032,897957,0,5944,892013
8/31/22,Latvia,56.8796,24.6032,899133,0,5946,893187
9/1/22,Latvia,56.8796,24.6032,899938,0,5947,893991
9/2/22,Latvia,56.8796,24.6032,900654,0,5949,894705
9/3/22,Latvia,56.8796,24.6032,900654,0,5949,894705
9/4/22,Latvia,56.8796,24.6032,900654,0,5949,894705
9/5/22,Latvia,56.8796,24.6032,902095,0,5950,896145
9/6/22,Latvia,56.8796,24.6032,902890,0,5953,896937
9/7/22,Latvia,56.8796,24.6032,904090,0,5954,898136
9/8/22,Latvia,56.8796,24.6032,904983,0,5956,899027
9/9/22,Latvia,56.8796,24.6032,905904,0,5957,899947
9/10/22,Latvia,56.8796,24.6032,905904,0,5957,899947
9/11/22,Latvia,56.8796,24.6032,905904,0,5957,899947
9/12/22,Latvia,56.8796,24.6032,907831,0,5957,901874
9/13/22,Latvia,56.8796,24.6032,908852,0,5960,902892
9/14/22,Latvia,56.8796,24.6032,910583,0,5964,904619
9/15/22,Latvia,56.8796,24.6032,912002,0,5965,906037
9/16/22,Latvia,56.8796,24.6032,913371,0,5969,907402
9/17/22,Latvia,56.8796,24.6032,913371,0,5969,907402
9/18/22,Latvia,56.8796,24.6032,913371,0,5969,907402
9/19/22,Latvia,56.8796,24.6032,916282,0,5971,910311
9/20/22,Latvia,56.8796,24.6032,917595,0,5974,911621
9/21/22,Latvia,56.8796,24.6032,918860,0,5977,912883
9/22/22,Latvia,56.8796,24.6032,920545,0,5980,914565
9/23/22,Latvia,56.8796,24.6032,921974,0,5981,915993
9/24/22,Latvia,56.8796,24.6032,921974,0,5981,915993
9/25/22,Latvia,56.8796,24.6032,921974,0,5981,915993
9/26/22,Latvia,56.8796,24.6032,924651,0,5981,918670
9/27/22,Latvia,56.8796,24.6032,925883,0,5984,919899
9/28/22,Latvia,56.8796,24.6032,927676,0,5984,921692
9/29/22,Latvia,56.8796,24.6032,929051,0,5990,923061
9/30/22,Latvia,56.8796,24.6032,930254,0,5994,924260
10/1/22,Latvia,56.8796,24.6032,930254,0,5994,924260
10/2/22,Latvia,56.8796,24.6032,930254,0,5994,924260
10/3/22,Latvia,56.8796,24.6032,932485,0,5998,926487
10/4/22,Latvia,56.8796,24.6032,933476,0,6006,927470
10/5/22,Latvia,56.8796,24.6032,934888,0,6008,928880
10/6/22,Latvia,56.8796,24.6032,936008,0,6009,929999
10/7/22,Latvia,56.8796,24.6032,937162,0,6012,931150
10/8/22,Latvia,56.8796,24.6032,937162,0,6012,931150
10/9/22,Latvia,56.8796,24.6032,937162,0,6012,931150
10/10/22,Latvia,56.8796,24.6032,939146,0,6013,933133
10/11/22,Latvia,56.8796,24.6032,940131,0,6019,934112
10/12/22,Latvia,56.8796,24.6032,941284,0,6023,935261
10/13/22,Latvia,56.8796,24.6032,942091,0,6026,936065
10/14/22,Latvia,56.8796,24.6032,942923,0,6028,936895
10/15/22,Latvia,56.8796,24.6032,942923,0,6028,936895
10/16/22,Latvia,56.8796,24.6032,942923,0,6028,936895
10/17/22,Latvia,56.8796,24.6032,944302,0,6033,938269
10/18/22,Latvia,56.8796,24.6032,945174,0,6036,939138
10/19/22,Latvia,56.8796,24.6032,946092,0,6036,940056
10/20/22,Latvia,56.8796,24.6032,946914,0,6037,940877
10/21/22,Latvia,56.8796,24.6032,947539,0,6039,941500
10/22/22,Latvia,56.8796,24.6032,947539,0,6039,941500
10/23/22,Latvia,56.8796,24.6032,947539,0,6039,941500
10/24/22,Latvia,56.8796,24.6032,948611,0,6041,942570
10/25/22,Latvia,56.8796,24.6032,949252,0,6044,943208
10/26/22,Latvia,56.8796,24.6032,949986,0,6047,943939
10/27/22,Latvia,56.8796,24.6032,950668,0,6050,944618
10/28/22,Latvia,56.8796,24.6032,951164,0,6053,945111
10/29/22,Latvia,56.8796,24.6032,951164,0,6053,945111
10/30/22,Latvia,56.8796,24.6032,951164,0,6053,945111
10/31/22,Latvia,56.8796,24.6032,952099,0,6053,946046
11/1/22,Latvia,56.8796,24.6032,952692,0,6056,946636
11/2/22,Latvia,56.8796,24.6032,953337,0,6056,947281
11/3/22,Latvia,56.8796,24.6032,953835,0,6058,947777
11/4/22,Latvia,56.8796,24.6032,954230,0,6062,948168
11/5/22,Latvia,56.8796,24.6032,954230,0,6062,948168
11/6/22,Latvia,56.8796,24.6032,954230,0,6062,948168
11/7/22,Latvia,56.8796,24.6032,954953,0,6064,948889
11/8/22,Latvia,56.8796,24.6032,955436,0,6067,949369
11/9/22,Latvia,56.8796,24.6032,955943,0,6070,949873
11/10/22,Latvia,56.8796,24.6032,956392,0,6073,950319
11/11/22,Latvia,56.8796,24.6032,956780,0,6076,950704
11/12/22,Latvia,56.8796,24.6032,956780,0,6076,950704
11/13/22,Latvia,56.8796,24.6032,956780,0,6076,950704
11/14/22,Latvia,56.8796,24.6032,957510,0,6078,951432
11/15/22,Latvia,56.8796,24.6032,958064,0,6082,951982
11/16/22,Latvia,56.8796,24.6032,958569,0,6083,952486
11/17/22,Latvia,56.8796,24.6032,959019,0,6083,952936
11/18/22,Latvia,56.8796,24.6032,959019,0,6083,952936
11/19/22,Latvia,56.8796,24.6032,959019,0,6083,952936
11/20/22,Latvia,56.8796,24.6032,959019,0,6083,952936
11/21/22,Latvia,56.8796,24.6032,959835,0,6083,953752
11/22/22,Latvia,56.8796,24.6032,960450,0,6084,954366
11/23/22,Latvia,56.8796,24.6032,961086,0,6085,955001
11/24/22,Latvia,56.8796,24.6032,961627,0,6086,955541
11/25/22,Latvia,56.8796,24.6032,962085,0,6087,955998
11/26/22,Latvia,56.8796,24.6032,962085,0,6087,955998
11/27/22,Latvia,56.8796,24.6032,962085,0,6087,955998
11/28/22,Latvia,56.8796,24.6032,962085,0,6087,955998
11/29/22,Latvia,56.8796,24.6032,963451,0,6091,957360
11/30/22,Latvia,56.8796,24.6032,963451,0,6091,957360
12/1/22,Latvia,56.8796,24.6032,964571,0,6097,958474
12/2/22,Latvia,56.8796,24.6032,964959,0,6102,958857
12/3/22,Latvia,56.8796,24.6032,964959,0,6102,958857
12/4/22,Latvia,56.8796,24.6032,964959,0,6102,958857
12/5/22,Latvia,56.8796,24.6032,965678,0,6103,959575
12/6/22,Latvia,56.8796,24.6032,966131,0,6105,960026
12/7/22,Latvia,56.8796,24.6032,966813,0,6107,960706
12/8/22,Latvia,56.8796,24.6032,967273,0,6107,961166
12/9/22,Latvia,56.8796,24.6032,967729,0,6108,961621
12/10/22,Latvia,56.8796,24.6032,967729,0,6108,961621
12/11/22,Latvia,56.8796,24.6032,967729,0,6108,961621
12/12/22,Latvia,56.8796,24.6032,968527,0,6111,962416
12/13/22,Latvia,56.8796,24.6032,968992,0,6113,962879
12/14/22,Latvia,56.8796,24.6032,969495,0,6113,963382
12/15/22,Latvia,56.8796,24.6032,969930,0,6117,963813
12/16/22,Latvia,56.8796,24.6032,970286,0,6121,964165
12/17/22,Latvia,56.8796,24.6032,970286,0,6121,964165
1/1/22,Lebanon,33.8547,35.8623,731288,0,9136,722152
1/2/22,Lebanon,33.8547,35.8623,732733,0,9154,723579
1/3/22,Lebanon,33.8547,35.8623,735727,0,9174,726553
1/4/22,Lebanon,33.8547,35.8623,740814,0,9193,731621
1/5/22,Lebanon,33.8547,35.8623,746632,0,9213,737419
1/6/22,Lebanon,33.8547,35.8623,753879,0,9231,744648
1/7/22,Lebanon,33.8547,35.8623,761853,0,9250,752603
1/8/22,Lebanon,33.8547,35.8623,769400,0,9267,760133
1/9/22,Lebanon,33.8547,35.8623,774180,0,9283,764897
1/10/22,Lebanon,33.8547,35.8623,780833,0,9298,771535
1/11/22,Lebanon,33.8547,35.8623,787498,0,9311,778187
1/12/22,Lebanon,33.8547,35.8623,794744,0,9325,785419
1/13/22,Lebanon,33.8547,35.8623,801801,0,9338,792463
1/14/22,Lebanon,33.8547,35.8623,808612,0,9353,799259
1/15/22,Lebanon,33.8547,35.8623,814631,0,9367,805264
1/16/22,Lebanon,33.8547,35.8623,820170,0,9383,810787
1/17/22,Lebanon,33.8547,35.8623,826279,0,9397,816882
1/18/22,Lebanon,33.8547,35.8623,833871,0,9412,824459
1/19/22,Lebanon,33.8547,35.8623,840514,0,9429,831085
1/20/22,Lebanon,33.8547,35.8623,847624,0,9445,838179
1/21/22,Lebanon,33.8547,35.8623,853252,0,9460,843792
1/22/22,Lebanon,33.8547,35.8623,858848,0,9474,849374
1/23/22,Lebanon,33.8547,35.8623,865229,0,9487,855742
1/24/22,Lebanon,33.8547,35.8623,866894,0,9499,857395
1/25/22,Lebanon,33.8547,35.8623,874144,0,9513,864631
1/26/22,Lebanon,33.8547,35.8623,882783,0,9528,873255
1/27/22,Lebanon,33.8547,35.8623,891982,0,9544,882438
1/28/22,Lebanon,33.8547,35.8623,900098,0,9561,890537
1/29/22,Lebanon,33.8547,35.8623,907824,0,9576,898248
1/30/22,Lebanon,33.8547,35.8623,914929,0,9590,905339
1/31/22,Lebanon,33.8547,35.8623,921208,0,9606,911602
2/1/22,Lebanon,33.8547,35.8623,928522,0,9621,918901
2/2/22,Lebanon,33.8547,35.8623,939282,0,9638,929644
2/3/22,Lebanon,33.8547,35.8623,948728,0,9657,939071
2/4/22,Lebanon,33.8547,35.8623,957155,0,9675,947480
2/5/22,Lebanon,33.8547,35.8623,965627,0,9694,955933
2/6/22,Lebanon,33.8547,35.8623,971774,0,9711,962063
2/7/22,Lebanon,33.8547,35.8623,978125,0,9730,968395
2/8/22,Lebanon,33.8547,35.8623,984607,0,9750,974857
2/9/22,Lebanon,33.8547,35.8623,993095,0,9769,983326
2/10/22,Lebanon,33.8547,35.8623,999155,0,9789,989366
2/11/22,Lebanon,33.8547,35.8623,1006109,0,9807,996302
2/12/22,Lebanon,33.8547,35.8623,1012044,0,9824,1002220
2/13/22,Lebanon,33.8547,35.8623,1016487,0,9840,1006647
2/14/22,Lebanon,33.8547,35.8623,1020204,0,9855,1010349
2/15/22,Lebanon,33.8547,35.8623,1023935,0,9872,1014063
2/16/22,Lebanon,33.8547,35.8623,1029998,0,9890,1020108
2/17/22,Lebanon,33.8547,35.8623,1035209,0,9909,1025300
2/18/22,Lebanon,33.8547,35.8623,1039299,0,9929,1029370
2/19/22,Lebanon,33.8547,35.8623,1043028,0,9950,1033078
2/20/22,Lebanon,33.8547,35.8623,1046173,0,9970,1036203
2/21/22,Lebanon,33.8547,35.8623,1049274,0,9989,1039285
2/22/22,Lebanon,33.8547,35.8623,1053252,0,10007,1043245
2/23/22,Lebanon,33.8547,35.8623,1057000,0,10027,1046973
2/24/22,Lebanon,33.8547,35.8623,1060152,0,10044,1050108
2/25/22,Lebanon,33.8547,35.8623,1062879,0,10058,1052821
2/26/22,Lebanon,33.8547,35.8623,1065307,0,10069,1055238
2/27/22,Lebanon,33.8547,35.8623,1066840,0,10079,1056761
2/28/22,Lebanon,33.8547,35.8623,1068710,0,10091,1058619
3/1/22,Lebanon,33.8547,35.8623,1070696,0,10104,1060592
3/2/22,Lebanon,33.8547,35.8623,1072537,0,10115,1062422
3/3/22,Lebanon,33.8547,35.8623,1074372,0,10125,1064247
3/4/22,Lebanon,33.8547,35.8623,1075974,0,10134,1065840
3/5/22,Lebanon,33.8547,35.8623,1077242,0,10142,1067100
3/6/22,Lebanon,33.8547,35.8623,1078249,0,10152,1068097
3/7/22,Lebanon,33.8547,35.8623,1079375,0,10161,1069214
3/8/22,Lebanon,33.8547,35.8623,1080381,0,10169,1070212
3/9/22,Lebanon,33.8547,35.8623,1081463,0,10176,1071287
3/10/22,Lebanon,33.8547,35.8623,1082419,0,10185,1072234
3/11/22,Lebanon,33.8547,35.8623,1083351,0,10193,1073158
3/12/22,Lebanon,33.8547,35.8623,1084114,0,10200,1073914
3/13/22,Lebanon,33.8547,35.8623,1084600,0,10206,1074394
3/14/22,Lebanon,33.8547,35.8623,1085232,0,10211,1075021
3/15/22,Lebanon,33.8547,35.8623,1085846,0,10219,1075627
3/16/22,Lebanon,33.8547,35.8623,1086382,0,10226,1076156
3/17/22,Lebanon,33.8547,35.8623,1086890,0,10232,1076658
3/18/22,Lebanon,33.8547,35.8623,1087387,0,10237,1077150
3/19/22,Lebanon,33.8547,35.8623,1087835,0,10243,1077592
3/20/22,Lebanon,33.8547,35.8623,1088196,0,10248,1077948
3/21/22,Lebanon,33.8547,35.8623,1088595,0,10252,1078343
3/22/22,Lebanon,33.8547,35.8623,1089005,0,10258,1078747
3/23/22,Lebanon,33.8547,35.8623,1089419,0,10263,1079156
3/24/22,Lebanon,33.8547,35.8623,1089830,0,10267,1079563
3/25/22,Lebanon,33.8547,35.8623,1090208,0,10272,1079936
3/26/22,Lebanon,33.8547,35.8623,1090498,0,10278,1080220
3/27/22,Lebanon,33.8547,35.8623,1090782,0,10283,1080499
3/28/22,Lebanon,33.8547,35.8623,1091084,0,10288,1080796
3/29/22,Lebanon,33.8547,35.8623,1091413,0,10292,1081121
3/30/22,Lebanon,33.8547,35.8623,1091777,0,10297,1081480
3/31/22,Lebanon,33.8547,35.8623,1092157,0,10303,1081854
4/1/22,Lebanon,33.8547,35.8623,1092509,0,10307,1082202
4/2/22,Lebanon,33.8547,35.8623,1092807,0,10312,1082495
4/3/22,Lebanon,33.8547,35.8623,1092995,0,10315,1082680
4/4/22,Lebanon,33.8547,35.8623,1093267,0,10319,1082948
4/5/22,Lebanon,33.8547,35.8623,1093551,0,10324,1083227
4/6/22,Lebanon,33.8547,35.8623,1093850,0,10327,1083523
4/7/22,Lebanon,33.8547,35.8623,1094096,0,10331,1083765
4/8/22,Lebanon,33.8547,35.8623,1094314,0,10334,1083980
4/9/22,Lebanon,33.8547,35.8623,1094503,0,10338,1084165
4/10/22,Lebanon,33.8547,35.8623,1094672,0,10341,1084331
4/11/22,Lebanon,33.8547,35.8623,1094803,0,10345,1084458
4/12/22,Lebanon,33.8547,35.8623,1094911,0,10350,1084561
4/13/22,Lebanon,33.8547,35.8623,1095099,0,10353,1084746
4/14/22,Lebanon,33.8547,35.8623,1095099,0,10353,1084746
4/15/22,Lebanon,33.8547,35.8623,1095406,0,10355,1085051
4/16/22,Lebanon,33.8547,35.8623,1095518,0,10358,1085160
4/17/22,Lebanon,33.8547,35.8623,1095613,0,10360,1085253
4/18/22,Lebanon,33.8547,35.8623,1095685,0,10363,1085322
4/19/22,Lebanon,33.8547,35.8623,1095811,0,10365,1085446
4/20/22,Lebanon,33.8547,35.8623,1095959,0,10368,1085591
4/21/22,Lebanon,33.8547,35.8623,1096099,0,10370,1085729
4/22/22,Lebanon,33.8547,35.8623,1096227,0,10372,1085855
4/23/22,Lebanon,33.8547,35.8623,1096320,0,10374,1085946
4/24/22,Lebanon,33.8547,35.8623,1096406,0,10375,1086031
4/25/22,Lebanon,33.8547,35.8623,1096462,0,10378,1086084
4/26/22,Lebanon,33.8547,35.8623,1096530,0,10380,1086150
4/27/22,Lebanon,33.8547,35.8623,1096648,0,10381,1086267
4/28/22,Lebanon,33.8547,35.8623,1096763,0,10382,1086381
4/29/22,Lebanon,33.8547,35.8623,1096854,0,10384,1086470
4/30/22,Lebanon,33.8547,35.8623,1096955,0,10386,1086569
5/1/22,Lebanon,33.8547,35.8623,1097044,0,10387,1086657
5/2/22,Lebanon,33.8547,35.8623,1097044,0,10387,1086657
5/3/22,Lebanon,33.8547,35.8623,1097118,0,10392,1086726
5/4/22,Lebanon,33.8547,35.8623,1097118,0,10392,1086726
5/5/22,Lebanon,33.8547,35.8623,1097268,0,10395,1086873
5/6/22,Lebanon,33.8547,35.8623,1097390,0,10396,1086994
5/7/22,Lebanon,33.8547,35.8623,1097492,0,10398,1087094
5/8/22,Lebanon,33.8547,35.8623,1097539,0,10399,1087140
5/9/22,Lebanon,33.8547,35.8623,1097575,0,10400,1087175
5/10/22,Lebanon,33.8547,35.8623,1097643,0,10402,1087241
5/11/22,Lebanon,33.8547,35.8623,1097720,0,10403,1087317
5/12/22,Lebanon,33.8547,35.8623,1097800,0,10404,1087396
5/13/22,Lebanon,33.8547,35.8623,1097820,0,10405,1087415
5/14/22,Lebanon,33.8547,35.8623,1097956,0,10407,1087549
5/15/22,Lebanon,33.8547,35.8623,1098034,0,10408,1087626
5/16/22,Lebanon,33.8547,35.8623,1098074,0,10409,1087665
5/17/22,Lebanon,33.8547,35.8623,1098124,0,10411,1087713
5/18/22,Lebanon,33.8547,35.8623,1098124,0,10411,1087713
5/19/22,Lebanon,33.8547,35.8623,1098313,0,10414,1087899
5/20/22,Lebanon,33.8547,35.8623,1098432,0,10416,1088016
5/21/22,Lebanon,33.8547,35.8623,1098503,0,10417,1088086
5/22/22,Lebanon,33.8547,35.8623,1098503,0,10417,1088086
5/23/22,Lebanon,33.8547,35.8623,1098640,0,10418,1088222
5/24/22,Lebanon,33.8547,35.8623,1098710,0,10420,1088290
5/25/22,Lebanon,33.8547,35.8623,1098791,0,10422,1088369
5/26/22,Lebanon,33.8547,35.8623,1098899,0,10423,1088476
5/27/22,Lebanon,33.8547,35.8623,1098971,0,10424,1088547
5/28/22,Lebanon,33.8547,35.8623,1099065,0,10425,1088640
5/29/22,Lebanon,33.8547,35.8623,1099148,0,10427,1088721
5/30/22,Lebanon,33.8547,35.8623,1099148,0,10428,1088720
5/31/22,Lebanon,33.8547,35.8623,1099199,0,10429,1088770
6/1/22,Lebanon,33.8547,35.8623,1099265,0,10431,1088834
6/2/22,Lebanon,33.8547,35.8623,1099368,0,10432,1088936
6/3/22,Lebanon,33.8547,35.8623,1099368,0,10432,1088936
6/4/22,Lebanon,33.8547,35.8623,1099745,0,10435,1089310
6/5/22,Lebanon,33.8547,35.8623,1099745,0,10435,1089310
6/6/22,Lebanon,33.8547,35.8623,1099896,0,10437,1089459
6/7/22,Lebanon,33.8547,35.8623,1099896,0,10438,1089458
6/8/22,Lebanon,33.8547,35.8623,1100007,0,10439,1089568
6/9/22,Lebanon,33.8547,35.8623,1100202,0,10440,1089762
6/10/22,Lebanon,33.8547,35.8623,1100202,0,10440,1089762
6/11/22,Lebanon,33.8547,35.8623,1100871,0,10444,1090427
6/12/22,Lebanon,33.8547,35.8623,1101109,0,10445,1090664
6/13/22,Lebanon,33.8547,35.8623,1101247,0,10446,1090801
6/14/22,Lebanon,33.8547,35.8623,1101508,0,10447,1091061
6/15/22,Lebanon,33.8547,35.8623,1101508,0,10447,1091061
6/16/22,Lebanon,33.8547,35.8623,1101508,0,10447,1091061
6/17/22,Lebanon,33.8547,35.8623,1102774,0,10448,1092326
6/18/22,Lebanon,33.8547,35.8623,1103264,0,10450,1092814
6/19/22,Lebanon,33.8547,35.8623,1103264,0,10450,1092814
6/20/22,Lebanon,33.8547,35.8623,1103711,0,10451,1093260
6/21/22,Lebanon,33.8547,35.8623,1104268,0,10455,1093813
6/22/22,Lebanon,33.8547,35.8623,1105129,0,10456,1094673
6/23/22,Lebanon,33.8547,35.8623,1105959,0,10457,1095502
6/24/22,Lebanon,33.8547,35.8623,1106766,0,10458,1096308
6/25/22,Lebanon,33.8547,35.8623,1107602,0,10460,1097142
6/26/22,Lebanon,33.8547,35.8623,1108213,0,10461,1097752
6/27/22,Lebanon,33.8547,35.8623,1108213,0,10461,1097752
6/28/22,Lebanon,33.8547,35.8623,1109423,0,10463,1098960
6/29/22,Lebanon,33.8547,35.8623,1110822,0,10464,1100358
6/30/22,Lebanon,33.8547,35.8623,1112199,0,10465,1101734
7/1/22,Lebanon,33.8547,35.8623,1113519,0,10466,1103053
7/2/22,Lebanon,33.8547,35.8623,1114814,0,10467,1104347
7/3/22,Lebanon,33.8547,35.8623,1115719,0,10468,1105251
7/4/22,Lebanon,33.8547,35.8623,1116798,0,10469,1106329
7/5/22,Lebanon,33.8547,35.8623,1117540,0,10470,1107070
7/6/22,Lebanon,33.8547,35.8623,1119461,0,10471,1108990
7/7/22,Lebanon,33.8547,35.8623,1121054,0,10473,1110581
7/8/22,Lebanon,33.8547,35.8623,1121054,0,10473,1110581
7/9/22,Lebanon,33.8547,35.8623,1121054,0,10473,1110581
7/10/22,Lebanon,33.8547,35.8623,1125720,0,10477,1115243
7/11/22,Lebanon,33.8547,35.8623,1125720,0,10477,1115243
7/12/22,Lebanon,33.8547,35.8623,1126411,0,10479,1115932
7/13/22,Lebanon,33.8547,35.8623,1126411,0,10479,1115932
7/14/22,Lebanon,33.8547,35.8623,1129660,0,10482,1119178
7/15/22,Lebanon,33.8547,35.8623,1135565,0,10485,1125080
7/16/22,Lebanon,33.8547,35.8623,1138458,0,10487,1127971
7/17/22,Lebanon,33.8547,35.8623,1140794,0,10489,1130305
7/18/22,Lebanon,33.8547,35.8623,1142644,0,10491,1132153
7/19/22,Lebanon,33.8547,35.8623,1144149,0,10494,1133655
7/20/22,Lebanon,33.8547,35.8623,1147581,0,10496,1137085
7/21/22,Lebanon,33.8547,35.8623,1150424,0,10499,1139925
7/22/22,Lebanon,33.8547,35.8623,1153070,0,10502,1142568
7/23/22,Lebanon,33.8547,35.8623,1155660,0,10506,1145154
7/24/22,Lebanon,33.8547,35.8623,1157682,0,10509,1147173
7/25/22,Lebanon,33.8547,35.8623,1159629,0,10512,1149117
7/26/22,Lebanon,33.8547,35.8623,1161100,0,10515,1150585
7/27/22,Lebanon,33.8547,35.8623,1164395,0,10519,1153876
7/28/22,Lebanon,33.8547,35.8623,1167040,0,10523,1156517
7/29/22,Lebanon,33.8547,35.8623,1169584,0,10526,1159058
7/30/22,Lebanon,33.8547,35.8623,1172269,0,10529,1161740
7/31/22,Lebanon,33.8547,35.8623,1173871,0,10532,1163339
8/1/22,Lebanon,33.8547,35.8623,1175514,0,10534,1164980
8/2/22,Lebanon,33.8547,35.8623,1176838,0,10536,1166302
8/3/22,Lebanon,33.8547,35.8623,1179481,0,10538,1168943
8/4/22,Lebanon,33.8547,35.8623,1181614,0,10540,1171074
8/5/22,Lebanon,33.8547,35.8623,1183450,0,10543,1172907
8/6/22,Lebanon,33.8547,35.8623,1185405,0,10546,1174859
8/7/22,Lebanon,33.8547,35.8623,1186920,0,10548,1176372
8/8/22,Lebanon,33.8547,35.8623,1188468,0,10550,1177918
8/9/22,Lebanon,33.8547,35.8623,1189500,0,10553,1178947
8/10/22,Lebanon,33.8547,35.8623,1191206,0,10557,1180649
8/11/22,Lebanon,33.8547,35.8623,1192687,0,10561,1182126
8/12/22,Lebanon,33.8547,35.8623,1194341,0,10566,1183775
8/13/22,Lebanon,33.8547,35.8623,1195784,0,10572,1185212
8/14/22,Lebanon,33.8547,35.8623,1197041,0,10576,1186465
8/15/22,Lebanon,33.8547,35.8623,1197866,0,10581,1187285
8/16/22,Lebanon,33.8547,35.8623,1198892,0,10585,1188307
8/17/22,Lebanon,33.8547,35.8623,1200111,0,10589,1189522
8/18/22,Lebanon,33.8547,35.8623,1201320,0,10593,1190727
8/19/22,Lebanon,33.8547,35.8623,1202481,0,10596,1191885
8/20/22,Lebanon,33.8547,35.8623,1203404,0,10599,1192805
8/21/22,Lebanon,33.8547,35.8623,1204106,0,10602,1193504
8/22/22,Lebanon,33.8547,35.8623,1204727,0,10606,1194121
8/23/22,Lebanon,33.8547,35.8623,1205169,0,10609,1194560
8/24/22,Lebanon,33.8547,35.8623,1206052,0,10612,1195440
8/25/22,Lebanon,33.8547,35.8623,1206757,0,10615,1196142
8/26/22,Lebanon,33.8547,35.8623,1207385,0,10617,1196768
8/27/22,Lebanon,33.8547,35.8623,1207873,0,10619,1197254
8/28/22,Lebanon,33.8547,35.8623,1208304,0,10621,1197683
8/29/22,Lebanon,33.8547,35.8623,1208681,0,10622,1198059
8/30/22,Lebanon,33.8547,35.8623,1208681,0,10622,1198059
8/31/22,Lebanon,33.8547,35.8623,1209478,0,10627,1198851
9/1/22,Lebanon,33.8547,35.8623,1209872,0,10631,1199241
9/2/22,Lebanon,33.8547,35.8623,1209872,0,10631,1199241
9/3/22,Lebanon,33.8547,35.8623,1210566,0,10636,1199930
9/4/22,Lebanon,33.8547,35.8623,1210847,0,10638,1200209
9/5/22,Lebanon,33.8547,35.8623,1211140,0,10639,1200501
9/6/22,Lebanon,33.8547,35.8623,1211274,0,10640,1200634
9/7/22,Lebanon,33.8547,35.8623,1211655,0,10641,1201014
9/8/22,Lebanon,33.8547,35.8623,1212025,0,10642,1201383
9/9/22,Lebanon,33.8547,35.8623,1212258,0,10644,1201614
9/10/22,Lebanon,33.8547,35.8623,1212497,0,10645,1201852
9/11/22,Lebanon,33.8547,35.8623,1212668,0,10646,1202022
9/12/22,Lebanon,33.8547,35.8623,1212815,0,10647,1202168
9/13/22,Lebanon,33.8547,35.8623,1212983,0,10648,1202335
9/14/22,Lebanon,33.8547,35.8623,1213200,0,10650,1202550
9/15/22,Lebanon,33.8547,35.8623,1213376,0,10653,1202723
9/16/22,Lebanon,33.8547,35.8623,1213589,0,10655,1202934
9/17/22,Lebanon,33.8547,35.8623,1213769,0,10657,1203112
9/18/22,Lebanon,33.8547,35.8623,1213769,0,10657,1203112
9/19/22,Lebanon,33.8547,35.8623,1213902,0,10659,1203243
9/20/22,Lebanon,33.8547,35.8623,1214164,0,10662,1203502
9/21/22,Lebanon,33.8547,35.8623,1214164,0,10662,1203502
9/22/22,Lebanon,33.8547,35.8623,1214408,0,10664,1203744
9/23/22,Lebanon,33.8547,35.8623,1214561,0,10666,1203895
9/24/22,Lebanon,33.8547,35.8623,1214892,0,10670,1204222
9/25/22,Lebanon,33.8547,35.8623,1214892,0,10670,1204222
9/26/22,Lebanon,33.8547,35.8623,1215148,0,10672,1204476
9/27/22,Lebanon,33.8547,35.8623,1215148,0,10672,1204476
9/28/22,Lebanon,33.8547,35.8623,1215265,0,10673,1204592
9/29/22,Lebanon,33.8547,35.8623,1215511,0,10674,1204837
9/30/22,Lebanon,33.8547,35.8623,1215805,0,10676,1205129
10/1/22,Lebanon,33.8547,35.8623,1215925,0,10677,1205248
10/2/22,Lebanon,33.8547,35.8623,1216025,0,10678,1205347
10/3/22,Lebanon,33.8547,35.8623,1216142,0,10679,1205463
10/4/22,Lebanon,33.8547,35.8623,1216190,0,10681,1205509
10/5/22,Lebanon,33.8547,35.8623,1216190,0,10681,1205509
10/6/22,Lebanon,33.8547,35.8623,1216522,0,10683,1205839
10/7/22,Lebanon,33.8547,35.8623,1216638,0,10684,1205954
10/8/22,Lebanon,33.8547,35.8623,1216638,0,10684,1205954
10/9/22,Lebanon,33.8547,35.8623,1216638,0,10684,1205954
10/10/22,Lebanon,33.8547,35.8623,1216638,0,10684,1205954
10/11/22,Lebanon,33.8547,35.8623,1216919,0,10687,1206232
10/12/22,Lebanon,33.8547,35.8623,1216999,0,10688,1206311
10/13/22,Lebanon,33.8547,35.8623,1216999,0,10688,1206311
10/14/22,Lebanon,33.8547,35.8623,1216999,0,10688,1206311
10/15/22,Lebanon,33.8547,35.8623,1216999,0,10688,1206311
10/16/22,Lebanon,33.8547,35.8623,1216999,0,10688,1206311
10/17/22,Lebanon,33.8547,35.8623,1216999,0,10688,1206311
10/18/22,Lebanon,33.8547,35.8623,1216999,0,10688,1206311
10/19/22,Lebanon,33.8547,35.8623,1217831,0,10696,1207135
10/20/22,Lebanon,33.8547,35.8623,1217831,0,10696,1207135
10/21/22,Lebanon,33.8547,35.8623,1218004,0,10698,1207306
10/22/22,Lebanon,33.8547,35.8623,1218082,0,10699,1207383
10/23/22,Lebanon,33.8547,35.8623,1218082,0,10699,1207383
10/24/22,Lebanon,33.8547,35.8623,1218207,0,10701,1207506
10/25/22,Lebanon,33.8547,35.8623,1218268,0,10702,1207566
10/26/22,Lebanon,33.8547,35.8623,1218268,0,10702,1207566
10/27/22,Lebanon,33.8547,35.8623,1218268,0,10702,1207566
10/28/22,Lebanon,33.8547,35.8623,1218474,0,10704,1207770
10/29/22,Lebanon,33.8547,35.8623,1218554,0,10705,1207849
10/30/22,Lebanon,33.8547,35.8623,1218630,0,10706,1207924
10/31/22,Lebanon,33.8547,35.8623,1218779,0,10708,1208071
11/1/22,Lebanon,33.8547,35.8623,1218779,0,10708,1208071
11/2/22,Lebanon,33.8547,35.8623,1218810,0,10709,1208101
11/3/22,Lebanon,33.8547,35.8623,1218923,0,10710,1208213
11/4/22,Lebanon,33.8547,35.8623,1218987,0,10711,1208276
11/5/22,Lebanon,33.8547,35.8623,1219066,0,10712,1208354
11/6/22,Lebanon,33.8547,35.8623,1219141,0,10713,1208428
11/7/22,Lebanon,33.8547,35.8623,1219141,0,10713,1208428
11/8/22,Lebanon,33.8547,35.8623,1219141,0,10713,1208428
11/9/22,Lebanon,33.8547,35.8623,1219297,0,10716,1208581
11/10/22,Lebanon,33.8547,35.8623,1219415,0,10717,1208698
11/11/22,Lebanon,33.8547,35.8623,1219465,0,10718,1208747
11/12/22,Lebanon,33.8547,35.8623,1219573,0,10720,1208853
11/13/22,Lebanon,33.8547,35.8623,1219608,0,10721,1208887
11/14/22,Lebanon,33.8547,35.8623,1219608,0,10721,1208887
11/15/22,Lebanon,33.8547,35.8623,1219677,0,10722,1208955
11/16/22,Lebanon,33.8547,35.8623,1219834,0,10724,1209110
11/17/22,Lebanon,33.8547,35.8623,1219834,0,10724,1209110
11/18/22,Lebanon,33.8547,35.8623,1219928,0,10725,1209203
11/19/22,Lebanon,33.8547,35.8623,1219993,0,10726,1209267
11/20/22,Lebanon,33.8547,35.8623,1220043,0,10727,1209316
11/21/22,Lebanon,33.8547,35.8623,1220127,0,10729,1209398
11/22/22,Lebanon,33.8547,35.8623,1220157,0,10730,1209427
11/23/22,Lebanon,33.8547,35.8623,1220211,0,10731,1209480
11/24/22,Lebanon,33.8547,35.8623,1220272,0,10732,1209540
11/25/22,Lebanon,33.8547,35.8623,1220329,0,10733,1209596
11/26/22,Lebanon,33.8547,35.8623,1220385,0,10734,1209651
11/27/22,Lebanon,33.8547,35.8623,1220385,0,10734,1209651
11/28/22,Lebanon,33.8547,35.8623,1220443,0,10736,1209707
11/29/22,Lebanon,33.8547,35.8623,1220443,0,10736,1209707
11/30/22,Lebanon,33.8547,35.8623,1220560,0,10737,1209823
12/1/22,Lebanon,33.8547,35.8623,1220602,0,10737,1209865
12/2/22,Lebanon,33.8547,35.8623,1220661,0,10738,1209923
12/3/22,Lebanon,33.8547,35.8623,1220714,0,10739,1209975
12/4/22,Lebanon,33.8547,35.8623,1220714,0,10739,1209975
12/5/22,Lebanon,33.8547,35.8623,1220800,0,10740,1210060
12/6/22,Lebanon,33.8547,35.8623,1220800,0,10740,1210060
12/7/22,Lebanon,33.8547,35.8623,1220831,0,10740,1210091
12/8/22,Lebanon,33.8547,35.8623,1220988,0,10741,1210247
12/9/22,Lebanon,33.8547,35.8623,1221049,0,10741,1210308
12/10/22,Lebanon,33.8547,35.8623,1221049,0,10741,1210308
12/11/22,Lebanon,33.8547,35.8623,1221144,0,10741,1210403
12/12/22,Lebanon,33.8547,35.8623,1221182,0,10741,1210441
12/13/22,Lebanon,33.8547,35.8623,1221273,0,10741,1210532
12/14/22,Lebanon,33.8547,35.8623,1221370,0,10742,1210628
12/15/22,Lebanon,33.8547,35.8623,1221370,0,10742,1210628
12/16/22,Lebanon,33.8547,35.8623,1221572,0,10742,1210830
12/17/22,Lebanon,33.8547,35.8623,1221640,0,10742,1210898
1/1/22,Lesotho,-29.61,28.2336,29652,0,671,28981
1/2/22,Lesotho,-29.61,28.2336,29756,0,671,29085
1/3/22,Lesotho,-29.61,28.2336,29999,0,673,29326
1/4/22,Lesotho,-29.61,28.2336,29999,0,673,29326
1/5/22,Lesotho,-29.61,28.2336,29999,0,673,29326
1/6/22,Lesotho,-29.61,28.2336,29999,0,673,29326
1/7/22,Lesotho,-29.61,28.2336,30651,0,678,29973
1/8/22,Lesotho,-29.61,28.2336,30853,0,679,30174
1/9/22,Lesotho,-29.61,28.2336,31106,0,683,30423
1/10/22,Lesotho,-29.61,28.2336,31106,0,683,30423
1/11/22,Lesotho,-29.61,28.2336,31372,0,686,30686
1/12/22,Lesotho,-29.61,28.2336,31372,0,686,30686
1/13/22,Lesotho,-29.61,28.2336,31604,0,687,30917
1/14/22,Lesotho,-29.61,28.2336,31604,0,687,30917
1/15/22,Lesotho,-29.61,28.2336,31734,0,687,31047
1/16/22,Lesotho,-29.61,28.2336,31734,0,687,31047
1/17/22,Lesotho,-29.61,28.2336,31734,0,687,31047
1/18/22,Lesotho,-29.61,28.2336,31734,0,687,31047
1/19/22,Lesotho,-29.61,28.2336,31899,0,690,31209
1/20/22,Lesotho,-29.61,28.2336,31899,0,690,31209
1/21/22,Lesotho,-29.61,28.2336,31899,0,690,31209
1/22/22,Lesotho,-29.61,28.2336,31899,0,690,31209
1/23/22,Lesotho,-29.61,28.2336,32049,0,690,31359
1/24/22,Lesotho,-29.61,28.2336,32049,0,690,31359
1/25/22,Lesotho,-29.61,28.2336,32049,0,690,31359
1/26/22,Lesotho,-29.61,28.2336,32049,0,690,31359
1/27/22,Lesotho,-29.61,28.2336,32049,0,690,31359
1/28/22,Lesotho,-29.61,28.2336,32176,0,693,31483
1/29/22,Lesotho,-29.61,28.2336,32176,0,693,31483
1/30/22,Lesotho,-29.61,28.2336,32176,0,693,31483
1/31/22,Lesotho,-29.61,28.2336,32176,0,693,31483
2/1/22,Lesotho,-29.61,28.2336,32176,0,693,31483
2/2/22,Lesotho,-29.61,28.2336,32258,0,694,31564
2/3/22,Lesotho,-29.61,28.2336,32258,0,694,31564
2/4/22,Lesotho,-29.61,28.2336,32258,0,694,31564
2/5/22,Lesotho,-29.61,28.2336,32258,0,694,31564
2/6/22,Lesotho,-29.61,28.2336,32258,0,694,31564
2/7/22,Lesotho,-29.61,28.2336,32350,0,695,31655
2/8/22,Lesotho,-29.61,28.2336,32350,0,695,31655
2/9/22,Lesotho,-29.61,28.2336,32350,0,695,31655
2/10/22,Lesotho,-29.61,28.2336,32372,0,696,31676
2/11/22,Lesotho,-29.61,28.2336,32372,0,696,31676
2/12/22,Lesotho,-29.61,28.2336,32372,0,696,31676
2/13/22,Lesotho,-29.61,28.2336,32372,0,696,31676
2/14/22,Lesotho,-29.61,28.2336,32434,0,696,31738
2/15/22,Lesotho,-29.61,28.2336,32434,0,696,31738
2/16/22,Lesotho,-29.61,28.2336,32434,0,696,31738
2/17/22,Lesotho,-29.61,28.2336,32434,0,696,31738
2/18/22,Lesotho,-29.61,28.2336,32434,0,696,31738
2/19/22,Lesotho,-29.61,28.2336,32434,0,696,31738
2/20/22,Lesotho,-29.61,28.2336,32434,0,696,31738
2/21/22,Lesotho,-29.61,28.2336,32434,0,696,31738
2/22/22,Lesotho,-29.61,28.2336,32599,0,696,31903
2/23/22,Lesotho,-29.61,28.2336,32599,0,696,31903
2/24/22,Lesotho,-29.61,28.2336,32599,0,696,31903
2/25/22,Lesotho,-29.61,28.2336,32612,0,696,31916
2/26/22,Lesotho,-29.61,28.2336,32612,0,696,31916
2/27/22,Lesotho,-29.61,28.2336,32612,0,696,31916
2/28/22,Lesotho,-29.61,28.2336,32612,0,696,31916
3/1/22,Lesotho,-29.61,28.2336,32612,0,696,31916
3/2/22,Lesotho,-29.61,28.2336,32612,0,696,31916
3/3/22,Lesotho,-29.61,28.2336,32707,0,697,32010
3/4/22,Lesotho,-29.61,28.2336,32707,0,697,32010
3/5/22,Lesotho,-29.61,28.2336,32707,0,697,32010
3/6/22,Lesotho,-29.61,28.2336,32707,0,697,32010
3/7/22,Lesotho,-29.61,28.2336,32707,0,697,32010
3/8/22,Lesotho,-29.61,28.2336,32716,0,697,32019
3/9/22,Lesotho,-29.61,28.2336,32716,0,697,32019
3/10/22,Lesotho,-29.61,28.2336,32716,0,697,32019
3/11/22,Lesotho,-29.61,28.2336,32716,0,697,32019
3/12/22,Lesotho,-29.61,28.2336,32716,0,697,32019
3/13/22,Lesotho,-29.61,28.2336,32716,0,697,32019
3/14/22,Lesotho,-29.61,28.2336,32775,0,697,32078
3/15/22,Lesotho,-29.61,28.2336,32775,0,697,32078
3/16/22,Lesotho,-29.61,28.2336,32775,0,697,32078
3/17/22,Lesotho,-29.61,28.2336,32775,0,697,32078
3/18/22,Lesotho,-29.61,28.2336,32775,0,697,32078
3/19/22,Lesotho,-29.61,28.2336,32775,0,697,32078
3/20/22,Lesotho,-29.61,28.2336,32775,0,697,32078
3/21/22,Lesotho,-29.61,28.2336,32775,0,697,32078
3/22/22,Lesotho,-29.61,28.2336,32880,0,697,32183
3/23/22,Lesotho,-29.61,28.2336,32880,0,697,32183
3/24/22,Lesotho,-29.61,28.2336,32880,0,697,32183
3/25/22,Lesotho,-29.61,28.2336,32880,0,697,32183
3/26/22,Lesotho,-29.61,28.2336,32880,0,697,32183
3/27/22,Lesotho,-29.61,28.2336,32880,0,697,32183
3/28/22,Lesotho,-29.61,28.2336,32880,0,697,32183
3/29/22,Lesotho,-29.61,28.2336,32880,0,697,32183
3/30/22,Lesotho,-29.61,28.2336,32899,0,697,32202
3/31/22,Lesotho,-29.61,28.2336,32910,0,697,32213
4/1/22,Lesotho,-29.61,28.2336,32910,0,697,32213
4/2/22,Lesotho,-29.61,28.2336,32910,0,697,32213
4/3/22,Lesotho,-29.61,28.2336,32910,0,697,32213
4/4/22,Lesotho,-29.61,28.2336,32910,0,697,32213
4/5/22,Lesotho,-29.61,28.2336,32910,0,697,32213
4/6/22,Lesotho,-29.61,28.2336,32910,0,697,32213
4/7/22,Lesotho,-29.61,28.2336,32910,0,697,32213
4/8/22,Lesotho,-29.61,28.2336,32910,0,697,32213
4/9/22,Lesotho,-29.61,28.2336,32910,0,697,32213
4/10/22,Lesotho,-29.61,28.2336,32910,0,697,32213
4/11/22,Lesotho,-29.61,28.2336,32968,0,697,32271
4/12/22,Lesotho,-29.61,28.2336,32968,0,697,32271
4/13/22,Lesotho,-29.61,28.2336,32968,0,697,32271
4/14/22,Lesotho,-29.61,28.2336,32968,0,697,32271
4/15/22,Lesotho,-29.61,28.2336,32968,0,697,32271
4/16/22,Lesotho,-29.61,28.2336,32968,0,697,32271
4/17/22,Lesotho,-29.61,28.2336,32968,0,697,32271
4/18/22,Lesotho,-29.61,28.2336,32968,0,697,32271
4/19/22,Lesotho,-29.61,28.2336,32968,0,697,32271
4/20/22,Lesotho,-29.61,28.2336,32968,0,697,32271
4/21/22,Lesotho,-29.61,28.2336,32968,0,697,32271
4/22/22,Lesotho,-29.61,28.2336,32968,0,697,32271
4/23/22,Lesotho,-29.61,28.2336,32968,0,697,32271
4/24/22,Lesotho,-29.61,28.2336,32968,0,697,32271
4/25/22,Lesotho,-29.61,28.2336,32968,0,697,32271
4/26/22,Lesotho,-29.61,28.2336,32968,0,697,32271
4/27/22,Lesotho,-29.61,28.2336,32968,0,697,32271
4/28/22,Lesotho,-29.61,28.2336,32968,0,697,32271
4/29/22,Lesotho,-29.61,28.2336,33015,0,697,32318
4/30/22,Lesotho,-29.61,28.2336,33015,0,697,32318
5/1/22,Lesotho,-29.61,28.2336,33015,0,697,32318
5/2/22,Lesotho,-29.61,28.2336,33134,0,697,32437
5/3/22,Lesotho,-29.61,28.2336,33134,0,697,32437
5/4/22,Lesotho,-29.61,28.2336,33134,0,697,32437
5/5/22,Lesotho,-29.61,28.2336,33151,0,697,32454
5/6/22,Lesotho,-29.61,28.2336,33151,0,697,32454
5/7/22,Lesotho,-29.61,28.2336,33151,0,697,32454
5/8/22,Lesotho,-29.61,28.2336,33151,0,697,32454
5/9/22,Lesotho,-29.61,28.2336,33151,0,697,32454
5/10/22,Lesotho,-29.61,28.2336,33151,0,697,32454
5/11/22,Lesotho,-29.61,28.2336,33151,0,697,32454
5/12/22,Lesotho,-29.61,28.2336,33151,0,697,32454
5/13/22,Lesotho,-29.61,28.2336,33151,0,697,32454
5/14/22,Lesotho,-29.61,28.2336,33151,0,697,32454
5/15/22,Lesotho,-29.61,28.2336,33151,0,697,32454
5/16/22,Lesotho,-29.61,28.2336,33151,0,697,32454
5/17/22,Lesotho,-29.61,28.2336,33151,0,697,32454
5/18/22,Lesotho,-29.61,28.2336,33305,0,698,32607
5/19/22,Lesotho,-29.61,28.2336,33305,0,698,32607
5/20/22,Lesotho,-29.61,28.2336,33305,0,698,32607
5/21/22,Lesotho,-29.61,28.2336,33305,0,698,32607
5/22/22,Lesotho,-29.61,28.2336,33305,0,698,32607
5/23/22,Lesotho,-29.61,28.2336,33305,0,698,32607
5/24/22,Lesotho,-29.61,28.2336,33305,0,698,32607
5/25/22,Lesotho,-29.61,28.2336,33358,0,698,32660
5/26/22,Lesotho,-29.61,28.2336,33358,0,698,32660
5/27/22,Lesotho,-29.61,28.2336,33358,0,698,32660
5/28/22,Lesotho,-29.61,28.2336,33358,0,698,32660
5/29/22,Lesotho,-29.61,28.2336,33358,0,698,32660
5/30/22,Lesotho,-29.61,28.2336,33358,0,698,32660
5/31/22,Lesotho,-29.61,28.2336,33358,0,698,32660
6/1/22,Lesotho,-29.61,28.2336,33358,0,698,32660
6/2/22,Lesotho,-29.61,28.2336,33562,0,699,32863
6/3/22,Lesotho,-29.61,28.2336,33562,0,699,32863
6/4/22,Lesotho,-29.61,28.2336,33562,0,699,32863
6/5/22,Lesotho,-29.61,28.2336,33562,0,699,32863
6/6/22,Lesotho,-29.61,28.2336,33562,0,699,32863
6/7/22,Lesotho,-29.61,28.2336,33562,0,699,32863
6/8/22,Lesotho,-29.61,28.2336,33690,0,699,32991
6/9/22,Lesotho,-29.61,28.2336,33746,0,699,33047
6/10/22,Lesotho,-29.61,28.2336,33746,0,699,33047
6/11/22,Lesotho,-29.61,28.2336,33746,0,699,33047
6/12/22,Lesotho,-29.61,28.2336,33746,0,699,33047
6/13/22,Lesotho,-29.61,28.2336,33746,0,699,33047
6/14/22,Lesotho,-29.61,28.2336,33746,0,699,33047
6/15/22,Lesotho,-29.61,28.2336,33746,0,699,33047
6/16/22,Lesotho,-29.61,28.2336,33746,0,699,33047
6/17/22,Lesotho,-29.61,28.2336,33746,0,699,33047
6/18/22,Lesotho,-29.61,28.2336,33746,0,699,33047
6/19/22,Lesotho,-29.61,28.2336,33746,0,699,33047
6/20/22,Lesotho,-29.61,28.2336,33938,0,699,33239
6/21/22,Lesotho,-29.61,28.2336,33938,0,699,33239
6/22/22,Lesotho,-29.61,28.2336,33938,0,699,33239
6/23/22,Lesotho,-29.61,28.2336,33938,0,699,33239
6/24/22,Lesotho,-29.61,28.2336,33938,0,699,33239
6/25/22,Lesotho,-29.61,28.2336,33938,0,699,33239
6/26/22,Lesotho,-29.61,28.2336,33938,0,699,33239
6/27/22,Lesotho,-29.61,28.2336,33938,0,699,33239
6/28/22,Lesotho,-29.61,28.2336,33938,0,699,33239
6/29/22,Lesotho,-29.61,28.2336,33938,0,699,33239
6/30/22,Lesotho,-29.61,28.2336,33938,0,699,33239
7/1/22,Lesotho,-29.61,28.2336,33938,0,699,33239
7/2/22,Lesotho,-29.61,28.2336,33938,0,699,33239
7/3/22,Lesotho,-29.61,28.2336,33938,0,699,33239
7/4/22,Lesotho,-29.61,28.2336,33938,0,699,33239
7/5/22,Lesotho,-29.61,28.2336,33938,0,699,33239
7/6/22,Lesotho,-29.61,28.2336,33938,0,699,33239
7/7/22,Lesotho,-29.61,28.2336,33938,0,699,33239
7/8/22,Lesotho,-29.61,28.2336,33938,0,699,33239
7/9/22,Lesotho,-29.61,28.2336,33938,0,699,33239
7/10/22,Lesotho,-29.61,28.2336,33938,0,699,33239
7/11/22,Lesotho,-29.61,28.2336,34040,0,702,33338
7/12/22,Lesotho,-29.61,28.2336,34040,0,702,33338
7/13/22,Lesotho,-29.61,28.2336,34040,0,702,33338
7/14/22,Lesotho,-29.61,28.2336,34040,0,702,33338
7/15/22,Lesotho,-29.61,28.2336,34040,0,702,33338
7/16/22,Lesotho,-29.61,28.2336,34040,0,702,33338
7/17/22,Lesotho,-29.61,28.2336,34040,0,702,33338
7/18/22,Lesotho,-29.61,28.2336,34040,0,702,33338
7/19/22,Lesotho,-29.61,28.2336,34040,0,702,33338
7/20/22,Lesotho,-29.61,28.2336,34040,0,702,33338
7/21/22,Lesotho,-29.61,28.2336,34040,0,702,33338
7/22/22,Lesotho,-29.61,28.2336,34040,0,702,33338
7/23/22,Lesotho,-29.61,28.2336,34040,0,702,33338
7/24/22,Lesotho,-29.61,28.2336,34040,0,702,33338
7/25/22,Lesotho,-29.61,28.2336,34040,0,702,33338
7/26/22,Lesotho,-29.61,28.2336,34040,0,702,33338
7/27/22,Lesotho,-29.61,28.2336,34040,0,702,33338
7/28/22,Lesotho,-29.61,28.2336,34040,0,702,33338
7/29/22,Lesotho,-29.61,28.2336,34040,0,702,33338
7/30/22,Lesotho,-29.61,28.2336,34040,0,702,33338
7/31/22,Lesotho,-29.61,28.2336,34040,0,702,33338
8/1/22,Lesotho,-29.61,28.2336,34040,0,702,33338
8/2/22,Lesotho,-29.61,28.2336,34040,0,702,33338
8/3/22,Lesotho,-29.61,28.2336,34040,0,702,33338
8/4/22,Lesotho,-29.61,28.2336,34040,0,702,33338
8/5/22,Lesotho,-29.61,28.2336,34040,0,702,33338
8/6/22,Lesotho,-29.61,28.2336,34040,0,702,33338
8/7/22,Lesotho,-29.61,28.2336,34040,0,702,33338
8/8/22,Lesotho,-29.61,28.2336,34206,0,704,33502
8/9/22,Lesotho,-29.61,28.2336,34206,0,704,33502
8/10/22,Lesotho,-29.61,28.2336,34206,0,704,33502
8/11/22,Lesotho,-29.61,28.2336,34206,0,704,33502
8/12/22,Lesotho,-29.61,28.2336,34206,0,704,33502
8/13/22,Lesotho,-29.61,28.2336,34206,0,704,33502
8/14/22,Lesotho,-29.61,28.2336,34206,0,704,33502
8/15/22,Lesotho,-29.61,28.2336,34206,0,704,33502
8/16/22,Lesotho,-29.61,28.2336,34206,0,704,33502
8/17/22,Lesotho,-29.61,28.2336,34206,0,704,33502
8/18/22,Lesotho,-29.61,28.2336,34206,0,704,33502
8/19/22,Lesotho,-29.61,28.2336,34206,0,704,33502
8/20/22,Lesotho,-29.61,28.2336,34206,0,704,33502
8/21/22,Lesotho,-29.61,28.2336,34206,0,704,33502
8/22/22,Lesotho,-29.61,28.2336,34206,0,704,33502
8/23/22,Lesotho,-29.61,28.2336,34206,0,704,33502
8/24/22,Lesotho,-29.61,28.2336,34206,0,704,33502
8/25/22,Lesotho,-29.61,28.2336,34206,0,704,33502
8/26/22,Lesotho,-29.61,28.2336,34206,0,704,33502
8/27/22,Lesotho,-29.61,28.2336,34206,0,704,33502
8/28/22,Lesotho,-29.61,28.2336,34206,0,704,33502
8/29/22,Lesotho,-29.61,28.2336,34206,0,704,33502
8/30/22,Lesotho,-29.61,28.2336,34206,0,704,33502
8/31/22,Lesotho,-29.61,28.2336,34206,0,704,33502
9/1/22,Lesotho,-29.61,28.2336,34206,0,704,33502
9/2/22,Lesotho,-29.61,28.2336,34206,0,704,33502
9/3/22,Lesotho,-29.61,28.2336,34206,0,704,33502
9/4/22,Lesotho,-29.61,28.2336,34206,0,704,33502
9/5/22,Lesotho,-29.61,28.2336,34287,0,704,33583
9/6/22,Lesotho,-29.61,28.2336,34287,0,704,33583
9/7/22,Lesotho,-29.61,28.2336,34287,0,704,33583
9/8/22,Lesotho,-29.61,28.2336,34287,0,704,33583
9/9/22,Lesotho,-29.61,28.2336,34287,0,704,33583
9/10/22,Lesotho,-29.61,28.2336,34287,0,704,33583
9/11/22,Lesotho,-29.61,28.2336,34287,0,704,33583
9/12/22,Lesotho,-29.61,28.2336,34287,0,704,33583
9/13/22,Lesotho,-29.61,28.2336,34287,0,704,33583
9/14/22,Lesotho,-29.61,28.2336,34287,0,704,33583
9/15/22,Lesotho,-29.61,28.2336,34287,0,704,33583
9/16/22,Lesotho,-29.61,28.2336,34490,0,706,33784
9/17/22,Lesotho,-29.61,28.2336,34490,0,706,33784
9/18/22,Lesotho,-29.61,28.2336,34490,0,706,33784
9/19/22,Lesotho,-29.61,28.2336,34490,0,706,33784
9/20/22,Lesotho,-29.61,28.2336,34490,0,706,33784
9/21/22,Lesotho,-29.61,28.2336,34490,0,706,33784
9/22/22,Lesotho,-29.61,28.2336,34490,0,706,33784
9/23/22,Lesotho,-29.61,28.2336,34490,0,706,33784
9/24/22,Lesotho,-29.61,28.2336,34490,0,706,33784
9/25/22,Lesotho,-29.61,28.2336,34490,0,706,33784
9/26/22,Lesotho,-29.61,28.2336,34490,0,706,33784
9/27/22,Lesotho,-29.61,28.2336,34490,0,706,33784
9/28/22,Lesotho,-29.61,28.2336,34490,0,706,33784
9/29/22,Lesotho,-29.61,28.2336,34490,0,706,33784
9/30/22,Lesotho,-29.61,28.2336,34490,0,706,33784
10/1/22,Lesotho,-29.61,28.2336,34490,0,706,33784
10/2/22,Lesotho,-29.61,28.2336,34490,0,706,33784
10/3/22,Lesotho,-29.61,28.2336,34490,0,706,33784
10/4/22,Lesotho,-29.61,28.2336,34490,0,706,33784
10/5/22,Lesotho,-29.61,28.2336,34490,0,706,33784
10/6/22,Lesotho,-29.61,28.2336,34490,0,706,33784
10/7/22,Lesotho,-29.61,28.2336,34490,0,706,33784
10/8/22,Lesotho,-29.61,28.2336,34490,0,706,33784
10/9/22,Lesotho,-29.61,28.2336,34490,0,706,33784
10/10/22,Lesotho,-29.61,28.2336,34490,0,706,33784
10/11/22,Lesotho,-29.61,28.2336,34490,0,706,33784
10/12/22,Lesotho,-29.61,28.2336,34490,0,706,33784
10/13/22,Lesotho,-29.61,28.2336,34490,0,706,33784
10/14/22,Lesotho,-29.61,28.2336,34490,0,706,33784
10/15/22,Lesotho,-29.61,28.2336,34490,0,706,33784
10/16/22,Lesotho,-29.61,28.2336,34490,0,706,33784
10/17/22,Lesotho,-29.61,28.2336,34490,0,706,33784
10/18/22,Lesotho,-29.61,28.2336,34490,0,706,33784
10/19/22,Lesotho,-29.61,28.2336,34490,0,706,33784
10/20/22,Lesotho,-29.61,28.2336,34490,0,706,33784
10/21/22,Lesotho,-29.61,28.2336,34490,0,706,33784
10/22/22,Lesotho,-29.61,28.2336,34490,0,706,33784
10/23/22,Lesotho,-29.61,28.2336,34490,0,706,33784
10/24/22,Lesotho,-29.61,28.2336,34490,0,706,33784
10/25/22,Lesotho,-29.61,28.2336,34490,0,706,33784
10/26/22,Lesotho,-29.61,28.2336,34490,0,706,33784
10/27/22,Lesotho,-29.61,28.2336,34490,0,706,33784
10/28/22,Lesotho,-29.61,28.2336,34490,0,706,33784
10/29/22,Lesotho,-29.61,28.2336,34490,0,706,33784
10/30/22,Lesotho,-29.61,28.2336,34490,0,706,33784
10/31/22,Lesotho,-29.61,28.2336,34490,0,706,33784
11/1/22,Lesotho,-29.61,28.2336,34490,0,706,33784
11/2/22,Lesotho,-29.61,28.2336,34490,0,706,33784
11/3/22,Lesotho,-29.61,28.2336,34490,0,706,33784
11/4/22,Lesotho,-29.61,28.2336,34490,0,706,33784
11/5/22,Lesotho,-29.61,28.2336,34490,0,706,33784
11/6/22,Lesotho,-29.61,28.2336,34490,0,706,33784
11/7/22,Lesotho,-29.61,28.2336,34490,0,706,33784
11/8/22,Lesotho,-29.61,28.2336,34490,0,706,33784
11/9/22,Lesotho,-29.61,28.2336,34490,0,706,33784
11/10/22,Lesotho,-29.61,28.2336,34490,0,706,33784
11/11/22,Lesotho,-29.61,28.2336,34490,0,706,33784
11/12/22,Lesotho,-29.61,28.2336,34490,0,706,33784
11/13/22,Lesotho,-29.61,28.2336,34490,0,706,33784
11/14/22,Lesotho,-29.61,28.2336,34490,0,706,33784
11/15/22,Lesotho,-29.61,28.2336,34490,0,706,33784
11/16/22,Lesotho,-29.61,28.2336,34490,0,706,33784
11/17/22,Lesotho,-29.61,28.2336,34490,0,706,33784
11/18/22,Lesotho,-29.61,28.2336,34490,0,706,33784
11/19/22,Lesotho,-29.61,28.2336,34490,0,706,33784
11/20/22,Lesotho,-29.61,28.2336,34490,0,706,33784
11/21/22,Lesotho,-29.61,28.2336,34490,0,706,33784
11/22/22,Lesotho,-29.61,28.2336,34490,0,706,33784
11/23/22,Lesotho,-29.61,28.2336,34490,0,706,33784
11/24/22,Lesotho,-29.61,28.2336,34490,0,706,33784
11/25/22,Lesotho,-29.61,28.2336,34490,0,706,33784
11/26/22,Lesotho,-29.61,28.2336,34490,0,706,33784
11/27/22,Lesotho,-29.61,28.2336,34490,0,706,33784
11/28/22,Lesotho,-29.61,28.2336,34490,0,706,33784
11/29/22,Lesotho,-29.61,28.2336,34490,0,706,33784
11/30/22,Lesotho,-29.61,28.2336,34490,0,706,33784
12/1/22,Lesotho,-29.61,28.2336,34490,0,706,33784
12/2/22,Lesotho,-29.61,28.2336,34490,0,706,33784
12/3/22,Lesotho,-29.61,28.2336,34490,0,706,33784
12/4/22,Lesotho,-29.61,28.2336,34490,0,706,33784
12/5/22,Lesotho,-29.61,28.2336,34490,0,706,33784
12/6/22,Lesotho,-29.61,28.2336,34490,0,706,33784
12/7/22,Lesotho,-29.61,28.2336,34490,0,706,33784
12/8/22,Lesotho,-29.61,28.2336,34490,0,706,33784
12/9/22,Lesotho,-29.61,28.2336,34490,0,706,33784
12/10/22,Lesotho,-29.61,28.2336,34490,0,706,33784
12/11/22,Lesotho,-29.61,28.2336,34490,0,706,33784
12/12/22,Lesotho,-29.61,28.2336,34490,0,706,33784
12/13/22,Lesotho,-29.61,28.2336,34490,0,706,33784
12/14/22,Lesotho,-29.61,28.2336,34490,0,706,33784
12/15/22,Lesotho,-29.61,28.2336,34490,0,706,33784
12/16/22,Lesotho,-29.61,28.2336,34490,0,706,33784
12/17/22,Lesotho,-29.61,28.2336,34490,0,706,33784
1/1/22,Liberia,6.428055,-9.429499,6278,0,287,5991
1/2/22,Liberia,6.428055,-9.429499,6278,0,287,5991
1/3/22,Liberia,6.428055,-9.429499,6278,0,287,5991
1/4/22,Liberia,6.428055,-9.429499,6404,0,287,6117
1/5/22,Liberia,6.428055,-9.429499,6851,0,287,6564
1/6/22,Liberia,6.428055,-9.429499,6851,0,287,6564
1/7/22,Liberia,6.428055,-9.429499,6851,0,287,6564
1/8/22,Liberia,6.428055,-9.429499,6851,0,287,6564
1/9/22,Liberia,6.428055,-9.429499,6851,0,287,6564
1/10/22,Liberia,6.428055,-9.429499,6851,0,287,6564
1/11/22,Liberia,6.428055,-9.429499,7054,0,287,6767
1/12/22,Liberia,6.428055,-9.429499,7054,0,287,6767
1/13/22,Liberia,6.428055,-9.429499,7121,0,287,6834
1/14/22,Liberia,6.428055,-9.429499,7121,0,287,6834
1/15/22,Liberia,6.428055,-9.429499,7121,0,287,6834
1/16/22,Liberia,6.428055,-9.429499,7121,0,287,6834
1/17/22,Liberia,6.428055,-9.429499,7121,0,287,6834
1/18/22,Liberia,6.428055,-9.429499,7121,0,287,6834
1/19/22,Liberia,6.428055,-9.429499,7121,0,287,6834
1/20/22,Liberia,6.428055,-9.429499,7208,0,288,6920
1/21/22,Liberia,6.428055,-9.429499,7208,0,288,6920
1/22/22,Liberia,6.428055,-9.429499,7208,0,288,6920
1/23/22,Liberia,6.428055,-9.429499,7208,0,288,6920
1/24/22,Liberia,6.428055,-9.429499,7243,0,289,6954
1/25/22,Liberia,6.428055,-9.429499,7243,0,289,6954
1/26/22,Liberia,6.428055,-9.429499,7243,0,289,6954
1/27/22,Liberia,6.428055,-9.429499,7243,0,289,6954
1/28/22,Liberia,6.428055,-9.429499,7254,0,290,6964
1/29/22,Liberia,6.428055,-9.429499,7254,0,290,6964
1/30/22,Liberia,6.428055,-9.429499,7254,0,290,6964
1/31/22,Liberia,6.428055,-9.429499,7272,0,290,6982
2/1/22,Liberia,6.428055,-9.429499,7272,0,290,6982
2/2/22,Liberia,6.428055,-9.429499,7272,0,290,6982
2/3/22,Liberia,6.428055,-9.429499,7272,0,290,6982
2/4/22,Liberia,6.428055,-9.429499,7276,0,290,6986
2/5/22,Liberia,6.428055,-9.429499,7276,0,290,6986
2/6/22,Liberia,6.428055,-9.429499,7276,0,290,6986
2/7/22,Liberia,6.428055,-9.429499,7346,0,290,7056
2/8/22,Liberia,6.428055,-9.429499,7346,0,290,7056
2/9/22,Liberia,6.428055,-9.429499,7346,0,290,7056
2/10/22,Liberia,6.428055,-9.429499,7358,0,290,7068
2/11/22,Liberia,6.428055,-9.429499,7358,0,290,7068
2/12/22,Liberia,6.428055,-9.429499,7358,0,290,7068
2/13/22,Liberia,6.428055,-9.429499,7358,0,290,7068
2/14/22,Liberia,6.428055,-9.429499,7359,0,290,7069
2/15/22,Liberia,6.428055,-9.429499,7360,0,290,7070
2/16/22,Liberia,6.428055,-9.429499,7360,0,290,7070
2/17/22,Liberia,6.428055,-9.429499,7360,0,290,7070
2/18/22,Liberia,6.428055,-9.429499,7360,0,290,7070
2/19/22,Liberia,6.428055,-9.429499,7360,0,290,7070
2/20/22,Liberia,6.428055,-9.429499,7360,0,290,7070
2/21/22,Liberia,6.428055,-9.429499,7360,0,290,7070
2/22/22,Liberia,6.428055,-9.429499,7360,0,290,7070
2/23/22,Liberia,6.428055,-9.429499,7360,0,290,7070
2/24/22,Liberia,6.428055,-9.429499,7360,0,290,7070
2/25/22,Liberia,6.428055,-9.429499,7360,0,290,7070
2/26/22,Liberia,6.428055,-9.429499,7360,0,290,7070
2/27/22,Liberia,6.428055,-9.429499,7360,0,290,7070
2/28/22,Liberia,6.428055,-9.429499,7384,0,294,7090
3/1/22,Liberia,6.428055,-9.429499,7384,0,294,7090
3/2/22,Liberia,6.428055,-9.429499,7384,0,294,7090
3/3/22,Liberia,6.428055,-9.429499,7384,0,294,7090
3/4/22,Liberia,6.428055,-9.429499,7384,0,294,7090
3/5/22,Liberia,6.428055,-9.429499,7384,0,294,7090
3/6/22,Liberia,6.428055,-9.429499,7384,0,294,7090
3/7/22,Liberia,6.428055,-9.429499,7384,0,294,7090
3/8/22,Liberia,6.428055,-9.429499,7384,0,294,7090
3/9/22,Liberia,6.428055,-9.429499,7387,0,294,7093
3/10/22,Liberia,6.428055,-9.429499,7392,0,294,7098
3/11/22,Liberia,6.428055,-9.429499,7392,0,294,7098
3/12/22,Liberia,6.428055,-9.429499,7392,0,294,7098
3/13/22,Liberia,6.428055,-9.429499,7392,0,294,7098
3/14/22,Liberia,6.428055,-9.429499,7397,0,294,7103
3/15/22,Liberia,6.428055,-9.429499,7397,0,294,7103
3/16/22,Liberia,6.428055,-9.429499,7397,0,294,7103
3/17/22,Liberia,6.428055,-9.429499,7397,0,294,7103
3/18/22,Liberia,6.428055,-9.429499,7397,0,294,7103
3/19/22,Liberia,6.428055,-9.429499,7397,0,294,7103
3/20/22,Liberia,6.428055,-9.429499,7397,0,294,7103
3/21/22,Liberia,6.428055,-9.429499,7397,0,294,7103
3/22/22,Liberia,6.428055,-9.429499,7397,0,294,7103
3/23/22,Liberia,6.428055,-9.429499,7397,0,294,7103
3/24/22,Liberia,6.428055,-9.429499,7397,0,294,7103
3/25/22,Liberia,6.428055,-9.429499,7397,0,294,7103
3/26/22,Liberia,6.428055,-9.429499,7397,0,294,7103
3/27/22,Liberia,6.428055,-9.429499,7397,0,294,7103
3/28/22,Liberia,6.428055,-9.429499,7400,0,294,7106
3/29/22,Liberia,6.428055,-9.429499,7400,0,294,7106
3/30/22,Liberia,6.428055,-9.429499,7400,0,294,7106
3/31/22,Liberia,6.428055,-9.429499,7400,0,294,7106
4/1/22,Liberia,6.428055,-9.429499,7400,0,294,7106
4/2/22,Liberia,6.428055,-9.429499,7400,0,294,7106
4/3/22,Liberia,6.428055,-9.429499,7400,0,294,7106
4/4/22,Liberia,6.428055,-9.429499,7400,0,294,7106
4/5/22,Liberia,6.428055,-9.429499,7400,0,294,7106
4/6/22,Liberia,6.428055,-9.429499,7400,0,294,7106
4/7/22,Liberia,6.428055,-9.429499,7400,0,294,7106
4/8/22,Liberia,6.428055,-9.429499,7400,0,294,7106
4/9/22,Liberia,6.428055,-9.429499,7400,0,294,7106
4/10/22,Liberia,6.428055,-9.429499,7400,0,294,7106
4/11/22,Liberia,6.428055,-9.429499,7402,0,294,7108
4/12/22,Liberia,6.428055,-9.429499,7402,0,294,7108
4/13/22,Liberia,6.428055,-9.429499,7402,0,294,7108
4/14/22,Liberia,6.428055,-9.429499,7402,0,294,7108
4/15/22,Liberia,6.428055,-9.429499,7402,0,294,7108
4/16/22,Liberia,6.428055,-9.429499,7402,0,294,7108
4/17/22,Liberia,6.428055,-9.429499,7402,0,294,7108
4/18/22,Liberia,6.428055,-9.429499,7402,0,294,7108
4/19/22,Liberia,6.428055,-9.429499,7432,0,294,7138
4/20/22,Liberia,6.428055,-9.429499,7432,0,294,7138
4/21/22,Liberia,6.428055,-9.429499,7432,0,294,7138
4/22/22,Liberia,6.428055,-9.429499,7432,0,294,7138
4/23/22,Liberia,6.428055,-9.429499,7432,0,294,7138
4/24/22,Liberia,6.428055,-9.429499,7432,0,294,7138
4/25/22,Liberia,6.428055,-9.429499,7432,0,294,7138
4/26/22,Liberia,6.428055,-9.429499,7434,0,294,7140
4/27/22,Liberia,6.428055,-9.429499,7434,0,294,7140
4/28/22,Liberia,6.428055,-9.429499,7434,0,294,7140
4/29/22,Liberia,6.428055,-9.429499,7434,0,294,7140
4/30/22,Liberia,6.428055,-9.429499,7434,0,294,7140
5/1/22,Liberia,6.428055,-9.429499,7434,0,294,7140
5/2/22,Liberia,6.428055,-9.429499,7434,0,294,7140
5/3/22,Liberia,6.428055,-9.429499,7434,0,294,7140
5/4/22,Liberia,6.428055,-9.429499,7434,0,294,7140
5/5/22,Liberia,6.428055,-9.429499,7434,0,294,7140
5/6/22,Liberia,6.428055,-9.429499,7434,0,294,7140
5/7/22,Liberia,6.428055,-9.429499,7434,0,294,7140
5/8/22,Liberia,6.428055,-9.429499,7434,0,294,7140
5/9/22,Liberia,6.428055,-9.429499,7434,0,294,7140
5/10/22,Liberia,6.428055,-9.429499,7434,0,294,7140
5/11/22,Liberia,6.428055,-9.429499,7434,0,294,7140
5/12/22,Liberia,6.428055,-9.429499,7451,0,294,7157
5/13/22,Liberia,6.428055,-9.429499,7451,0,294,7157
5/14/22,Liberia,6.428055,-9.429499,7451,0,294,7157
5/15/22,Liberia,6.428055,-9.429499,7451,0,294,7157
5/16/22,Liberia,6.428055,-9.429499,7452,0,294,7158
5/17/22,Liberia,6.428055,-9.429499,7452,0,294,7158
5/18/22,Liberia,6.428055,-9.429499,7452,0,294,7158
5/19/22,Liberia,6.428055,-9.429499,7455,0,294,7161
5/20/22,Liberia,6.428055,-9.429499,7455,0,294,7161
5/21/22,Liberia,6.428055,-9.429499,7455,0,294,7161
5/22/22,Liberia,6.428055,-9.429499,7455,0,294,7161
5/23/22,Liberia,6.428055,-9.429499,7455,0,294,7161
5/24/22,Liberia,6.428055,-9.429499,7455,0,294,7161
5/25/22,Liberia,6.428055,-9.429499,7455,0,294,7161
5/26/22,Liberia,6.428055,-9.429499,7455,0,294,7161
5/27/22,Liberia,6.428055,-9.429499,7455,0,294,7161
5/28/22,Liberia,6.428055,-9.429499,7455,0,294,7161
5/29/22,Liberia,6.428055,-9.429499,7455,0,294,7161
5/30/22,Liberia,6.428055,-9.429499,7455,0,294,7161
5/31/22,Liberia,6.428055,-9.429499,7456,0,294,7162
6/1/22,Liberia,6.428055,-9.429499,7456,0,294,7162
6/2/22,Liberia,6.428055,-9.429499,7456,0,294,7162
6/3/22,Liberia,6.428055,-9.429499,7456,0,294,7162
6/4/22,Liberia,6.428055,-9.429499,7456,0,294,7162
6/5/22,Liberia,6.428055,-9.429499,7456,0,294,7162
6/6/22,Liberia,6.428055,-9.429499,7456,0,294,7162
6/7/22,Liberia,6.428055,-9.429499,7456,0,294,7162
6/8/22,Liberia,6.428055,-9.429499,7456,0,294,7162
6/9/22,Liberia,6.428055,-9.429499,7456,0,294,7162
6/10/22,Liberia,6.428055,-9.429499,7459,0,294,7165
6/11/22,Liberia,6.428055,-9.429499,7459,0,294,7165
6/12/22,Liberia,6.428055,-9.429499,7459,0,294,7165
6/13/22,Liberia,6.428055,-9.429499,7459,0,294,7165
6/14/22,Liberia,6.428055,-9.429499,7460,0,294,7166
6/15/22,Liberia,6.428055,-9.429499,7460,0,294,7166
6/16/22,Liberia,6.428055,-9.429499,7489,0,294,7195
6/17/22,Liberia,6.428055,-9.429499,7489,0,294,7195
6/18/22,Liberia,6.428055,-9.429499,7489,0,294,7195
6/19/22,Liberia,6.428055,-9.429499,7489,0,294,7195
6/20/22,Liberia,6.428055,-9.429499,7493,0,294,7199
6/21/22,Liberia,6.428055,-9.429499,7493,0,294,7199
6/22/22,Liberia,6.428055,-9.429499,7493,0,294,7199
6/23/22,Liberia,6.428055,-9.429499,7493,0,294,7199
6/24/22,Liberia,6.428055,-9.429499,7493,0,294,7199
6/25/22,Liberia,6.428055,-9.429499,7493,0,294,7199
6/26/22,Liberia,6.428055,-9.429499,7493,0,294,7199
6/27/22,Liberia,6.428055,-9.429499,7493,0,294,7199
6/28/22,Liberia,6.428055,-9.429499,7493,0,294,7199
6/29/22,Liberia,6.428055,-9.429499,7493,0,294,7199
6/30/22,Liberia,6.428055,-9.429499,7497,0,294,7203
7/1/22,Liberia,6.428055,-9.429499,7497,0,294,7203
7/2/22,Liberia,6.428055,-9.429499,7497,0,294,7203
7/3/22,Liberia,6.428055,-9.429499,7497,0,294,7203
7/4/22,Liberia,6.428055,-9.429499,7497,0,294,7203
7/5/22,Liberia,6.428055,-9.429499,7500,0,294,7206
7/6/22,Liberia,6.428055,-9.429499,7500,0,294,7206
7/7/22,Liberia,6.428055,-9.429499,7500,0,294,7206
7/8/22,Liberia,6.428055,-9.429499,7500,0,294,7206
7/9/22,Liberia,6.428055,-9.429499,7500,0,294,7206
7/10/22,Liberia,6.428055,-9.429499,7500,0,294,7206
7/11/22,Liberia,6.428055,-9.429499,7502,0,294,7208
7/12/22,Liberia,6.428055,-9.429499,7502,0,294,7208
7/13/22,Liberia,6.428055,-9.429499,7502,0,294,7208
7/14/22,Liberia,6.428055,-9.429499,7504,0,294,7210
7/15/22,Liberia,6.428055,-9.429499,7504,0,294,7210
7/16/22,Liberia,6.428055,-9.429499,7504,0,294,7210
7/17/22,Liberia,6.428055,-9.429499,7504,0,294,7210
7/18/22,Liberia,6.428055,-9.429499,7504,0,294,7210
7/19/22,Liberia,6.428055,-9.429499,7505,0,294,7211
7/20/22,Liberia,6.428055,-9.429499,7505,0,294,7211
7/21/22,Liberia,6.428055,-9.429499,7508,0,294,7214
7/22/22,Liberia,6.428055,-9.429499,7508,0,294,7214
7/23/22,Liberia,6.428055,-9.429499,7508,0,294,7214
7/24/22,Liberia,6.428055,-9.429499,7508,0,294,7214
7/25/22,Liberia,6.428055,-9.429499,7508,0,294,7214
7/26/22,Liberia,6.428055,-9.429499,7508,0,294,7214
7/27/22,Liberia,6.428055,-9.429499,7508,0,294,7214
7/28/22,Liberia,6.428055,-9.429499,7508,0,294,7214
7/29/22,Liberia,6.428055,-9.429499,7538,0,294,7244
7/30/22,Liberia,6.428055,-9.429499,7538,0,294,7244
7/31/22,Liberia,6.428055,-9.429499,7538,0,294,7244
8/1/22,Liberia,6.428055,-9.429499,7538,0,294,7244
8/2/22,Liberia,6.428055,-9.429499,7538,0,294,7244
8/3/22,Liberia,6.428055,-9.429499,7538,0,294,7244
8/4/22,Liberia,6.428055,-9.429499,7538,0,294,7244
8/5/22,Liberia,6.428055,-9.429499,7548,0,294,7254
8/6/22,Liberia,6.428055,-9.429499,7548,0,294,7254
8/7/22,Liberia,6.428055,-9.429499,7548,0,294,7254
8/8/22,Liberia,6.428055,-9.429499,7548,0,294,7254
8/9/22,Liberia,6.428055,-9.429499,7548,0,294,7254
8/10/22,Liberia,6.428055,-9.429499,7548,0,294,7254
8/11/22,Liberia,6.428055,-9.429499,7552,0,294,7258
8/12/22,Liberia,6.428055,-9.429499,7578,0,294,7284
8/13/22,Liberia,6.428055,-9.429499,7578,0,294,7284
8/14/22,Liberia,6.428055,-9.429499,7578,0,294,7284
8/15/22,Liberia,6.428055,-9.429499,7578,0,294,7284
8/16/22,Liberia,6.428055,-9.429499,7656,0,294,7362
8/17/22,Liberia,6.428055,-9.429499,7656,0,294,7362
8/18/22,Liberia,6.428055,-9.429499,7656,0,294,7362
8/19/22,Liberia,6.428055,-9.429499,7656,0,294,7362
8/20/22,Liberia,6.428055,-9.429499,7656,0,294,7362
8/21/22,Liberia,6.428055,-9.429499,7656,0,294,7362
8/22/22,Liberia,6.428055,-9.429499,7656,0,294,7362
8/23/22,Liberia,6.428055,-9.429499,7732,0,294,7438
8/24/22,Liberia,6.428055,-9.429499,7732,0,294,7438
8/25/22,Liberia,6.428055,-9.429499,7732,0,294,7438
8/26/22,Liberia,6.428055,-9.429499,7732,0,294,7438
8/27/22,Liberia,6.428055,-9.429499,7732,0,294,7438
8/28/22,Liberia,6.428055,-9.429499,7732,0,294,7438
8/29/22,Liberia,6.428055,-9.429499,7835,0,294,7541
8/30/22,Liberia,6.428055,-9.429499,7835,0,294,7541
8/31/22,Liberia,6.428055,-9.429499,7883,0,294,7589
9/1/22,Liberia,6.428055,-9.429499,7883,0,294,7589
9/2/22,Liberia,6.428055,-9.429499,7883,0,294,7589
9/3/22,Liberia,6.428055,-9.429499,7883,0,294,7589
9/4/22,Liberia,6.428055,-9.429499,7883,0,294,7589
9/5/22,Liberia,6.428055,-9.429499,7898,0,294,7604
9/6/22,Liberia,6.428055,-9.429499,7898,0,294,7604
9/7/22,Liberia,6.428055,-9.429499,7898,0,294,7604
9/8/22,Liberia,6.428055,-9.429499,7898,0,294,7604
9/9/22,Liberia,6.428055,-9.429499,7898,0,294,7604
9/10/22,Liberia,6.428055,-9.429499,7898,0,294,7604
9/11/22,Liberia,6.428055,-9.429499,7898,0,294,7604
9/12/22,Liberia,6.428055,-9.429499,7929,0,294,7635
9/13/22,Liberia,6.428055,-9.429499,7929,0,294,7635
9/14/22,Liberia,6.428055,-9.429499,7929,0,294,7635
9/15/22,Liberia,6.428055,-9.429499,7929,0,294,7635
9/16/22,Liberia,6.428055,-9.429499,7929,0,294,7635
9/17/22,Liberia,6.428055,-9.429499,7929,0,294,7635
9/18/22,Liberia,6.428055,-9.429499,7929,0,294,7635
9/19/22,Liberia,6.428055,-9.429499,7957,0,294,7663
9/20/22,Liberia,6.428055,-9.429499,7961,0,294,7667
9/21/22,Liberia,6.428055,-9.429499,7961,0,294,7667
9/22/22,Liberia,6.428055,-9.429499,7961,0,294,7667
9/23/22,Liberia,6.428055,-9.429499,7961,0,294,7667
9/24/22,Liberia,6.428055,-9.429499,7961,0,294,7667
9/25/22,Liberia,6.428055,-9.429499,7961,0,294,7667
9/26/22,Liberia,6.428055,-9.429499,7961,0,294,7667
9/27/22,Liberia,6.428055,-9.429499,7961,0,294,7667
9/28/22,Liberia,6.428055,-9.429499,7961,0,294,7667
9/29/22,Liberia,6.428055,-9.429499,7961,0,294,7667
9/30/22,Liberia,6.428055,-9.429499,7961,0,294,7667
10/1/22,Liberia,6.428055,-9.429499,7961,0,294,7667
10/2/22,Liberia,6.428055,-9.429499,7961,0,294,7667
10/3/22,Liberia,6.428055,-9.429499,7974,0,294,7680
10/4/22,Liberia,6.428055,-9.429499,7974,0,294,7680
10/5/22,Liberia,6.428055,-9.429499,7974,0,294,7680
10/6/22,Liberia,6.428055,-9.429499,7974,0,294,7680
10/7/22,Liberia,6.428055,-9.429499,7974,0,294,7680
10/8/22,Liberia,6.428055,-9.429499,7974,0,294,7680
10/9/22,Liberia,6.428055,-9.429499,7974,0,294,7680
10/10/22,Liberia,6.428055,-9.429499,7974,0,294,7680
10/11/22,Liberia,6.428055,-9.429499,7985,0,294,7691
10/12/22,Liberia,6.428055,-9.429499,7985,0,294,7691
10/13/22,Liberia,6.428055,-9.429499,7985,0,294,7691
10/14/22,Liberia,6.428055,-9.429499,7985,0,294,7691
10/15/22,Liberia,6.428055,-9.429499,7985,0,294,7691
10/16/22,Liberia,6.428055,-9.429499,7985,0,294,7691
10/17/22,Liberia,6.428055,-9.429499,7988,0,294,7694
10/18/22,Liberia,6.428055,-9.429499,7988,0,294,7694
10/19/22,Liberia,6.428055,-9.429499,7988,0,294,7694
10/20/22,Liberia,6.428055,-9.429499,7988,0,294,7694
10/21/22,Liberia,6.428055,-9.429499,7988,0,294,7694
10/22/22,Liberia,6.428055,-9.429499,7988,0,294,7694
10/23/22,Liberia,6.428055,-9.429499,7988,0,294,7694
10/24/22,Liberia,6.428055,-9.429499,7988,0,294,7694
10/25/22,Liberia,6.428055,-9.429499,7988,0,294,7694
10/26/22,Liberia,6.428055,-9.429499,7988,0,294,7694
10/27/22,Liberia,6.428055,-9.429499,7988,0,294,7694
10/28/22,Liberia,6.428055,-9.429499,7991,0,294,7697
10/29/22,Liberia,6.428055,-9.429499,7991,0,294,7697
10/30/22,Liberia,6.428055,-9.429499,7991,0,294,7697
10/31/22,Liberia,6.428055,-9.429499,7996,0,294,7702
11/1/22,Liberia,6.428055,-9.429499,7996,0,294,7702
11/2/22,Liberia,6.428055,-9.429499,7996,0,294,7702
11/3/22,Liberia,6.428055,-9.429499,7996,0,294,7702
11/4/22,Liberia,6.428055,-9.429499,7996,0,294,7702
11/5/22,Liberia,6.428055,-9.429499,7996,0,294,7702
11/6/22,Liberia,6.428055,-9.429499,7996,0,294,7702
11/7/22,Liberia,6.428055,-9.429499,7998,0,294,7704
11/8/22,Liberia,6.428055,-9.429499,7998,0,294,7704
11/9/22,Liberia,6.428055,-9.429499,7998,0,294,7704
11/10/22,Liberia,6.428055,-9.429499,7998,0,294,7704
11/11/22,Liberia,6.428055,-9.429499,7998,0,294,7704
11/12/22,Liberia,6.428055,-9.429499,7998,0,294,7704
11/13/22,Liberia,6.428055,-9.429499,7998,0,294,7704
11/14/22,Liberia,6.428055,-9.429499,7998,0,294,7704
11/15/22,Liberia,6.428055,-9.429499,8014,0,294,7720
11/16/22,Liberia,6.428055,-9.429499,8014,0,294,7720
11/17/22,Liberia,6.428055,-9.429499,8014,0,294,7720
11/18/22,Liberia,6.428055,-9.429499,8014,0,294,7720
11/19/22,Liberia,6.428055,-9.429499,8014,0,294,7720
11/20/22,Liberia,6.428055,-9.429499,8014,0,294,7720
11/21/22,Liberia,6.428055,-9.429499,8014,0,294,7720
11/22/22,Liberia,6.428055,-9.429499,8014,0,294,7720
11/23/22,Liberia,6.428055,-9.429499,8014,0,294,7720
11/24/22,Liberia,6.428055,-9.429499,8014,0,294,7720
11/25/22,Liberia,6.428055,-9.429499,8014,0,294,7720
11/26/22,Liberia,6.428055,-9.429499,8014,0,294,7720
11/27/22,Liberia,6.428055,-9.429499,8014,0,294,7720
11/28/22,Liberia,6.428055,-9.429499,8014,0,294,7720
11/29/22,Liberia,6.428055,-9.429499,8022,0,294,7728
11/30/22,Liberia,6.428055,-9.429499,8022,0,294,7728
12/1/22,Liberia,6.428055,-9.429499,8022,0,294,7728
12/2/22,Liberia,6.428055,-9.429499,8022,0,294,7728
12/3/22,Liberia,6.428055,-9.429499,8022,0,294,7728
12/4/22,Liberia,6.428055,-9.429499,8022,0,294,7728
12/5/22,Liberia,6.428055,-9.429499,8022,0,294,7728
12/6/22,Liberia,6.428055,-9.429499,8035,0,294,7741
12/7/22,Liberia,6.428055,-9.429499,8035,0,294,7741
12/8/22,Liberia,6.428055,-9.429499,8035,0,294,7741
12/9/22,Liberia,6.428055,-9.429499,8035,0,294,7741
12/10/22,Liberia,6.428055,-9.429499,8035,0,294,7741
12/11/22,Liberia,6.428055,-9.429499,8035,0,294,7741
12/12/22,Liberia,6.428055,-9.429499,8037,0,294,7743
12/13/22,Liberia,6.428055,-9.429499,8037,0,294,7743
12/14/22,Liberia,6.428055,-9.429499,8041,0,294,7747
12/15/22,Liberia,6.428055,-9.429499,8041,0,294,7747
12/16/22,Liberia,6.428055,-9.429499,8043,0,294,7749
12/17/22,Liberia,6.428055,-9.429499,8043,0,294,7749
1/1/22,Libya,26.3351,17.228331,388734,0,5710,383024
1/2/22,Libya,26.3351,17.228331,389650,0,5722,383928
1/3/22,Libya,26.3351,17.228331,390284,0,5727,384557
1/4/22,Libya,26.3351,17.228331,390935,0,5740,385195
1/5/22,Libya,26.3351,17.228331,391633,0,5752,385881
1/6/22,Libya,26.3351,17.228331,392276,0,5767,386509
1/7/22,Libya,26.3351,17.228331,392868,0,5778,387090
1/8/22,Libya,26.3351,17.228331,392868,0,5778,387090
1/9/22,Libya,26.3351,17.228331,393447,0,5788,387659
1/10/22,Libya,26.3351,17.228331,393983,0,5796,388187
1/11/22,Libya,26.3351,17.228331,394470,0,5805,388665
1/12/22,Libya,26.3351,17.228331,395069,0,5813,389256
1/13/22,Libya,26.3351,17.228331,395687,0,5822,389865
1/14/22,Libya,26.3351,17.228331,396452,0,5828,390624
1/15/22,Libya,26.3351,17.228331,396452,0,5828,390624
1/16/22,Libya,26.3351,17.228331,397319,0,5841,391478
1/17/22,Libya,26.3351,17.228331,398055,0,5853,392202
1/18/22,Libya,26.3351,17.228331,398940,0,5863,393077
1/19/22,Libya,26.3351,17.228331,400113,0,5874,394239
1/20/22,Libya,26.3351,17.228331,401444,0,5889,395555
1/21/22,Libya,26.3351,17.228331,403144,0,5907,397237
1/22/22,Libya,26.3351,17.228331,403144,0,5907,397237
1/23/22,Libya,26.3351,17.228331,405425,0,5921,399504
1/24/22,Libya,26.3351,17.228331,407758,0,5936,401822
1/25/22,Libya,26.3351,17.228331,410821,0,5950,404871
1/26/22,Libya,26.3351,17.228331,413066,0,5967,407099
1/27/22,Libya,26.3351,17.228331,416223,0,5979,410244
1/28/22,Libya,26.3351,17.228331,419543,0,5993,413550
1/29/22,Libya,26.3351,17.228331,419543,0,5993,413550
1/30/22,Libya,26.3351,17.228331,425237,0,6007,419230
1/31/22,Libya,26.3351,17.228331,429666,0,6017,423649
2/1/22,Libya,26.3351,17.228331,433932,0,6028,427904
2/2/22,Libya,26.3351,17.228331,438303,0,6035,432268
2/3/22,Libya,26.3351,17.228331,441959,0,6044,435915
2/4/22,Libya,26.3351,17.228331,445876,0,6052,439824
2/5/22,Libya,26.3351,17.228331,445876,0,6052,439824
2/6/22,Libya,26.3351,17.228331,450118,0,6067,444051
2/7/22,Libya,26.3351,17.228331,452950,0,6080,446870
2/8/22,Libya,26.3351,17.228331,456276,0,6087,450189
2/9/22,Libya,26.3351,17.228331,459548,0,6096,453452
2/10/22,Libya,26.3351,17.228331,463321,0,6107,457214
2/11/22,Libya,26.3351,17.228331,466666,0,6113,460553
2/12/22,Libya,26.3351,17.228331,466666,0,6113,460553
2/13/22,Libya,26.3351,17.228331,470314,0,6125,464189
2/14/22,Libya,26.3351,17.228331,473114,0,6135,466979
2/15/22,Libya,26.3351,17.228331,475604,0,6143,469461
2/16/22,Libya,26.3351,17.228331,478488,0,6156,472332
2/17/22,Libya,26.3351,17.228331,480945,0,6169,474776
2/18/22,Libya,26.3351,17.228331,482153,0,6178,475975
2/19/22,Libya,26.3351,17.228331,482153,0,6178,475975
2/20/22,Libya,26.3351,17.228331,484445,0,6191,478254
2/21/22,Libya,26.3351,17.228331,486752,0,6201,480551
2/22/22,Libya,26.3351,17.228331,488567,0,6210,482357
2/23/22,Libya,26.3351,17.228331,489940,0,6222,483718
2/24/22,Libya,26.3351,17.228331,491216,0,6232,484984
2/25/22,Libya,26.3351,17.228331,492154,0,6241,485913
2/26/22,Libya,26.3351,17.228331,492154,0,6241,485913
2/27/22,Libya,26.3351,17.228331,493548,0,6250,487298
2/28/22,Libya,26.3351,17.228331,494446,0,6261,488185
3/1/22,Libya,26.3351,17.228331,495115,0,6269,488846
3/2/22,Libya,26.3351,17.228331,495972,0,6276,489696
3/3/22,Libya,26.3351,17.228331,496778,0,6284,490494
3/4/22,Libya,26.3351,17.228331,497279,0,6288,490991
3/5/22,Libya,26.3351,17.228331,497279,0,6288,490991
3/6/22,Libya,26.3351,17.228331,497958,0,6299,491659
3/7/22,Libya,26.3351,17.228331,498453,0,6308,492145
3/8/22,Libya,26.3351,17.228331,498839,0,6314,492525
3/9/22,Libya,26.3351,17.228331,499132,0,6321,492811
3/10/22,Libya,26.3351,17.228331,499465,0,6326,493139
3/11/22,Libya,26.3351,17.228331,499767,0,6336,493431
3/12/22,Libya,26.3351,17.228331,499767,0,6336,493431
3/13/22,Libya,26.3351,17.228331,500000,0,6344,493656
3/14/22,Libya,26.3351,17.228331,500304,0,6350,493954
3/15/22,Libya,26.3351,17.228331,500497,0,6354,494143
3/16/22,Libya,26.3351,17.228331,500626,0,6361,494265
3/17/22,Libya,26.3351,17.228331,500760,0,6365,494395
3/18/22,Libya,26.3351,17.228331,500864,0,6368,494496
3/19/22,Libya,26.3351,17.228331,500864,0,6368,494496
3/20/22,Libya,26.3351,17.228331,501015,0,6374,494641
3/21/22,Libya,26.3351,17.228331,501135,0,6377,494758
3/22/22,Libya,26.3351,17.228331,501211,0,6382,494829
3/23/22,Libya,26.3351,17.228331,501296,0,6389,494907
3/24/22,Libya,26.3351,17.228331,501379,0,6392,494987
3/25/22,Libya,26.3351,17.228331,501420,0,6397,495023
3/26/22,Libya,26.3351,17.228331,501420,0,6397,495023
3/27/22,Libya,26.3351,17.228331,501495,0,6404,495091
3/28/22,Libya,26.3351,17.228331,501559,0,6408,495151
3/29/22,Libya,26.3351,17.228331,501610,0,6411,495199
3/30/22,Libya,26.3351,17.228331,501657,0,6413,495244
3/31/22,Libya,26.3351,17.228331,501705,0,6415,495290
4/1/22,Libya,26.3351,17.228331,501738,0,6419,495319
4/2/22,Libya,26.3351,17.228331,501738,0,6419,495319
4/3/22,Libya,26.3351,17.228331,501738,0,6419,495319
4/4/22,Libya,26.3351,17.228331,501738,0,6419,495319
4/5/22,Libya,26.3351,17.228331,501738,0,6419,495319
4/6/22,Libya,26.3351,17.228331,501738,0,6419,495319
4/7/22,Libya,26.3351,17.228331,501738,0,6419,495319
4/8/22,Libya,26.3351,17.228331,501738,0,6419,495319
4/9/22,Libya,26.3351,17.228331,501807,0,6425,495382
4/10/22,Libya,26.3351,17.228331,501834,0,6429,495405
4/11/22,Libya,26.3351,17.228331,501834,0,6429,495405
4/12/22,Libya,26.3351,17.228331,501834,0,6429,495405
4/13/22,Libya,26.3351,17.228331,501834,0,6429,495405
4/14/22,Libya,26.3351,17.228331,501834,0,6429,495405
4/15/22,Libya,26.3351,17.228331,501834,0,6429,495405
4/16/22,Libya,26.3351,17.228331,501834,0,6429,495405
4/17/22,Libya,26.3351,17.228331,501862,0,6429,495433
4/18/22,Libya,26.3351,17.228331,501862,0,6429,495433
4/19/22,Libya,26.3351,17.228331,501862,0,6429,495433
4/20/22,Libya,26.3351,17.228331,501862,0,6429,495433
4/21/22,Libya,26.3351,17.228331,501862,0,6429,495433
4/22/22,Libya,26.3351,17.228331,501862,0,6429,495433
4/23/22,Libya,26.3351,17.228331,501862,0,6429,495433
4/24/22,Libya,26.3351,17.228331,501862,0,6429,495433
4/25/22,Libya,26.3351,17.228331,501862,0,6429,495433
4/26/22,Libya,26.3351,17.228331,501904,0,6430,495474
4/27/22,Libya,26.3351,17.228331,501904,0,6430,495474
4/28/22,Libya,26.3351,17.228331,501904,0,6430,495474
4/29/22,Libya,26.3351,17.228331,501904,0,6430,495474
4/30/22,Libya,26.3351,17.228331,501904,0,6430,495474
5/1/22,Libya,26.3351,17.228331,501904,0,6430,495474
5/2/22,Libya,26.3351,17.228331,501916,0,6430,495486
5/3/22,Libya,26.3351,17.228331,501916,0,6430,495486
5/4/22,Libya,26.3351,17.228331,501916,0,6430,495486
5/5/22,Libya,26.3351,17.228331,501916,0,6430,495486
5/6/22,Libya,26.3351,17.228331,501916,0,6430,495486
5/7/22,Libya,26.3351,17.228331,501916,0,6430,495486
5/8/22,Libya,26.3351,17.228331,501916,0,6430,495486
5/9/22,Libya,26.3351,17.228331,501919,0,6430,495489
5/10/22,Libya,26.3351,17.228331,501919,0,6430,495489
5/11/22,Libya,26.3351,17.228331,501919,0,6430,495489
5/12/22,Libya,26.3351,17.228331,501919,0,6430,495489
5/13/22,Libya,26.3351,17.228331,501919,0,6430,495489
5/14/22,Libya,26.3351,17.228331,501919,0,6430,495489
5/15/22,Libya,26.3351,17.228331,501919,0,6430,495489
5/16/22,Libya,26.3351,17.228331,501954,0,6430,495524
5/17/22,Libya,26.3351,17.228331,501954,0,6430,495524
5/18/22,Libya,26.3351,17.228331,501954,0,6430,495524
5/19/22,Libya,26.3351,17.228331,501954,0,6430,495524
5/20/22,Libya,26.3351,17.228331,501954,0,6430,495524
5/21/22,Libya,26.3351,17.228331,501954,0,6430,495524
5/22/22,Libya,26.3351,17.228331,501954,0,6430,495524
5/23/22,Libya,26.3351,17.228331,501987,0,6430,495557
5/24/22,Libya,26.3351,17.228331,501987,0,6430,495557
5/25/22,Libya,26.3351,17.228331,501987,0,6430,495557
5/26/22,Libya,26.3351,17.228331,501987,0,6430,495557
5/27/22,Libya,26.3351,17.228331,501987,0,6430,495557
5/28/22,Libya,26.3351,17.228331,501987,0,6430,495557
5/29/22,Libya,26.3351,17.228331,501987,0,6430,495557
5/30/22,Libya,26.3351,17.228331,502016,0,6430,495586
5/31/22,Libya,26.3351,17.228331,502016,0,6430,495586
6/1/22,Libya,26.3351,17.228331,502016,0,6430,495586
6/2/22,Libya,26.3351,17.228331,502016,0,6430,495586
6/3/22,Libya,26.3351,17.228331,502016,0,6430,495586
6/4/22,Libya,26.3351,17.228331,502016,0,6430,495586
6/5/22,Libya,26.3351,17.228331,502016,0,6430,495586
6/6/22,Libya,26.3351,17.228331,502040,0,6430,495610
6/7/22,Libya,26.3351,17.228331,502040,0,6430,495610
6/8/22,Libya,26.3351,17.228331,502040,0,6430,495610
6/9/22,Libya,26.3351,17.228331,502040,0,6430,495610
6/10/22,Libya,26.3351,17.228331,502040,0,6430,495610
6/11/22,Libya,26.3351,17.228331,502040,0,6430,495610
6/12/22,Libya,26.3351,17.228331,502040,0,6430,495610
6/13/22,Libya,26.3351,17.228331,502076,0,6430,495646
6/14/22,Libya,26.3351,17.228331,502076,0,6430,495646
6/15/22,Libya,26.3351,17.228331,502076,0,6430,495646
6/16/22,Libya,26.3351,17.228331,502076,0,6430,495646
6/17/22,Libya,26.3351,17.228331,502076,0,6430,495646
6/18/22,Libya,26.3351,17.228331,502076,0,6430,495646
6/19/22,Libya,26.3351,17.228331,502076,0,6430,495646
6/20/22,Libya,26.3351,17.228331,502110,0,6430,495680
6/21/22,Libya,26.3351,17.228331,502110,0,6430,495680
6/22/22,Libya,26.3351,17.228331,502110,0,6430,495680
6/23/22,Libya,26.3351,17.228331,502110,0,6430,495680
6/24/22,Libya,26.3351,17.228331,502110,0,6430,495680
6/25/22,Libya,26.3351,17.228331,502110,0,6430,495680
6/26/22,Libya,26.3351,17.228331,502110,0,6430,495680
6/27/22,Libya,26.3351,17.228331,502138,0,6430,495708
6/28/22,Libya,26.3351,17.228331,502138,0,6430,495708
6/29/22,Libya,26.3351,17.228331,502138,0,6430,495708
6/30/22,Libya,26.3351,17.228331,502138,0,6430,495708
7/1/22,Libya,26.3351,17.228331,502138,0,6430,495708
7/2/22,Libya,26.3351,17.228331,502138,0,6430,495708
7/3/22,Libya,26.3351,17.228331,502138,0,6430,495708
7/4/22,Libya,26.3351,17.228331,502189,0,6430,495759
7/5/22,Libya,26.3351,17.228331,502189,0,6430,495759
7/6/22,Libya,26.3351,17.228331,502189,0,6430,495759
7/7/22,Libya,26.3351,17.228331,502189,0,6430,495759
7/8/22,Libya,26.3351,17.228331,502189,0,6430,495759
7/9/22,Libya,26.3351,17.228331,502189,0,6430,495759
7/10/22,Libya,26.3351,17.228331,502189,0,6430,495759
7/11/22,Libya,26.3351,17.228331,502189,0,6430,495759
7/12/22,Libya,26.3351,17.228331,502289,0,6430,495859
7/13/22,Libya,26.3351,17.228331,502289,0,6430,495859
7/14/22,Libya,26.3351,17.228331,502289,0,6430,495859
7/15/22,Libya,26.3351,17.228331,502289,0,6430,495859
7/16/22,Libya,26.3351,17.228331,502289,0,6430,495859
7/17/22,Libya,26.3351,17.228331,502289,0,6430,495859
7/18/22,Libya,26.3351,17.228331,502642,0,6431,496211
7/19/22,Libya,26.3351,17.228331,502642,0,6431,496211
7/20/22,Libya,26.3351,17.228331,502642,0,6431,496211
7/21/22,Libya,26.3351,17.228331,502642,0,6431,496211
7/22/22,Libya,26.3351,17.228331,502642,0,6431,496211
7/23/22,Libya,26.3351,17.228331,502642,0,6431,496211
7/24/22,Libya,26.3351,17.228331,502642,0,6431,496211
7/25/22,Libya,26.3351,17.228331,503611,0,6431,497180
7/26/22,Libya,26.3351,17.228331,503611,0,6431,497180
7/27/22,Libya,26.3351,17.228331,503611,0,6431,497180
7/28/22,Libya,26.3351,17.228331,503611,0,6431,497180
7/29/22,Libya,26.3351,17.228331,503611,0,6431,497180
7/30/22,Libya,26.3351,17.228331,503611,0,6431,497180
7/31/22,Libya,26.3351,17.228331,503611,0,6431,497180
8/1/22,Libya,26.3351,17.228331,503611,0,6431,497180
8/2/22,Libya,26.3351,17.228331,504997,0,6431,498566
8/3/22,Libya,26.3351,17.228331,505220,0,6432,498788
8/4/22,Libya,26.3351,17.228331,505350,0,6433,498917
8/5/22,Libya,26.3351,17.228331,505350,0,6433,498917
8/6/22,Libya,26.3351,17.228331,505350,0,6433,498917
8/7/22,Libya,26.3351,17.228331,505350,0,6433,498917
8/8/22,Libya,26.3351,17.228331,505705,0,6433,499272
8/9/22,Libya,26.3351,17.228331,505805,0,6433,499372
8/10/22,Libya,26.3351,17.228331,505859,0,6433,499426
8/11/22,Libya,26.3351,17.228331,505956,0,6434,499522
8/12/22,Libya,26.3351,17.228331,505956,0,6434,499522
8/13/22,Libya,26.3351,17.228331,505956,0,6434,499522
8/14/22,Libya,26.3351,17.228331,505956,0,6434,499522
8/15/22,Libya,26.3351,17.228331,506314,0,6435,499879
8/16/22,Libya,26.3351,17.228331,506359,0,6435,499924
8/17/22,Libya,26.3351,17.228331,506441,0,6436,500005
8/18/22,Libya,26.3351,17.228331,506475,0,6436,500039
8/19/22,Libya,26.3351,17.228331,506515,0,6436,500079
8/20/22,Libya,26.3351,17.228331,506515,0,6436,500079
8/21/22,Libya,26.3351,17.228331,506515,0,6436,500079
8/22/22,Libya,26.3351,17.228331,506602,0,6436,500166
8/23/22,Libya,26.3351,17.228331,506654,0,6436,500218
8/24/22,Libya,26.3351,17.228331,506689,0,6436,500253
8/25/22,Libya,26.3351,17.228331,506705,0,6436,500269
8/26/22,Libya,26.3351,17.228331,506746,0,6436,500310
8/27/22,Libya,26.3351,17.228331,506746,0,6436,500310
8/28/22,Libya,26.3351,17.228331,506751,0,6436,500315
8/29/22,Libya,26.3351,17.228331,506768,0,6437,500331
8/30/22,Libya,26.3351,17.228331,506775,0,6437,500338
8/31/22,Libya,26.3351,17.228331,506790,0,6437,500353
9/1/22,Libya,26.3351,17.228331,506822,0,6437,500385
9/2/22,Libya,26.3351,17.228331,506838,0,6437,500401
9/3/22,Libya,26.3351,17.228331,506838,0,6437,500401
9/4/22,Libya,26.3351,17.228331,506849,0,6437,500412
9/5/22,Libya,26.3351,17.228331,506860,0,6437,500423
9/6/22,Libya,26.3351,17.228331,506864,0,6437,500427
9/7/22,Libya,26.3351,17.228331,506878,0,6437,500441
9/8/22,Libya,26.3351,17.228331,506881,0,6437,500444
9/9/22,Libya,26.3351,17.228331,506889,0,6437,500452
9/10/22,Libya,26.3351,17.228331,506889,0,6437,500452
9/11/22,Libya,26.3351,17.228331,506889,0,6437,500452
9/12/22,Libya,26.3351,17.228331,506898,0,6437,500461
9/13/22,Libya,26.3351,17.228331,506898,0,6437,500461
9/14/22,Libya,26.3351,17.228331,506909,0,6437,500472
9/15/22,Libya,26.3351,17.228331,506918,0,6437,500481
9/16/22,Libya,26.3351,17.228331,506922,0,6437,500485
9/17/22,Libya,26.3351,17.228331,506922,0,6437,500485
9/18/22,Libya,26.3351,17.228331,506926,0,6437,500489
9/19/22,Libya,26.3351,17.228331,506932,0,6437,500495
9/20/22,Libya,26.3351,17.228331,506941,0,6437,500504
9/21/22,Libya,26.3351,17.228331,506947,0,6437,500510
9/22/22,Libya,26.3351,17.228331,506949,0,6437,500512
9/23/22,Libya,26.3351,17.228331,506954,0,6437,500517
9/24/22,Libya,26.3351,17.228331,506954,0,6437,500517
9/25/22,Libya,26.3351,17.228331,506955,0,6437,500518
9/26/22,Libya,26.3351,17.228331,506986,0,6437,500549
9/27/22,Libya,26.3351,17.228331,506988,0,6437,500551
9/28/22,Libya,26.3351,17.228331,506991,0,6437,500554
9/29/22,Libya,26.3351,17.228331,506991,0,6437,500554
9/30/22,Libya,26.3351,17.228331,506994,0,6437,500557
10/1/22,Libya,26.3351,17.228331,506994,0,6437,500557
10/2/22,Libya,26.3351,17.228331,507004,0,6437,500567
10/3/22,Libya,26.3351,17.228331,507005,0,6437,500568
10/4/22,Libya,26.3351,17.228331,507008,0,6437,500571
10/5/22,Libya,26.3351,17.228331,507009,0,6437,500572
10/6/22,Libya,26.3351,17.228331,507010,0,6437,500573
10/7/22,Libya,26.3351,17.228331,507010,0,6437,500573
10/8/22,Libya,26.3351,17.228331,507010,0,6437,500573
10/9/22,Libya,26.3351,17.228331,507010,0,6437,500573
10/10/22,Libya,26.3351,17.228331,507010,0,6437,500573
10/11/22,Libya,26.3351,17.228331,507010,0,6437,500573
10/12/22,Libya,26.3351,17.228331,507012,0,6437,500575
10/13/22,Libya,26.3351,17.228331,507012,0,6437,500575
10/14/22,Libya,26.3351,17.228331,507012,0,6437,500575
10/15/22,Libya,26.3351,17.228331,507012,0,6437,500575
10/16/22,Libya,26.3351,17.228331,507012,0,6437,500575
10/17/22,Libya,26.3351,17.228331,507024,0,6437,500587
10/18/22,Libya,26.3351,17.228331,507024,0,6437,500587
10/19/22,Libya,26.3351,17.228331,507024,0,6437,500587
10/20/22,Libya,26.3351,17.228331,507024,0,6437,500587
10/21/22,Libya,26.3351,17.228331,507024,0,6437,500587
10/22/22,Libya,26.3351,17.228331,507024,0,6437,500587
10/23/22,Libya,26.3351,17.228331,507024,0,6437,500587
10/24/22,Libya,26.3351,17.228331,507034,0,6437,500597
10/25/22,Libya,26.3351,17.228331,507034,0,6437,500597
10/26/22,Libya,26.3351,17.228331,507034,0,6437,500597
10/27/22,Libya,26.3351,17.228331,507034,0,6437,500597
10/28/22,Libya,26.3351,17.228331,507034,0,6437,500597
10/29/22,Libya,26.3351,17.228331,507034,0,6437,500597
10/30/22,Libya,26.3351,17.228331,507034,0,6437,500597
10/31/22,Libya,26.3351,17.228331,507051,0,6437,500614
11/1/22,Libya,26.3351,17.228331,507051,0,6437,500614
11/2/22,Libya,26.3351,17.228331,507051,0,6437,500614
11/3/22,Libya,26.3351,17.228331,507051,0,6437,500614
11/4/22,Libya,26.3351,17.228331,507051,0,6437,500614
11/5/22,Libya,26.3351,17.228331,507051,0,6437,500614
11/6/22,Libya,26.3351,17.228331,507051,0,6437,500614
11/7/22,Libya,26.3351,17.228331,507060,0,6437,500623
11/8/22,Libya,26.3351,17.228331,507060,0,6437,500623
11/9/22,Libya,26.3351,17.228331,507060,0,6437,500623
11/10/22,Libya,26.3351,17.228331,507060,0,6437,500623
11/11/22,Libya,26.3351,17.228331,507060,0,6437,500623
11/12/22,Libya,26.3351,17.228331,507060,0,6437,500623
11/13/22,Libya,26.3351,17.228331,507060,0,6437,500623
11/14/22,Libya,26.3351,17.228331,507060,0,6437,500623
11/15/22,Libya,26.3351,17.228331,507070,0,6437,500633
11/16/22,Libya,26.3351,17.228331,507070,0,6437,500633
11/17/22,Libya,26.3351,17.228331,507070,0,6437,500633
11/18/22,Libya,26.3351,17.228331,507070,0,6437,500633
11/19/22,Libya,26.3351,17.228331,507070,0,6437,500633
11/20/22,Libya,26.3351,17.228331,507070,0,6437,500633
11/21/22,Libya,26.3351,17.228331,507078,0,6437,500641
11/22/22,Libya,26.3351,17.228331,507078,0,6437,500641
11/23/22,Libya,26.3351,17.228331,507078,0,6437,500641
11/24/22,Libya,26.3351,17.228331,507078,0,6437,500641
11/25/22,Libya,26.3351,17.228331,507078,0,6437,500641
11/26/22,Libya,26.3351,17.228331,507078,0,6437,500641
11/27/22,Libya,26.3351,17.228331,507078,0,6437,500641
11/28/22,Libya,26.3351,17.228331,507084,0,6437,500647
11/29/22,Libya,26.3351,17.228331,507084,0,6437,500647
11/30/22,Libya,26.3351,17.228331,507084,0,6437,500647
12/1/22,Libya,26.3351,17.228331,507084,0,6437,500647
12/2/22,Libya,26.3351,17.228331,507084,0,6437,500647
12/3/22,Libya,26.3351,17.228331,507084,0,6437,500647
12/4/22,Libya,26.3351,17.228331,507084,0,6437,500647
12/5/22,Libya,26.3351,17.228331,507100,0,6437,500663
12/6/22,Libya,26.3351,17.228331,507100,0,6437,500663
12/7/22,Libya,26.3351,17.228331,507100,0,6437,500663
12/8/22,Libya,26.3351,17.228331,507100,0,6437,500663
12/9/22,Libya,26.3351,17.228331,507100,0,6437,500663
12/10/22,Libya,26.3351,17.228331,507100,0,6437,500663
12/11/22,Libya,26.3351,17.228331,507100,0,6437,500663
12/12/22,Libya,26.3351,17.228331,507100,0,6437,500663
12/13/22,Libya,26.3351,17.228331,507112,0,6437,500675
12/14/22,Libya,26.3351,17.228331,507112,0,6437,500675
12/15/22,Libya,26.3351,17.228331,507112,0,6437,500675
12/16/22,Libya,26.3351,17.228331,507112,0,6437,500675
12/17/22,Libya,26.3351,17.228331,507112,0,6437,500675
1/1/22,Liechtenstein,47.14,9.55,6167,0,69,6098
1/2/22,Liechtenstein,47.14,9.55,6208,0,69,6139
1/3/22,Liechtenstein,47.14,9.55,6236,0,71,6165
1/4/22,Liechtenstein,47.14,9.55,6348,0,71,6277
1/5/22,Liechtenstein,47.14,9.55,6406,0,71,6335
1/6/22,Liechtenstein,47.14,9.55,6483,0,71,6412
1/7/22,Liechtenstein,47.14,9.55,6597,0,71,6526
1/8/22,Liechtenstein,47.14,9.55,6597,0,71,6526
1/9/22,Liechtenstein,47.14,9.55,6658,0,71,6587
1/10/22,Liechtenstein,47.14,9.55,6716,0,71,6645
1/11/22,Liechtenstein,47.14,9.55,6824,0,71,6753
1/12/22,Liechtenstein,47.14,9.55,6916,0,71,6845
1/13/22,Liechtenstein,47.14,9.55,7013,0,72,6941
1/14/22,Liechtenstein,47.14,9.55,7020,0,72,6948
1/15/22,Liechtenstein,47.14,9.55,7153,0,72,7081
1/16/22,Liechtenstein,47.14,9.55,7201,0,72,7129
1/17/22,Liechtenstein,47.14,9.55,7265,0,73,7192
1/18/22,Liechtenstein,47.14,9.55,7371,0,73,7298
1/19/22,Liechtenstein,47.14,9.55,7488,0,73,7415
1/20/22,Liechtenstein,47.14,9.55,7671,0,73,7598
1/21/22,Liechtenstein,47.14,9.55,7746,0,73,7673
1/22/22,Liechtenstein,47.14,9.55,7838,0,73,7765
1/23/22,Liechtenstein,47.14,9.55,7838,0,73,7765
1/24/22,Liechtenstein,47.14,9.55,8013,0,73,7940
1/25/22,Liechtenstein,47.14,9.55,8171,0,73,8098
1/26/22,Liechtenstein,47.14,9.55,8346,0,73,8273
1/27/22,Liechtenstein,47.14,9.55,8465,0,73,8392
1/28/22,Liechtenstein,47.14,9.55,8590,0,73,8517
1/29/22,Liechtenstein,47.14,9.55,8775,0,73,8702
1/30/22,Liechtenstein,47.14,9.55,8854,0,73,8781
1/31/22,Liechtenstein,47.14,9.55,8928,0,73,8855
2/1/22,Liechtenstein,47.14,9.55,9035,0,73,8962
2/2/22,Liechtenstein,47.14,9.55,9176,0,73,9103
2/3/22,Liechtenstein,47.14,9.55,9355,0,74,9281
2/4/22,Liechtenstein,47.14,9.55,9514,0,74,9440
2/5/22,Liechtenstein,47.14,9.55,9611,0,74,9537
2/6/22,Liechtenstein,47.14,9.55,9672,0,74,9598
2/7/22,Liechtenstein,47.14,9.55,9764,0,74,9690
2/8/22,Liechtenstein,47.14,9.55,9956,0,74,9882
2/9/22,Liechtenstein,47.14,9.55,10093,0,74,10019
2/10/22,Liechtenstein,47.14,9.55,10254,0,74,10180
2/11/22,Liechtenstein,47.14,9.55,10411,0,74,10337
2/12/22,Liechtenstein,47.14,9.55,10451,0,74,10377
2/13/22,Liechtenstein,47.14,9.55,10523,0,74,10449
2/14/22,Liechtenstein,47.14,9.55,10686,0,74,10612
2/15/22,Liechtenstein,47.14,9.55,10768,0,75,10693
2/16/22,Liechtenstein,47.14,9.55,10837,0,75,10762
2/17/22,Liechtenstein,47.14,9.55,10958,0,75,10883
2/18/22,Liechtenstein,47.14,9.55,11051,0,75,10976
2/19/22,Liechtenstein,47.14,9.55,11113,0,75,11038
2/20/22,Liechtenstein,47.14,9.55,11238,0,75,11163
2/21/22,Liechtenstein,47.14,9.55,11293,0,75,11218
2/22/22,Liechtenstein,47.14,9.55,11362,0,76,11286
2/23/22,Liechtenstein,47.14,9.55,11467,0,76,11391
2/24/22,Liechtenstein,47.14,9.55,11564,0,77,11487
2/25/22,Liechtenstein,47.14,9.55,11671,0,78,11593
2/26/22,Liechtenstein,47.14,9.55,11752,0,78,11674
2/27/22,Liechtenstein,47.14,9.55,11809,0,78,11731
2/28/22,Liechtenstein,47.14,9.55,12001,0,78,11923
3/1/22,Liechtenstein,47.14,9.55,12052,0,78,11974
3/2/22,Liechtenstein,47.14,9.55,12161,0,78,12083
3/3/22,Liechtenstein,47.14,9.55,12332,0,78,12254
3/4/22,Liechtenstein,47.14,9.55,12681,0,78,12603
3/5/22,Liechtenstein,47.14,9.55,12833,0,78,12755
3/6/22,Liechtenstein,47.14,9.55,12932,0,78,12854
3/7/22,Liechtenstein,47.14,9.55,13195,0,78,13117
3/8/22,Liechtenstein,47.14,9.55,13222,0,79,13143
3/9/22,Liechtenstein,47.14,9.55,13471,0,79,13392
3/10/22,Liechtenstein,47.14,9.55,13590,0,79,13511
3/11/22,Liechtenstein,47.14,9.55,13789,0,79,13710
3/12/22,Liechtenstein,47.14,9.55,14025,0,79,13946
3/13/22,Liechtenstein,47.14,9.55,14234,0,79,14155
3/14/22,Liechtenstein,47.14,9.55,14235,0,79,14156
3/15/22,Liechtenstein,47.14,9.55,14424,0,79,14345
3/16/22,Liechtenstein,47.14,9.55,14642,0,81,14561
3/17/22,Liechtenstein,47.14,9.55,14926,0,81,14845
3/18/22,Liechtenstein,47.14,9.55,15043,0,81,14962
3/19/22,Liechtenstein,47.14,9.55,15243,0,81,15162
3/20/22,Liechtenstein,47.14,9.55,15312,0,81,15231
3/21/22,Liechtenstein,47.14,9.55,15458,0,83,15375
3/22/22,Liechtenstein,47.14,9.55,15497,0,83,15414
3/23/22,Liechtenstein,47.14,9.55,15649,0,83,15566
3/24/22,Liechtenstein,47.14,9.55,15761,0,83,15678
3/25/22,Liechtenstein,47.14,9.55,15889,0,83,15806
3/26/22,Liechtenstein,47.14,9.55,16017,0,83,15934
3/27/22,Liechtenstein,47.14,9.55,16098,0,83,16015
3/28/22,Liechtenstein,47.14,9.55,16139,0,83,16056
3/29/22,Liechtenstein,47.14,9.55,16176,0,84,16092
3/30/22,Liechtenstein,47.14,9.55,16286,0,84,16202
3/31/22,Liechtenstein,47.14,9.55,16378,0,84,16294
4/1/22,Liechtenstein,47.14,9.55,16429,0,84,16345
4/2/22,Liechtenstein,47.14,9.55,16429,0,84,16345
4/3/22,Liechtenstein,47.14,9.55,16429,0,84,16345
4/4/22,Liechtenstein,47.14,9.55,16429,0,84,16345
4/5/22,Liechtenstein,47.14,9.55,16429,0,84,16345
4/6/22,Liechtenstein,47.14,9.55,16624,0,84,16540
4/7/22,Liechtenstein,47.14,9.55,16702,0,84,16618
4/8/22,Liechtenstein,47.14,9.55,16702,0,84,16618
4/9/22,Liechtenstein,47.14,9.55,16702,0,84,16618
4/10/22,Liechtenstein,47.14,9.55,16757,0,84,16673
4/11/22,Liechtenstein,47.14,9.55,16784,0,84,16700
4/12/22,Liechtenstein,47.14,9.55,16834,0,84,16750
4/13/22,Liechtenstein,47.14,9.55,16865,0,84,16781
4/14/22,Liechtenstein,47.14,9.55,16906,0,84,16822
4/15/22,Liechtenstein,47.14,9.55,16946,0,84,16862
4/16/22,Liechtenstein,47.14,9.55,16975,0,84,16891
4/17/22,Liechtenstein,47.14,9.55,16981,0,84,16897
4/18/22,Liechtenstein,47.14,9.55,17003,0,84,16919
4/19/22,Liechtenstein,47.14,9.55,17005,0,84,16921
4/20/22,Liechtenstein,47.14,9.55,17027,0,84,16943
4/21/22,Liechtenstein,47.14,9.55,17049,0,84,16965
4/22/22,Liechtenstein,47.14,9.55,17064,0,84,16980
4/23/22,Liechtenstein,47.14,9.55,17091,0,84,17007
4/24/22,Liechtenstein,47.14,9.55,17103,0,85,17018
4/25/22,Liechtenstein,47.14,9.55,17105,0,85,17020
4/26/22,Liechtenstein,47.14,9.55,17126,0,85,17041
4/27/22,Liechtenstein,47.14,9.55,17133,0,84,17049
4/28/22,Liechtenstein,47.14,9.55,17163,0,84,17079
4/29/22,Liechtenstein,47.14,9.55,17171,0,84,17087
4/30/22,Liechtenstein,47.14,9.55,17185,0,84,17101
5/1/22,Liechtenstein,47.14,9.55,17185,0,84,17101
5/2/22,Liechtenstein,47.14,9.55,17199,0,84,17115
5/3/22,Liechtenstein,47.14,9.55,17214,0,84,17130
5/4/22,Liechtenstein,47.14,9.55,17225,0,84,17141
5/5/22,Liechtenstein,47.14,9.55,17230,0,84,17146
5/6/22,Liechtenstein,47.14,9.55,17260,0,84,17176
5/7/22,Liechtenstein,47.14,9.55,17265,0,84,17181
5/8/22,Liechtenstein,47.14,9.55,17280,0,84,17196
5/9/22,Liechtenstein,47.14,9.55,17281,0,84,17197
5/10/22,Liechtenstein,47.14,9.55,17292,0,84,17208
5/11/22,Liechtenstein,47.14,9.55,17306,0,84,17222
5/12/22,Liechtenstein,47.14,9.55,17306,0,84,17222
5/13/22,Liechtenstein,47.14,9.55,17329,0,84,17245
5/14/22,Liechtenstein,47.14,9.55,17333,0,84,17249
5/15/22,Liechtenstein,47.14,9.55,17347,0,84,17263
5/16/22,Liechtenstein,47.14,9.55,17347,0,84,17263
5/17/22,Liechtenstein,47.14,9.55,17361,0,84,17277
5/18/22,Liechtenstein,47.14,9.55,17376,0,84,17292
5/19/22,Liechtenstein,47.14,9.55,17377,0,84,17293
5/20/22,Liechtenstein,47.14,9.55,17392,0,84,17308
5/21/22,Liechtenstein,47.14,9.55,17392,0,84,17308
5/22/22,Liechtenstein,47.14,9.55,17392,0,84,17308
5/23/22,Liechtenstein,47.14,9.55,17407,0,84,17323
5/24/22,Liechtenstein,47.14,9.55,17417,0,84,17333
5/25/22,Liechtenstein,47.14,9.55,17428,0,84,17344
5/26/22,Liechtenstein,47.14,9.55,17428,0,84,17344
5/27/22,Liechtenstein,47.14,9.55,17428,0,84,17344
5/28/22,Liechtenstein,47.14,9.55,17428,0,84,17344
5/29/22,Liechtenstein,47.14,9.55,17428,0,84,17344
5/30/22,Liechtenstein,47.14,9.55,17463,0,84,17379
5/31/22,Liechtenstein,47.14,9.55,17469,0,84,17385
6/1/22,Liechtenstein,47.14,9.55,17507,0,84,17423
6/2/22,Liechtenstein,47.14,9.55,17512,0,84,17428
6/3/22,Liechtenstein,47.14,9.55,17532,0,84,17448
6/4/22,Liechtenstein,47.14,9.55,17532,0,84,17448
6/5/22,Liechtenstein,47.14,9.55,17532,0,84,17448
6/6/22,Liechtenstein,47.14,9.55,17532,0,84,17448
6/7/22,Liechtenstein,47.14,9.55,17568,0,84,17484
6/8/22,Liechtenstein,47.14,9.55,17583,0,84,17499
6/9/22,Liechtenstein,47.14,9.55,17590,0,85,17505
6/10/22,Liechtenstein,47.14,9.55,17605,0,85,17520
6/11/22,Liechtenstein,47.14,9.55,17605,0,85,17520
6/12/22,Liechtenstein,47.14,9.55,17605,0,85,17520
6/13/22,Liechtenstein,47.14,9.55,17628,0,85,17543
6/14/22,Liechtenstein,47.14,9.55,17628,0,85,17543
6/15/22,Liechtenstein,47.14,9.55,17653,0,85,17568
6/16/22,Liechtenstein,47.14,9.55,17653,0,85,17568
6/17/22,Liechtenstein,47.14,9.55,17653,0,85,17568
6/18/22,Liechtenstein,47.14,9.55,17653,0,85,17568
6/19/22,Liechtenstein,47.14,9.55,17653,0,85,17568
6/20/22,Liechtenstein,47.14,9.55,17706,0,85,17621
6/21/22,Liechtenstein,47.14,9.55,17738,0,85,17653
6/22/22,Liechtenstein,47.14,9.55,17774,0,85,17689
6/23/22,Liechtenstein,47.14,9.55,17779,0,85,17694
6/24/22,Liechtenstein,47.14,9.55,17814,0,85,17729
6/25/22,Liechtenstein,47.14,9.55,17814,0,85,17729
6/26/22,Liechtenstein,47.14,9.55,17814,0,85,17729
6/27/22,Liechtenstein,47.14,9.55,17814,0,85,17729
6/28/22,Liechtenstein,47.14,9.55,17860,0,85,17775
6/29/22,Liechtenstein,47.14,9.55,17897,0,85,17812
6/30/22,Liechtenstein,47.14,9.55,17903,0,85,17818
7/1/22,Liechtenstein,47.14,9.55,17935,0,85,17850
7/2/22,Liechtenstein,47.14,9.55,17935,0,85,17850
7/3/22,Liechtenstein,47.14,9.55,17935,0,85,17850
7/4/22,Liechtenstein,47.14,9.55,17935,0,85,17850
7/5/22,Liechtenstein,47.14,9.55,18032,0,85,17947
7/6/22,Liechtenstein,47.14,9.55,18051,0,85,17966
7/7/22,Liechtenstein,47.14,9.55,18077,0,85,17992
7/8/22,Liechtenstein,47.14,9.55,18141,0,85,18056
7/9/22,Liechtenstein,47.14,9.55,18141,0,85,18056
7/10/22,Liechtenstein,47.14,9.55,18141,0,85,18056
7/11/22,Liechtenstein,47.14,9.55,18141,0,85,18056
7/12/22,Liechtenstein,47.14,9.55,18226,0,85,18141
7/13/22,Liechtenstein,47.14,9.55,18257,0,85,18172
7/14/22,Liechtenstein,47.14,9.55,18299,0,85,18214
7/15/22,Liechtenstein,47.14,9.55,18335,0,85,18250
7/16/22,Liechtenstein,47.14,9.55,18335,0,85,18250
7/17/22,Liechtenstein,47.14,9.55,18335,0,85,18250
7/18/22,Liechtenstein,47.14,9.55,18335,0,85,18250
7/19/22,Liechtenstein,47.14,9.55,18425,0,85,18340
7/20/22,Liechtenstein,47.14,9.55,18452,0,85,18367
7/21/22,Liechtenstein,47.14,9.55,18468,0,85,18383
7/22/22,Liechtenstein,47.14,9.55,18478,0,85,18393
7/23/22,Liechtenstein,47.14,9.55,18478,0,85,18393
7/24/22,Liechtenstein,47.14,9.55,18478,0,85,18393
7/25/22,Liechtenstein,47.14,9.55,18571,0,86,18485
7/26/22,Liechtenstein,47.14,9.55,18609,0,86,18523
7/27/22,Liechtenstein,47.14,9.55,18642,0,86,18556
7/28/22,Liechtenstein,47.14,9.55,18653,0,86,18567
7/29/22,Liechtenstein,47.14,9.55,18678,0,86,18592
7/30/22,Liechtenstein,47.14,9.55,18678,0,86,18592
7/31/22,Liechtenstein,47.14,9.55,18678,0,86,18592
8/1/22,Liechtenstein,47.14,9.55,18713,0,86,18627
8/2/22,Liechtenstein,47.14,9.55,18756,0,86,18670
8/3/22,Liechtenstein,47.14,9.55,18774,0,86,18688
8/4/22,Liechtenstein,47.14,9.55,18776,0,86,18690
8/5/22,Liechtenstein,47.14,9.55,18805,0,86,18719
8/6/22,Liechtenstein,47.14,9.55,18805,0,86,18719
8/7/22,Liechtenstein,47.14,9.55,18805,0,86,18719
8/8/22,Liechtenstein,47.14,9.55,18827,0,86,18741
8/9/22,Liechtenstein,47.14,9.55,18853,0,86,18767
8/10/22,Liechtenstein,47.14,9.55,18872,0,86,18786
8/11/22,Liechtenstein,47.14,9.55,18889,0,86,18803
8/12/22,Liechtenstein,47.14,9.55,18907,0,86,18821
8/13/22,Liechtenstein,47.14,9.55,18907,0,86,18821
8/14/22,Liechtenstein,47.14,9.55,18907,0,86,18821
8/15/22,Liechtenstein,47.14,9.55,18907,0,86,18821
8/16/22,Liechtenstein,47.14,9.55,18939,0,86,18853
8/17/22,Liechtenstein,47.14,9.55,18961,0,86,18875
8/18/22,Liechtenstein,47.14,9.55,18968,0,86,18882
8/19/22,Liechtenstein,47.14,9.55,18985,0,86,18899
8/20/22,Liechtenstein,47.14,9.55,18985,0,86,18899
8/21/22,Liechtenstein,47.14,9.55,18985,0,86,18899
8/22/22,Liechtenstein,47.14,9.55,19005,0,86,18919
8/23/22,Liechtenstein,47.14,9.55,19031,0,86,18945
8/24/22,Liechtenstein,47.14,9.55,19047,0,86,18961
8/25/22,Liechtenstein,47.14,9.55,19047,0,86,18961
8/26/22,Liechtenstein,47.14,9.55,19086,0,86,19000
8/27/22,Liechtenstein,47.14,9.55,19086,0,86,19000
8/28/22,Liechtenstein,47.14,9.55,19086,0,86,19000
8/29/22,Liechtenstein,47.14,9.55,19111,0,86,19025
8/30/22,Liechtenstein,47.14,9.55,19146,0,86,19060
8/31/22,Liechtenstein,47.14,9.55,19161,0,86,19075
9/1/22,Liechtenstein,47.14,9.55,19161,0,86,19075
9/2/22,Liechtenstein,47.14,9.55,19183,0,86,19097
9/3/22,Liechtenstein,47.14,9.55,19183,0,86,19097
9/4/22,Liechtenstein,47.14,9.55,19183,0,86,19097
9/5/22,Liechtenstein,47.14,9.55,19231,0,86,19145
9/6/22,Liechtenstein,47.14,9.55,19259,0,86,19173
9/7/22,Liechtenstein,47.14,9.55,19285,0,86,19199
9/8/22,Liechtenstein,47.14,9.55,19285,0,86,19199
9/9/22,Liechtenstein,47.14,9.55,19285,0,86,19199
9/10/22,Liechtenstein,47.14,9.55,19285,0,86,19199
9/11/22,Liechtenstein,47.14,9.55,19285,0,86,19199
9/12/22,Liechtenstein,47.14,9.55,19333,0,86,19247
9/13/22,Liechtenstein,47.14,9.55,19349,0,86,19263
9/14/22,Liechtenstein,47.14,9.55,19385,0,86,19299
9/15/22,Liechtenstein,47.14,9.55,19390,0,86,19304
9/16/22,Liechtenstein,47.14,9.55,19419,0,86,19333
9/17/22,Liechtenstein,47.14,9.55,19419,0,86,19333
9/18/22,Liechtenstein,47.14,9.55,19419,0,86,19333
9/19/22,Liechtenstein,47.14,9.55,19439,0,86,19353
9/20/22,Liechtenstein,47.14,9.55,19463,0,86,19377
9/21/22,Liechtenstein,47.14,9.55,19490,0,86,19404
9/22/22,Liechtenstein,47.14,9.55,19490,0,86,19404
9/23/22,Liechtenstein,47.14,9.55,19490,0,86,19404
9/24/22,Liechtenstein,47.14,9.55,19490,0,86,19404
9/25/22,Liechtenstein,47.14,9.55,19490,0,86,19404
9/26/22,Liechtenstein,47.14,9.55,19543,0,86,19457
9/27/22,Liechtenstein,47.14,9.55,19612,0,86,19526
9/28/22,Liechtenstein,47.14,9.55,19680,0,86,19594
9/29/22,Liechtenstein,47.14,9.55,19713,0,86,19627
9/30/22,Liechtenstein,47.14,9.55,19713,0,86,19627
10/1/22,Liechtenstein,47.14,9.55,19713,0,86,19627
10/2/22,Liechtenstein,47.14,9.55,19713,0,86,19627
10/3/22,Liechtenstein,47.14,9.55,19859,0,86,19773
10/4/22,Liechtenstein,47.14,9.55,19883,0,86,19797
10/5/22,Liechtenstein,47.14,9.55,19978,0,86,19892
10/6/22,Liechtenstein,47.14,9.55,19988,0,86,19902
10/7/22,Liechtenstein,47.14,9.55,20077,0,86,19991
10/8/22,Liechtenstein,47.14,9.55,20077,0,86,19991
10/9/22,Liechtenstein,47.14,9.55,20077,0,86,19991
10/10/22,Liechtenstein,47.14,9.55,20143,0,86,20057
10/11/22,Liechtenstein,47.14,9.55,20211,0,86,20125
10/12/22,Liechtenstein,47.14,9.55,20263,0,86,20177
10/13/22,Liechtenstein,47.14,9.55,20266,0,86,20180
10/14/22,Liechtenstein,47.14,9.55,20325,0,86,20239
10/15/22,Liechtenstein,47.14,9.55,20325,0,86,20239
10/16/22,Liechtenstein,47.14,9.55,20325,0,86,20239
10/17/22,Liechtenstein,47.14,9.55,20389,0,86,20303
10/18/22,Liechtenstein,47.14,9.55,20434,0,86,20348
10/19/22,Liechtenstein,47.14,9.55,20465,0,86,20379
10/20/22,Liechtenstein,47.14,9.55,20470,0,86,20384
10/21/22,Liechtenstein,47.14,9.55,20509,0,86,20423
10/22/22,Liechtenstein,47.14,9.55,20509,0,86,20423
10/23/22,Liechtenstein,47.14,9.55,20509,0,86,20423
10/24/22,Liechtenstein,47.14,9.55,20541,0,86,20455
10/25/22,Liechtenstein,47.14,9.55,20548,0,86,20462
10/26/22,Liechtenstein,47.14,9.55,20582,0,86,20496
10/27/22,Liechtenstein,47.14,9.55,20588,0,87,20501
10/28/22,Liechtenstein,47.14,9.55,20607,0,87,20520
10/29/22,Liechtenstein,47.14,9.55,20607,0,87,20520
10/30/22,Liechtenstein,47.14,9.55,20607,0,87,20520
10/31/22,Liechtenstein,47.14,9.55,20626,0,87,20539
11/1/22,Liechtenstein,47.14,9.55,20626,0,87,20539
11/2/22,Liechtenstein,47.14,9.55,20663,0,87,20576
11/3/22,Liechtenstein,47.14,9.55,20663,0,87,20576
11/4/22,Liechtenstein,47.14,9.55,20663,0,87,20576
11/5/22,Liechtenstein,47.14,9.55,20663,0,87,20576
11/6/22,Liechtenstein,47.14,9.55,20663,0,87,20576
11/7/22,Liechtenstein,47.14,9.55,20687,0,87,20600
11/8/22,Liechtenstein,47.14,9.55,20709,0,87,20622
11/9/22,Liechtenstein,47.14,9.55,20741,0,87,20654
11/10/22,Liechtenstein,47.14,9.55,20741,0,87,20654
11/11/22,Liechtenstein,47.14,9.55,20750,0,87,20663
11/12/22,Liechtenstein,47.14,9.55,20750,0,87,20663
11/13/22,Liechtenstein,47.14,9.55,20750,0,87,20663
11/14/22,Liechtenstein,47.14,9.55,20765,0,87,20678
11/15/22,Liechtenstein,47.14,9.55,20779,0,87,20692
11/16/22,Liechtenstein,47.14,9.55,20796,0,87,20709
11/17/22,Liechtenstein,47.14,9.55,20798,0,87,20711
11/18/22,Liechtenstein,47.14,9.55,20815,0,87,20728
11/19/22,Liechtenstein,47.14,9.55,20815,0,87,20728
11/20/22,Liechtenstein,47.14,9.55,20815,0,87,20728
11/21/22,Liechtenstein,47.14,9.55,20831,0,87,20744
11/22/22,Liechtenstein,47.14,9.55,20831,0,87,20744
11/23/22,Liechtenstein,47.14,9.55,20859,0,87,20772
11/24/22,Liechtenstein,47.14,9.55,20859,0,87,20772
11/25/22,Liechtenstein,47.14,9.55,20874,0,87,20787
11/26/22,Liechtenstein,47.14,9.55,20874,0,87,20787
11/27/22,Liechtenstein,47.14,9.55,20874,0,87,20787
11/28/22,Liechtenstein,47.14,9.55,20890,0,87,20803
11/29/22,Liechtenstein,47.14,9.55,20919,0,87,20832
11/30/22,Liechtenstein,47.14,9.55,20935,0,87,20848
12/1/22,Liechtenstein,47.14,9.55,20935,0,87,20848
12/2/22,Liechtenstein,47.14,9.55,20984,0,87,20897
12/3/22,Liechtenstein,47.14,9.55,20984,0,87,20897
12/4/22,Liechtenstein,47.14,9.55,20984,0,87,20897
12/5/22,Liechtenstein,47.14,9.55,20984,0,87,20897
12/6/22,Liechtenstein,47.14,9.55,21042,0,88,20954
12/7/22,Liechtenstein,47.14,9.55,21064,0,88,20976
12/8/22,Liechtenstein,47.14,9.55,21064,0,88,20976
12/9/22,Liechtenstein,47.14,9.55,21077,0,88,20989
12/10/22,Liechtenstein,47.14,9.55,21077,0,88,20989
12/11/22,Liechtenstein,47.14,9.55,21077,0,88,20989
12/12/22,Liechtenstein,47.14,9.55,21094,0,88,21006
12/13/22,Liechtenstein,47.14,9.55,21124,0,88,21036
12/14/22,Liechtenstein,47.14,9.55,21145,0,88,21057
12/15/22,Liechtenstein,47.14,9.55,21145,0,88,21057
12/16/22,Liechtenstein,47.14,9.55,21170,0,88,21082
12/17/22,Liechtenstein,47.14,9.55,21170,0,88,21082
1/1/22,Lithuania,55.1694,23.8813,526628,0,7412,519216
1/2/22,Lithuania,55.1694,23.8813,527906,0,7432,520474
1/3/22,Lithuania,55.1694,23.8813,529212,0,7452,521760
1/4/22,Lithuania,55.1694,23.8813,531687,0,7474,524213
1/5/22,Lithuania,55.1694,23.8813,535177,0,7488,527689
1/6/22,Lithuania,55.1694,23.8813,538619,0,7508,531111
1/7/22,Lithuania,55.1694,23.8813,542456,0,7514,534942
1/8/22,Lithuania,55.1694,23.8813,546314,0,7534,538780
1/9/22,Lithuania,55.1694,23.8813,549285,0,7552,541733
1/10/22,Lithuania,55.1694,23.8813,551188,0,7566,543622
1/11/22,Lithuania,55.1694,23.8813,554246,0,7581,546665
1/12/22,Lithuania,55.1694,23.8813,559595,0,7592,552003
1/13/22,Lithuania,55.1694,23.8813,564181,0,7618,556563
1/14/22,Lithuania,55.1694,23.8813,568737,0,7631,561106
1/15/22,Lithuania,55.1694,23.8813,573484,0,7651,565833
1/16/22,Lithuania,55.1694,23.8813,577588,0,7665,569923
1/17/22,Lithuania,55.1694,23.8813,580748,0,7676,573072
1/18/22,Lithuania,55.1694,23.8813,586197,0,7691,578506
1/19/22,Lithuania,55.1694,23.8813,593342,0,7703,585639
1/20/22,Lithuania,55.1694,23.8813,601383,0,7718,593665
1/21/22,Lithuania,55.1694,23.8813,609126,0,7735,601391
1/22/22,Lithuania,55.1694,23.8813,617325,0,7752,609573
1/23/22,Lithuania,55.1694,23.8813,623753,0,7765,615988
1/24/22,Lithuania,55.1694,23.8813,628370,0,7772,620598
1/25/22,Lithuania,55.1694,23.8813,634929,0,7790,627139
1/26/22,Lithuania,55.1694,23.8813,646763,0,7809,638954
1/27/22,Lithuania,55.1694,23.8813,659556,0,7821,651735
1/28/22,Lithuania,55.1694,23.8813,673034,0,7838,665196
1/29/22,Lithuania,55.1694,23.8813,686347,0,7851,678496
1/30/22,Lithuania,55.1694,23.8813,697856,0,7869,689987
1/31/22,Lithuania,55.1694,23.8813,705158,0,7889,697269
2/1/22,Lithuania,55.1694,23.8813,715474,0,7905,707569
2/2/22,Lithuania,55.1694,23.8813,730245,0,7925,722320
2/3/22,Lithuania,55.1694,23.8813,745657,0,7941,737716
2/4/22,Lithuania,55.1694,23.8813,760533,0,7956,752577
2/5/22,Lithuania,55.1694,23.8813,775255,0,7974,767281
2/6/22,Lithuania,55.1694,23.8813,786158,0,7991,778167
2/7/22,Lithuania,55.1694,23.8813,794046,0,8007,786039
2/8/22,Lithuania,55.1694,23.8813,804300,0,8016,796284
2/9/22,Lithuania,55.1694,23.8813,818479,0,8040,810439
2/10/22,Lithuania,55.1694,23.8813,830965,0,8051,822914
2/11/22,Lithuania,55.1694,23.8813,843042,0,8070,834972
2/12/22,Lithuania,55.1694,23.8813,854681,0,8092,846589
2/13/22,Lithuania,55.1694,23.8813,863960,0,8122,855838
2/14/22,Lithuania,55.1694,23.8813,869035,0,8142,860893
2/15/22,Lithuania,55.1694,23.8813,876595,0,8178,868417
2/16/22,Lithuania,55.1694,23.8813,887068,0,8199,878869
2/17/22,Lithuania,55.1694,23.8813,894809,0,8213,886596
2/18/22,Lithuania,55.1694,23.8813,901787,0,8221,893566
2/19/22,Lithuania,55.1694,23.8813,911276,0,8239,903037
2/20/22,Lithuania,55.1694,23.8813,918117,0,8254,909863
2/21/22,Lithuania,55.1694,23.8813,922284,0,8276,914008
2/22/22,Lithuania,55.1694,23.8813,929307,0,8300,921007
2/23/22,Lithuania,55.1694,23.8813,938419,0,8320,930099
2/24/22,Lithuania,55.1694,23.8813,946310,0,8341,937969
2/25/22,Lithuania,55.1694,23.8813,953098,0,8374,944724
2/26/22,Lithuania,55.1694,23.8813,959177,0,8387,950790
2/27/22,Lithuania,55.1694,23.8813,963422,0,8415,955007
2/28/22,Lithuania,55.1694,23.8813,965873,0,8426,957447
3/1/22,Lithuania,55.1694,23.8813,971464,0,8448,963016
3/2/22,Lithuania,55.1694,23.8813,978454,0,8463,969991
3/3/22,Lithuania,55.1694,23.8813,984885,0,8484,976401
3/4/22,Lithuania,55.1694,23.8813,990997,0,8499,982498
3/5/22,Lithuania,55.1694,23.8813,996636,0,8520,988116
3/6/22,Lithuania,55.1694,23.8813,1000474,0,8535,991939
3/7/22,Lithuania,55.1694,23.8813,1003126,0,8554,994572
3/8/22,Lithuania,55.1694,23.8813,1008935,0,8572,1000363
3/9/22,Lithuania,55.1694,23.8813,1016341,0,8591,1007750
3/10/22,Lithuania,55.1694,23.8813,1023289,0,8602,1014687
3/11/22,Lithuania,55.1694,23.8813,1029593,0,8608,1020985
3/12/22,Lithuania,55.1694,23.8813,1032883,0,8629,1024254
3/13/22,Lithuania,55.1694,23.8813,1035959,0,8641,1027318
3/14/22,Lithuania,55.1694,23.8813,1038588,0,8654,1029934
3/15/22,Lithuania,55.1694,23.8813,1044509,0,8669,1035840
3/16/22,Lithuania,55.1694,23.8813,1051633,0,8684,1042949
3/17/22,Lithuania,55.1694,23.8813,1057892,0,8701,1049191
3/18/22,Lithuania,55.1694,23.8813,1063327,0,8708,1054619
3/19/22,Lithuania,55.1694,23.8813,1068640,0,8723,1059917
3/20/22,Lithuania,55.1694,23.8813,1071844,0,8737,1063107
3/21/22,Lithuania,55.1694,23.8813,1074108,0,8747,1065361
3/22/22,Lithuania,55.1694,23.8813,1078686,0,8761,1069925
3/23/22,Lithuania,55.1694,23.8813,1084293,0,8777,1075516
3/24/22,Lithuania,55.1694,23.8813,1088831,0,8796,1080035
3/25/22,Lithuania,55.1694,23.8813,1093017,0,8813,1084204
3/26/22,Lithuania,55.1694,23.8813,1096690,0,8826,1087864
3/27/22,Lithuania,55.1694,23.8813,1099114,0,8840,1090274
3/28/22,Lithuania,55.1694,23.8813,1100399,0,8856,1091543
3/29/22,Lithuania,55.1694,23.8813,1103594,0,8865,1094729
3/30/22,Lithuania,55.1694,23.8813,1107334,0,8877,1098457
3/31/22,Lithuania,55.1694,23.8813,1110803,0,8885,1101918
4/1/22,Lithuania,55.1694,23.8813,1113808,0,8894,1104914
4/2/22,Lithuania,55.1694,23.8813,1116207,0,8906,1107301
4/3/22,Lithuania,55.1694,23.8813,1117988,0,8916,1109072
4/4/22,Lithuania,55.1694,23.8813,1118916,0,8922,1109994
4/5/22,Lithuania,55.1694,23.8813,1121144,0,8934,1112210
4/6/22,Lithuania,55.1694,23.8813,1123668,0,8941,1114727
4/7/22,Lithuania,55.1694,23.8813,1125639,0,8948,1116691
4/8/22,Lithuania,55.1694,23.8813,1127456,0,8960,1118496
4/9/22,Lithuania,55.1694,23.8813,1129298,0,8966,1120332
4/10/22,Lithuania,55.1694,23.8813,1130302,0,8972,1121330
4/11/22,Lithuania,55.1694,23.8813,1131033,0,8980,1122053
4/12/22,Lithuania,55.1694,23.8813,1132729,0,8984,1123745
4/13/22,Lithuania,55.1694,23.8813,1134575,0,8995,1125580
4/14/22,Lithuania,55.1694,23.8813,1136089,0,9003,1127086
4/15/22,Lithuania,55.1694,23.8813,1137471,0,9009,1128462
4/16/22,Lithuania,55.1694,23.8813,1138855,0,9017,1129838
4/17/22,Lithuania,55.1694,23.8813,1139639,0,9023,1130616
4/18/22,Lithuania,55.1694,23.8813,1140124,0,9026,1131098
4/19/22,Lithuania,55.1694,23.8813,1140601,0,9029,1131572
4/20/22,Lithuania,55.1694,23.8813,1141856,0,9037,1132819
4/21/22,Lithuania,55.1694,23.8813,1143245,0,9044,1134201
4/22/22,Lithuania,55.1694,23.8813,1144415,0,9052,1135363
4/23/22,Lithuania,55.1694,23.8813,1145293,0,9057,1136236
4/24/22,Lithuania,55.1694,23.8813,1145802,0,9070,1136732
4/25/22,Lithuania,55.1694,23.8813,1146099,0,9079,1137020
4/26/22,Lithuania,55.1694,23.8813,1147008,0,9081,1137927
4/27/22,Lithuania,55.1694,23.8813,1148002,0,9083,1138919
4/28/22,Lithuania,55.1694,23.8813,1148748,0,9090,1139658
4/29/22,Lithuania,55.1694,23.8813,1149395,0,9096,1140299
4/30/22,Lithuania,55.1694,23.8813,1149993,0,9098,1140895
5/1/22,Lithuania,55.1694,23.8813,1150264,0,9103,1141161
5/2/22,Lithuania,55.1694,23.8813,1150382,0,9110,1141272
5/3/22,Lithuania,55.1694,23.8813,1150650,0,9113,1141537
5/4/22,Lithuania,55.1694,23.8813,1150900,0,9115,1141785
5/5/22,Lithuania,55.1694,23.8813,1151115,0,9116,1141999
5/6/22,Lithuania,55.1694,23.8813,1151312,0,9118,1142194
5/7/22,Lithuania,55.1694,23.8813,1151530,0,9121,1142409
5/8/22,Lithuania,55.1694,23.8813,1151567,0,9123,1142444
5/9/22,Lithuania,55.1694,23.8813,1151585,0,9123,1142462
5/10/22,Lithuania,55.1694,23.8813,1151887,0,9126,1142761
5/11/22,Lithuania,55.1694,23.8813,1152124,0,9127,1142997
5/12/22,Lithuania,55.1694,23.8813,1152359,0,9129,1143230
5/13/22,Lithuania,55.1694,23.8813,1152528,0,9131,1143397
5/14/22,Lithuania,55.1694,23.8813,1152712,0,9132,1143580
5/15/22,Lithuania,55.1694,23.8813,1152747,0,9132,1143615
5/16/22,Lithuania,55.1694,23.8813,1152768,0,9132,1143636
5/17/22,Lithuania,55.1694,23.8813,1153053,0,9132,1143921
5/18/22,Lithuania,55.1694,23.8813,1153258,0,9133,1144125
5/19/22,Lithuania,55.1694,23.8813,1153442,0,9134,1144308
5/20/22,Lithuania,55.1694,23.8813,1153586,0,9135,1144451
5/21/22,Lithuania,55.1694,23.8813,1153751,0,9136,1144615
5/22/22,Lithuania,55.1694,23.8813,1153392,0,9134,1144258
5/23/22,Lithuania,55.1694,23.8813,1153803,0,9137,1144666
5/24/22,Lithuania,55.1694,23.8813,1154054,0,9140,1144914
5/25/22,Lithuania,55.1694,23.8813,1154219,0,9140,1145079
5/26/22,Lithuania,55.1694,23.8813,1154388,0,9141,1145247
5/27/22,Lithuania,55.1694,23.8813,1154518,0,9143,1145375
5/28/22,Lithuania,55.1694,23.8813,1154667,0,9143,1145524
5/29/22,Lithuania,55.1694,23.8813,1154694,0,9144,1145550
5/30/22,Lithuania,55.1694,23.8813,1154707,0,9145,1145562
5/31/22,Lithuania,55.1694,23.8813,1154914,0,9146,1145768
6/1/22,Lithuania,55.1694,23.8813,1155082,0,9146,1145936
6/2/22,Lithuania,55.1694,23.8813,1155246,0,9147,1146099
6/3/22,Lithuania,55.1694,23.8813,1155399,0,9149,1146250
6/4/22,Lithuania,55.1694,23.8813,1155539,0,9149,1146390
6/5/22,Lithuania,55.1694,23.8813,1155571,0,9149,1146422
6/6/22,Lithuania,55.1694,23.8813,1155584,0,9149,1146435
6/7/22,Lithuania,55.1694,23.8813,1155804,0,9150,1146654
6/8/22,Lithuania,55.1694,23.8813,1156022,0,9151,1146871
6/9/22,Lithuania,55.1694,23.8813,1156229,0,9152,1147077
6/10/22,Lithuania,55.1694,23.8813,1156451,0,9153,1147298
6/11/22,Lithuania,55.1694,23.8813,1156634,0,9153,1147481
6/12/22,Lithuania,55.1694,23.8813,1156670,0,9153,1147517
6/13/22,Lithuania,55.1694,23.8813,1156693,0,9155,1147538
6/14/22,Lithuania,55.1694,23.8813,1156980,0,9156,1147824
6/15/22,Lithuania,55.1694,23.8813,1157248,0,9156,1148092
6/16/22,Lithuania,55.1694,23.8813,1157492,0,9156,1148336
6/17/22,Lithuania,55.1694,23.8813,1157689,0,9157,1148532
6/18/22,Lithuania,55.1694,23.8813,1157928,0,9158,1148770
6/19/22,Lithuania,55.1694,23.8813,1157973,0,9158,1148815
6/20/22,Lithuania,55.1694,23.8813,1157997,0,9162,1148835
6/21/22,Lithuania,55.1694,23.8813,1158394,0,9162,1149232
6/22/22,Lithuania,55.1694,23.8813,1158727,0,9162,1149565
6/23/22,Lithuania,55.1694,23.8813,1159082,0,9164,1149918
6/24/22,Lithuania,55.1694,23.8813,1159413,0,9164,1150249
6/25/22,Lithuania,55.1694,23.8813,1159452,0,9165,1150287
6/26/22,Lithuania,55.1694,23.8813,1159507,0,9166,1150341
6/27/22,Lithuania,55.1694,23.8813,1159567,0,9168,1150399
6/28/22,Lithuania,55.1694,23.8813,1160189,0,9170,1151019
6/29/22,Lithuania,55.1694,23.8813,1160680,0,9173,1151507
6/30/22,Lithuania,55.1694,23.8813,1161146,0,9173,1151973
7/1/22,Lithuania,55.1694,23.8813,1161568,0,9174,1152394
7/2/22,Lithuania,55.1694,23.8813,1162060,0,9174,1152886
7/3/22,Lithuania,55.1694,23.8813,1162126,0,9174,1152952
7/4/22,Lithuania,55.1694,23.8813,1162184,0,9175,1153009
7/5/22,Lithuania,55.1694,23.8813,1162831,0,9176,1153655
7/6/22,Lithuania,55.1694,23.8813,1163443,0,9176,1154267
7/7/22,Lithuania,55.1694,23.8813,1163529,0,9178,1154351
7/8/22,Lithuania,55.1694,23.8813,1164273,0,9178,1155095
7/9/22,Lithuania,55.1694,23.8813,1164952,0,9178,1155774
7/10/22,Lithuania,55.1694,23.8813,1165053,0,9178,1155875
7/11/22,Lithuania,55.1694,23.8813,1165105,0,9181,1155924
7/12/22,Lithuania,55.1694,23.8813,1166108,0,9181,1156927
7/13/22,Lithuania,55.1694,23.8813,1166944,0,9185,1157759
7/14/22,Lithuania,55.1694,23.8813,1167750,0,9188,1158562
7/15/22,Lithuania,55.1694,23.8813,1168585,0,9188,1159397
7/16/22,Lithuania,55.1694,23.8813,1169489,0,9188,1160301
7/17/22,Lithuania,55.1694,23.8813,1169600,0,9188,1160412
7/18/22,Lithuania,55.1694,23.8813,1169673,0,9190,1160483
7/19/22,Lithuania,55.1694,23.8813,1171034,0,9191,1161843
7/20/22,Lithuania,55.1694,23.8813,1172186,0,9194,1162992
7/21/22,Lithuania,55.1694,23.8813,1173330,0,9194,1164136
7/22/22,Lithuania,55.1694,23.8813,1174481,0,9197,1165284
7/23/22,Lithuania,55.1694,23.8813,1175704,0,9197,1166507
7/24/22,Lithuania,55.1694,23.8813,1175891,0,9197,1166694
7/25/22,Lithuania,55.1694,23.8813,1175998,0,9201,1166797
7/26/22,Lithuania,55.1694,23.8813,1177827,0,9206,1168621
7/27/22,Lithuania,55.1694,23.8813,1179372,0,9205,1170167
7/28/22,Lithuania,55.1694,23.8813,1180648,0,9207,1171441
7/29/22,Lithuania,55.1694,23.8813,1181995,0,9208,1172787
7/30/22,Lithuania,55.1694,23.8813,1183300,0,9208,1174092
7/31/22,Lithuania,55.1694,23.8813,1183422,0,9208,1174214
8/1/22,Lithuania,55.1694,23.8813,1183536,0,9209,1174327
8/2/22,Lithuania,55.1694,23.8813,1185583,0,9210,1176373
8/3/22,Lithuania,55.1694,23.8813,1187213,0,9211,1178002
8/4/22,Lithuania,55.1694,23.8813,1188767,0,9216,1179551
8/5/22,Lithuania,55.1694,23.8813,1190172,0,9218,1180954
8/6/22,Lithuania,55.1694,23.8813,1191712,0,9218,1182494
8/7/22,Lithuania,55.1694,23.8813,1191888,0,9218,1182670
8/8/22,Lithuania,55.1694,23.8813,1191996,0,9223,1182773
8/9/22,Lithuania,55.1694,23.8813,1193955,0,9226,1184729
8/10/22,Lithuania,55.1694,23.8813,1195813,0,9227,1186586
8/11/22,Lithuania,55.1694,23.8813,1197416,0,9229,1188187
8/12/22,Lithuania,55.1694,23.8813,1198747,0,9230,1189517
8/13/22,Lithuania,55.1694,23.8813,1200279,0,9230,1191049
8/14/22,Lithuania,55.1694,23.8813,1200477,0,9230,1191247
8/15/22,Lithuania,55.1694,23.8813,1200610,0,9230,1191380
8/16/22,Lithuania,55.1694,23.8813,1200807,0,9245,1191562
8/17/22,Lithuania,55.1694,23.8813,1203644,0,9250,1194394
8/18/22,Lithuania,55.1694,23.8813,1205579,0,9252,1196327
8/19/22,Lithuania,55.1694,23.8813,1207268,0,9254,1198014
8/20/22,Lithuania,55.1694,23.8813,1208667,0,9254,1199413
8/21/22,Lithuania,55.1694,23.8813,1208790,0,9254,1199536
8/22/22,Lithuania,55.1694,23.8813,1208857,0,9262,1199595
8/23/22,Lithuania,55.1694,23.8813,1211077,0,9266,1201811
8/24/22,Lithuania,55.1694,23.8813,1212309,0,9267,1203042
8/25/22,Lithuania,55.1694,23.8813,1213520,0,9270,1204250
8/26/22,Lithuania,55.1694,23.8813,1214484,0,9276,1205208
8/27/22,Lithuania,55.1694,23.8813,1215461,0,9276,1206185
8/28/22,Lithuania,55.1694,23.8813,1215461,0,9276,1206185
8/29/22,Lithuania,55.1694,23.8813,1215605,0,9285,1206320
8/30/22,Lithuania,55.1694,23.8813,1217300,0,9286,1208014
8/31/22,Lithuania,55.1694,23.8813,1218327,0,9289,1209038
9/1/22,Lithuania,55.1694,23.8813,1219230,0,9291,1209939
9/2/22,Lithuania,55.1694,23.8813,1219977,0,9293,1210684
9/3/22,Lithuania,55.1694,23.8813,1220758,0,9293,1211465
9/4/22,Lithuania,55.1694,23.8813,1220822,0,9293,1211529
9/5/22,Lithuania,55.1694,23.8813,1220882,0,9293,1211589
9/6/22,Lithuania,55.1694,23.8813,1222463,0,9297,1213166
9/7/22,Lithuania,55.1694,23.8813,1223495,0,9296,1214199
9/8/22,Lithuania,55.1694,23.8813,1224515,0,9296,1215219
9/9/22,Lithuania,55.1694,23.8813,1225478,0,9294,1216184
9/10/22,Lithuania,55.1694,23.8813,1226496,0,9294,1217202
9/11/22,Lithuania,55.1694,23.8813,1226614,0,9294,1217320
9/12/22,Lithuania,55.1694,23.8813,1226685,0,9296,1217389
9/13/22,Lithuania,55.1694,23.8813,1229048,0,9295,1219753
9/14/22,Lithuania,55.1694,23.8813,1230785,0,9297,1221488
9/15/22,Lithuania,55.1694,23.8813,1232367,0,9301,1223066
9/16/22,Lithuania,55.1694,23.8813,1233862,0,9304,1224558
9/17/22,Lithuania,55.1694,23.8813,1235248,0,9304,1225944
9/18/22,Lithuania,55.1694,23.8813,1235373,0,9304,1226069
9/19/22,Lithuania,55.1694,23.8813,1235469,0,9306,1226163
9/20/22,Lithuania,55.1694,23.8813,1238195,0,9308,1228887
9/21/22,Lithuania,55.1694,23.8813,1240000,0,9309,1230691
9/22/22,Lithuania,55.1694,23.8813,1241497,0,9309,1232188
9/23/22,Lithuania,55.1694,23.8813,1242730,0,9313,1233417
9/24/22,Lithuania,55.1694,23.8813,1243951,0,9313,1234638
9/25/22,Lithuania,55.1694,23.8813,1244080,0,9313,1234767
9/26/22,Lithuania,55.1694,23.8813,1244174,0,9315,1234859
9/27/22,Lithuania,55.1694,23.8813,1246398,0,9317,1237081
9/28/22,Lithuania,55.1694,23.8813,1247792,0,9319,1238473
9/29/22,Lithuania,55.1694,23.8813,1249134,0,9320,1239814
9/30/22,Lithuania,55.1694,23.8813,1250158,0,9320,1240838
10/1/22,Lithuania,55.1694,23.8813,1251209,0,9320,1241889
10/2/22,Lithuania,55.1694,23.8813,1251328,0,9320,1242008
10/3/22,Lithuania,55.1694,23.8813,1251410,0,9327,1242083
10/4/22,Lithuania,55.1694,23.8813,1253167,0,9330,1243837
10/5/22,Lithuania,55.1694,23.8813,1254247,0,9335,1244912
10/6/22,Lithuania,55.1694,23.8813,1255181,0,9336,1245845
10/7/22,Lithuania,55.1694,23.8813,1256003,0,9339,1246664
10/8/22,Lithuania,55.1694,23.8813,1256823,0,9339,1247484
10/9/22,Lithuania,55.1694,23.8813,1256954,0,9339,1247615
10/10/22,Lithuania,55.1694,23.8813,1257011,0,9344,1247667
10/11/22,Lithuania,55.1694,23.8813,1258521,0,9347,1249174
10/12/22,Lithuania,55.1694,23.8813,1259428,0,9350,1250078
10/13/22,Lithuania,55.1694,23.8813,1260161,0,9355,1250806
10/14/22,Lithuania,55.1694,23.8813,1260809,0,9355,1251454
10/15/22,Lithuania,55.1694,23.8813,1261435,0,9355,1252080
10/16/22,Lithuania,55.1694,23.8813,1261596,0,9355,1252241
10/17/22,Lithuania,55.1694,23.8813,1261643,0,9363,1252280
10/18/22,Lithuania,55.1694,23.8813,1262782,0,9369,1253413
10/19/22,Lithuania,55.1694,23.8813,1263538,0,9369,1254169
10/20/22,Lithuania,55.1694,23.8813,1264090,0,9373,1254717
10/21/22,Lithuania,55.1694,23.8813,1264602,0,9373,1255229
10/22/22,Lithuania,55.1694,23.8813,1265081,0,9373,1255708
10/23/22,Lithuania,55.1694,23.8813,1265120,0,9373,1255747
10/24/22,Lithuania,55.1694,23.8813,1265161,0,9381,1255780
10/25/22,Lithuania,55.1694,23.8813,1265985,0,9386,1256599
10/26/22,Lithuania,55.1694,23.8813,1266559,0,9387,1257172
10/27/22,Lithuania,55.1694,23.8813,1267094,0,9387,1257707
10/28/22,Lithuania,55.1694,23.8813,1267507,0,9391,1258116
10/29/22,Lithuania,55.1694,23.8813,1267973,0,9391,1258582
10/30/22,Lithuania,55.1694,23.8813,1268010,0,9391,1258619
10/31/22,Lithuania,55.1694,23.8813,1268046,0,9393,1258653
11/1/22,Lithuania,55.1694,23.8813,1268633,0,9393,1259240
11/2/22,Lithuania,55.1694,23.8813,1268671,0,9393,1259278
11/3/22,Lithuania,55.1694,23.8813,1268707,0,9396,1259311
11/4/22,Lithuania,55.1694,23.8813,1268707,0,9398,1259309
11/5/22,Lithuania,55.1694,23.8813,1269729,0,9398,1260331
11/6/22,Lithuania,55.1694,23.8813,1269772,0,9398,1260374
11/7/22,Lithuania,55.1694,23.8813,1269806,0,9401,1260405
11/8/22,Lithuania,55.1694,23.8813,1270349,0,9403,1260946
11/9/22,Lithuania,55.1694,23.8813,1270708,0,9404,1261304
11/10/22,Lithuania,55.1694,23.8813,1270986,0,9405,1261581
11/11/22,Lithuania,55.1694,23.8813,1271238,0,9407,1261831
11/12/22,Lithuania,55.1694,23.8813,1271466,0,9407,1262059
11/13/22,Lithuania,55.1694,23.8813,1271487,0,9407,1262080
11/14/22,Lithuania,55.1694,23.8813,1271502,0,9413,1262089
11/15/22,Lithuania,55.1694,23.8813,1271987,0,9412,1262575
11/16/22,Lithuania,55.1694,23.8813,1272269,0,9414,1262855
11/17/22,Lithuania,55.1694,23.8813,1272547,0,9412,1263135
11/18/22,Lithuania,55.1694,23.8813,1272774,0,9414,1263360
11/19/22,Lithuania,55.1694,23.8813,1273009,0,9414,1263595
11/20/22,Lithuania,55.1694,23.8813,1273036,0,9414,1263622
11/21/22,Lithuania,55.1694,23.8813,1273064,0,9419,1263645
11/22/22,Lithuania,55.1694,23.8813,1273554,0,9420,1264134
11/23/22,Lithuania,55.1694,23.8813,1273886,0,9422,1264464
11/24/22,Lithuania,55.1694,23.8813,1274185,0,9424,1264761
11/25/22,Lithuania,55.1694,23.8813,1274499,0,9429,1265070
11/26/22,Lithuania,55.1694,23.8813,1274830,0,9429,1265401
11/27/22,Lithuania,55.1694,23.8813,1274862,0,9429,1265433
11/28/22,Lithuania,55.1694,23.8813,1274885,0,9432,1265453
11/29/22,Lithuania,55.1694,23.8813,1275230,0,9431,1265799
11/30/22,Lithuania,55.1694,23.8813,1276076,0,9434,1266642
12/1/22,Lithuania,55.1694,23.8813,1276600,0,9434,1267166
12/2/22,Lithuania,55.1694,23.8813,1277041,0,9435,1267606
12/3/22,Lithuania,55.1694,23.8813,1277475,0,9435,1268040
12/4/22,Lithuania,55.1694,23.8813,1277545,0,9435,1268110
12/5/22,Lithuania,55.1694,23.8813,1277579,0,9437,1268142
12/6/22,Lithuania,55.1694,23.8813,1278458,0,9439,1269019
12/7/22,Lithuania,55.1694,23.8813,1279048,0,9442,1269606
12/8/22,Lithuania,55.1694,23.8813,1279559,0,9440,1270119
12/9/22,Lithuania,55.1694,23.8813,1280029,0,9442,1270587
12/10/22,Lithuania,55.1694,23.8813,1280474,0,9442,1271032
12/11/22,Lithuania,55.1694,23.8813,1280574,0,9442,1271132
12/12/22,Lithuania,55.1694,23.8813,1280625,0,9441,1271184
12/13/22,Lithuania,55.1694,23.8813,1280625,0,9442,1271183
12/14/22,Lithuania,55.1694,23.8813,1281955,0,9450,1272505
12/15/22,Lithuania,55.1694,23.8813,1282485,0,9452,1273033
12/16/22,Lithuania,55.1694,23.8813,1282732,0,9452,1273280
12/17/22,Lithuania,55.1694,23.8813,1283322,0,9452,1273870
1/1/22,Luxembourg,49.8153,6.1296,103766,0,915,102851
1/2/22,Luxembourg,49.8153,6.1296,103766,0,915,102851
1/3/22,Luxembourg,49.8153,6.1296,105358,0,917,104441
1/4/22,Luxembourg,49.8153,6.1296,106235,0,918,105317
1/5/22,Luxembourg,49.8153,6.1296,108366,0,920,107446
1/6/22,Luxembourg,49.8153,6.1296,110298,0,921,109377
1/7/22,Luxembourg,49.8153,6.1296,112203,0,922,111281
1/8/22,Luxembourg,49.8153,6.1296,112203,0,922,111281
1/9/22,Luxembourg,49.8153,6.1296,112203,0,922,111281
1/10/22,Luxembourg,49.8153,6.1296,116039,0,930,115109
1/11/22,Luxembourg,49.8153,6.1296,117001,0,930,116071
1/12/22,Luxembourg,49.8153,6.1296,118925,0,930,117995
1/13/22,Luxembourg,49.8153,6.1296,121237,0,931,120306
1/14/22,Luxembourg,49.8153,6.1296,123340,0,934,122406
1/15/22,Luxembourg,49.8153,6.1296,123340,0,934,122406
1/16/22,Luxembourg,49.8153,6.1296,123340,0,934,122406
1/17/22,Luxembourg,49.8153,6.1296,127765,0,938,126827
1/18/22,Luxembourg,49.8153,6.1296,129092,0,940,128152
1/19/22,Luxembourg,49.8153,6.1296,131644,0,941,130703
1/20/22,Luxembourg,49.8153,6.1296,134714,0,941,133773
1/21/22,Luxembourg,49.8153,6.1296,137570,0,943,136627
1/22/22,Luxembourg,49.8153,6.1296,137570,0,943,136627
1/23/22,Luxembourg,49.8153,6.1296,137570,0,943,136627
1/24/22,Luxembourg,49.8153,6.1296,143067,0,945,142122
1/25/22,Luxembourg,49.8153,6.1296,144781,0,945,143836
1/26/22,Luxembourg,49.8153,6.1296,147854,0,946,146908
1/27/22,Luxembourg,49.8153,6.1296,150883,0,947,149936
1/28/22,Luxembourg,49.8153,6.1296,153435,0,948,152487
1/29/22,Luxembourg,49.8153,6.1296,153435,0,948,152487
1/30/22,Luxembourg,49.8153,6.1296,153435,0,948,152487
1/31/22,Luxembourg,49.8153,6.1296,157985,0,952,157033
2/1/22,Luxembourg,49.8153,6.1296,159438,0,953,158485
2/2/22,Luxembourg,49.8153,6.1296,161986,0,956,161030
2/3/22,Luxembourg,49.8153,6.1296,163980,0,956,163024
2/4/22,Luxembourg,49.8153,6.1296,165958,0,958,165000
2/5/22,Luxembourg,49.8153,6.1296,165958,0,958,165000
2/6/22,Luxembourg,49.8153,6.1296,165958,0,958,165000
2/7/22,Luxembourg,49.8153,6.1296,168988,0,964,168024
2/8/22,Luxembourg,49.8153,6.1296,170100,0,966,169134
2/9/22,Luxembourg,49.8153,6.1296,171452,0,966,170486
2/10/22,Luxembourg,49.8153,6.1296,172502,0,968,171534
2/11/22,Luxembourg,49.8153,6.1296,173419,0,969,172450
2/12/22,Luxembourg,49.8153,6.1296,173419,0,969,172450
2/13/22,Luxembourg,49.8153,6.1296,173419,0,969,172450
2/14/22,Luxembourg,49.8153,6.1296,174856,0,976,173880
2/15/22,Luxembourg,49.8153,6.1296,175408,0,979,174429
2/16/22,Luxembourg,49.8153,6.1296,176177,0,979,175198
2/17/22,Luxembourg,49.8153,6.1296,176736,0,982,175754
2/18/22,Luxembourg,49.8153,6.1296,177372,0,983,176389
2/19/22,Luxembourg,49.8153,6.1296,177372,0,983,176389
2/20/22,Luxembourg,49.8153,6.1296,177372,0,983,176389
2/21/22,Luxembourg,49.8153,6.1296,178507,0,985,177522
2/22/22,Luxembourg,49.8153,6.1296,179305,0,986,178319
2/23/22,Luxembourg,49.8153,6.1296,180376,0,988,179388
2/24/22,Luxembourg,49.8153,6.1296,181195,0,988,180207
2/25/22,Luxembourg,49.8153,6.1296,181903,0,988,180915
2/26/22,Luxembourg,49.8153,6.1296,181903,0,988,180915
2/27/22,Luxembourg,49.8153,6.1296,181903,0,988,180915
2/28/22,Luxembourg,49.8153,6.1296,183177,0,991,182186
3/1/22,Luxembourg,49.8153,6.1296,183802,0,992,182810
3/2/22,Luxembourg,49.8153,6.1296,184862,0,993,183869
3/3/22,Luxembourg,49.8153,6.1296,185707,0,995,184712
3/4/22,Luxembourg,49.8153,6.1296,186360,0,996,185364
3/5/22,Luxembourg,49.8153,6.1296,186360,0,996,185364
3/6/22,Luxembourg,49.8153,6.1296,186360,0,996,185364
3/7/22,Luxembourg,49.8153,6.1296,187971,0,999,186972
3/8/22,Luxembourg,49.8153,6.1296,188748,0,999,187749
3/9/22,Luxembourg,49.8153,6.1296,189830,0,1000,188830
3/10/22,Luxembourg,49.8153,6.1296,191006,0,1004,190002
3/11/22,Luxembourg,49.8153,6.1296,191964,0,1004,190960
3/12/22,Luxembourg,49.8153,6.1296,191964,0,1004,190960
3/13/22,Luxembourg,49.8153,6.1296,191964,0,1004,190960
3/14/22,Luxembourg,49.8153,6.1296,193939,0,1006,192933
3/15/22,Luxembourg,49.8153,6.1296,194846,0,1007,193839
3/16/22,Luxembourg,49.8153,6.1296,196296,0,1008,195288
3/17/22,Luxembourg,49.8153,6.1296,197701,0,1010,196691
3/18/22,Luxembourg,49.8153,6.1296,199202,0,1010,198192
3/19/22,Luxembourg,49.8153,6.1296,199202,0,1010,198192
3/20/22,Luxembourg,49.8153,6.1296,199202,0,1010,198192
3/21/22,Luxembourg,49.8153,6.1296,201718,0,1015,200703
3/22/22,Luxembourg,49.8153,6.1296,202577,0,1019,201558
3/23/22,Luxembourg,49.8153,6.1296,203861,0,1019,202842
3/24/22,Luxembourg,49.8153,6.1296,206044,0,1023,205021
3/25/22,Luxembourg,49.8153,6.1296,208223,0,1025,207198
3/26/22,Luxembourg,49.8153,6.1296,208223,0,1025,207198
3/27/22,Luxembourg,49.8153,6.1296,208223,0,1025,207198
3/28/22,Luxembourg,49.8153,6.1296,211280,0,1032,210248
3/29/22,Luxembourg,49.8153,6.1296,212390,0,1035,211355
3/30/22,Luxembourg,49.8153,6.1296,214099,0,1035,213064
3/31/22,Luxembourg,49.8153,6.1296,215831,0,1036,214795
4/1/22,Luxembourg,49.8153,6.1296,216979,0,1037,215942
4/2/22,Luxembourg,49.8153,6.1296,216979,0,1037,215942
4/3/22,Luxembourg,49.8153,6.1296,216979,0,1037,215942
4/4/22,Luxembourg,49.8153,6.1296,219390,0,1041,218349
4/5/22,Luxembourg,49.8153,6.1296,220034,0,1042,218992
4/6/22,Luxembourg,49.8153,6.1296,221555,0,1042,220513
4/7/22,Luxembourg,49.8153,6.1296,222804,0,1042,221762
4/8/22,Luxembourg,49.8153,6.1296,223666,0,1045,222621
4/9/22,Luxembourg,49.8153,6.1296,223666,0,1045,222621
4/10/22,Luxembourg,49.8153,6.1296,223666,0,1045,222621
4/11/22,Luxembourg,49.8153,6.1296,225562,0,1050,224512
4/12/22,Luxembourg,49.8153,6.1296,226339,0,1051,225288
4/13/22,Luxembourg,49.8153,6.1296,227528,0,1052,226476
4/14/22,Luxembourg,49.8153,6.1296,227536,0,1053,226483
4/15/22,Luxembourg,49.8153,6.1296,229311,0,1054,228257
4/16/22,Luxembourg,49.8153,6.1296,229311,0,1054,228257
4/17/22,Luxembourg,49.8153,6.1296,229311,0,1054,228257
4/18/22,Luxembourg,49.8153,6.1296,229311,0,1054,228257
4/19/22,Luxembourg,49.8153,6.1296,230991,0,1055,229936
4/20/22,Luxembourg,49.8153,6.1296,231669,0,1056,230613
4/21/22,Luxembourg,49.8153,6.1296,233137,0,1056,232081
4/22/22,Luxembourg,49.8153,6.1296,233966,0,1058,232908
4/23/22,Luxembourg,49.8153,6.1296,233966,0,1058,232908
4/24/22,Luxembourg,49.8153,6.1296,233966,0,1058,232908
4/25/22,Luxembourg,49.8153,6.1296,235276,0,1062,234214
4/26/22,Luxembourg,49.8153,6.1296,235864,0,1062,234802
4/27/22,Luxembourg,49.8153,6.1296,236686,0,1063,235623
4/28/22,Luxembourg,49.8153,6.1296,237248,0,1064,236184
4/29/22,Luxembourg,49.8153,6.1296,237856,0,1064,236792
4/30/22,Luxembourg,49.8153,6.1296,237856,0,1064,236792
5/1/22,Luxembourg,49.8153,6.1296,237856,0,1064,236792
5/2/22,Luxembourg,49.8153,6.1296,238917,0,1068,237849
5/3/22,Luxembourg,49.8153,6.1296,239335,0,1068,238267
5/4/22,Luxembourg,49.8153,6.1296,240132,0,1068,239064
5/5/22,Luxembourg,49.8153,6.1296,240675,0,1068,239607
5/6/22,Luxembourg,49.8153,6.1296,241160,0,1068,240092
5/7/22,Luxembourg,49.8153,6.1296,241160,0,1068,240092
5/8/22,Luxembourg,49.8153,6.1296,241686,0,1068,240618
5/9/22,Luxembourg,49.8153,6.1296,242165,0,1069,241096
5/10/22,Luxembourg,49.8153,6.1296,242178,0,1070,241108
5/11/22,Luxembourg,49.8153,6.1296,242194,0,1071,241123
5/12/22,Luxembourg,49.8153,6.1296,242700,0,1072,241628
5/13/22,Luxembourg,49.8153,6.1296,243569,0,1073,242496
5/14/22,Luxembourg,49.8153,6.1296,244182,0,1073,243109
5/15/22,Luxembourg,49.8153,6.1296,244620,0,1073,243547
5/16/22,Luxembourg,49.8153,6.1296,244866,0,1073,243793
5/17/22,Luxembourg,49.8153,6.1296,244882,0,1073,243809
5/18/22,Luxembourg,49.8153,6.1296,245318,0,1073,244245
5/19/22,Luxembourg,49.8153,6.1296,245750,0,1073,244677
5/20/22,Luxembourg,49.8153,6.1296,246081,0,1074,245007
5/21/22,Luxembourg,49.8153,6.1296,246342,0,1075,245267
5/22/22,Luxembourg,49.8153,6.1296,246579,0,1075,245504
5/23/22,Luxembourg,49.8153,6.1296,246748,0,1075,245673
5/24/22,Luxembourg,49.8153,6.1296,246761,0,1076,245685
5/25/22,Luxembourg,49.8153,6.1296,247022,0,1077,245945
5/26/22,Luxembourg,49.8153,6.1296,247257,0,1077,246180
5/27/22,Luxembourg,49.8153,6.1296,247502,0,1077,246425
5/28/22,Luxembourg,49.8153,6.1296,247539,0,1077,246462
5/29/22,Luxembourg,49.8153,6.1296,247760,0,1077,246683
5/30/22,Luxembourg,49.8153,6.1296,247920,0,1078,246842
5/31/22,Luxembourg,49.8153,6.1296,247935,0,1078,246857
6/1/22,Luxembourg,49.8153,6.1296,248279,0,1078,247201
6/2/22,Luxembourg,49.8153,6.1296,248702,0,1078,247624
6/3/22,Luxembourg,49.8153,6.1296,248972,0,1079,247893
6/4/22,Luxembourg,49.8153,6.1296,248972,0,1079,247893
6/5/22,Luxembourg,49.8153,6.1296,248972,0,1079,247893
6/6/22,Luxembourg,49.8153,6.1296,249319,0,1079,248240
6/7/22,Luxembourg,49.8153,6.1296,249319,0,1079,248240
6/8/22,Luxembourg,49.8153,6.1296,249939,0,1081,248858
6/9/22,Luxembourg,49.8153,6.1296,251873,0,1084,250789
6/10/22,Luxembourg,49.8153,6.1296,251873,0,1084,250789
6/11/22,Luxembourg,49.8153,6.1296,251873,0,1084,250789
6/12/22,Luxembourg,49.8153,6.1296,251873,0,1084,250789
6/13/22,Luxembourg,49.8153,6.1296,251873,0,1084,250789
6/14/22,Luxembourg,49.8153,6.1296,252693,0,1084,251609
6/15/22,Luxembourg,49.8153,6.1296,253318,0,1084,252234
6/16/22,Luxembourg,49.8153,6.1296,254173,0,1084,253089
6/17/22,Luxembourg,49.8153,6.1296,254865,0,1084,253781
6/18/22,Luxembourg,49.8153,6.1296,254865,0,1084,253781
6/19/22,Luxembourg,49.8153,6.1296,254865,0,1084,253781
6/20/22,Luxembourg,49.8153,6.1296,255469,0,1084,254385
6/21/22,Luxembourg,49.8153,6.1296,256678,0,1086,255592
6/22/22,Luxembourg,49.8153,6.1296,257503,0,1087,256416
6/23/22,Luxembourg,49.8153,6.1296,258467,0,1088,257379
6/24/22,Luxembourg,49.8153,6.1296,258467,0,1088,257379
6/25/22,Luxembourg,49.8153,6.1296,258467,0,1088,257379
6/26/22,Luxembourg,49.8153,6.1296,258467,0,1088,257379
6/27/22,Luxembourg,49.8153,6.1296,258467,0,1088,257379
6/28/22,Luxembourg,49.8153,6.1296,261163,0,1092,260071
6/29/22,Luxembourg,49.8153,6.1296,263167,0,1094,262073
6/30/22,Luxembourg,49.8153,6.1296,263387,0,1094,262293
7/1/22,Luxembourg,49.8153,6.1296,264571,0,1094,263477
7/2/22,Luxembourg,49.8153,6.1296,264571,0,1094,263477
7/3/22,Luxembourg,49.8153,6.1296,264571,0,1094,263477
7/4/22,Luxembourg,49.8153,6.1296,265323,0,1094,264229
7/5/22,Luxembourg,49.8153,6.1296,266904,0,1094,265810
7/6/22,Luxembourg,49.8153,6.1296,267707,0,1094,266613
7/7/22,Luxembourg,49.8153,6.1296,269086,0,1095,267991
7/8/22,Luxembourg,49.8153,6.1296,270130,0,1097,269033
7/9/22,Luxembourg,49.8153,6.1296,270130,0,1097,269033
7/10/22,Luxembourg,49.8153,6.1296,270130,0,1097,269033
7/11/22,Luxembourg,49.8153,6.1296,271049,0,1098,269951
7/12/22,Luxembourg,49.8153,6.1296,272520,0,1100,271420
7/13/22,Luxembourg,49.8153,6.1296,273401,0,1100,272301
7/14/22,Luxembourg,49.8153,6.1296,274677,0,1102,273575
7/15/22,Luxembourg,49.8153,6.1296,275512,0,1103,274409
7/16/22,Luxembourg,49.8153,6.1296,275512,0,1103,274409
7/17/22,Luxembourg,49.8153,6.1296,275512,0,1103,274409
7/18/22,Luxembourg,49.8153,6.1296,276134,0,1106,275028
7/19/22,Luxembourg,49.8153,6.1296,277350,0,1107,276243
7/20/22,Luxembourg,49.8153,6.1296,277888,0,1107,276781
7/21/22,Luxembourg,49.8153,6.1296,278975,0,1107,277868
7/22/22,Luxembourg,49.8153,6.1296,279517,0,1107,278410
7/23/22,Luxembourg,49.8153,6.1296,279517,0,1107,278410
7/24/22,Luxembourg,49.8153,6.1296,279517,0,1107,278410
7/25/22,Luxembourg,49.8153,6.1296,280088,0,1108,278980
7/26/22,Luxembourg,49.8153,6.1296,280929,0,1108,279821
7/27/22,Luxembourg,49.8153,6.1296,281271,0,1108,280163
7/28/22,Luxembourg,49.8153,6.1296,281839,0,1109,280730
7/29/22,Luxembourg,49.8153,6.1296,282252,0,1109,281143
7/30/22,Luxembourg,49.8153,6.1296,282252,0,1109,281143
7/31/22,Luxembourg,49.8153,6.1296,282252,0,1109,281143
8/1/22,Luxembourg,49.8153,6.1296,282252,0,1109,281143
8/2/22,Luxembourg,49.8153,6.1296,282929,0,1113,281816
8/3/22,Luxembourg,49.8153,6.1296,283214,0,1113,282101
8/4/22,Luxembourg,49.8153,6.1296,283507,0,1114,282393
8/5/22,Luxembourg,49.8153,6.1296,283721,0,1115,282606
8/6/22,Luxembourg,49.8153,6.1296,283721,0,1115,282606
8/7/22,Luxembourg,49.8153,6.1296,284931,0,1115,283816
8/8/22,Luxembourg,49.8153,6.1296,284931,0,1117,283814
8/9/22,Luxembourg,49.8153,6.1296,284931,0,1117,283814
8/10/22,Luxembourg,49.8153,6.1296,284931,0,1117,283814
8/11/22,Luxembourg,49.8153,6.1296,284931,0,1117,283814
8/12/22,Luxembourg,49.8153,6.1296,284931,0,1119,283812
8/13/22,Luxembourg,49.8153,6.1296,284931,0,1119,283812
8/14/22,Luxembourg,49.8153,6.1296,284931,0,1119,283812
8/15/22,Luxembourg,49.8153,6.1296,284931,0,1119,283812
8/16/22,Luxembourg,49.8153,6.1296,284931,0,1119,283812
8/17/22,Luxembourg,49.8153,6.1296,285145,0,1121,284024
8/18/22,Luxembourg,49.8153,6.1296,285345,0,1121,284224
8/19/22,Luxembourg,49.8153,6.1296,285552,0,1121,284431
8/20/22,Luxembourg,49.8153,6.1296,285552,0,1121,284431
8/21/22,Luxembourg,49.8153,6.1296,285552,0,1121,284431
8/22/22,Luxembourg,49.8153,6.1296,285689,0,1121,284568
8/23/22,Luxembourg,49.8153,6.1296,285883,0,1121,284762
8/24/22,Luxembourg,49.8153,6.1296,286045,0,1121,284924
8/25/22,Luxembourg,49.8153,6.1296,286188,0,1122,285066
8/26/22,Luxembourg,49.8153,6.1296,286289,0,1122,285167
8/27/22,Luxembourg,49.8153,6.1296,286289,0,1122,285167
8/28/22,Luxembourg,49.8153,6.1296,286289,0,1122,285167
8/29/22,Luxembourg,49.8153,6.1296,286289,0,1122,285167
8/30/22,Luxembourg,49.8153,6.1296,286660,0,1123,285537
8/31/22,Luxembourg,49.8153,6.1296,286827,0,1123,285704
9/1/22,Luxembourg,49.8153,6.1296,286968,0,1123,285845
9/2/22,Luxembourg,49.8153,6.1296,287100,0,1123,285977
9/3/22,Luxembourg,49.8153,6.1296,288658,0,1123,287535
9/4/22,Luxembourg,49.8153,6.1296,288658,0,1123,287535
9/5/22,Luxembourg,49.8153,6.1296,288658,0,1123,287535
9/6/22,Luxembourg,49.8153,6.1296,288658,0,1123,287535
9/7/22,Luxembourg,49.8153,6.1296,288658,0,1123,287535
9/8/22,Luxembourg,49.8153,6.1296,288658,0,1123,287535
9/9/22,Luxembourg,49.8153,6.1296,288658,0,1123,287535
9/10/22,Luxembourg,49.8153,6.1296,288658,0,1123,287535
9/11/22,Luxembourg,49.8153,6.1296,288658,0,1123,287535
9/12/22,Luxembourg,49.8153,6.1296,288658,0,1124,287534
9/13/22,Luxembourg,49.8153,6.1296,288658,0,1125,287533
9/14/22,Luxembourg,49.8153,6.1296,288658,0,1126,287532
9/15/22,Luxembourg,49.8153,6.1296,288658,0,1126,287532
9/16/22,Luxembourg,49.8153,6.1296,288721,0,1126,287595
9/17/22,Luxembourg,49.8153,6.1296,288721,0,1126,287595
9/18/22,Luxembourg,49.8153,6.1296,288721,0,1126,287595
9/19/22,Luxembourg,49.8153,6.1296,288865,0,1127,287738
9/20/22,Luxembourg,49.8153,6.1296,289164,0,1127,288037
9/21/22,Luxembourg,49.8153,6.1296,289386,0,1127,288259
9/22/22,Luxembourg,49.8153,6.1296,289633,0,1127,288506
9/23/22,Luxembourg,49.8153,6.1296,289831,0,1127,288704
9/24/22,Luxembourg,49.8153,6.1296,289831,0,1127,288704
9/25/22,Luxembourg,49.8153,6.1296,289831,0,1127,288704
9/26/22,Luxembourg,49.8153,6.1296,290074,0,1127,288947
9/27/22,Luxembourg,49.8153,6.1296,290464,0,1127,289337
9/28/22,Luxembourg,49.8153,6.1296,290945,0,1128,289817
9/29/22,Luxembourg,49.8153,6.1296,291380,0,1129,290251
9/30/22,Luxembourg,49.8153,6.1296,291758,0,1129,290629
10/1/22,Luxembourg,49.8153,6.1296,291758,0,1129,290629
10/2/22,Luxembourg,49.8153,6.1296,291758,0,1129,290629
10/3/22,Luxembourg,49.8153,6.1296,291758,0,1129,290629
10/4/22,Luxembourg,49.8153,6.1296,292788,0,1131,291657
10/5/22,Luxembourg,49.8153,6.1296,293201,0,1132,292069
10/6/22,Luxembourg,49.8153,6.1296,294753,0,1133,293620
10/7/22,Luxembourg,49.8153,6.1296,294753,0,1133,293620
10/8/22,Luxembourg,49.8153,6.1296,294753,0,1133,293620
10/9/22,Luxembourg,49.8153,6.1296,294753,0,1133,293620
10/10/22,Luxembourg,49.8153,6.1296,294931,0,1133,293798
10/11/22,Luxembourg,49.8153,6.1296,295792,0,1135,294657
10/12/22,Luxembourg,49.8153,6.1296,296195,0,1136,295059
10/13/22,Luxembourg,49.8153,6.1296,296941,0,1136,295805
10/14/22,Luxembourg,49.8153,6.1296,297757,0,1136,296621
10/15/22,Luxembourg,49.8153,6.1296,297757,0,1136,296621
10/16/22,Luxembourg,49.8153,6.1296,297757,0,1136,296621
10/17/22,Luxembourg,49.8153,6.1296,297835,0,1136,296699
10/18/22,Luxembourg,49.8153,6.1296,298647,0,1140,297507
10/19/22,Luxembourg,49.8153,6.1296,299022,0,1139,297883
10/20/22,Luxembourg,49.8153,6.1296,299715,0,1139,298576
10/21/22,Luxembourg,49.8153,6.1296,300099,0,1139,298960
10/22/22,Luxembourg,49.8153,6.1296,300099,0,1139,298960
10/23/22,Luxembourg,49.8153,6.1296,300099,0,1139,298960
10/24/22,Luxembourg,49.8153,6.1296,300436,0,1139,299297
10/25/22,Luxembourg,49.8153,6.1296,301031,0,1144,299887
10/26/22,Luxembourg,49.8153,6.1296,301353,0,1144,300209
10/27/22,Luxembourg,49.8153,6.1296,301761,0,1144,300617
10/28/22,Luxembourg,49.8153,6.1296,302031,0,1145,300886
10/29/22,Luxembourg,49.8153,6.1296,302031,0,1145,300886
10/30/22,Luxembourg,49.8153,6.1296,302031,0,1145,300886
10/31/22,Luxembourg,49.8153,6.1296,302221,0,1145,301076
11/1/22,Luxembourg,49.8153,6.1296,302221,0,1145,301076
11/2/22,Luxembourg,49.8153,6.1296,302221,0,1145,301076
11/3/22,Luxembourg,49.8153,6.1296,302868,0,1146,301722
11/4/22,Luxembourg,49.8153,6.1296,303025,0,1147,301878
11/5/22,Luxembourg,49.8153,6.1296,303025,0,1147,301878
11/6/22,Luxembourg,49.8153,6.1296,303025,0,1147,301878
11/7/22,Luxembourg,49.8153,6.1296,303214,0,1149,302065
11/8/22,Luxembourg,49.8153,6.1296,303464,0,1149,302315
11/9/22,Luxembourg,49.8153,6.1296,303571,0,1151,302420
11/10/22,Luxembourg,49.8153,6.1296,303571,0,1151,302420
11/11/22,Luxembourg,49.8153,6.1296,303571,0,1151,302420
11/12/22,Luxembourg,49.8153,6.1296,303571,0,1151,302420
11/13/22,Luxembourg,49.8153,6.1296,303571,0,1151,302420
11/14/22,Luxembourg,49.8153,6.1296,304151,0,1152,302999
11/15/22,Luxembourg,49.8153,6.1296,304377,0,1153,303224
11/16/22,Luxembourg,49.8153,6.1296,304556,0,1154,303402
11/17/22,Luxembourg,49.8153,6.1296,304770,0,1154,303616
11/18/22,Luxembourg,49.8153,6.1296,304962,0,1154,303808
11/19/22,Luxembourg,49.8153,6.1296,304962,0,1154,303808
11/20/22,Luxembourg,49.8153,6.1296,304962,0,1154,303808
11/21/22,Luxembourg,49.8153,6.1296,305163,0,1154,304009
11/22/22,Luxembourg,49.8153,6.1296,305434,0,1157,304277
11/23/22,Luxembourg,49.8153,6.1296,305694,0,1157,304537
11/24/22,Luxembourg,49.8153,6.1296,305929,0,1158,304771
11/25/22,Luxembourg,49.8153,6.1296,306139,0,1158,304981
11/26/22,Luxembourg,49.8153,6.1296,306139,0,1158,304981
11/27/22,Luxembourg,49.8153,6.1296,306139,0,1158,304981
11/28/22,Luxembourg,49.8153,6.1296,306343,0,1158,305185
11/29/22,Luxembourg,49.8153,6.1296,306599,0,1160,305439
11/30/22,Luxembourg,49.8153,6.1296,306843,0,1162,305681
12/1/22,Luxembourg,49.8153,6.1296,307089,0,1163,305926
12/2/22,Luxembourg,49.8153,6.1296,307290,0,1165,306125
12/3/22,Luxembourg,49.8153,6.1296,307290,0,1165,306125
12/4/22,Luxembourg,49.8153,6.1296,307290,0,1165,306125
12/5/22,Luxembourg,49.8153,6.1296,307523,0,1165,306358
12/6/22,Luxembourg,49.8153,6.1296,307813,0,1168,306645
12/7/22,Luxembourg,49.8153,6.1296,308061,0,1168,306893
12/8/22,Luxembourg,49.8153,6.1296,308274,0,1168,307106
12/9/22,Luxembourg,49.8153,6.1296,308572,0,1168,307404
12/10/22,Luxembourg,49.8153,6.1296,308572,0,1168,307404
12/11/22,Luxembourg,49.8153,6.1296,308572,0,1168,307404
12/12/22,Luxembourg,49.8153,6.1296,308800,0,1168,307632
12/13/22,Luxembourg,49.8153,6.1296,309253,0,1170,308083
12/14/22,Luxembourg,49.8153,6.1296,309432,0,1171,308261
12/15/22,Luxembourg,49.8153,6.1296,309818,0,1171,308647
12/16/22,Luxembourg,49.8153,6.1296,310066,0,1172,308894
12/17/22,Luxembourg,49.8153,6.1296,310066,0,1172,308894
1/1/22,Madagascar,-18.766947,46.869107,50279,0,1027,49252
1/2/22,Madagascar,-18.766947,46.869107,50279,0,1027,49252
1/3/22,Madagascar,-18.766947,46.869107,50279,0,1027,49252
1/4/22,Madagascar,-18.766947,46.869107,52434,0,1067,51367
1/5/22,Madagascar,-18.766947,46.869107,52434,0,1067,51367
1/6/22,Madagascar,-18.766947,46.869107,52434,0,1067,51367
1/7/22,Madagascar,-18.766947,46.869107,52434,0,1067,51367
1/8/22,Madagascar,-18.766947,46.869107,54101,0,1117,52984
1/9/22,Madagascar,-18.766947,46.869107,54101,0,1117,52984
1/10/22,Madagascar,-18.766947,46.869107,54101,0,1117,52984
1/11/22,Madagascar,-18.766947,46.869107,54101,0,1117,52984
1/12/22,Madagascar,-18.766947,46.869107,54101,0,1117,52984
1/13/22,Madagascar,-18.766947,46.869107,54101,0,1117,52984
1/14/22,Madagascar,-18.766947,46.869107,54101,0,1117,52984
1/15/22,Madagascar,-18.766947,46.869107,55138,0,1169,53969
1/16/22,Madagascar,-18.766947,46.869107,55138,0,1169,53969
1/17/22,Madagascar,-18.766947,46.869107,55827,0,1169,54658
1/18/22,Madagascar,-18.766947,46.869107,55827,0,1169,54658
1/19/22,Madagascar,-18.766947,46.869107,55827,0,1169,54658
1/20/22,Madagascar,-18.766947,46.869107,55827,0,1169,54658
1/21/22,Madagascar,-18.766947,46.869107,55827,0,1169,54658
1/22/22,Madagascar,-18.766947,46.869107,57375,0,1223,56152
1/23/22,Madagascar,-18.766947,46.869107,57375,0,1223,56152
1/24/22,Madagascar,-18.766947,46.869107,57375,0,1223,56152
1/25/22,Madagascar,-18.766947,46.869107,57375,0,1223,56152
1/26/22,Madagascar,-18.766947,46.869107,57375,0,1223,56152
1/27/22,Madagascar,-18.766947,46.869107,57375,0,1223,56152
1/28/22,Madagascar,-18.766947,46.869107,57375,0,1223,56152
1/29/22,Madagascar,-18.766947,46.869107,59319,0,1274,58045
1/30/22,Madagascar,-18.766947,46.869107,59319,0,1274,58045
1/31/22,Madagascar,-18.766947,46.869107,59319,0,1274,58045
2/1/22,Madagascar,-18.766947,46.869107,59319,0,1274,58045
2/2/22,Madagascar,-18.766947,46.869107,59319,0,1274,58045
2/3/22,Madagascar,-18.766947,46.869107,59319,0,1274,58045
2/4/22,Madagascar,-18.766947,46.869107,59319,0,1274,58045
2/5/22,Madagascar,-18.766947,46.869107,61434,0,1307,60127
2/6/22,Madagascar,-18.766947,46.869107,61434,0,1307,60127
2/7/22,Madagascar,-18.766947,46.869107,61434,0,1307,60127
2/8/22,Madagascar,-18.766947,46.869107,61434,0,1307,60127
2/9/22,Madagascar,-18.766947,46.869107,61434,0,1307,60127
2/10/22,Madagascar,-18.766947,46.869107,61434,0,1307,60127
2/11/22,Madagascar,-18.766947,46.869107,61434,0,1307,60127
2/12/22,Madagascar,-18.766947,46.869107,62844,0,1335,61509
2/13/22,Madagascar,-18.766947,46.869107,62844,0,1335,61509
2/14/22,Madagascar,-18.766947,46.869107,62844,0,1335,61509
2/15/22,Madagascar,-18.766947,46.869107,62844,0,1335,61509
2/16/22,Madagascar,-18.766947,46.869107,62844,0,1335,61509
2/17/22,Madagascar,-18.766947,46.869107,62844,0,1335,61509
2/18/22,Madagascar,-18.766947,46.869107,62844,0,1335,61509
2/19/22,Madagascar,-18.766947,46.869107,63433,0,1350,62083
2/20/22,Madagascar,-18.766947,46.869107,63433,0,1350,62083
2/21/22,Madagascar,-18.766947,46.869107,63433,0,1350,62083
2/22/22,Madagascar,-18.766947,46.869107,63433,0,1350,62083
2/23/22,Madagascar,-18.766947,46.869107,63433,0,1350,62083
2/24/22,Madagascar,-18.766947,46.869107,63433,0,1350,62083
2/25/22,Madagascar,-18.766947,46.869107,63433,0,1350,62083
2/26/22,Madagascar,-18.766947,46.869107,63659,0,1366,62293
2/27/22,Madagascar,-18.766947,46.869107,63659,0,1366,62293
2/28/22,Madagascar,-18.766947,46.869107,63659,0,1366,62293
3/1/22,Madagascar,-18.766947,46.869107,63659,0,1366,62293
3/2/22,Madagascar,-18.766947,46.869107,63659,0,1366,62293
3/3/22,Madagascar,-18.766947,46.869107,63659,0,1366,62293
3/4/22,Madagascar,-18.766947,46.869107,63659,0,1366,62293
3/5/22,Madagascar,-18.766947,46.869107,63791,0,1373,62418
3/6/22,Madagascar,-18.766947,46.869107,63791,0,1373,62418
3/7/22,Madagascar,-18.766947,46.869107,63791,0,1373,62418
3/8/22,Madagascar,-18.766947,46.869107,63791,0,1373,62418
3/9/22,Madagascar,-18.766947,46.869107,63791,0,1373,62418
3/10/22,Madagascar,-18.766947,46.869107,63791,0,1373,62418
3/11/22,Madagascar,-18.766947,46.869107,63791,0,1373,62418
3/12/22,Madagascar,-18.766947,46.869107,63870,0,1377,62493
3/13/22,Madagascar,-18.766947,46.869107,63870,0,1377,62493
3/14/22,Madagascar,-18.766947,46.869107,63870,0,1377,62493
3/15/22,Madagascar,-18.766947,46.869107,63870,0,1377,62493
3/16/22,Madagascar,-18.766947,46.869107,63870,0,1377,62493
3/17/22,Madagascar,-18.766947,46.869107,63870,0,1377,62493
3/18/22,Madagascar,-18.766947,46.869107,63870,0,1377,62493
3/19/22,Madagascar,-18.766947,46.869107,63928,0,1380,62548
3/20/22,Madagascar,-18.766947,46.869107,63928,0,1380,62548
3/21/22,Madagascar,-18.766947,46.869107,63928,0,1380,62548
3/22/22,Madagascar,-18.766947,46.869107,63928,0,1380,62548
3/23/22,Madagascar,-18.766947,46.869107,63928,0,1380,62548
3/24/22,Madagascar,-18.766947,46.869107,63928,0,1380,62548
3/25/22,Madagascar,-18.766947,46.869107,63928,0,1380,62548
3/26/22,Madagascar,-18.766947,46.869107,64009,0,1384,62625
3/27/22,Madagascar,-18.766947,46.869107,64009,0,1384,62625
3/28/22,Madagascar,-18.766947,46.869107,64009,0,1384,62625
3/29/22,Madagascar,-18.766947,46.869107,64009,0,1384,62625
3/30/22,Madagascar,-18.766947,46.869107,64009,0,1384,62625
3/31/22,Madagascar,-18.766947,46.869107,64009,0,1384,62625
4/1/22,Madagascar,-18.766947,46.869107,64009,0,1384,62625
4/2/22,Madagascar,-18.766947,46.869107,64050,0,1388,62662
4/3/22,Madagascar,-18.766947,46.869107,64050,0,1388,62662
4/4/22,Madagascar,-18.766947,46.869107,64050,0,1388,62662
4/5/22,Madagascar,-18.766947,46.869107,64050,0,1388,62662
4/6/22,Madagascar,-18.766947,46.869107,64050,0,1388,62662
4/7/22,Madagascar,-18.766947,46.869107,64050,0,1388,62662
4/8/22,Madagascar,-18.766947,46.869107,64050,0,1388,62662
4/9/22,Madagascar,-18.766947,46.869107,64050,0,1388,62662
4/10/22,Madagascar,-18.766947,46.869107,64089,0,1390,62699
4/11/22,Madagascar,-18.766947,46.869107,64089,0,1390,62699
4/12/22,Madagascar,-18.766947,46.869107,64089,0,1390,62699
4/13/22,Madagascar,-18.766947,46.869107,64089,0,1390,62699
4/14/22,Madagascar,-18.766947,46.869107,64089,0,1390,62699
4/15/22,Madagascar,-18.766947,46.869107,64089,0,1390,62699
4/16/22,Madagascar,-18.766947,46.869107,64089,0,1390,62699
4/17/22,Madagascar,-18.766947,46.869107,64121,0,1391,62730
4/18/22,Madagascar,-18.766947,46.869107,64121,0,1391,62730
4/19/22,Madagascar,-18.766947,46.869107,64121,0,1391,62730
4/20/22,Madagascar,-18.766947,46.869107,64121,0,1391,62730
4/21/22,Madagascar,-18.766947,46.869107,64121,0,1391,62730
4/22/22,Madagascar,-18.766947,46.869107,64121,0,1391,62730
4/23/22,Madagascar,-18.766947,46.869107,64121,0,1391,62730
4/24/22,Madagascar,-18.766947,46.869107,64152,0,1391,62761
4/25/22,Madagascar,-18.766947,46.869107,64152,0,1391,62761
4/26/22,Madagascar,-18.766947,46.869107,64152,0,1391,62761
4/27/22,Madagascar,-18.766947,46.869107,64152,0,1391,62761
4/28/22,Madagascar,-18.766947,46.869107,64152,0,1391,62761
4/29/22,Madagascar,-18.766947,46.869107,64152,0,1391,62761
4/30/22,Madagascar,-18.766947,46.869107,64152,0,1391,62761
5/1/22,Madagascar,-18.766947,46.869107,64152,0,1391,62761
5/2/22,Madagascar,-18.766947,46.869107,64181,0,1391,62790
5/3/22,Madagascar,-18.766947,46.869107,64181,0,1391,62790
5/4/22,Madagascar,-18.766947,46.869107,64181,0,1391,62790
5/5/22,Madagascar,-18.766947,46.869107,64181,0,1391,62790
5/6/22,Madagascar,-18.766947,46.869107,64181,0,1391,62790
5/7/22,Madagascar,-18.766947,46.869107,64181,0,1391,62790
5/8/22,Madagascar,-18.766947,46.869107,64236,0,1393,62843
5/9/22,Madagascar,-18.766947,46.869107,64236,0,1393,62843
5/10/22,Madagascar,-18.766947,46.869107,64236,0,1393,62843
5/11/22,Madagascar,-18.766947,46.869107,64236,0,1393,62843
5/12/22,Madagascar,-18.766947,46.869107,64236,0,1393,62843
5/13/22,Madagascar,-18.766947,46.869107,64236,0,1393,62843
5/14/22,Madagascar,-18.766947,46.869107,64236,0,1393,62843
5/15/22,Madagascar,-18.766947,46.869107,64276,0,1393,62883
5/16/22,Madagascar,-18.766947,46.869107,64276,0,1393,62883
5/17/22,Madagascar,-18.766947,46.869107,64276,0,1393,62883
5/18/22,Madagascar,-18.766947,46.869107,64276,0,1393,62883
5/19/22,Madagascar,-18.766947,46.869107,64276,0,1393,62883
5/20/22,Madagascar,-18.766947,46.869107,64276,0,1393,62883
5/21/22,Madagascar,-18.766947,46.869107,64276,0,1393,62883
5/22/22,Madagascar,-18.766947,46.869107,64314,0,1393,62921
5/23/22,Madagascar,-18.766947,46.869107,64314,0,1393,62921
5/24/22,Madagascar,-18.766947,46.869107,64314,0,1393,62921
5/25/22,Madagascar,-18.766947,46.869107,64314,0,1393,62921
5/26/22,Madagascar,-18.766947,46.869107,64314,0,1393,62921
5/27/22,Madagascar,-18.766947,46.869107,64314,0,1393,62921
5/28/22,Madagascar,-18.766947,46.869107,64314,0,1393,62921
5/29/22,Madagascar,-18.766947,46.869107,64377,0,1395,62982
5/30/22,Madagascar,-18.766947,46.869107,64377,0,1395,62982
5/31/22,Madagascar,-18.766947,46.869107,64377,0,1395,62982
6/1/22,Madagascar,-18.766947,46.869107,64377,0,1395,62982
6/2/22,Madagascar,-18.766947,46.869107,64377,0,1395,62982
6/3/22,Madagascar,-18.766947,46.869107,64377,0,1395,62982
6/4/22,Madagascar,-18.766947,46.869107,64377,0,1395,62982
6/5/22,Madagascar,-18.766947,46.869107,64377,0,1395,62982
6/6/22,Madagascar,-18.766947,46.869107,64478,0,1396,63082
6/7/22,Madagascar,-18.766947,46.869107,64478,0,1396,63082
6/8/22,Madagascar,-18.766947,46.869107,64478,0,1396,63082
6/9/22,Madagascar,-18.766947,46.869107,64478,0,1396,63082
6/10/22,Madagascar,-18.766947,46.869107,64478,0,1396,63082
6/11/22,Madagascar,-18.766947,46.869107,64478,0,1396,63082
6/12/22,Madagascar,-18.766947,46.869107,64685,0,1396,63289
6/13/22,Madagascar,-18.766947,46.869107,64685,0,1396,63289
6/14/22,Madagascar,-18.766947,46.869107,64685,0,1396,63289
6/15/22,Madagascar,-18.766947,46.869107,64685,0,1396,63289
6/16/22,Madagascar,-18.766947,46.869107,64685,0,1396,63289
6/17/22,Madagascar,-18.766947,46.869107,64685,0,1396,63289
6/18/22,Madagascar,-18.766947,46.869107,64685,0,1396,63289
6/19/22,Madagascar,-18.766947,46.869107,65009,0,1398,63611
6/20/22,Madagascar,-18.766947,46.869107,65009,0,1398,63611
6/21/22,Madagascar,-18.766947,46.869107,65009,0,1398,63611
6/22/22,Madagascar,-18.766947,46.869107,65009,0,1398,63611
6/23/22,Madagascar,-18.766947,46.869107,65009,0,1398,63611
6/24/22,Madagascar,-18.766947,46.869107,65009,0,1398,63611
6/25/22,Madagascar,-18.766947,46.869107,65009,0,1398,63611
6/26/22,Madagascar,-18.766947,46.869107,65381,0,1398,63983
6/27/22,Madagascar,-18.766947,46.869107,65381,0,1398,63983
6/28/22,Madagascar,-18.766947,46.869107,65381,0,1398,63983
6/29/22,Madagascar,-18.766947,46.869107,65381,0,1398,63983
6/30/22,Madagascar,-18.766947,46.869107,65381,0,1398,63983
7/1/22,Madagascar,-18.766947,46.869107,65381,0,1398,63983
7/2/22,Madagascar,-18.766947,46.869107,65381,0,1398,63983
7/3/22,Madagascar,-18.766947,46.869107,65787,0,1401,64386
7/4/22,Madagascar,-18.766947,46.869107,65787,0,1401,64386
7/5/22,Madagascar,-18.766947,46.869107,65787,0,1401,64386
7/6/22,Madagascar,-18.766947,46.869107,65787,0,1401,64386
7/7/22,Madagascar,-18.766947,46.869107,65787,0,1401,64386
7/8/22,Madagascar,-18.766947,46.869107,65787,0,1401,64386
7/9/22,Madagascar,-18.766947,46.869107,65787,0,1401,64386
7/10/22,Madagascar,-18.766947,46.869107,66098,0,1403,64695
7/11/22,Madagascar,-18.766947,46.869107,66098,0,1403,64695
7/12/22,Madagascar,-18.766947,46.869107,66098,0,1403,64695
7/13/22,Madagascar,-18.766947,46.869107,66098,0,1403,64695
7/14/22,Madagascar,-18.766947,46.869107,66098,0,1403,64695
7/15/22,Madagascar,-18.766947,46.869107,66098,0,1403,64695
7/16/22,Madagascar,-18.766947,46.869107,66098,0,1403,64695
7/17/22,Madagascar,-18.766947,46.869107,66289,0,1406,64883
7/18/22,Madagascar,-18.766947,46.869107,66289,0,1406,64883
7/19/22,Madagascar,-18.766947,46.869107,66289,0,1406,64883
7/20/22,Madagascar,-18.766947,46.869107,66289,0,1406,64883
7/21/22,Madagascar,-18.766947,46.869107,66289,0,1406,64883
7/22/22,Madagascar,-18.766947,46.869107,66289,0,1406,64883
7/23/22,Madagascar,-18.766947,46.869107,66289,0,1406,64883
7/24/22,Madagascar,-18.766947,46.869107,66416,0,1407,65009
7/25/22,Madagascar,-18.766947,46.869107,66416,0,1407,65009
7/26/22,Madagascar,-18.766947,46.869107,66416,0,1407,65009
7/27/22,Madagascar,-18.766947,46.869107,66416,0,1407,65009
7/28/22,Madagascar,-18.766947,46.869107,66416,0,1407,65009
7/29/22,Madagascar,-18.766947,46.869107,66416,0,1407,65009
7/30/22,Madagascar,-18.766947,46.869107,66416,0,1407,65009
7/31/22,Madagascar,-18.766947,46.869107,66491,0,1408,65083
8/1/22,Madagascar,-18.766947,46.869107,66491,0,1408,65083
8/2/22,Madagascar,-18.766947,46.869107,66491,0,1408,65083
8/3/22,Madagascar,-18.766947,46.869107,66491,0,1408,65083
8/4/22,Madagascar,-18.766947,46.869107,66491,0,1408,65083
8/5/22,Madagascar,-18.766947,46.869107,66491,0,1408,65083
8/6/22,Madagascar,-18.766947,46.869107,66491,0,1408,65083
8/7/22,Madagascar,-18.766947,46.869107,66557,0,1409,65148
8/8/22,Madagascar,-18.766947,46.869107,66557,0,1409,65148
8/9/22,Madagascar,-18.766947,46.869107,66557,0,1409,65148
8/10/22,Madagascar,-18.766947,46.869107,66557,0,1409,65148
8/11/22,Madagascar,-18.766947,46.869107,66557,0,1409,65148
8/12/22,Madagascar,-18.766947,46.869107,66557,0,1409,65148
8/13/22,Madagascar,-18.766947,46.869107,66557,0,1409,65148
8/14/22,Madagascar,-18.766947,46.869107,66599,0,1410,65189
8/15/22,Madagascar,-18.766947,46.869107,66599,0,1410,65189
8/16/22,Madagascar,-18.766947,46.869107,66599,0,1410,65189
8/17/22,Madagascar,-18.766947,46.869107,66599,0,1410,65189
8/18/22,Madagascar,-18.766947,46.869107,66599,0,1410,65189
8/19/22,Madagascar,-18.766947,46.869107,66599,0,1410,65189
8/20/22,Madagascar,-18.766947,46.869107,66599,0,1410,65189
8/21/22,Madagascar,-18.766947,46.869107,66615,0,1410,65205
8/22/22,Madagascar,-18.766947,46.869107,66615,0,1410,65205
8/23/22,Madagascar,-18.766947,46.869107,66615,0,1410,65205
8/24/22,Madagascar,-18.766947,46.869107,66615,0,1410,65205
8/25/22,Madagascar,-18.766947,46.869107,66615,0,1410,65205
8/26/22,Madagascar,-18.766947,46.869107,66615,0,1410,65205
8/27/22,Madagascar,-18.766947,46.869107,66615,0,1410,65205
8/28/22,Madagascar,-18.766947,46.869107,66626,0,1410,65216
8/29/22,Madagascar,-18.766947,46.869107,66626,0,1410,65216
8/30/22,Madagascar,-18.766947,46.869107,66626,0,1410,65216
8/31/22,Madagascar,-18.766947,46.869107,66626,0,1410,65216
9/1/22,Madagascar,-18.766947,46.869107,66626,0,1410,65216
9/2/22,Madagascar,-18.766947,46.869107,66626,0,1410,65216
9/3/22,Madagascar,-18.766947,46.869107,66626,0,1410,65216
9/4/22,Madagascar,-18.766947,46.869107,66640,0,1410,65230
9/5/22,Madagascar,-18.766947,46.869107,66640,0,1410,65230
9/6/22,Madagascar,-18.766947,46.869107,66640,0,1410,65230
9/7/22,Madagascar,-18.766947,46.869107,66640,0,1410,65230
9/8/22,Madagascar,-18.766947,46.869107,66640,0,1410,65230
9/9/22,Madagascar,-18.766947,46.869107,66640,0,1410,65230
9/10/22,Madagascar,-18.766947,46.869107,66640,0,1410,65230
9/11/22,Madagascar,-18.766947,46.869107,66652,0,1410,65242
9/12/22,Madagascar,-18.766947,46.869107,66652,0,1410,65242
9/13/22,Madagascar,-18.766947,46.869107,66652,0,1410,65242
9/14/22,Madagascar,-18.766947,46.869107,66652,0,1410,65242
9/15/22,Madagascar,-18.766947,46.869107,66652,0,1410,65242
9/16/22,Madagascar,-18.766947,46.869107,66652,0,1410,65242
9/17/22,Madagascar,-18.766947,46.869107,66652,0,1410,65242
9/18/22,Madagascar,-18.766947,46.869107,66660,0,1410,65250
9/19/22,Madagascar,-18.766947,46.869107,66660,0,1410,65250
9/20/22,Madagascar,-18.766947,46.869107,66660,0,1410,65250
9/21/22,Madagascar,-18.766947,46.869107,66660,0,1410,65250
9/22/22,Madagascar,-18.766947,46.869107,66660,0,1410,65250
9/23/22,Madagascar,-18.766947,46.869107,66660,0,1410,65250
9/24/22,Madagascar,-18.766947,46.869107,66660,0,1410,65250
9/25/22,Madagascar,-18.766947,46.869107,66676,0,1410,65266
9/26/22,Madagascar,-18.766947,46.869107,66676,0,1410,65266
9/27/22,Madagascar,-18.766947,46.869107,66676,0,1410,65266
9/28/22,Madagascar,-18.766947,46.869107,66676,0,1410,65266
9/29/22,Madagascar,-18.766947,46.869107,66676,0,1410,65266
9/30/22,Madagascar,-18.766947,46.869107,66676,0,1410,65266
10/1/22,Madagascar,-18.766947,46.869107,66676,0,1410,65266
10/2/22,Madagascar,-18.766947,46.869107,66684,0,1410,65274
10/3/22,Madagascar,-18.766947,46.869107,66684,0,1410,65274
10/4/22,Madagascar,-18.766947,46.869107,66684,0,1410,65274
10/5/22,Madagascar,-18.766947,46.869107,66684,0,1410,65274
10/6/22,Madagascar,-18.766947,46.869107,66684,0,1410,65274
10/7/22,Madagascar,-18.766947,46.869107,66684,0,1410,65274
10/8/22,Madagascar,-18.766947,46.869107,66684,0,1410,65274
10/9/22,Madagascar,-18.766947,46.869107,66687,0,1410,65277
10/10/22,Madagascar,-18.766947,46.869107,66687,0,1410,65277
10/11/22,Madagascar,-18.766947,46.869107,66687,0,1410,65277
10/12/22,Madagascar,-18.766947,46.869107,66687,0,1410,65277
10/13/22,Madagascar,-18.766947,46.869107,66687,0,1410,65277
10/14/22,Madagascar,-18.766947,46.869107,66687,0,1410,65277
10/15/22,Madagascar,-18.766947,46.869107,66687,0,1410,65277
10/16/22,Madagascar,-18.766947,46.869107,66687,0,1410,65277
10/17/22,Madagascar,-18.766947,46.869107,66687,0,1410,65277
10/18/22,Madagascar,-18.766947,46.869107,66687,0,1410,65277
10/19/22,Madagascar,-18.766947,46.869107,66687,0,1410,65277
10/20/22,Madagascar,-18.766947,46.869107,66687,0,1410,65277
10/21/22,Madagascar,-18.766947,46.869107,66687,0,1410,65277
10/22/22,Madagascar,-18.766947,46.869107,66687,0,1410,65277
10/23/22,Madagascar,-18.766947,46.869107,66706,0,1411,65295
10/24/22,Madagascar,-18.766947,46.869107,66706,0,1411,65295
10/25/22,Madagascar,-18.766947,46.869107,66706,0,1411,65295
10/26/22,Madagascar,-18.766947,46.869107,66706,0,1411,65295
10/27/22,Madagascar,-18.766947,46.869107,66706,0,1411,65295
10/28/22,Madagascar,-18.766947,46.869107,66706,0,1411,65295
10/29/22,Madagascar,-18.766947,46.869107,66706,0,1411,65295
10/30/22,Madagascar,-18.766947,46.869107,66749,0,1411,65338
10/31/22,Madagascar,-18.766947,46.869107,66749,0,1411,65338
11/1/22,Madagascar,-18.766947,46.869107,66749,0,1411,65338
11/2/22,Madagascar,-18.766947,46.869107,66749,0,1411,65338
11/3/22,Madagascar,-18.766947,46.869107,66749,0,1411,65338
11/4/22,Madagascar,-18.766947,46.869107,66749,0,1411,65338
11/5/22,Madagascar,-18.766947,46.869107,66749,0,1411,65338
11/6/22,Madagascar,-18.766947,46.869107,66788,0,1411,65377
11/7/22,Madagascar,-18.766947,46.869107,66788,0,1411,65377
11/8/22,Madagascar,-18.766947,46.869107,66788,0,1411,65377
11/9/22,Madagascar,-18.766947,46.869107,66788,0,1411,65377
11/10/22,Madagascar,-18.766947,46.869107,66788,0,1411,65377
11/11/22,Madagascar,-18.766947,46.869107,66788,0,1411,65377
11/12/22,Madagascar,-18.766947,46.869107,66788,0,1411,65377
11/13/22,Madagascar,-18.766947,46.869107,66859,0,1411,65448
11/14/22,Madagascar,-18.766947,46.869107,66859,0,1411,65448
11/15/22,Madagascar,-18.766947,46.869107,66859,0,1411,65448
11/16/22,Madagascar,-18.766947,46.869107,66859,0,1411,65448
11/17/22,Madagascar,-18.766947,46.869107,66859,0,1411,65448
11/18/22,Madagascar,-18.766947,46.869107,66859,0,1411,65448
11/19/22,Madagascar,-18.766947,46.869107,66859,0,1411,65448
11/20/22,Madagascar,-18.766947,46.869107,67054,0,1411,65643
11/21/22,Madagascar,-18.766947,46.869107,67054,0,1411,65643
11/22/22,Madagascar,-18.766947,46.869107,67054,0,1411,65643
11/23/22,Madagascar,-18.766947,46.869107,67054,0,1411,65643
11/24/22,Madagascar,-18.766947,46.869107,67054,0,1411,65643
11/25/22,Madagascar,-18.766947,46.869107,67054,0,1411,65643
11/26/22,Madagascar,-18.766947,46.869107,67054,0,1411,65643
11/27/22,Madagascar,-18.766947,46.869107,67054,0,1411,65643
11/28/22,Madagascar,-18.766947,46.869107,67054,0,1411,65643
11/29/22,Madagascar,-18.766947,46.869107,67259,0,1412,65847
11/30/22,Madagascar,-18.766947,46.869107,67259,0,1412,65847
12/1/22,Madagascar,-18.766947,46.869107,67259,0,1412,65847
12/2/22,Madagascar,-18.766947,46.869107,67259,0,1412,65847
12/3/22,Madagascar,-18.766947,46.869107,67259,0,1412,65847
12/4/22,Madagascar,-18.766947,46.869107,67488,0,1413,66075
12/5/22,Madagascar,-18.766947,46.869107,67488,0,1413,66075
12/6/22,Madagascar,-18.766947,46.869107,67488,0,1413,66075
12/7/22,Madagascar,-18.766947,46.869107,67488,0,1413,66075
12/8/22,Madagascar,-18.766947,46.869107,67488,0,1413,66075
12/9/22,Madagascar,-18.766947,46.869107,67488,0,1413,66075
12/10/22,Madagascar,-18.766947,46.869107,67488,0,1413,66075
12/11/22,Madagascar,-18.766947,46.869107,67621,0,1414,66207
12/12/22,Madagascar,-18.766947,46.869107,67621,0,1414,66207
12/13/22,Madagascar,-18.766947,46.869107,67621,0,1414,66207
12/14/22,Madagascar,-18.766947,46.869107,67621,0,1414,66207
12/15/22,Madagascar,-18.766947,46.869107,67621,0,1414,66207
12/16/22,Madagascar,-18.766947,46.869107,67621,0,1414,66207
12/17/22,Madagascar,-18.766947,46.869107,67621,0,1414,66207
1/1/22,Malawi,-13.2543,34.3015,75828,0,2368,73460
1/2/22,Malawi,-13.2543,34.3015,76066,0,2371,73695
1/3/22,Malawi,-13.2543,34.3015,76295,0,2378,73917
1/4/22,Malawi,-13.2543,34.3015,76801,0,2386,74415
1/5/22,Malawi,-13.2543,34.3015,77629,0,2395,75234
1/6/22,Malawi,-13.2543,34.3015,78405,0,2400,76005
1/7/22,Malawi,-13.2543,34.3015,79082,0,2407,76675
1/8/22,Malawi,-13.2543,34.3015,79713,0,2411,77302
1/9/22,Malawi,-13.2543,34.3015,79987,0,2413,77574
1/10/22,Malawi,-13.2543,34.3015,80269,0,2420,77849
1/11/22,Malawi,-13.2543,34.3015,80867,0,2427,78440
1/12/22,Malawi,-13.2543,34.3015,81414,0,2437,78977
1/13/22,Malawi,-13.2543,34.3015,81890,0,2445,79445
1/14/22,Malawi,-13.2543,34.3015,82262,0,2453,79809
1/15/22,Malawi,-13.2543,34.3015,82506,0,2459,80047
1/16/22,Malawi,-13.2543,34.3015,82719,0,2466,80253
1/17/22,Malawi,-13.2543,34.3015,82792,0,2474,80318
1/18/22,Malawi,-13.2543,34.3015,82975,0,2480,80495
1/19/22,Malawi,-13.2543,34.3015,83219,0,2491,80728
1/20/22,Malawi,-13.2543,34.3015,83403,0,2502,80901
1/21/22,Malawi,-13.2543,34.3015,83565,0,2507,81058
1/22/22,Malawi,-13.2543,34.3015,83765,0,2519,81246
1/23/22,Malawi,-13.2543,34.3015,83823,0,2523,81300
1/24/22,Malawi,-13.2543,34.3015,83927,0,2528,81399
1/25/22,Malawi,-13.2543,34.3015,84013,0,2534,81479
1/26/22,Malawi,-13.2543,34.3015,84105,0,2537,81568
1/27/22,Malawi,-13.2543,34.3015,84224,0,2544,81680
1/28/22,Malawi,-13.2543,34.3015,84309,0,2553,81756
1/29/22,Malawi,-13.2543,34.3015,84389,0,2557,81832
1/30/22,Malawi,-13.2543,34.3015,84420,0,2558,81862
1/31/22,Malawi,-13.2543,34.3015,84475,0,2561,81914
2/1/22,Malawi,-13.2543,34.3015,84572,0,2563,82009
2/2/22,Malawi,-13.2543,34.3015,84632,0,2564,82068
2/3/22,Malawi,-13.2543,34.3015,84693,0,2565,82128
2/4/22,Malawi,-13.2543,34.3015,84738,0,2567,82171
2/5/22,Malawi,-13.2543,34.3015,84795,0,2570,82225
2/6/22,Malawi,-13.2543,34.3015,84813,0,2571,82242
2/7/22,Malawi,-13.2543,34.3015,84844,0,2573,82271
2/8/22,Malawi,-13.2543,34.3015,84876,0,2575,82301
2/9/22,Malawi,-13.2543,34.3015,84915,0,2580,82335
2/10/22,Malawi,-13.2543,34.3015,84936,0,2586,82350
2/11/22,Malawi,-13.2543,34.3015,84974,0,2591,82383
2/12/22,Malawi,-13.2543,34.3015,85009,0,2594,82415
2/13/22,Malawi,-13.2543,34.3015,85025,0,2596,82429
2/14/22,Malawi,-13.2543,34.3015,85033,0,2598,82435
2/15/22,Malawi,-13.2543,34.3015,85065,0,2599,82466
2/16/22,Malawi,-13.2543,34.3015,85106,0,2599,82507
2/17/22,Malawi,-13.2543,34.3015,85134,0,2600,82534
2/18/22,Malawi,-13.2543,34.3015,85179,0,2602,82577
2/19/22,Malawi,-13.2543,34.3015,85205,0,2605,82600
2/20/22,Malawi,-13.2543,34.3015,85219,0,2606,82613
2/21/22,Malawi,-13.2543,34.3015,85228,0,2606,82622
2/22/22,Malawi,-13.2543,34.3015,85238,0,2609,82629
2/23/22,Malawi,-13.2543,34.3015,85257,0,2610,82647
2/24/22,Malawi,-13.2543,34.3015,85276,0,2612,82664
2/25/22,Malawi,-13.2543,34.3015,85295,0,2612,82683
2/26/22,Malawi,-13.2543,34.3015,85314,0,2613,82701
2/27/22,Malawi,-13.2543,34.3015,85328,0,2615,82713
2/28/22,Malawi,-13.2543,34.3015,85339,0,2615,82724
3/1/22,Malawi,-13.2543,34.3015,85347,0,2615,82732
3/2/22,Malawi,-13.2543,34.3015,85362,0,2617,82745
3/3/22,Malawi,-13.2543,34.3015,85383,0,2617,82766
3/4/22,Malawi,-13.2543,34.3015,85396,0,2617,82779
3/5/22,Malawi,-13.2543,34.3015,85411,0,2618,82793
3/6/22,Malawi,-13.2543,34.3015,85429,0,2619,82810
3/7/22,Malawi,-13.2543,34.3015,85440,0,2619,82821
3/8/22,Malawi,-13.2543,34.3015,85452,0,2619,82833
3/9/22,Malawi,-13.2543,34.3015,85461,0,2620,82841
3/10/22,Malawi,-13.2543,34.3015,85476,0,2620,82856
3/11/22,Malawi,-13.2543,34.3015,85486,0,2620,82866
3/12/22,Malawi,-13.2543,34.3015,85495,0,2620,82875
3/13/22,Malawi,-13.2543,34.3015,85499,0,2623,82876
3/14/22,Malawi,-13.2543,34.3015,85499,0,2623,82876
3/15/22,Malawi,-13.2543,34.3015,85515,0,2624,82891
3/16/22,Malawi,-13.2543,34.3015,85526,0,2624,82902
3/17/22,Malawi,-13.2543,34.3015,85539,0,2624,82915
3/18/22,Malawi,-13.2543,34.3015,85544,0,2624,82920
3/19/22,Malawi,-13.2543,34.3015,85556,0,2626,82930
3/20/22,Malawi,-13.2543,34.3015,85561,0,2626,82935
3/21/22,Malawi,-13.2543,34.3015,85563,0,2626,82937
3/22/22,Malawi,-13.2543,34.3015,85566,0,2626,82940
3/23/22,Malawi,-13.2543,34.3015,85574,0,2626,82948
3/24/22,Malawi,-13.2543,34.3015,85586,0,2626,82960
3/25/22,Malawi,-13.2543,34.3015,85596,0,2626,82970
3/26/22,Malawi,-13.2543,34.3015,85608,0,2626,82982
3/27/22,Malawi,-13.2543,34.3015,85610,0,2626,82984
3/28/22,Malawi,-13.2543,34.3015,85620,0,2626,82994
3/29/22,Malawi,-13.2543,34.3015,85625,0,2626,82999
3/30/22,Malawi,-13.2543,34.3015,85631,0,2626,83005
3/31/22,Malawi,-13.2543,34.3015,85640,0,2626,83014
4/1/22,Malawi,-13.2543,34.3015,85650,0,2626,83024
4/2/22,Malawi,-13.2543,34.3015,85657,0,2626,83031
4/3/22,Malawi,-13.2543,34.3015,85664,0,2626,83038
4/4/22,Malawi,-13.2543,34.3015,85664,0,2626,83038
4/5/22,Malawi,-13.2543,34.3015,85667,0,2626,83041
4/6/22,Malawi,-13.2543,34.3015,85676,0,2627,83049
4/7/22,Malawi,-13.2543,34.3015,85683,0,2628,83055
4/8/22,Malawi,-13.2543,34.3015,85694,0,2628,83066
4/9/22,Malawi,-13.2543,34.3015,85702,0,2628,83074
4/10/22,Malawi,-13.2543,34.3015,85703,0,2628,83075
4/11/22,Malawi,-13.2543,34.3015,85705,0,2628,83077
4/12/22,Malawi,-13.2543,34.3015,85707,0,2628,83079
4/13/22,Malawi,-13.2543,34.3015,85713,0,2628,83085
4/14/22,Malawi,-13.2543,34.3015,85717,0,2628,83089
4/15/22,Malawi,-13.2543,34.3015,85723,0,2630,83093
4/16/22,Malawi,-13.2543,34.3015,85727,0,2631,83096
4/17/22,Malawi,-13.2543,34.3015,85728,0,2631,83097
4/18/22,Malawi,-13.2543,34.3015,85728,0,2632,83096
4/19/22,Malawi,-13.2543,34.3015,85728,0,2632,83096
4/20/22,Malawi,-13.2543,34.3015,85735,0,2632,83103
4/21/22,Malawi,-13.2543,34.3015,85741,0,2633,83108
4/22/22,Malawi,-13.2543,34.3015,85743,0,2633,83110
4/23/22,Malawi,-13.2543,34.3015,85747,0,2633,83114
4/24/22,Malawi,-13.2543,34.3015,85747,0,2633,83114
4/25/22,Malawi,-13.2543,34.3015,85747,0,2633,83114
4/26/22,Malawi,-13.2543,34.3015,85752,0,2633,83119
4/27/22,Malawi,-13.2543,34.3015,85761,0,2633,83128
4/28/22,Malawi,-13.2543,34.3015,85767,0,2634,83133
4/29/22,Malawi,-13.2543,34.3015,85781,0,2634,83147
4/30/22,Malawi,-13.2543,34.3015,85781,0,2634,83147
5/1/22,Malawi,-13.2543,34.3015,85781,0,2634,83147
5/2/22,Malawi,-13.2543,34.3015,85790,0,2634,83156
5/3/22,Malawi,-13.2543,34.3015,85790,0,2634,83156
5/4/22,Malawi,-13.2543,34.3015,85795,0,2634,83161
5/5/22,Malawi,-13.2543,34.3015,85797,0,2634,83163
5/6/22,Malawi,-13.2543,34.3015,85800,0,2634,83166
5/7/22,Malawi,-13.2543,34.3015,85811,0,2634,83177
5/8/22,Malawi,-13.2543,34.3015,85811,0,2634,83177
5/9/22,Malawi,-13.2543,34.3015,85811,0,2634,83177
5/10/22,Malawi,-13.2543,34.3015,85825,0,2635,83190
5/11/22,Malawi,-13.2543,34.3015,85842,0,2635,83207
5/12/22,Malawi,-13.2543,34.3015,85855,0,2635,83220
5/13/22,Malawi,-13.2543,34.3015,85866,0,2636,83230
5/14/22,Malawi,-13.2543,34.3015,85887,0,2636,83251
5/15/22,Malawi,-13.2543,34.3015,85888,0,2636,83252
5/16/22,Malawi,-13.2543,34.3015,85889,0,2637,83252
5/17/22,Malawi,-13.2543,34.3015,85895,0,2637,83258
5/18/22,Malawi,-13.2543,34.3015,85898,0,2637,83261
5/19/22,Malawi,-13.2543,34.3015,85909,0,2637,83272
5/20/22,Malawi,-13.2543,34.3015,85918,0,2637,83281
5/21/22,Malawi,-13.2543,34.3015,85929,0,2638,83291
5/22/22,Malawi,-13.2543,34.3015,85929,0,2638,83291
5/23/22,Malawi,-13.2543,34.3015,85935,0,2638,83297
5/24/22,Malawi,-13.2543,34.3015,85943,0,2639,83304
5/25/22,Malawi,-13.2543,34.3015,85943,0,2639,83304
5/26/22,Malawi,-13.2543,34.3015,85943,0,2639,83304
5/27/22,Malawi,-13.2543,34.3015,85964,0,2639,83325
5/28/22,Malawi,-13.2543,34.3015,85964,0,2639,83325
5/29/22,Malawi,-13.2543,34.3015,85973,0,2640,83333
5/30/22,Malawi,-13.2543,34.3015,85978,0,2640,83338
5/31/22,Malawi,-13.2543,34.3015,85985,0,2640,83345
6/1/22,Malawi,-13.2543,34.3015,85991,0,2641,83350
6/2/22,Malawi,-13.2543,34.3015,85995,0,2641,83354
6/3/22,Malawi,-13.2543,34.3015,86001,0,2642,83359
6/4/22,Malawi,-13.2543,34.3015,86011,0,2642,83369
6/5/22,Malawi,-13.2543,34.3015,86011,0,2642,83369
6/6/22,Malawi,-13.2543,34.3015,86022,0,2642,83380
6/7/22,Malawi,-13.2543,34.3015,86036,0,2642,83394
6/8/22,Malawi,-13.2543,34.3015,86043,0,2642,83401
6/9/22,Malawi,-13.2543,34.3015,86058,0,2642,83416
6/10/22,Malawi,-13.2543,34.3015,86075,0,2642,83433
6/11/22,Malawi,-13.2543,34.3015,86090,0,2642,83448
6/12/22,Malawi,-13.2543,34.3015,86107,0,2642,83465
6/13/22,Malawi,-13.2543,34.3015,86107,0,2642,83465
6/14/22,Malawi,-13.2543,34.3015,86134,0,2642,83492
6/15/22,Malawi,-13.2543,34.3015,86146,0,2642,83504
6/16/22,Malawi,-13.2543,34.3015,86162,0,2643,83519
6/17/22,Malawi,-13.2543,34.3015,86189,0,2643,83546
6/18/22,Malawi,-13.2543,34.3015,86202,0,2643,83559
6/19/22,Malawi,-13.2543,34.3015,86204,0,2644,83560
6/20/22,Malawi,-13.2543,34.3015,86225,0,2644,83581
6/21/22,Malawi,-13.2543,34.3015,86249,0,2644,83605
6/22/22,Malawi,-13.2543,34.3015,86287,0,2645,83642
6/23/22,Malawi,-13.2543,34.3015,86320,0,2645,83675
6/24/22,Malawi,-13.2543,34.3015,86348,0,2645,83703
6/25/22,Malawi,-13.2543,34.3015,86348,0,2645,83703
6/26/22,Malawi,-13.2543,34.3015,86348,0,2645,83703
6/27/22,Malawi,-13.2543,34.3015,86410,0,2645,83765
6/28/22,Malawi,-13.2543,34.3015,86448,0,2645,83803
6/29/22,Malawi,-13.2543,34.3015,86478,0,2645,83833
6/30/22,Malawi,-13.2543,34.3015,86506,0,2645,83861
7/1/22,Malawi,-13.2543,34.3015,86534,0,2645,83889
7/2/22,Malawi,-13.2543,34.3015,86565,0,2646,83919
7/3/22,Malawi,-13.2543,34.3015,86576,0,2646,83930
7/4/22,Malawi,-13.2543,34.3015,86600,0,2646,83954
7/5/22,Malawi,-13.2543,34.3015,86626,0,2646,83980
7/6/22,Malawi,-13.2543,34.3015,86645,0,2646,83999
7/7/22,Malawi,-13.2543,34.3015,86658,0,2646,84012
7/8/22,Malawi,-13.2543,34.3015,86706,0,2647,84059
7/9/22,Malawi,-13.2543,34.3015,86706,0,2647,84059
7/10/22,Malawi,-13.2543,34.3015,86741,0,2648,84093
7/11/22,Malawi,-13.2543,34.3015,86750,0,2649,84101
7/12/22,Malawi,-13.2543,34.3015,86799,0,2651,84148
7/13/22,Malawi,-13.2543,34.3015,86823,0,2651,84172
7/14/22,Malawi,-13.2543,34.3015,86823,0,2651,84172
7/15/22,Malawi,-13.2543,34.3015,86900,0,2652,84248
7/16/22,Malawi,-13.2543,34.3015,86900,0,2652,84248
7/17/22,Malawi,-13.2543,34.3015,86931,0,2653,84278
7/18/22,Malawi,-13.2543,34.3015,86968,0,2655,84313
7/19/22,Malawi,-13.2543,34.3015,86968,0,2655,84313
7/20/22,Malawi,-13.2543,34.3015,87105,0,2655,84450
7/21/22,Malawi,-13.2543,34.3015,87156,0,2656,84500
7/22/22,Malawi,-13.2543,34.3015,87156,0,2656,84500
7/23/22,Malawi,-13.2543,34.3015,87156,0,2656,84500
7/24/22,Malawi,-13.2543,34.3015,87238,0,2658,84580
7/25/22,Malawi,-13.2543,34.3015,87250,0,2660,84590
7/26/22,Malawi,-13.2543,34.3015,87286,0,2661,84625
7/27/22,Malawi,-13.2543,34.3015,87323,0,2663,84660
7/28/22,Malawi,-13.2543,34.3015,87365,0,2664,84701
7/29/22,Malawi,-13.2543,34.3015,87395,0,2665,84730
7/30/22,Malawi,-13.2543,34.3015,87410,0,2665,84745
7/31/22,Malawi,-13.2543,34.3015,87410,0,2665,84745
8/1/22,Malawi,-13.2543,34.3015,87425,0,2667,84758
8/2/22,Malawi,-13.2543,34.3015,87476,0,2667,84809
8/3/22,Malawi,-13.2543,34.3015,87514,0,2669,84845
8/4/22,Malawi,-13.2543,34.3015,87547,0,2670,84877
8/5/22,Malawi,-13.2543,34.3015,87570,0,2670,84900
8/6/22,Malawi,-13.2543,34.3015,87617,0,2670,84947
8/7/22,Malawi,-13.2543,34.3015,87627,0,2670,84957
8/8/22,Malawi,-13.2543,34.3015,87630,0,2670,84960
8/9/22,Malawi,-13.2543,34.3015,87637,0,2671,84966
8/10/22,Malawi,-13.2543,34.3015,87670,0,2672,84998
8/11/22,Malawi,-13.2543,34.3015,87691,0,2672,85019
8/12/22,Malawi,-13.2543,34.3015,87705,0,2672,85033
8/13/22,Malawi,-13.2543,34.3015,87710,0,2673,85037
8/14/22,Malawi,-13.2543,34.3015,87711,0,2673,85038
8/15/22,Malawi,-13.2543,34.3015,87718,0,2673,85045
8/16/22,Malawi,-13.2543,34.3015,87732,0,2673,85059
8/17/22,Malawi,-13.2543,34.3015,87732,0,2673,85059
8/18/22,Malawi,-13.2543,34.3015,87763,0,2675,85088
8/19/22,Malawi,-13.2543,34.3015,87771,0,2675,85096
8/20/22,Malawi,-13.2543,34.3015,87779,0,2676,85103
8/21/22,Malawi,-13.2543,34.3015,87783,0,2676,85107
8/22/22,Malawi,-13.2543,34.3015,87786,0,2676,85110
8/23/22,Malawi,-13.2543,34.3015,87793,0,2676,85117
8/24/22,Malawi,-13.2543,34.3015,87793,0,2676,85117
8/25/22,Malawi,-13.2543,34.3015,87814,0,2676,85138
8/26/22,Malawi,-13.2543,34.3015,87828,0,2676,85152
8/27/22,Malawi,-13.2543,34.3015,87834,0,2676,85158
8/28/22,Malawi,-13.2543,34.3015,87839,0,2676,85163
8/29/22,Malawi,-13.2543,34.3015,87842,0,2676,85166
8/30/22,Malawi,-13.2543,34.3015,87856,0,2676,85180
8/31/22,Malawi,-13.2543,34.3015,87860,0,2676,85184
9/1/22,Malawi,-13.2543,34.3015,87877,0,2676,85201
9/2/22,Malawi,-13.2543,34.3015,87877,0,2676,85201
9/3/22,Malawi,-13.2543,34.3015,87894,0,2677,85217
9/4/22,Malawi,-13.2543,34.3015,87901,0,2678,85223
9/5/22,Malawi,-13.2543,34.3015,87908,0,2678,85230
9/6/22,Malawi,-13.2543,34.3015,87912,0,2678,85234
9/7/22,Malawi,-13.2543,34.3015,87912,0,2678,85234
9/8/22,Malawi,-13.2543,34.3015,87927,0,2679,85248
9/9/22,Malawi,-13.2543,34.3015,87933,0,2679,85254
9/10/22,Malawi,-13.2543,34.3015,87933,0,2679,85254
9/11/22,Malawi,-13.2543,34.3015,87933,0,2679,85254
9/12/22,Malawi,-13.2543,34.3015,87943,0,2680,85263
9/13/22,Malawi,-13.2543,34.3015,87943,0,2680,85263
9/14/22,Malawi,-13.2543,34.3015,87946,0,2680,85266
9/15/22,Malawi,-13.2543,34.3015,87946,0,2680,85266
9/16/22,Malawi,-13.2543,34.3015,87946,0,2680,85266
9/17/22,Malawi,-13.2543,34.3015,87972,0,2680,85292
9/18/22,Malawi,-13.2543,34.3015,87980,0,2680,85300
9/19/22,Malawi,-13.2543,34.3015,87981,0,2680,85301
9/20/22,Malawi,-13.2543,34.3015,87981,0,2680,85301
9/21/22,Malawi,-13.2543,34.3015,87991,0,2680,85311
9/22/22,Malawi,-13.2543,34.3015,87997,0,2680,85317
9/23/22,Malawi,-13.2543,34.3015,88005,0,2680,85325
9/24/22,Malawi,-13.2543,34.3015,88005,0,2680,85325
9/25/22,Malawi,-13.2543,34.3015,88005,0,2680,85325
9/26/22,Malawi,-13.2543,34.3015,88005,0,2680,85325
9/27/22,Malawi,-13.2543,34.3015,88005,0,2680,85325
9/28/22,Malawi,-13.2543,34.3015,88005,0,2680,85325
9/29/22,Malawi,-13.2543,34.3015,88024,0,2682,85342
9/30/22,Malawi,-13.2543,34.3015,88028,0,2682,85346
10/1/22,Malawi,-13.2543,34.3015,88028,0,2682,85346
10/2/22,Malawi,-13.2543,34.3015,88029,0,2682,85347
10/3/22,Malawi,-13.2543,34.3015,88030,0,2682,85348
10/4/22,Malawi,-13.2543,34.3015,88034,0,2682,85352
10/5/22,Malawi,-13.2543,34.3015,88035,0,2682,85353
10/6/22,Malawi,-13.2543,34.3015,88039,0,2682,85357
10/7/22,Malawi,-13.2543,34.3015,88041,0,2682,85359
10/8/22,Malawi,-13.2543,34.3015,88045,0,2682,85363
10/9/22,Malawi,-13.2543,34.3015,88046,0,2682,85364
10/10/22,Malawi,-13.2543,34.3015,88047,0,2682,85365
10/11/22,Malawi,-13.2543,34.3015,88050,0,2682,85368
10/12/22,Malawi,-13.2543,34.3015,88055,0,2682,85373
10/13/22,Malawi,-13.2543,34.3015,88055,0,2682,85373
10/14/22,Malawi,-13.2543,34.3015,88057,0,2682,85375
10/15/22,Malawi,-13.2543,34.3015,88057,0,2682,85375
10/16/22,Malawi,-13.2543,34.3015,88057,0,2682,85375
10/17/22,Malawi,-13.2543,34.3015,88057,0,2682,85375
10/18/22,Malawi,-13.2543,34.3015,88061,0,2683,85378
10/19/22,Malawi,-13.2543,34.3015,88064,0,2683,85381
10/20/22,Malawi,-13.2543,34.3015,88065,0,2683,85382
10/21/22,Malawi,-13.2543,34.3015,88065,0,2683,85382
10/22/22,Malawi,-13.2543,34.3015,88073,0,2683,85390
10/23/22,Malawi,-13.2543,34.3015,88073,0,2683,85390
10/24/22,Malawi,-13.2543,34.3015,88073,0,2683,85390
10/25/22,Malawi,-13.2543,34.3015,88073,0,2683,85390
10/26/22,Malawi,-13.2543,34.3015,88073,0,2683,85390
10/27/22,Malawi,-13.2543,34.3015,88073,0,2683,85390
10/28/22,Malawi,-13.2543,34.3015,88073,0,2683,85390
10/29/22,Malawi,-13.2543,34.3015,88073,0,2683,85390
10/30/22,Malawi,-13.2543,34.3015,88073,0,2683,85390
10/31/22,Malawi,-13.2543,34.3015,88073,0,2683,85390
11/1/22,Malawi,-13.2543,34.3015,88073,0,2683,85390
11/2/22,Malawi,-13.2543,34.3015,88073,0,2683,85390
11/3/22,Malawi,-13.2543,34.3015,88073,0,2683,85390
11/4/22,Malawi,-13.2543,34.3015,88099,0,2683,85416
11/5/22,Malawi,-13.2543,34.3015,88099,0,2683,85416
11/6/22,Malawi,-13.2543,34.3015,88099,0,2683,85416
11/7/22,Malawi,-13.2543,34.3015,88073,0,2683,85390
11/8/22,Malawi,-13.2543,34.3015,88099,0,2683,85416
11/9/22,Malawi,-13.2543,34.3015,88099,0,2683,85416
11/10/22,Malawi,-13.2543,34.3015,88073,0,2685,85388
11/11/22,Malawi,-13.2543,34.3015,88073,0,2685,85388
11/12/22,Malawi,-13.2543,34.3015,88073,0,2685,85388
11/13/22,Malawi,-13.2543,34.3015,88073,0,2685,85388
11/14/22,Malawi,-13.2543,34.3015,88073,0,2685,85388
11/15/22,Malawi,-13.2543,34.3015,88073,0,2685,85388
11/16/22,Malawi,-13.2543,34.3015,88073,0,2896,85177
11/17/22,Malawi,-13.2543,34.3015,88073,0,2896,85177
11/18/22,Malawi,-13.2543,34.3015,88073,0,2896,85177
11/19/22,Malawi,-13.2543,34.3015,88073,0,2896,85177
11/20/22,Malawi,-13.2543,34.3015,88073,0,2896,85177
11/21/22,Malawi,-13.2543,34.3015,88073,0,2896,85177
11/22/22,Malawi,-13.2543,34.3015,88073,0,2685,85388
11/23/22,Malawi,-13.2543,34.3015,88073,0,2685,85388
11/24/22,Malawi,-13.2543,34.3015,88073,0,2685,85388
11/25/22,Malawi,-13.2543,34.3015,88073,0,2685,85388
11/26/22,Malawi,-13.2543,34.3015,88073,0,2685,85388
11/27/22,Malawi,-13.2543,34.3015,88073,0,2685,85388
11/28/22,Malawi,-13.2543,34.3015,88083,0,2685,85398
11/29/22,Malawi,-13.2543,34.3015,88086,0,2685,85401
11/30/22,Malawi,-13.2543,34.3015,88086,0,2685,85401
12/1/22,Malawi,-13.2543,34.3015,88086,0,2685,85401
12/2/22,Malawi,-13.2543,34.3015,88086,0,2685,85401
12/3/22,Malawi,-13.2543,34.3015,88086,0,2685,85401
12/4/22,Malawi,-13.2543,34.3015,88086,0,2685,85401
12/5/22,Malawi,-13.2543,34.3015,88086,0,2685,85401
12/6/22,Malawi,-13.2543,34.3015,88086,0,2685,85401
12/7/22,Malawi,-13.2543,34.3015,88220,0,2685,85535
12/8/22,Malawi,-13.2543,34.3015,88220,0,2685,85535
12/9/22,Malawi,-13.2543,34.3015,88220,0,2685,85535
12/10/22,Malawi,-13.2543,34.3015,88220,0,2685,85535
12/11/22,Malawi,-13.2543,34.3015,88220,0,2685,85535
12/12/22,Malawi,-13.2543,34.3015,88220,0,2685,85535
12/13/22,Malawi,-13.2543,34.3015,88220,0,2685,85535
12/14/22,Malawi,-13.2543,34.3015,88220,0,2685,85535
12/15/22,Malawi,-13.2543,34.3015,88220,0,2685,85535
12/16/22,Malawi,-13.2543,34.3015,88220,0,2685,85535
12/17/22,Malawi,-13.2543,34.3015,88220,0,2685,85535
1/1/22,Malaysia,4.210484,101.975766,2761472,0,31513,2729959
1/2/22,Malaysia,4.210484,101.975766,2764354,0,31532,2732822
1/3/22,Malaysia,4.210484,101.975766,2767044,0,31560,2735484
1/4/22,Malaysia,4.210484,101.975766,2769886,0,31591,2738295
1/5/22,Malaysia,4.210484,101.975766,2773156,0,31609,2741547
1/6/22,Malaysia,4.210484,101.975766,2776699,0,31628,2745071
1/7/22,Malaysia,4.210484,101.975766,2780080,0,31644,2748436
1/8/22,Malaysia,4.210484,101.975766,2783331,0,31655,2751676
1/9/22,Malaysia,4.210484,101.975766,2786219,0,31678,2754541
1/10/22,Malaysia,4.210484,101.975766,2788860,0,31696,2757164
1/11/22,Malaysia,4.210484,101.975766,2792035,0,31723,2760312
1/12/22,Malaysia,4.210484,101.975766,2795233,0,31738,2763495
1/13/22,Malaysia,4.210484,101.975766,2798917,0,31750,2767167
1/14/22,Malaysia,4.210484,101.975766,2802263,0,31762,2770501
1/15/22,Malaysia,4.210484,101.975766,2805337,0,31781,2773556
1/16/22,Malaysia,4.210484,101.975766,2808347,0,31793,2776554
1/17/22,Malaysia,4.210484,101.975766,2810689,0,31809,2778880
1/18/22,Malaysia,4.210484,101.975766,2813934,0,31818,2782116
1/19/22,Malaysia,4.210484,101.975766,2817163,0,31831,2785332
1/20/22,Malaysia,4.210484,101.975766,2820927,0,31853,2789074
1/21/22,Malaysia,4.210484,101.975766,2824973,0,31869,2793104
1/22/22,Malaysia,4.210484,101.975766,2829089,0,31882,2797207
1/23/22,Malaysia,4.210484,101.975766,2832945,0,31892,2801053
1/24/22,Malaysia,4.210484,101.975766,2836159,0,31902,2804257
1/25/22,Malaysia,4.210484,101.975766,2840225,0,31918,2808307
1/26/22,Malaysia,4.210484,101.975766,2844969,0,31930,2813039
1/27/22,Malaysia,4.210484,101.975766,2850408,0,31940,2818468
1/28/22,Malaysia,4.210484,101.975766,2855930,0,31952,2823978
1/29/22,Malaysia,4.210484,101.975766,2861069,0,31957,2829112
1/30/22,Malaysia,4.210484,101.975766,2865984,0,31965,2834019
1/31/22,Malaysia,4.210484,101.975766,2870758,0,31978,2838780
2/1/22,Malaysia,4.210484,101.975766,2876324,0,31985,2844339
2/2/22,Malaysia,4.210484,101.975766,2882060,0,31992,2850068
2/3/22,Malaysia,4.210484,101.975766,2887780,0,32000,2855780
2/4/22,Malaysia,4.210484,101.975766,2895014,0,32011,2863003
2/5/22,Malaysia,4.210484,101.975766,2904131,0,32025,2872106
2/6/22,Malaysia,4.210484,101.975766,2914220,0,32034,2882186
2/7/22,Malaysia,4.210484,101.975766,2925254,0,32043,2893211
2/8/22,Malaysia,4.210484,101.975766,2939198,0,32056,2907142
2/9/22,Malaysia,4.210484,101.975766,2956332,0,32065,2924267
2/10/22,Malaysia,4.210484,101.975766,2975422,0,32075,2943347
2/11/22,Malaysia,4.210484,101.975766,2996361,0,32099,2964262
2/12/22,Malaysia,4.210484,101.975766,3019163,0,32114,2987049
2/13/22,Malaysia,4.210484,101.975766,3040235,0,32125,3008110
2/14/22,Malaysia,4.210484,101.975766,3064575,0,32149,3032426
2/15/22,Malaysia,4.210484,101.975766,3083683,0,32180,3051503
2/16/22,Malaysia,4.210484,101.975766,3111514,0,32201,3079313
2/17/22,Malaysia,4.210484,101.975766,3138215,0,32240,3105975
2/18/22,Malaysia,4.210484,101.975766,3166023,0,32276,3133747
2/19/22,Malaysia,4.210484,101.975766,3194848,0,32310,3162538
2/20/22,Malaysia,4.210484,101.975766,3221680,0,32347,3189333
2/21/22,Malaysia,4.210484,101.975766,3246779,0,32390,3214389
2/22/22,Malaysia,4.210484,101.975766,3273958,0,32433,3241525
2/23/22,Malaysia,4.210484,101.975766,3305157,0,32488,3272669
2/24/22,Malaysia,4.210484,101.975766,3337227,0,32534,3304693
2/25/22,Malaysia,4.210484,101.975766,3367871,0,32591,3335280
2/26/22,Malaysia,4.210484,101.975766,3395170,0,32634,3362536
2/27/22,Malaysia,4.210484,101.975766,3419636,0,32674,3386962
2/28/22,Malaysia,4.210484,101.975766,3442736,0,32749,3409987
3/1/22,Malaysia,4.210484,101.975766,3468590,0,32827,3435763
3/2/22,Malaysia,4.210484,101.975766,3496090,0,32942,3463148
3/3/22,Malaysia,4.210484,101.975766,3528557,0,33028,3495529
3/4/22,Malaysia,4.210484,101.975766,3561766,0,33106,3528660
3/5/22,Malaysia,4.210484,101.975766,3595172,0,33173,3561999
3/6/22,Malaysia,4.210484,101.975766,3622607,0,33228,3589379
3/7/22,Malaysia,4.210484,101.975766,3649463,0,33305,3616158
3/8/22,Malaysia,4.210484,101.975766,3680953,0,33384,3647569
3/9/22,Malaysia,4.210484,101.975766,3711199,0,33497,3677702
3/10/22,Malaysia,4.210484,101.975766,3741986,0,33567,3708419
3/11/22,Malaysia,4.210484,101.975766,3774786,0,33643,3741143
3/12/22,Malaysia,4.210484,101.975766,3801036,0,33720,3767316
3/13/22,Malaysia,4.210484,101.975766,3823571,0,33807,3789764
3/14/22,Malaysia,4.210484,101.975766,3845601,0,33899,3811702
3/15/22,Malaysia,4.210484,101.975766,3872135,0,33994,3838141
3/16/22,Malaysia,4.210484,101.975766,3900433,0,34099,3866334
3/17/22,Malaysia,4.210484,101.975766,3927437,0,34185,3893252
3/18/22,Malaysia,4.210484,101.975766,3951678,0,34244,3917434
3/19/22,Malaysia,4.210484,101.975766,3974019,0,34329,3939690
3/20/22,Malaysia,4.210484,101.975766,3993124,0,34400,3958724
3/21/22,Malaysia,4.210484,101.975766,4010952,0,34463,3976489
3/22/22,Malaysia,4.210484,101.975766,4032435,0,34535,3997900
3/23/22,Malaysia,4.210484,101.975766,4054926,0,34600,4020326
3/24/22,Malaysia,4.210484,101.975766,4079242,0,34664,4044578
3/25/22,Malaysia,4.210484,101.975766,4101081,0,34717,4066364
3/26/22,Malaysia,4.210484,101.975766,4122004,0,34751,4087253
3/27/22,Malaysia,4.210484,101.975766,4137736,0,34758,4102978
3/28/22,Malaysia,4.210484,101.975766,4152203,0,34842,4117361
3/29/22,Malaysia,4.210484,101.975766,4167418,0,34906,4132512
3/30/22,Malaysia,4.210484,101.975766,4183359,0,34939,4148420
3/31/22,Malaysia,4.210484,101.975766,4201919,0,34983,4166936
4/1/22,Malaysia,4.210484,101.975766,4219395,0,35013,4184382
4/2/22,Malaysia,4.210484,101.975766,4234087,0,35069,4199018
4/3/22,Malaysia,4.210484,101.975766,4246467,0,35099,4211368
4/4/22,Malaysia,4.210484,101.975766,4256469,0,35127,4221342
4/5/22,Malaysia,4.210484,101.975766,4268486,0,35160,4233326
4/6/22,Malaysia,4.210484,101.975766,4280591,0,35192,4245399
4/7/22,Malaysia,4.210484,101.975766,4292585,0,35228,4257357
4/8/22,Malaysia,4.210484,101.975766,4307529,0,35259,4272270
4/9/22,Malaysia,4.210484,101.975766,4317706,0,35280,4282426
4/10/22,Malaysia,4.210484,101.975766,4325818,0,35292,4290526
4/11/22,Malaysia,4.210484,101.975766,4333557,0,35311,4298246
4/12/22,Malaysia,4.210484,101.975766,4342559,0,35341,4307218
4/13/22,Malaysia,4.210484,101.975766,4352611,0,35363,4317248
4/14/22,Malaysia,4.210484,101.975766,4363024,0,35381,4327643
4/15/22,Malaysia,4.210484,101.975766,4372697,0,35397,4337300
4/16/22,Malaysia,4.210484,101.975766,4382402,0,35409,4346993
4/17/22,Malaysia,4.210484,101.975766,4389025,0,35421,4353604
4/18/22,Malaysia,4.210484,101.975766,4396165,0,35437,4360728
4/19/22,Malaysia,4.210484,101.975766,4402234,0,35449,4366785
4/20/22,Malaysia,4.210484,101.975766,4409202,0,35465,4373737
4/21/22,Malaysia,4.210484,101.975766,4415101,0,35470,4379631
4/22/22,Malaysia,4.210484,101.975766,4421443,0,35482,4385961
4/23/22,Malaysia,4.210484,101.975766,4427067,0,35491,4391576
4/24/22,Malaysia,4.210484,101.975766,4431073,0,35499,4395574
4/25/22,Malaysia,4.210484,101.975766,4433551,0,35507,4398044
4/26/22,Malaysia,4.210484,101.975766,4436912,0,35520,4401392
4/27/22,Malaysia,4.210484,101.975766,4440383,0,35526,4404857
4/28/22,Malaysia,4.210484,101.975766,4443318,0,35536,4407782
4/29/22,Malaysia,4.210484,101.975766,4445897,0,35542,4410355
4/30/22,Malaysia,4.210484,101.975766,4448004,0,35547,4412457
5/1/22,Malaysia,4.210484,101.975766,4449507,0,35550,4413957
5/2/22,Malaysia,4.210484,101.975766,4450859,0,35555,4415304
5/3/22,Malaysia,4.210484,101.975766,4451781,0,35564,4416217
5/4/22,Malaysia,4.210484,101.975766,4452835,0,35567,4417268
5/5/22,Malaysia,4.210484,101.975766,4454113,0,35569,4418544
5/6/22,Malaysia,4.210484,101.975766,4455364,0,35576,4419788
5/7/22,Malaysia,4.210484,101.975766,4456736,0,35579,4421157
5/8/22,Malaysia,4.210484,101.975766,4458889,0,35583,4423306
5/9/22,Malaysia,4.210484,101.975766,4461135,0,35584,4425551
5/10/22,Malaysia,4.210484,101.975766,4463740,0,35590,4428150
5/11/22,Malaysia,4.210484,101.975766,4467061,0,35598,4431463
5/12/22,Malaysia,4.210484,101.975766,4470471,0,35602,4434869
5/13/22,Malaysia,4.210484,101.975766,4473500,0,35607,4437893
5/14/22,Malaysia,4.210484,101.975766,4475873,0,35612,4440261
5/15/22,Malaysia,4.210484,101.975766,4478112,0,35615,4442497
5/16/22,Malaysia,4.210484,101.975766,4479809,0,35620,4444189
5/17/22,Malaysia,4.210484,101.975766,4481278,0,35623,4445655
5/18/22,Malaysia,4.210484,101.975766,4483295,0,35630,4447665
5/19/22,Malaysia,4.210484,101.975766,4485419,0,35633,4449786
5/20/22,Malaysia,4.210484,101.975766,4487482,0,35638,4451844
5/21/22,Malaysia,4.210484,101.975766,4489503,0,35641,4453862
5/22/22,Malaysia,4.210484,101.975766,4491320,0,35643,4455677
5/23/22,Malaysia,4.210484,101.975766,4492864,0,35645,4457219
5/24/22,Malaysia,4.210484,101.975766,4494782,0,35647,4459135
5/25/22,Malaysia,4.210484,101.975766,4497212,0,35653,4461559
5/26/22,Malaysia,4.210484,101.975766,4499057,0,35656,4463401
5/27/22,Malaysia,4.210484,101.975766,4500934,0,35658,4465276
5/28/22,Malaysia,4.210484,101.975766,4502579,0,35660,4466919
5/29/22,Malaysia,4.210484,101.975766,4503734,0,35665,4468069
5/30/22,Malaysia,4.210484,101.975766,4505059,0,35669,4469390
5/31/22,Malaysia,4.210484,101.975766,4506510,0,35676,4470834
6/1/22,Malaysia,4.210484,101.975766,4508319,0,35678,4472641
6/2/22,Malaysia,4.210484,101.975766,4510196,0,35680,4474516
6/3/22,Malaysia,4.210484,101.975766,4512040,0,35681,4476359
6/4/22,Malaysia,4.210484,101.975766,4513631,0,35686,4477945
6/5/22,Malaysia,4.210484,101.975766,4514989,0,35688,4479301
6/6/22,Malaysia,4.210484,101.975766,4516319,0,35690,4480629
6/7/22,Malaysia,4.210484,101.975766,4517447,0,35699,4481748
6/8/22,Malaysia,4.210484,101.975766,4518965,0,35705,4483260
6/9/22,Malaysia,4.210484,101.975766,4520852,0,35708,4485144
6/10/22,Malaysia,4.210484,101.975766,4523018,0,35709,4487309
6/11/22,Malaysia,4.210484,101.975766,4524727,0,35711,4489016
6/12/22,Malaysia,4.210484,101.975766,4526298,0,35712,4490586
6/13/22,Malaysia,4.210484,101.975766,4528390,0,35716,4492674
6/14/22,Malaysia,4.210484,101.975766,4530312,0,35720,4494592
6/15/22,Malaysia,4.210484,101.975766,4532632,0,35725,4496907
6/16/22,Malaysia,4.210484,101.975766,4534665,0,35730,4498935
6/17/22,Malaysia,4.210484,101.975766,4536795,0,35731,4501064
6/18/22,Malaysia,4.210484,101.975766,4538922,0,35732,4503190
6/19/22,Malaysia,4.210484,101.975766,4540612,0,35732,4504880
6/20/22,Malaysia,4.210484,101.975766,4542705,0,35735,4506970
6/21/22,Malaysia,4.210484,101.975766,4544626,0,35737,4508889
6/22/22,Malaysia,4.210484,101.975766,4547051,0,35741,4511310
6/23/22,Malaysia,4.210484,101.975766,4549847,0,35742,4514105
6/24/22,Malaysia,4.210484,101.975766,4552359,0,35745,4516614
6/25/22,Malaysia,4.210484,101.975766,4554661,0,35745,4518916
6/26/22,Malaysia,4.210484,101.975766,4556664,0,35746,4520918
6/27/22,Malaysia,4.210484,101.975766,4558558,0,35754,4522804
6/28/22,Malaysia,4.210484,101.975766,4560583,0,35758,4524825
6/29/22,Malaysia,4.210484,101.975766,4563188,0,35763,4527425
6/30/22,Malaysia,4.210484,101.975766,4566055,0,35765,4530290
7/1/22,Malaysia,4.210484,101.975766,4568828,0,35771,4533057
7/2/22,Malaysia,4.210484,101.975766,4571355,0,35771,4535584
7/3/22,Malaysia,4.210484,101.975766,4573891,0,35776,4538115
7/4/22,Malaysia,4.210484,101.975766,4575809,0,35784,4540025
7/5/22,Malaysia,4.210484,101.975766,4578741,0,35787,4542954
7/6/22,Malaysia,4.210484,101.975766,4582302,0,35792,4546510
7/7/22,Malaysia,4.210484,101.975766,4586322,0,35795,4550527
7/8/22,Malaysia,4.210484,101.975766,4589911,0,35801,4554110
7/9/22,Malaysia,4.210484,101.975766,4592710,0,35809,4556901
7/10/22,Malaysia,4.210484,101.975766,4595974,0,35811,4560163
7/11/22,Malaysia,4.210484,101.975766,4598391,0,35816,4562575
7/12/22,Malaysia,4.210484,101.975766,4600736,0,35819,4564917
7/13/22,Malaysia,4.210484,101.975766,4604670,0,35828,4568842
7/14/22,Malaysia,4.210484,101.975766,4608768,0,35836,4572932
7/15/22,Malaysia,4.210484,101.975766,4613998,0,35844,4578154
7/16/22,Malaysia,4.210484,101.975766,4619045,0,35848,4583197
7/17/22,Malaysia,4.210484,101.975766,4622981,0,35855,4587126
7/18/22,Malaysia,4.210484,101.975766,4626061,0,35862,4590199
7/19/22,Malaysia,4.210484,101.975766,4629963,0,35870,4594093
7/20/22,Malaysia,4.210484,101.975766,4635648,0,35878,4599770
7/21/22,Malaysia,4.210484,101.975766,4640235,0,35888,4604347
7/22/22,Malaysia,4.210484,101.975766,4644115,0,35902,4608213
7/23/22,Malaysia,4.210484,101.975766,4648931,0,35911,4613020
7/24/22,Malaysia,4.210484,101.975766,4651651,0,35914,4615737
7/25/22,Malaysia,4.210484,101.975766,4654951,0,35923,4619028
7/26/22,Malaysia,4.210484,101.975766,4659710,0,35932,4623778
7/27/22,Malaysia,4.210484,101.975766,4664213,0,35942,4628271
7/28/22,Malaysia,4.210484,101.975766,4668139,0,35946,4632193
7/29/22,Malaysia,4.210484,101.975766,4672999,0,35956,4637043
7/30/22,Malaysia,4.210484,101.975766,4677270,0,35960,4641310
7/31/22,Malaysia,4.210484,101.975766,4680053,0,35969,4644084
8/1/22,Malaysia,4.210484,101.975766,4683266,0,35977,4647289
8/2/22,Malaysia,4.210484,101.975766,4687470,0,35985,4651485
8/3/22,Malaysia,4.210484,101.975766,4692800,0,35995,4656805
8/4/22,Malaysia,4.210484,101.975766,4697213,0,36003,4661210
8/5/22,Malaysia,4.210484,101.975766,4701140,0,36009,4665131
8/6/22,Malaysia,4.210484,101.975766,4705824,0,36020,4669804
8/7/22,Malaysia,4.210484,101.975766,4708552,0,36026,4672526
8/8/22,Malaysia,4.210484,101.975766,4711415,0,36032,4675383
8/9/22,Malaysia,4.210484,101.975766,4714498,0,36044,4678454
8/10/22,Malaysia,4.210484,101.975766,4719394,0,36056,4683338
8/11/22,Malaysia,4.210484,101.975766,4724225,0,36066,4688159
8/12/22,Malaysia,4.210484,101.975766,4728168,0,36070,4692098
8/13/22,Malaysia,4.210484,101.975766,4732502,0,36080,4696422
8/14/22,Malaysia,4.210484,101.975766,4735547,0,36085,4699462
8/15/22,Malaysia,4.210484,101.975766,4737984,0,36093,4701891
8/16/22,Malaysia,4.210484,101.975766,4741413,0,36102,4705311
8/17/22,Malaysia,4.210484,101.975766,4744929,0,36117,4708812
8/18/22,Malaysia,4.210484,101.975766,4749000,0,36124,4712876
8/19/22,Malaysia,4.210484,101.975766,4752490,0,36130,4716360
8/20/22,Malaysia,4.210484,101.975766,4755288,0,36136,4719152
8/21/22,Malaysia,4.210484,101.975766,4757752,0,36145,4721607
8/22/22,Malaysia,4.210484,101.975766,4759830,0,36155,4723675
8/23/22,Malaysia,4.210484,101.975766,4762552,0,36166,4726386
8/24/22,Malaysia,4.210484,101.975766,4765188,0,36177,4729011
8/25/22,Malaysia,4.210484,101.975766,4768394,0,36185,4732209
8/26/22,Malaysia,4.210484,101.975766,4771512,0,36191,4735321
8/27/22,Malaysia,4.210484,101.975766,4774003,0,36196,4737807
8/28/22,Malaysia,4.210484,101.975766,4776194,0,36198,4739996
8/29/22,Malaysia,4.210484,101.975766,4777769,0,36232,4741537
8/30/22,Malaysia,4.210484,101.975766,4780284,0,36210,4744074
8/31/22,Malaysia,4.210484,101.975766,4782624,0,36216,4746408
9/1/22,Malaysia,4.210484,101.975766,4784980,0,36225,4748755
9/2/22,Malaysia,4.210484,101.975766,4787308,0,36234,4751074
9/3/22,Malaysia,4.210484,101.975766,4789552,0,36243,4753309
9/4/22,Malaysia,4.210484,101.975766,4791456,0,36245,4755211
9/5/22,Malaysia,4.210484,101.975766,4792942,0,36249,4756693
9/6/22,Malaysia,4.210484,101.975766,4795009,0,36255,4758754
9/7/22,Malaysia,4.210484,101.975766,4797437,0,36262,4761175
9/8/22,Malaysia,4.210484,101.975766,4799663,0,36270,4763393
9/9/22,Malaysia,4.210484,101.975766,4801653,0,36274,4765379
9/10/22,Malaysia,4.210484,101.975766,4803624,0,36277,4767347
9/11/22,Malaysia,4.210484,101.975766,4805107,0,36280,4768827
9/12/22,Malaysia,4.210484,101.975766,4806954,0,36285,4770669
9/13/22,Malaysia,4.210484,101.975766,4808896,0,36291,4772605
9/14/22,Malaysia,4.210484,101.975766,4811327,0,36296,4775031
9/15/22,Malaysia,4.210484,101.975766,4813702,0,36299,4777403
9/16/22,Malaysia,4.210484,101.975766,4815679,0,36305,4779374
9/17/22,Malaysia,4.210484,101.975766,4817251,0,36308,4780943
9/18/22,Malaysia,4.210484,101.975766,4818890,0,36312,4782578
9/19/22,Malaysia,4.210484,101.975766,4820197,0,36317,4783880
9/20/22,Malaysia,4.210484,101.975766,4821864,0,36324,4785540
9/21/22,Malaysia,4.210484,101.975766,4823975,0,36330,4787645
9/22/22,Malaysia,4.210484,101.975766,4826220,0,36342,4789878
9/23/22,Malaysia,4.210484,101.975766,4828290,0,36345,4791945
9/24/22,Malaysia,4.210484,101.975766,4830214,0,36348,4793866
9/25/22,Malaysia,4.210484,101.975766,4831822,0,36350,4795472
9/26/22,Malaysia,4.210484,101.975766,4833008,0,36357,4796651
9/27/22,Malaysia,4.210484,101.975766,4834560,0,36363,4798197
9/28/22,Malaysia,4.210484,101.975766,4837005,0,36365,4800640
9/29/22,Malaysia,4.210484,101.975766,4838872,0,36369,4802503
9/30/22,Malaysia,4.210484,101.975766,4840879,0,36374,4804505
10/1/22,Malaysia,4.210484,101.975766,4845757,0,36374,4809383
10/2/22,Malaysia,4.210484,101.975766,4845649,0,36375,4809274
10/3/22,Malaysia,4.210484,101.975766,4845691,0,36376,4809315
10/4/22,Malaysia,4.210484,101.975766,4846592,0,36385,4810207
10/5/22,Malaysia,4.210484,101.975766,4848314,0,36387,4811927
10/6/22,Malaysia,4.210484,101.975766,4850108,0,36391,4813717
10/7/22,Malaysia,4.210484,101.975766,4851896,0,36394,4815502
10/8/22,Malaysia,4.210484,101.975766,4853523,0,36398,4817125
10/9/22,Malaysia,4.210484,101.975766,4854976,0,36400,4818576
10/10/22,Malaysia,4.210484,101.975766,4856217,0,36403,4819814
10/11/22,Malaysia,4.210484,101.975766,4857508,0,36406,4821102
10/12/22,Malaysia,4.210484,101.975766,4859136,0,36407,4822729
10/13/22,Malaysia,4.210484,101.975766,4861226,0,36410,4824816
10/14/22,Malaysia,4.210484,101.975766,4863457,0,36415,4827042
10/15/22,Malaysia,4.210484,101.975766,4865480,0,36415,4829065
10/16/22,Malaysia,4.210484,101.975766,4867192,0,36417,4830775
10/17/22,Malaysia,4.210484,101.975766,4868402,0,36423,4831979
10/18/22,Malaysia,4.210484,101.975766,4870275,0,36426,4833849
10/19/22,Malaysia,4.210484,101.975766,4872570,0,36429,4836141
10/20/22,Malaysia,4.210484,101.975766,4875131,0,36437,4838694
10/21/22,Malaysia,4.210484,101.975766,4877387,0,36440,4840947
10/22/22,Malaysia,4.210484,101.975766,4880005,0,36444,4843561
10/23/22,Malaysia,4.210484,101.975766,4882059,0,36444,4845615
10/24/22,Malaysia,4.210484,101.975766,4883796,0,36447,4847349
10/25/22,Malaysia,4.210484,101.975766,4885539,0,36452,4849087
10/26/22,Malaysia,4.210484,101.975766,4887675,0,36458,4851217
10/27/22,Malaysia,4.210484,101.975766,4890437,0,36462,4853975
10/28/22,Malaysia,4.210484,101.975766,4893733,0,36463,4857270
10/29/22,Malaysia,4.210484,101.975766,4896922,0,36464,4860458
10/30/22,Malaysia,4.210484,101.975766,4900051,0,36466,4863585
10/31/22,Malaysia,4.210484,101.975766,4902964,0,36475,4866489
11/1/22,Malaysia,4.210484,101.975766,4905877,0,36478,4869399
11/2/22,Malaysia,4.210484,101.975766,4909846,0,36480,4873366
11/3/22,Malaysia,4.210484,101.975766,4914557,0,36480,4878077
11/4/22,Malaysia,4.210484,101.975766,4918917,0,36481,4882436
11/5/22,Malaysia,4.210484,101.975766,4923538,0,36482,4887056
11/6/22,Malaysia,4.210484,101.975766,4927451,0,36487,4890964
11/7/22,Malaysia,4.210484,101.975766,4929972,0,36495,4893477
11/8/22,Malaysia,4.210484,101.975766,4933753,0,36504,4897249
11/9/22,Malaysia,4.210484,101.975766,4937020,0,36514,4900506
11/10/22,Malaysia,4.210484,101.975766,4940456,0,36522,4903934
11/11/22,Malaysia,4.210484,101.975766,4943701,0,36537,4907164
11/12/22,Malaysia,4.210484,101.975766,4946583,0,36546,4910037
11/13/22,Malaysia,4.210484,101.975766,4948817,0,36548,4912269
11/14/22,Malaysia,4.210484,101.975766,4950566,0,36554,4914012
11/15/22,Malaysia,4.210484,101.975766,4953418,0,36566,4916852
11/16/22,Malaysia,4.210484,101.975766,4956722,0,36574,4920148
11/17/22,Malaysia,4.210484,101.975766,4960179,0,36583,4923596
11/18/22,Malaysia,4.210484,101.975766,4963216,0,36588,4926628
11/19/22,Malaysia,4.210484,101.975766,4965666,0,36593,4929073
11/20/22,Malaysia,4.210484,101.975766,4967299,0,36595,4930704
11/21/22,Malaysia,4.210484,101.975766,4969420,0,36609,4932811
11/22/22,Malaysia,4.210484,101.975766,4971936,0,36620,4935316
11/23/22,Malaysia,4.210484,101.975766,4975473,0,36628,4938845
11/24/22,Malaysia,4.210484,101.975766,4978350,0,36636,4941714
11/25/22,Malaysia,4.210484,101.975766,4981374,0,36644,4944730
11/26/22,Malaysia,4.210484,101.975766,4984272,0,36648,4947624
11/27/22,Malaysia,4.210484,101.975766,4986294,0,36652,4949642
11/28/22,Malaysia,4.210484,101.975766,4988759,0,36657,4952102
11/29/22,Malaysia,4.210484,101.975766,4990431,0,36667,4953764
11/30/22,Malaysia,4.210484,101.975766,4992168,0,36684,4955484
12/1/22,Malaysia,4.210484,101.975766,4994543,0,36695,4957848
12/2/22,Malaysia,4.210484,101.975766,4996964,0,36704,4960260
12/3/22,Malaysia,4.210484,101.975766,4998830,0,36710,4962120
12/4/22,Malaysia,4.210484,101.975766,5000332,0,36713,4963619
12/5/22,Malaysia,4.210484,101.975766,5001908,0,36716,4965192
12/6/22,Malaysia,4.210484,101.975766,5003557,0,36732,4966825
12/7/22,Malaysia,4.210484,101.975766,5005239,0,36738,4968501
12/8/22,Malaysia,4.210484,101.975766,5006855,0,36742,4970113
12/9/22,Malaysia,4.210484,101.975766,5008452,0,36748,4971704
12/10/22,Malaysia,4.210484,101.975766,5009767,0,36753,4973014
12/11/22,Malaysia,4.210484,101.975766,5010634,0,36763,4973871
12/12/22,Malaysia,4.210484,101.975766,5011443,0,36769,4974674
12/13/22,Malaysia,4.210484,101.975766,5012483,0,36778,4975705
12/14/22,Malaysia,4.210484,101.975766,5013724,0,36784,4976940
12/15/22,Malaysia,4.210484,101.975766,5014885,0,36787,4978098
12/16/22,Malaysia,4.210484,101.975766,5016023,0,36795,4979228
12/17/22,Malaysia,4.210484,101.975766,5017016,0,36800,4980216
1/1/22,Maldives,3.2028,73.2207,95891,0,262,95629
1/2/22,Maldives,3.2028,73.2207,96052,0,262,95790
1/3/22,Maldives,3.2028,73.2207,96294,0,262,96032
1/4/22,Maldives,3.2028,73.2207,96522,0,263,96259
1/5/22,Maldives,3.2028,73.2207,96746,0,263,96483
1/6/22,Maldives,3.2028,73.2207,97050,0,264,96786
1/7/22,Maldives,3.2028,73.2207,97331,0,264,97067
1/8/22,Maldives,3.2028,73.2207,97668,0,264,97404
1/9/22,Maldives,3.2028,73.2207,98052,0,264,97788
1/10/22,Maldives,3.2028,73.2207,98506,0,264,98242
1/11/22,Maldives,3.2028,73.2207,99099,0,264,98835
1/12/22,Maldives,3.2028,73.2207,99635,0,264,99371
1/13/22,Maldives,3.2028,73.2207,100451,0,264,100187
1/14/22,Maldives,3.2028,73.2207,101418,0,265,101153
1/15/22,Maldives,3.2028,73.2207,102372,0,265,102107
1/16/22,Maldives,3.2028,73.2207,103581,0,265,103316
1/17/22,Maldives,3.2028,73.2207,105001,0,265,104736
1/18/22,Maldives,3.2028,73.2207,106595,0,265,106330
1/19/22,Maldives,3.2028,73.2207,108732,0,265,108467
1/20/22,Maldives,3.2028,73.2207,110931,0,269,110662
1/21/22,Maldives,3.2028,73.2207,112628,0,269,112359
1/22/22,Maldives,3.2028,73.2207,114977,0,269,114708
1/23/22,Maldives,3.2028,73.2207,117461,0,270,117191
1/24/22,Maldives,3.2028,73.2207,120168,0,270,119898
1/25/22,Maldives,3.2028,73.2207,122777,0,271,122506
1/26/22,Maldives,3.2028,73.2207,125590,0,272,125318
1/27/22,Maldives,3.2028,73.2207,128089,0,274,127815
1/28/22,Maldives,3.2028,73.2207,130599,0,274,130325
1/29/22,Maldives,3.2028,73.2207,133288,0,274,133014
1/30/22,Maldives,3.2028,73.2207,136126,0,275,135851
1/31/22,Maldives,3.2028,73.2207,138880,0,276,138604
2/1/22,Maldives,3.2028,73.2207,141060,0,277,140783
2/2/22,Maldives,3.2028,73.2207,143202,0,278,142924
2/3/22,Maldives,3.2028,73.2207,145036,0,280,144756
2/4/22,Maldives,3.2028,73.2207,146991,0,280,146711
2/5/22,Maldives,3.2028,73.2207,148580,0,281,148299
2/6/22,Maldives,3.2028,73.2207,150337,0,283,150054
2/7/22,Maldives,3.2028,73.2207,151913,0,284,151629
2/8/22,Maldives,3.2028,73.2207,153415,0,285,153130
2/9/22,Maldives,3.2028,73.2207,154511,0,286,154225
2/10/22,Maldives,3.2028,73.2207,155917,0,287,155630
2/11/22,Maldives,3.2028,73.2207,156903,0,287,156616
2/12/22,Maldives,3.2028,73.2207,158031,0,288,157743
2/13/22,Maldives,3.2028,73.2207,159061,0,289,158772
2/14/22,Maldives,3.2028,73.2207,160076,0,289,159787
2/15/22,Maldives,3.2028,73.2207,161113,0,289,160824
2/16/22,Maldives,3.2028,73.2207,162169,0,289,161880
2/17/22,Maldives,3.2028,73.2207,162974,0,290,162684
2/18/22,Maldives,3.2028,73.2207,163581,0,290,163291
2/19/22,Maldives,3.2028,73.2207,164229,0,290,163939
2/20/22,Maldives,3.2028,73.2207,165073,0,291,164782
2/21/22,Maldives,3.2028,73.2207,165729,0,292,165437
2/22/22,Maldives,3.2028,73.2207,166525,0,292,166233
2/23/22,Maldives,3.2028,73.2207,167496,0,293,167203
2/24/22,Maldives,3.2028,73.2207,168124,0,294,167830
2/25/22,Maldives,3.2028,73.2207,168631,0,294,168337
2/26/22,Maldives,3.2028,73.2207,169148,0,296,168852
2/27/22,Maldives,3.2028,73.2207,169632,0,297,169335
2/28/22,Maldives,3.2028,73.2207,170192,0,297,169895
3/1/22,Maldives,3.2028,73.2207,170655,0,297,170358
3/2/22,Maldives,3.2028,73.2207,171114,0,297,170817
3/3/22,Maldives,3.2028,73.2207,171649,0,297,171352
3/4/22,Maldives,3.2028,73.2207,171947,0,297,171650
3/5/22,Maldives,3.2028,73.2207,172270,0,297,171973
3/6/22,Maldives,3.2028,73.2207,172576,0,297,172279
3/7/22,Maldives,3.2028,73.2207,173064,0,297,172767
3/8/22,Maldives,3.2028,73.2207,173337,0,297,173040
3/9/22,Maldives,3.2028,73.2207,173666,0,297,173369
3/10/22,Maldives,3.2028,73.2207,173991,0,297,173694
3/11/22,Maldives,3.2028,73.2207,174163,0,297,173866
3/12/22,Maldives,3.2028,73.2207,174367,0,297,174070
3/13/22,Maldives,3.2028,73.2207,174658,0,297,174361
3/14/22,Maldives,3.2028,73.2207,174658,0,297,174361
3/15/22,Maldives,3.2028,73.2207,174658,0,297,174361
3/16/22,Maldives,3.2028,73.2207,174658,0,297,174361
3/17/22,Maldives,3.2028,73.2207,174658,0,297,174361
3/18/22,Maldives,3.2028,73.2207,174658,0,297,174361
3/19/22,Maldives,3.2028,73.2207,174658,0,297,174361
3/20/22,Maldives,3.2028,73.2207,174658,0,297,174361
3/21/22,Maldives,3.2028,73.2207,174658,0,297,174361
3/22/22,Maldives,3.2028,73.2207,174658,0,297,174361
3/23/22,Maldives,3.2028,73.2207,174658,0,297,174361
3/24/22,Maldives,3.2028,73.2207,174658,0,297,174361
3/25/22,Maldives,3.2028,73.2207,174658,0,297,174361
3/26/22,Maldives,3.2028,73.2207,174658,0,297,174361
3/27/22,Maldives,3.2028,73.2207,174658,0,297,174361
3/28/22,Maldives,3.2028,73.2207,177000,0,298,176702
3/29/22,Maldives,3.2028,73.2207,177000,0,298,176702
3/30/22,Maldives,3.2028,73.2207,177000,0,298,176702
3/31/22,Maldives,3.2028,73.2207,177000,0,298,176702
4/1/22,Maldives,3.2028,73.2207,177000,0,298,176702
4/2/22,Maldives,3.2028,73.2207,177000,0,298,176702
4/3/22,Maldives,3.2028,73.2207,177000,0,298,176702
4/4/22,Maldives,3.2028,73.2207,177665,0,298,177367
4/5/22,Maldives,3.2028,73.2207,177665,0,298,177367
4/6/22,Maldives,3.2028,73.2207,177665,0,298,177367
4/7/22,Maldives,3.2028,73.2207,177665,0,298,177367
4/8/22,Maldives,3.2028,73.2207,177665,0,298,177367
4/9/22,Maldives,3.2028,73.2207,177665,0,298,177367
4/10/22,Maldives,3.2028,73.2207,177665,0,298,177367
4/11/22,Maldives,3.2028,73.2207,178320,0,298,178022
4/12/22,Maldives,3.2028,73.2207,178320,0,298,178022
4/13/22,Maldives,3.2028,73.2207,178320,0,298,178022
4/14/22,Maldives,3.2028,73.2207,178320,0,298,178022
4/15/22,Maldives,3.2028,73.2207,178320,0,298,178022
4/16/22,Maldives,3.2028,73.2207,178320,0,298,178022
4/17/22,Maldives,3.2028,73.2207,178320,0,298,178022
4/18/22,Maldives,3.2028,73.2207,178320,0,298,178022
4/19/22,Maldives,3.2028,73.2207,178883,0,298,178585
4/20/22,Maldives,3.2028,73.2207,178883,0,298,178585
4/21/22,Maldives,3.2028,73.2207,178883,0,298,178585
4/22/22,Maldives,3.2028,73.2207,178883,0,298,178585
4/23/22,Maldives,3.2028,73.2207,178883,0,298,178585
4/24/22,Maldives,3.2028,73.2207,178883,0,298,178585
4/25/22,Maldives,3.2028,73.2207,179171,0,298,178873
4/26/22,Maldives,3.2028,73.2207,179171,0,298,178873
4/27/22,Maldives,3.2028,73.2207,179171,0,298,178873
4/28/22,Maldives,3.2028,73.2207,179171,0,298,178873
4/29/22,Maldives,3.2028,73.2207,179171,0,298,178873
4/30/22,Maldives,3.2028,73.2207,179171,0,298,178873
5/1/22,Maldives,3.2028,73.2207,179171,0,298,178873
5/2/22,Maldives,3.2028,73.2207,179171,0,298,178873
5/3/22,Maldives,3.2028,73.2207,179171,0,298,178873
5/4/22,Maldives,3.2028,73.2207,179171,0,298,178873
5/5/22,Maldives,3.2028,73.2207,179414,0,298,179116
5/6/22,Maldives,3.2028,73.2207,179414,0,298,179116
5/7/22,Maldives,3.2028,73.2207,179414,0,298,179116
5/8/22,Maldives,3.2028,73.2207,179414,0,298,179116
5/9/22,Maldives,3.2028,73.2207,179483,0,298,179185
5/10/22,Maldives,3.2028,73.2207,179483,0,298,179185
5/11/22,Maldives,3.2028,73.2207,179483,0,298,179185
5/12/22,Maldives,3.2028,73.2207,179483,0,298,179185
5/13/22,Maldives,3.2028,73.2207,179483,0,298,179185
5/14/22,Maldives,3.2028,73.2207,179483,0,298,179185
5/15/22,Maldives,3.2028,73.2207,179483,0,298,179185
5/16/22,Maldives,3.2028,73.2207,179560,0,298,179262
5/17/22,Maldives,3.2028,73.2207,179560,0,298,179262
5/18/22,Maldives,3.2028,73.2207,179560,0,298,179262
5/19/22,Maldives,3.2028,73.2207,179560,0,298,179262
5/20/22,Maldives,3.2028,73.2207,179560,0,298,179262
5/21/22,Maldives,3.2028,73.2207,179560,0,298,179262
5/22/22,Maldives,3.2028,73.2207,179560,0,298,179262
5/23/22,Maldives,3.2028,73.2207,179662,0,298,179364
5/24/22,Maldives,3.2028,73.2207,179662,0,298,179364
5/25/22,Maldives,3.2028,73.2207,179662,0,298,179364
5/26/22,Maldives,3.2028,73.2207,179662,0,298,179364
5/27/22,Maldives,3.2028,73.2207,179662,0,298,179364
5/28/22,Maldives,3.2028,73.2207,179662,0,298,179364
5/29/22,Maldives,3.2028,73.2207,179662,0,298,179364
5/30/22,Maldives,3.2028,73.2207,179753,0,299,179454
5/31/22,Maldives,3.2028,73.2207,179753,0,299,179454
6/1/22,Maldives,3.2028,73.2207,179753,0,299,179454
6/2/22,Maldives,3.2028,73.2207,179753,0,299,179454
6/3/22,Maldives,3.2028,73.2207,179753,0,299,179454
6/4/22,Maldives,3.2028,73.2207,179753,0,299,179454
6/5/22,Maldives,3.2028,73.2207,179753,0,299,179454
6/6/22,Maldives,3.2028,73.2207,179837,0,299,179538
6/7/22,Maldives,3.2028,73.2207,179837,0,299,179538
6/8/22,Maldives,3.2028,73.2207,179837,0,299,179538
6/9/22,Maldives,3.2028,73.2207,179837,0,299,179538
6/10/22,Maldives,3.2028,73.2207,179837,0,299,179538
6/11/22,Maldives,3.2028,73.2207,179837,0,299,179538
6/12/22,Maldives,3.2028,73.2207,179837,0,299,179538
6/13/22,Maldives,3.2028,73.2207,179979,0,299,179680
6/14/22,Maldives,3.2028,73.2207,179979,0,299,179680
6/15/22,Maldives,3.2028,73.2207,179979,0,299,179680
6/16/22,Maldives,3.2028,73.2207,179979,0,299,179680
6/17/22,Maldives,3.2028,73.2207,179979,0,299,179680
6/18/22,Maldives,3.2028,73.2207,179979,0,299,179680
6/19/22,Maldives,3.2028,73.2207,179979,0,299,179680
6/20/22,Maldives,3.2028,73.2207,180384,0,300,180084
6/21/22,Maldives,3.2028,73.2207,180384,0,300,180084
6/22/22,Maldives,3.2028,73.2207,180384,0,300,180084
6/23/22,Maldives,3.2028,73.2207,180384,0,300,180084
6/24/22,Maldives,3.2028,73.2207,180384,0,300,180084
6/25/22,Maldives,3.2028,73.2207,180384,0,300,180084
6/26/22,Maldives,3.2028,73.2207,180384,0,300,180084
6/27/22,Maldives,3.2028,73.2207,181586,0,305,181281
6/28/22,Maldives,3.2028,73.2207,181586,0,305,181281
6/29/22,Maldives,3.2028,73.2207,181586,0,305,181281
6/30/22,Maldives,3.2028,73.2207,181586,0,305,181281
7/1/22,Maldives,3.2028,73.2207,181586,0,305,181281
7/2/22,Maldives,3.2028,73.2207,181586,0,305,181281
7/3/22,Maldives,3.2028,73.2207,181586,0,305,181281
7/4/22,Maldives,3.2028,73.2207,182720,0,306,182414
7/5/22,Maldives,3.2028,73.2207,182720,0,306,182414
7/6/22,Maldives,3.2028,73.2207,182720,0,306,182414
7/7/22,Maldives,3.2028,73.2207,182720,0,306,182414
7/8/22,Maldives,3.2028,73.2207,182720,0,306,182414
7/9/22,Maldives,3.2028,73.2207,182720,0,306,182414
7/10/22,Maldives,3.2028,73.2207,182720,0,306,182414
7/11/22,Maldives,3.2028,73.2207,183491,0,307,183184
7/12/22,Maldives,3.2028,73.2207,183491,0,307,183184
7/13/22,Maldives,3.2028,73.2207,183491,0,307,183184
7/14/22,Maldives,3.2028,73.2207,183491,0,307,183184
7/15/22,Maldives,3.2028,73.2207,183491,0,307,183184
7/16/22,Maldives,3.2028,73.2207,183491,0,307,183184
7/17/22,Maldives,3.2028,73.2207,183491,0,307,183184
7/18/22,Maldives,3.2028,73.2207,183908,0,307,183601
7/19/22,Maldives,3.2028,73.2207,183908,0,307,183601
7/20/22,Maldives,3.2028,73.2207,183908,0,307,183601
7/21/22,Maldives,3.2028,73.2207,183908,0,307,183601
7/22/22,Maldives,3.2028,73.2207,183908,0,307,183601
7/23/22,Maldives,3.2028,73.2207,183908,0,307,183601
7/24/22,Maldives,3.2028,73.2207,183908,0,307,183601
7/25/22,Maldives,3.2028,73.2207,184302,0,307,183995
7/26/22,Maldives,3.2028,73.2207,184302,0,307,183995
7/27/22,Maldives,3.2028,73.2207,184302,0,307,183995
7/28/22,Maldives,3.2028,73.2207,184302,0,307,183995
7/29/22,Maldives,3.2028,73.2207,184302,0,307,183995
7/30/22,Maldives,3.2028,73.2207,184302,0,307,183995
7/31/22,Maldives,3.2028,73.2207,184302,0,307,183995
8/1/22,Maldives,3.2028,73.2207,184485,0,307,184178
8/2/22,Maldives,3.2028,73.2207,184485,0,307,184178
8/3/22,Maldives,3.2028,73.2207,184485,0,307,184178
8/4/22,Maldives,3.2028,73.2207,184485,0,307,184178
8/5/22,Maldives,3.2028,73.2207,184485,0,307,184178
8/6/22,Maldives,3.2028,73.2207,184485,0,307,184178
8/7/22,Maldives,3.2028,73.2207,184485,0,307,184178
8/8/22,Maldives,3.2028,73.2207,184591,0,307,184284
8/9/22,Maldives,3.2028,73.2207,184591,0,307,184284
8/10/22,Maldives,3.2028,73.2207,184591,0,307,184284
8/11/22,Maldives,3.2028,73.2207,184591,0,307,184284
8/12/22,Maldives,3.2028,73.2207,184591,0,307,184284
8/13/22,Maldives,3.2028,73.2207,184591,0,307,184284
8/14/22,Maldives,3.2028,73.2207,184591,0,307,184284
8/15/22,Maldives,3.2028,73.2207,184689,0,307,184382
8/16/22,Maldives,3.2028,73.2207,184689,0,307,184382
8/17/22,Maldives,3.2028,73.2207,184689,0,307,184382
8/18/22,Maldives,3.2028,73.2207,184689,0,307,184382
8/19/22,Maldives,3.2028,73.2207,184689,0,307,184382
8/20/22,Maldives,3.2028,73.2207,184689,0,307,184382
8/21/22,Maldives,3.2028,73.2207,184689,0,307,184382
8/22/22,Maldives,3.2028,73.2207,184788,0,307,184481
8/23/22,Maldives,3.2028,73.2207,184788,0,307,184481
8/24/22,Maldives,3.2028,73.2207,184788,0,307,184481
8/25/22,Maldives,3.2028,73.2207,184788,0,307,184481
8/26/22,Maldives,3.2028,73.2207,184788,0,307,184481
8/27/22,Maldives,3.2028,73.2207,184788,0,307,184481
8/28/22,Maldives,3.2028,73.2207,184788,0,307,184481
8/29/22,Maldives,3.2028,73.2207,184856,0,308,184548
8/30/22,Maldives,3.2028,73.2207,184856,0,308,184548
8/31/22,Maldives,3.2028,73.2207,184856,0,308,184548
9/1/22,Maldives,3.2028,73.2207,184856,0,308,184548
9/2/22,Maldives,3.2028,73.2207,184856,0,308,184548
9/3/22,Maldives,3.2028,73.2207,184856,0,308,184548
9/4/22,Maldives,3.2028,73.2207,184856,0,308,184548
9/5/22,Maldives,3.2028,73.2207,184924,0,308,184616
9/6/22,Maldives,3.2028,73.2207,184924,0,308,184616
9/7/22,Maldives,3.2028,73.2207,184924,0,308,184616
9/8/22,Maldives,3.2028,73.2207,184924,0,308,184616
9/9/22,Maldives,3.2028,73.2207,184924,0,308,184616
9/10/22,Maldives,3.2028,73.2207,184924,0,308,184616
9/11/22,Maldives,3.2028,73.2207,184924,0,308,184616
9/12/22,Maldives,3.2028,73.2207,184966,0,308,184658
9/13/22,Maldives,3.2028,73.2207,184966,0,308,184658
9/14/22,Maldives,3.2028,73.2207,184966,0,308,184658
9/15/22,Maldives,3.2028,73.2207,184966,0,308,184658
9/16/22,Maldives,3.2028,73.2207,184966,0,308,184658
9/17/22,Maldives,3.2028,73.2207,184966,0,308,184658
9/18/22,Maldives,3.2028,73.2207,184966,0,308,184658
9/19/22,Maldives,3.2028,73.2207,185004,0,308,184696
9/20/22,Maldives,3.2028,73.2207,185004,0,308,184696
9/21/22,Maldives,3.2028,73.2207,185004,0,308,184696
9/22/22,Maldives,3.2028,73.2207,185004,0,308,184696
9/23/22,Maldives,3.2028,73.2207,185004,0,308,184696
9/24/22,Maldives,3.2028,73.2207,185004,0,308,184696
9/25/22,Maldives,3.2028,73.2207,185004,0,308,184696
9/26/22,Maldives,3.2028,73.2207,185042,0,308,184734
9/27/22,Maldives,3.2028,73.2207,185042,0,308,184734
9/28/22,Maldives,3.2028,73.2207,185042,0,308,184734
9/29/22,Maldives,3.2028,73.2207,185042,0,308,184734
9/30/22,Maldives,3.2028,73.2207,185042,0,308,184734
10/1/22,Maldives,3.2028,73.2207,185042,0,308,184734
10/2/22,Maldives,3.2028,73.2207,185042,0,308,184734
10/3/22,Maldives,3.2028,73.2207,185082,0,308,184774
10/4/22,Maldives,3.2028,73.2207,185082,0,308,184774
10/5/22,Maldives,3.2028,73.2207,185082,0,308,184774
10/6/22,Maldives,3.2028,73.2207,185082,0,308,184774
10/7/22,Maldives,3.2028,73.2207,185082,0,308,184774
10/8/22,Maldives,3.2028,73.2207,185082,0,308,184774
10/9/22,Maldives,3.2028,73.2207,185082,0,308,184774
10/10/22,Maldives,3.2028,73.2207,185125,0,308,184817
10/11/22,Maldives,3.2028,73.2207,185125,0,308,184817
10/12/22,Maldives,3.2028,73.2207,185125,0,308,184817
10/13/22,Maldives,3.2028,73.2207,185125,0,308,184817
10/14/22,Maldives,3.2028,73.2207,185125,0,308,184817
10/15/22,Maldives,3.2028,73.2207,185125,0,308,184817
10/16/22,Maldives,3.2028,73.2207,185125,0,308,184817
10/17/22,Maldives,3.2028,73.2207,185194,0,308,184886
10/18/22,Maldives,3.2028,73.2207,185194,0,308,184886
10/19/22,Maldives,3.2028,73.2207,185194,0,308,184886
10/20/22,Maldives,3.2028,73.2207,185194,0,308,184886
10/21/22,Maldives,3.2028,73.2207,185194,0,308,184886
10/22/22,Maldives,3.2028,73.2207,185194,0,308,184886
10/23/22,Maldives,3.2028,73.2207,185194,0,308,184886
10/24/22,Maldives,3.2028,73.2207,185280,0,308,184972
10/25/22,Maldives,3.2028,73.2207,185280,0,308,184972
10/26/22,Maldives,3.2028,73.2207,185280,0,308,184972
10/27/22,Maldives,3.2028,73.2207,185280,0,308,184972
10/28/22,Maldives,3.2028,73.2207,185280,0,308,184972
10/29/22,Maldives,3.2028,73.2207,185280,0,308,184972
10/30/22,Maldives,3.2028,73.2207,185280,0,308,184972
10/31/22,Maldives,3.2028,73.2207,185364,0,308,185056
11/1/22,Maldives,3.2028,73.2207,185364,0,308,185056
11/2/22,Maldives,3.2028,73.2207,185364,0,308,185056
11/3/22,Maldives,3.2028,73.2207,185364,0,308,185056
11/4/22,Maldives,3.2028,73.2207,185364,0,308,185056
11/5/22,Maldives,3.2028,73.2207,185364,0,308,185056
11/6/22,Maldives,3.2028,73.2207,185364,0,308,185056
11/7/22,Maldives,3.2028,73.2207,185454,0,309,185145
11/8/22,Maldives,3.2028,73.2207,185454,0,309,185145
11/9/22,Maldives,3.2028,73.2207,185454,0,309,185145
11/10/22,Maldives,3.2028,73.2207,185454,0,309,185145
11/11/22,Maldives,3.2028,73.2207,185454,0,309,185145
11/12/22,Maldives,3.2028,73.2207,185454,0,309,185145
11/13/22,Maldives,3.2028,73.2207,185454,0,309,185145
11/14/22,Maldives,3.2028,73.2207,185549,0,311,185238
11/15/22,Maldives,3.2028,73.2207,185549,0,311,185238
11/16/22,Maldives,3.2028,73.2207,185549,0,311,185238
11/17/22,Maldives,3.2028,73.2207,185549,0,311,185238
11/18/22,Maldives,3.2028,73.2207,185549,0,311,185238
11/19/22,Maldives,3.2028,73.2207,185549,0,311,185238
11/20/22,Maldives,3.2028,73.2207,185549,0,311,185238
11/21/22,Maldives,3.2028,73.2207,185584,0,311,185273
11/22/22,Maldives,3.2028,73.2207,185584,0,311,185273
11/23/22,Maldives,3.2028,73.2207,185584,0,311,185273
11/24/22,Maldives,3.2028,73.2207,185584,0,311,185273
11/25/22,Maldives,3.2028,73.2207,185584,0,311,185273
11/26/22,Maldives,3.2028,73.2207,185584,0,311,185273
11/27/22,Maldives,3.2028,73.2207,185584,0,311,185273
11/28/22,Maldives,3.2028,73.2207,185618,0,311,185307
11/29/22,Maldives,3.2028,73.2207,185618,0,311,185307
11/30/22,Maldives,3.2028,73.2207,185618,0,311,185307
12/1/22,Maldives,3.2028,73.2207,185618,0,311,185307
12/2/22,Maldives,3.2028,73.2207,185618,0,311,185307
12/3/22,Maldives,3.2028,73.2207,185618,0,311,185307
12/4/22,Maldives,3.2028,73.2207,185618,0,311,185307
12/5/22,Maldives,3.2028,73.2207,185632,0,311,185321
12/6/22,Maldives,3.2028,73.2207,185632,0,311,185321
12/7/22,Maldives,3.2028,73.2207,185632,0,311,185321
12/8/22,Maldives,3.2028,73.2207,185632,0,311,185321
12/9/22,Maldives,3.2028,73.2207,185632,0,311,185321
12/10/22,Maldives,3.2028,73.2207,185632,0,311,185321
12/11/22,Maldives,3.2028,73.2207,185632,0,311,185321
12/12/22,Maldives,3.2028,73.2207,185651,0,311,185340
12/13/22,Maldives,3.2028,73.2207,185651,0,311,185340
12/14/22,Maldives,3.2028,73.2207,185651,0,311,185340
12/15/22,Maldives,3.2028,73.2207,185651,0,311,185340
12/16/22,Maldives,3.2028,73.2207,185651,0,311,185340
12/17/22,Maldives,3.2028,73.2207,185651,0,311,185340
1/1/22,Mali,17.570692,-3.996166,21378,0,668,20710
1/2/22,Mali,17.570692,-3.996166,21549,0,668,20881
1/3/22,Mali,17.570692,-3.996166,21806,0,668,21138
1/4/22,Mali,17.570692,-3.996166,22383,0,670,21713
1/5/22,Mali,17.570692,-3.996166,22834,0,670,22164
1/6/22,Mali,17.570692,-3.996166,23600,0,670,22930
1/7/22,Mali,17.570692,-3.996166,23980,0,671,23309
1/8/22,Mali,17.570692,-3.996166,23980,0,671,23309
1/9/22,Mali,17.570692,-3.996166,25197,0,672,24525
1/10/22,Mali,17.570692,-3.996166,26011,0,675,25336
1/11/22,Mali,17.570692,-3.996166,26513,0,675,25838
1/12/22,Mali,17.570692,-3.996166,27149,0,677,26472
1/13/22,Mali,17.570692,-3.996166,27653,0,678,26975
1/14/22,Mali,17.570692,-3.996166,27980,0,683,27297
1/15/22,Mali,17.570692,-3.996166,28321,0,688,27633
1/16/22,Mali,17.570692,-3.996166,28585,0,691,27894
1/17/22,Mali,17.570692,-3.996166,28755,0,692,28063
1/18/22,Mali,17.570692,-3.996166,29039,0,692,28347
1/19/22,Mali,17.570692,-3.996166,29257,0,701,28556
1/20/22,Mali,17.570692,-3.996166,29359,0,704,28655
1/21/22,Mali,17.570692,-3.996166,29430,0,704,28726
1/22/22,Mali,17.570692,-3.996166,29597,0,704,28893
1/23/22,Mali,17.570692,-3.996166,29677,0,705,28972
1/24/22,Mali,17.570692,-3.996166,29742,0,707,29035
1/25/22,Mali,17.570692,-3.996166,29858,0,709,29149
1/26/22,Mali,17.570692,-3.996166,29895,0,710,29185
1/27/22,Mali,17.570692,-3.996166,29949,0,711,29238
1/28/22,Mali,17.570692,-3.996166,29983,0,711,29272
1/29/22,Mali,17.570692,-3.996166,30008,0,711,29297
1/30/22,Mali,17.570692,-3.996166,30045,0,711,29334
1/31/22,Mali,17.570692,-3.996166,30052,0,714,29338
2/1/22,Mali,17.570692,-3.996166,30101,0,715,29386
2/2/22,Mali,17.570692,-3.996166,30131,0,715,29416
2/3/22,Mali,17.570692,-3.996166,30148,0,715,29433
2/4/22,Mali,17.570692,-3.996166,30156,0,715,29441
2/5/22,Mali,17.570692,-3.996166,30156,0,715,29441
2/6/22,Mali,17.570692,-3.996166,30205,0,715,29490
2/7/22,Mali,17.570692,-3.996166,30215,0,715,29500
2/8/22,Mali,17.570692,-3.996166,30227,0,715,29512
2/9/22,Mali,17.570692,-3.996166,30236,0,715,29521
2/10/22,Mali,17.570692,-3.996166,30251,0,715,29536
2/11/22,Mali,17.570692,-3.996166,30257,0,716,29541
2/12/22,Mali,17.570692,-3.996166,30259,0,716,29543
2/13/22,Mali,17.570692,-3.996166,30265,0,716,29549
2/14/22,Mali,17.570692,-3.996166,30266,0,716,29550
2/15/22,Mali,17.570692,-3.996166,30286,0,717,29569
2/16/22,Mali,17.570692,-3.996166,30303,0,717,29586
2/17/22,Mali,17.570692,-3.996166,30321,0,717,29604
2/18/22,Mali,17.570692,-3.996166,30333,0,717,29616
2/19/22,Mali,17.570692,-3.996166,30338,0,717,29621
2/20/22,Mali,17.570692,-3.996166,30340,0,720,29620
2/21/22,Mali,17.570692,-3.996166,30346,0,720,29626
2/22/22,Mali,17.570692,-3.996166,30352,0,722,29630
2/23/22,Mali,17.570692,-3.996166,30355,0,722,29633
2/24/22,Mali,17.570692,-3.996166,30358,0,722,29636
2/25/22,Mali,17.570692,-3.996166,30365,0,722,29643
2/26/22,Mali,17.570692,-3.996166,30371,0,722,29649
2/27/22,Mali,17.570692,-3.996166,30378,0,722,29656
2/28/22,Mali,17.570692,-3.996166,30381,0,722,29659
3/1/22,Mali,17.570692,-3.996166,30383,0,722,29661
3/2/22,Mali,17.570692,-3.996166,30391,0,722,29669
3/3/22,Mali,17.570692,-3.996166,30392,0,724,29668
3/4/22,Mali,17.570692,-3.996166,30396,0,724,29672
3/5/22,Mali,17.570692,-3.996166,30398,0,724,29674
3/6/22,Mali,17.570692,-3.996166,30398,0,725,29673
3/7/22,Mali,17.570692,-3.996166,30398,0,725,29673
3/8/22,Mali,17.570692,-3.996166,30401,0,725,29676
3/9/22,Mali,17.570692,-3.996166,30402,0,725,29677
3/10/22,Mali,17.570692,-3.996166,30407,0,726,29681
3/11/22,Mali,17.570692,-3.996166,30409,0,726,29683
3/12/22,Mali,17.570692,-3.996166,30414,0,726,29688
3/13/22,Mali,17.570692,-3.996166,30420,0,726,29694
3/14/22,Mali,17.570692,-3.996166,30423,0,726,29697
3/15/22,Mali,17.570692,-3.996166,30428,0,726,29702
3/16/22,Mali,17.570692,-3.996166,30433,0,727,29706
3/17/22,Mali,17.570692,-3.996166,30439,0,727,29712
3/18/22,Mali,17.570692,-3.996166,30444,0,727,29717
3/19/22,Mali,17.570692,-3.996166,30448,0,727,29721
3/20/22,Mali,17.570692,-3.996166,30453,0,727,29726
3/21/22,Mali,17.570692,-3.996166,30454,0,727,29727
3/22/22,Mali,17.570692,-3.996166,30458,0,727,29731
3/23/22,Mali,17.570692,-3.996166,30463,0,727,29736
3/24/22,Mali,17.570692,-3.996166,30466,0,727,29739
3/25/22,Mali,17.570692,-3.996166,30468,0,727,29741
3/26/22,Mali,17.570692,-3.996166,30470,0,727,29743
3/27/22,Mali,17.570692,-3.996166,30472,0,727,29745
3/28/22,Mali,17.570692,-3.996166,30473,0,727,29746
3/29/22,Mali,17.570692,-3.996166,30476,0,727,29749
3/30/22,Mali,17.570692,-3.996166,30480,0,727,29753
3/31/22,Mali,17.570692,-3.996166,30484,0,727,29757
4/1/22,Mali,17.570692,-3.996166,30489,0,728,29761
4/2/22,Mali,17.570692,-3.996166,30493,0,728,29765
4/3/22,Mali,17.570692,-3.996166,30495,0,728,29767
4/4/22,Mali,17.570692,-3.996166,30506,0,728,29778
4/5/22,Mali,17.570692,-3.996166,30512,0,728,29784
4/6/22,Mali,17.570692,-3.996166,30519,0,728,29791
4/7/22,Mali,17.570692,-3.996166,30526,0,729,29797
4/8/22,Mali,17.570692,-3.996166,30535,0,729,29806
4/9/22,Mali,17.570692,-3.996166,30546,0,729,29817
4/10/22,Mali,17.570692,-3.996166,30566,0,729,29837
4/11/22,Mali,17.570692,-3.996166,30578,0,729,29849
4/12/22,Mali,17.570692,-3.996166,30589,0,729,29860
4/13/22,Mali,17.570692,-3.996166,30602,0,729,29873
4/14/22,Mali,17.570692,-3.996166,30617,0,729,29888
4/15/22,Mali,17.570692,-3.996166,30633,0,729,29904
4/16/22,Mali,17.570692,-3.996166,30651,0,729,29922
4/17/22,Mali,17.570692,-3.996166,30658,0,729,29929
4/18/22,Mali,17.570692,-3.996166,30669,0,729,29940
4/19/22,Mali,17.570692,-3.996166,30678,0,730,29948
4/20/22,Mali,17.570692,-3.996166,30691,0,730,29961
4/21/22,Mali,17.570692,-3.996166,30700,0,731,29969
4/22/22,Mali,17.570692,-3.996166,30716,0,731,29985
4/23/22,Mali,17.570692,-3.996166,30727,0,731,29996
4/24/22,Mali,17.570692,-3.996166,30740,0,731,30009
4/25/22,Mali,17.570692,-3.996166,30752,0,731,30021
4/26/22,Mali,17.570692,-3.996166,30769,0,731,30038
4/27/22,Mali,17.570692,-3.996166,30785,0,731,30054
4/28/22,Mali,17.570692,-3.996166,30804,0,731,30073
4/29/22,Mali,17.570692,-3.996166,30815,0,732,30083
4/30/22,Mali,17.570692,-3.996166,30833,0,732,30101
5/1/22,Mali,17.570692,-3.996166,30843,0,732,30111
5/2/22,Mali,17.570692,-3.996166,30850,0,732,30118
5/3/22,Mali,17.570692,-3.996166,30860,0,732,30128
5/4/22,Mali,17.570692,-3.996166,30874,0,732,30142
5/5/22,Mali,17.570692,-3.996166,30888,0,732,30156
5/6/22,Mali,17.570692,-3.996166,30907,0,733,30174
5/7/22,Mali,17.570692,-3.996166,30927,0,733,30194
5/8/22,Mali,17.570692,-3.996166,30937,0,733,30204
5/9/22,Mali,17.570692,-3.996166,30940,0,733,30207
5/10/22,Mali,17.570692,-3.996166,30950,0,733,30217
5/11/22,Mali,17.570692,-3.996166,30960,0,733,30227
5/12/22,Mali,17.570692,-3.996166,30978,0,733,30245
5/13/22,Mali,17.570692,-3.996166,30991,0,733,30258
5/14/22,Mali,17.570692,-3.996166,31003,0,733,30270
5/15/22,Mali,17.570692,-3.996166,31004,0,733,30271
5/16/22,Mali,17.570692,-3.996166,31014,0,734,30280
5/17/22,Mali,17.570692,-3.996166,31023,0,734,30289
5/18/22,Mali,17.570692,-3.996166,31041,0,734,30307
5/19/22,Mali,17.570692,-3.996166,31043,0,734,30309
5/20/22,Mali,17.570692,-3.996166,31048,0,734,30314
5/21/22,Mali,17.570692,-3.996166,31054,0,734,30320
5/22/22,Mali,17.570692,-3.996166,31056,0,734,30322
5/23/22,Mali,17.570692,-3.996166,31057,0,734,30323
5/24/22,Mali,17.570692,-3.996166,31058,0,734,30324
5/25/22,Mali,17.570692,-3.996166,31069,0,734,30335
5/26/22,Mali,17.570692,-3.996166,31071,0,734,30337
5/27/22,Mali,17.570692,-3.996166,31082,0,734,30348
5/28/22,Mali,17.570692,-3.996166,31088,0,734,30354
5/29/22,Mali,17.570692,-3.996166,31096,0,734,30362
5/30/22,Mali,17.570692,-3.996166,31097,0,734,30363
5/31/22,Mali,17.570692,-3.996166,31097,0,734,30363
6/1/22,Mali,17.570692,-3.996166,31102,0,735,30367
6/2/22,Mali,17.570692,-3.996166,31103,0,735,30368
6/3/22,Mali,17.570692,-3.996166,31108,0,735,30373
6/4/22,Mali,17.570692,-3.996166,31109,0,735,30374
6/5/22,Mali,17.570692,-3.996166,31110,0,735,30375
6/6/22,Mali,17.570692,-3.996166,31111,0,735,30376
6/7/22,Mali,17.570692,-3.996166,31115,0,735,30380
6/8/22,Mali,17.570692,-3.996166,31118,0,735,30383
6/9/22,Mali,17.570692,-3.996166,31120,0,735,30385
6/10/22,Mali,17.570692,-3.996166,31122,0,735,30387
6/11/22,Mali,17.570692,-3.996166,31122,0,735,30387
6/12/22,Mali,17.570692,-3.996166,31125,0,735,30390
6/13/22,Mali,17.570692,-3.996166,31127,0,736,30391
6/14/22,Mali,17.570692,-3.996166,31132,0,736,30396
6/15/22,Mali,17.570692,-3.996166,31134,0,736,30398
6/16/22,Mali,17.570692,-3.996166,31135,0,736,30399
6/17/22,Mali,17.570692,-3.996166,31136,0,736,30400
6/18/22,Mali,17.570692,-3.996166,31137,0,736,30401
6/19/22,Mali,17.570692,-3.996166,31137,0,736,30401
6/20/22,Mali,17.570692,-3.996166,31140,0,736,30404
6/21/22,Mali,17.570692,-3.996166,31142,0,736,30406
6/22/22,Mali,17.570692,-3.996166,31147,0,736,30411
6/23/22,Mali,17.570692,-3.996166,31149,0,736,30413
6/24/22,Mali,17.570692,-3.996166,31150,0,736,30414
6/25/22,Mali,17.570692,-3.996166,31153,0,737,30416
6/26/22,Mali,17.570692,-3.996166,31156,0,737,30419
6/27/22,Mali,17.570692,-3.996166,31158,0,737,30421
6/28/22,Mali,17.570692,-3.996166,31160,0,737,30423
6/29/22,Mali,17.570692,-3.996166,31163,0,737,30426
6/30/22,Mali,17.570692,-3.996166,31165,0,737,30428
7/1/22,Mali,17.570692,-3.996166,31169,0,737,30432
7/2/22,Mali,17.570692,-3.996166,31171,0,737,30434
7/3/22,Mali,17.570692,-3.996166,31171,0,737,30434
7/4/22,Mali,17.570692,-3.996166,31176,0,737,30439
7/5/22,Mali,17.570692,-3.996166,31176,0,737,30439
7/6/22,Mali,17.570692,-3.996166,31181,0,737,30444
7/7/22,Mali,17.570692,-3.996166,31182,0,737,30445
7/8/22,Mali,17.570692,-3.996166,31184,0,737,30447
7/9/22,Mali,17.570692,-3.996166,31186,0,737,30449
7/10/22,Mali,17.570692,-3.996166,31187,0,737,30450
7/11/22,Mali,17.570692,-3.996166,31189,0,737,30452
7/12/22,Mali,17.570692,-3.996166,31192,0,737,30455
7/13/22,Mali,17.570692,-3.996166,31195,0,737,30458
7/14/22,Mali,17.570692,-3.996166,31196,0,737,30459
7/15/22,Mali,17.570692,-3.996166,31196,0,737,30459
7/16/22,Mali,17.570692,-3.996166,31198,0,737,30461
7/17/22,Mali,17.570692,-3.996166,31200,0,737,30463
7/18/22,Mali,17.570692,-3.996166,31203,0,737,30466
7/19/22,Mali,17.570692,-3.996166,31203,0,737,30466
7/20/22,Mali,17.570692,-3.996166,31205,0,737,30468
7/21/22,Mali,17.570692,-3.996166,31208,0,737,30471
7/22/22,Mali,17.570692,-3.996166,31208,0,737,30471
7/23/22,Mali,17.570692,-3.996166,31212,0,737,30475
7/24/22,Mali,17.570692,-3.996166,31216,0,737,30479
7/25/22,Mali,17.570692,-3.996166,31216,0,737,30479
7/26/22,Mali,17.570692,-3.996166,31217,0,737,30480
7/27/22,Mali,17.570692,-3.996166,31217,0,737,30480
7/28/22,Mali,17.570692,-3.996166,31221,0,739,30482
7/29/22,Mali,17.570692,-3.996166,31222,0,739,30483
7/30/22,Mali,17.570692,-3.996166,31222,0,739,30483
7/31/22,Mali,17.570692,-3.996166,31228,0,739,30489
8/1/22,Mali,17.570692,-3.996166,31228,0,739,30489
8/2/22,Mali,17.570692,-3.996166,31230,0,739,30491
8/3/22,Mali,17.570692,-3.996166,31232,0,739,30493
8/4/22,Mali,17.570692,-3.996166,31232,0,739,30493
8/5/22,Mali,17.570692,-3.996166,31234,0,739,30495
8/6/22,Mali,17.570692,-3.996166,31236,0,739,30497
8/7/22,Mali,17.570692,-3.996166,31236,0,739,30497
8/8/22,Mali,17.570692,-3.996166,31237,0,739,30498
8/9/22,Mali,17.570692,-3.996166,31237,0,739,30498
8/10/22,Mali,17.570692,-3.996166,31238,0,739,30499
8/11/22,Mali,17.570692,-3.996166,31240,0,739,30501
8/12/22,Mali,17.570692,-3.996166,31242,0,739,30503
8/13/22,Mali,17.570692,-3.996166,31244,0,739,30505
8/14/22,Mali,17.570692,-3.996166,31245,0,739,30506
8/15/22,Mali,17.570692,-3.996166,31245,0,739,30506
8/16/22,Mali,17.570692,-3.996166,31249,0,739,30510
8/17/22,Mali,17.570692,-3.996166,31249,0,739,30510
8/18/22,Mali,17.570692,-3.996166,31255,0,739,30516
8/19/22,Mali,17.570692,-3.996166,31257,0,739,30518
8/20/22,Mali,17.570692,-3.996166,31259,0,739,30520
8/21/22,Mali,17.570692,-3.996166,31260,0,739,30521
8/22/22,Mali,17.570692,-3.996166,31262,0,739,30523
8/23/22,Mali,17.570692,-3.996166,31263,0,739,30524
8/24/22,Mali,17.570692,-3.996166,31275,0,739,30536
8/25/22,Mali,17.570692,-3.996166,31290,0,739,30551
8/26/22,Mali,17.570692,-3.996166,31302,0,739,30563
8/27/22,Mali,17.570692,-3.996166,31314,0,739,30575
8/28/22,Mali,17.570692,-3.996166,31325,0,739,30586
8/29/22,Mali,17.570692,-3.996166,31337,0,739,30598
8/30/22,Mali,17.570692,-3.996166,31365,0,739,30626
8/31/22,Mali,17.570692,-3.996166,31412,0,739,30673
9/1/22,Mali,17.570692,-3.996166,31462,0,739,30723
9/2/22,Mali,17.570692,-3.996166,31518,0,739,30779
9/3/22,Mali,17.570692,-3.996166,31576,0,739,30837
9/4/22,Mali,17.570692,-3.996166,31623,0,739,30884
9/5/22,Mali,17.570692,-3.996166,31664,0,739,30925
9/6/22,Mali,17.570692,-3.996166,31781,0,739,31042
9/7/22,Mali,17.570692,-3.996166,31912,0,739,31173
9/8/22,Mali,17.570692,-3.996166,31998,0,739,31259
9/9/22,Mali,17.570692,-3.996166,32117,0,739,31378
9/10/22,Mali,17.570692,-3.996166,32205,0,739,31466
9/11/22,Mali,17.570692,-3.996166,32248,0,739,31509
9/12/22,Mali,17.570692,-3.996166,32263,0,739,31524
9/13/22,Mali,17.570692,-3.996166,32330,0,739,31591
9/14/22,Mali,17.570692,-3.996166,32385,0,739,31646
9/15/22,Mali,17.570692,-3.996166,32440,0,739,31701
9/16/22,Mali,17.570692,-3.996166,32478,0,739,31739
9/17/22,Mali,17.570692,-3.996166,32497,0,739,31758
9/18/22,Mali,17.570692,-3.996166,32508,0,740,31768
9/19/22,Mali,17.570692,-3.996166,32532,0,740,31792
9/20/22,Mali,17.570692,-3.996166,32548,0,740,31808
9/21/22,Mali,17.570692,-3.996166,32580,0,740,31840
9/22/22,Mali,17.570692,-3.996166,32592,0,740,31852
9/23/22,Mali,17.570692,-3.996166,32595,0,741,31854
9/24/22,Mali,17.570692,-3.996166,32601,0,741,31860
9/25/22,Mali,17.570692,-3.996166,32604,0,741,31863
9/26/22,Mali,17.570692,-3.996166,32607,0,741,31866
9/27/22,Mali,17.570692,-3.996166,32622,0,741,31881
9/28/22,Mali,17.570692,-3.996166,32622,0,741,31881
9/29/22,Mali,17.570692,-3.996166,32625,0,742,31883
9/30/22,Mali,17.570692,-3.996166,32638,0,742,31896
10/1/22,Mali,17.570692,-3.996166,32641,0,742,31899
10/2/22,Mali,17.570692,-3.996166,32683,0,742,31941
10/3/22,Mali,17.570692,-3.996166,32683,0,742,31941
10/4/22,Mali,17.570692,-3.996166,32686,0,742,31944
10/5/22,Mali,17.570692,-3.996166,32689,0,742,31947
10/6/22,Mali,17.570692,-3.996166,32692,0,742,31950
10/7/22,Mali,17.570692,-3.996166,32695,0,742,31953
10/8/22,Mali,17.570692,-3.996166,32697,0,742,31955
10/9/22,Mali,17.570692,-3.996166,32697,0,742,31955
10/10/22,Mali,17.570692,-3.996166,32697,0,742,31955
10/11/22,Mali,17.570692,-3.996166,32697,0,742,31955
10/12/22,Mali,17.570692,-3.996166,32698,0,742,31956
10/13/22,Mali,17.570692,-3.996166,32701,0,742,31959
10/14/22,Mali,17.570692,-3.996166,32704,0,742,31962
10/15/22,Mali,17.570692,-3.996166,32706,0,742,31964
10/16/22,Mali,17.570692,-3.996166,32709,0,742,31967
10/17/22,Mali,17.570692,-3.996166,32711,0,742,31969
10/18/22,Mali,17.570692,-3.996166,32711,0,742,31969
10/19/22,Mali,17.570692,-3.996166,32712,0,742,31970
10/20/22,Mali,17.570692,-3.996166,32714,0,742,31972
10/21/22,Mali,17.570692,-3.996166,32715,0,742,31973
10/22/22,Mali,17.570692,-3.996166,32715,0,742,31973
10/23/22,Mali,17.570692,-3.996166,32715,0,742,31973
10/24/22,Mali,17.570692,-3.996166,32719,0,742,31977
10/25/22,Mali,17.570692,-3.996166,32722,0,742,31980
10/26/22,Mali,17.570692,-3.996166,32722,0,742,31980
10/27/22,Mali,17.570692,-3.996166,32723,0,742,31981
10/28/22,Mali,17.570692,-3.996166,32724,0,742,31982
10/29/22,Mali,17.570692,-3.996166,32731,0,742,31989
10/30/22,Mali,17.570692,-3.996166,32731,0,742,31989
10/31/22,Mali,17.570692,-3.996166,32733,0,742,31991
11/1/22,Mali,17.570692,-3.996166,32735,0,742,31993
11/2/22,Mali,17.570692,-3.996166,32737,0,742,31995
11/3/22,Mali,17.570692,-3.996166,32738,0,742,31996
11/4/22,Mali,17.570692,-3.996166,32738,0,742,31996
11/5/22,Mali,17.570692,-3.996166,32738,0,742,31996
11/6/22,Mali,17.570692,-3.996166,32738,0,742,31996
11/7/22,Mali,17.570692,-3.996166,32738,0,742,31996
11/8/22,Mali,17.570692,-3.996166,32739,0,742,31997
11/9/22,Mali,17.570692,-3.996166,32741,0,742,31999
11/10/22,Mali,17.570692,-3.996166,32744,0,742,32002
11/11/22,Mali,17.570692,-3.996166,32745,0,742,32003
11/12/22,Mali,17.570692,-3.996166,32745,0,742,32003
11/13/22,Mali,17.570692,-3.996166,32745,0,742,32003
11/14/22,Mali,17.570692,-3.996166,32745,0,742,32003
11/15/22,Mali,17.570692,-3.996166,32749,0,742,32007
11/16/22,Mali,17.570692,-3.996166,32750,0,742,32008
11/17/22,Mali,17.570692,-3.996166,32750,0,742,32008
11/18/22,Mali,17.570692,-3.996166,32755,0,742,32013
11/19/22,Mali,17.570692,-3.996166,32755,0,742,32013
11/20/22,Mali,17.570692,-3.996166,32755,0,742,32013
11/21/22,Mali,17.570692,-3.996166,32755,0,742,32013
11/22/22,Mali,17.570692,-3.996166,32756,0,742,32014
11/23/22,Mali,17.570692,-3.996166,32756,0,742,32014
11/24/22,Mali,17.570692,-3.996166,32757,0,742,32015
11/25/22,Mali,17.570692,-3.996166,32757,0,742,32015
11/26/22,Mali,17.570692,-3.996166,32757,0,742,32015
11/27/22,Mali,17.570692,-3.996166,32758,0,742,32016
11/28/22,Mali,17.570692,-3.996166,32758,0,742,32016
11/29/22,Mali,17.570692,-3.996166,32758,0,742,32016
11/30/22,Mali,17.570692,-3.996166,32760,0,742,32018
12/1/22,Mali,17.570692,-3.996166,32760,0,742,32018
12/2/22,Mali,17.570692,-3.996166,32760,0,742,32018
12/3/22,Mali,17.570692,-3.996166,32760,0,742,32018
12/4/22,Mali,17.570692,-3.996166,32760,0,742,32018
12/5/22,Mali,17.570692,-3.996166,32760,0,742,32018
12/6/22,Mali,17.570692,-3.996166,32760,0,742,32018
12/7/22,Mali,17.570692,-3.996166,32760,0,742,32018
12/8/22,Mali,17.570692,-3.996166,32762,0,742,32020
12/9/22,Mali,17.570692,-3.996166,32763,0,742,32021
12/10/22,Mali,17.570692,-3.996166,32763,0,742,32021
12/11/22,Mali,17.570692,-3.996166,32763,0,742,32021
12/12/22,Mali,17.570692,-3.996166,32764,0,743,32021
12/13/22,Mali,17.570692,-3.996166,32764,0,743,32021
12/14/22,Mali,17.570692,-3.996166,32764,0,743,32021
12/15/22,Mali,17.570692,-3.996166,32764,0,743,32021
12/16/22,Mali,17.570692,-3.996166,32764,0,743,32021
12/17/22,Mali,17.570692,-3.996166,32764,0,743,32021
1/1/22,Malta,35.9375,14.3754,53503,0,477,53026
1/2/22,Malta,35.9375,14.3754,54250,0,479,53771
1/3/22,Malta,35.9375,14.3754,55062,0,479,54583
1/4/22,Malta,35.9375,14.3754,56209,0,479,55730
1/5/22,Malta,35.9375,14.3754,57131,0,482,56649
1/6/22,Malta,35.9375,14.3754,58275,0,484,57791
1/7/22,Malta,35.9375,14.3754,59061,0,485,58576
1/8/22,Malta,35.9375,14.3754,59823,0,487,59336
1/9/22,Malta,35.9375,14.3754,60386,0,487,59899
1/10/22,Malta,35.9375,14.3754,60823,0,488,60335
1/11/22,Malta,35.9375,14.3754,61255,0,492,60763
1/12/22,Malta,35.9375,14.3754,61928,0,496,61432
1/13/22,Malta,35.9375,14.3754,62390,0,496,61894
1/14/22,Malta,35.9375,14.3754,62906,0,501,62405
1/15/22,Malta,35.9375,14.3754,63409,0,504,62905
1/16/22,Malta,35.9375,14.3754,63710,0,506,63204
1/17/22,Malta,35.9375,14.3754,63998,0,506,63492
1/18/22,Malta,35.9375,14.3754,64377,0,509,63868
1/19/22,Malta,35.9375,14.3754,64719,0,514,64205
1/20/22,Malta,35.9375,14.3754,65005,0,520,64485
1/21/22,Malta,35.9375,14.3754,65311,0,521,64790
1/22/22,Malta,35.9375,14.3754,65596,0,525,65071
1/23/22,Malta,35.9375,14.3754,65869,0,532,65337
1/24/22,Malta,35.9375,14.3754,66071,0,534,65537
1/25/22,Malta,35.9375,14.3754,66394,0,536,65858
1/26/22,Malta,35.9375,14.3754,66708,0,538,66170
1/27/22,Malta,35.9375,14.3754,66938,0,541,66397
1/28/22,Malta,35.9375,14.3754,67167,0,544,66623
1/29/22,Malta,35.9375,14.3754,67357,0,545,66812
1/30/22,Malta,35.9375,14.3754,67548,0,547,67001
1/31/22,Malta,35.9375,14.3754,67717,0,550,67167
2/1/22,Malta,35.9375,14.3754,67966,0,551,67415
2/2/22,Malta,35.9375,14.3754,68193,0,556,67637
2/3/22,Malta,35.9375,14.3754,68433,0,559,67874
2/4/22,Malta,35.9375,14.3754,68647,0,560,68087
2/5/22,Malta,35.9375,14.3754,68842,0,565,68277
2/6/22,Malta,35.9375,14.3754,69000,0,569,68431
2/7/22,Malta,35.9375,14.3754,69175,0,570,68605
2/8/22,Malta,35.9375,14.3754,69361,0,570,68791
2/9/22,Malta,35.9375,14.3754,69533,0,572,68961
2/10/22,Malta,35.9375,14.3754,69651,0,576,69075
2/11/22,Malta,35.9375,14.3754,69794,0,579,69215
2/12/22,Malta,35.9375,14.3754,69901,0,585,69316
2/13/22,Malta,35.9375,14.3754,70017,0,589,69428
2/14/22,Malta,35.9375,14.3754,70089,0,592,69497
2/15/22,Malta,35.9375,14.3754,70211,0,593,69618
2/16/22,Malta,35.9375,14.3754,70328,0,594,69734
2/17/22,Malta,35.9375,14.3754,70437,0,594,69843
2/18/22,Malta,35.9375,14.3754,70516,0,594,69922
2/19/22,Malta,35.9375,14.3754,70588,0,594,69994
2/20/22,Malta,35.9375,14.3754,70665,0,596,70069
2/21/22,Malta,35.9375,14.3754,70739,0,598,70141
2/22/22,Malta,35.9375,14.3754,70829,0,599,70230
2/23/22,Malta,35.9375,14.3754,70908,0,601,70307
2/24/22,Malta,35.9375,14.3754,71003,0,601,70402
2/25/22,Malta,35.9375,14.3754,71083,0,601,70482
2/26/22,Malta,35.9375,14.3754,71179,0,602,70577
2/27/22,Malta,35.9375,14.3754,71235,0,604,70631
2/28/22,Malta,35.9375,14.3754,71275,0,605,70670
3/1/22,Malta,35.9375,14.3754,71361,0,605,70756
3/2/22,Malta,35.9375,14.3754,71455,0,606,70849
3/3/22,Malta,35.9375,14.3754,71581,0,607,70974
3/4/22,Malta,35.9375,14.3754,71679,0,607,71072
3/5/22,Malta,35.9375,14.3754,71800,0,608,71192
3/6/22,Malta,35.9375,14.3754,71899,0,608,71291
3/7/22,Malta,35.9375,14.3754,71971,0,609,71362
3/8/22,Malta,35.9375,14.3754,72130,0,610,71520
3/9/22,Malta,35.9375,14.3754,72268,0,612,71656
3/10/22,Malta,35.9375,14.3754,72421,0,613,71808
3/11/22,Malta,35.9375,14.3754,72560,0,613,71947
3/12/22,Malta,35.9375,14.3754,72687,0,614,72073
3/13/22,Malta,35.9375,14.3754,72858,0,614,72244
3/14/22,Malta,35.9375,14.3754,73001,0,615,72386
3/15/22,Malta,35.9375,14.3754,73195,0,617,72578
3/16/22,Malta,35.9375,14.3754,73424,0,618,72806
3/17/22,Malta,35.9375,14.3754,73728,0,619,73109
3/18/22,Malta,35.9375,14.3754,74029,0,621,73408
3/19/22,Malta,35.9375,14.3754,74315,0,621,73694
3/20/22,Malta,35.9375,14.3754,74518,0,622,73896
3/21/22,Malta,35.9375,14.3754,74769,0,624,74145
3/22/22,Malta,35.9375,14.3754,75102,0,624,74478
3/23/22,Malta,35.9375,14.3754,75477,0,626,74851
3/24/22,Malta,35.9375,14.3754,75892,0,626,75266
3/25/22,Malta,35.9375,14.3754,76357,0,627,75730
3/26/22,Malta,35.9375,14.3754,76749,0,630,76119
3/27/22,Malta,35.9375,14.3754,77102,0,631,76471
3/28/22,Malta,35.9375,14.3754,77102,0,631,76471
3/29/22,Malta,35.9375,14.3754,77102,0,631,76471
3/30/22,Malta,35.9375,14.3754,78779,0,638,78141
3/31/22,Malta,35.9375,14.3754,79539,0,638,78901
4/1/22,Malta,35.9375,14.3754,80198,0,638,79560
4/2/22,Malta,35.9375,14.3754,80989,0,639,80350
4/3/22,Malta,35.9375,14.3754,81596,0,641,80955
4/4/22,Malta,35.9375,14.3754,82126,0,644,81482
4/5/22,Malta,35.9375,14.3754,82845,0,649,82196
4/6/22,Malta,35.9375,14.3754,83667,0,650,83017
4/7/22,Malta,35.9375,14.3754,84398,0,652,83746
4/8/22,Malta,35.9375,14.3754,85057,0,656,84401
4/9/22,Malta,35.9375,14.3754,85620,0,659,84961
4/10/22,Malta,35.9375,14.3754,86162,0,662,85500
4/11/22,Malta,35.9375,14.3754,86595,0,664,85931
4/12/22,Malta,35.9375,14.3754,87033,0,667,86366
4/13/22,Malta,35.9375,14.3754,87441,0,669,86772
4/14/22,Malta,35.9375,14.3754,87872,0,671,87201
4/15/22,Malta,35.9375,14.3754,88244,0,672,87572
4/16/22,Malta,35.9375,14.3754,88558,0,673,87885
4/17/22,Malta,35.9375,14.3754,88558,0,673,87885
4/18/22,Malta,35.9375,14.3754,89028,0,677,88351
4/19/22,Malta,35.9375,14.3754,89310,0,677,88633
4/20/22,Malta,35.9375,14.3754,89607,0,679,88928
4/21/22,Malta,35.9375,14.3754,89919,0,684,89235
4/22/22,Malta,35.9375,14.3754,90168,0,684,89484
4/23/22,Malta,35.9375,14.3754,90399,0,687,89712
4/24/22,Malta,35.9375,14.3754,90595,0,688,89907
4/25/22,Malta,35.9375,14.3754,90773,0,692,90081
4/26/22,Malta,35.9375,14.3754,91032,0,693,90339
4/27/22,Malta,35.9375,14.3754,91221,0,696,90525
4/28/22,Malta,35.9375,14.3754,91427,0,698,90729
4/29/22,Malta,35.9375,14.3754,91605,0,698,90907
4/30/22,Malta,35.9375,14.3754,91741,0,698,91043
5/1/22,Malta,35.9375,14.3754,91861,0,698,91163
5/2/22,Malta,35.9375,14.3754,91975,0,700,91275
5/3/22,Malta,35.9375,14.3754,92150,0,702,91448
5/4/22,Malta,35.9375,14.3754,92308,0,703,91605
5/5/22,Malta,35.9375,14.3754,92475,0,708,91767
5/6/22,Malta,35.9375,14.3754,92597,0,708,91889
5/7/22,Malta,35.9375,14.3754,92729,0,708,92021
5/8/22,Malta,35.9375,14.3754,92848,0,709,92139
5/9/22,Malta,35.9375,14.3754,92953,0,711,92242
5/10/22,Malta,35.9375,14.3754,93041,0,713,92328
5/11/22,Malta,35.9375,14.3754,93149,0,713,92436
5/12/22,Malta,35.9375,14.3754,93249,0,713,92536
5/13/22,Malta,35.9375,14.3754,93360,0,713,92647
5/14/22,Malta,35.9375,14.3754,93446,0,713,92733
5/15/22,Malta,35.9375,14.3754,93508,0,713,92795
5/16/22,Malta,35.9375,14.3754,93572,0,713,92859
5/17/22,Malta,35.9375,14.3754,93682,0,714,92968
5/18/22,Malta,35.9375,14.3754,93758,0,716,93042
5/19/22,Malta,35.9375,14.3754,93843,0,716,93127
5/20/22,Malta,35.9375,14.3754,93912,0,716,93196
5/21/22,Malta,35.9375,14.3754,93985,0,717,93268
5/22/22,Malta,35.9375,14.3754,94046,0,717,93329
5/23/22,Malta,35.9375,14.3754,94113,0,718,93395
5/24/22,Malta,35.9375,14.3754,94205,0,719,93486
5/25/22,Malta,35.9375,14.3754,94264,0,719,93545
5/26/22,Malta,35.9375,14.3754,94354,0,719,93635
5/27/22,Malta,35.9375,14.3754,94440,0,719,93721
5/28/22,Malta,35.9375,14.3754,94513,0,719,93794
5/29/22,Malta,35.9375,14.3754,94579,0,721,93858
5/30/22,Malta,35.9375,14.3754,94643,0,721,93922
5/31/22,Malta,35.9375,14.3754,94742,0,721,94021
6/1/22,Malta,35.9375,14.3754,94857,0,721,94136
6/2/22,Malta,35.9375,14.3754,94950,0,722,94228
6/3/22,Malta,35.9375,14.3754,95068,0,722,94346
6/4/22,Malta,35.9375,14.3754,95144,0,722,94422
6/5/22,Malta,35.9375,14.3754,95210,0,723,94487
6/6/22,Malta,35.9375,14.3754,95272,0,723,94549
6/7/22,Malta,35.9375,14.3754,95365,0,723,94642
6/8/22,Malta,35.9375,14.3754,95467,0,723,94744
6/9/22,Malta,35.9375,14.3754,95642,0,723,94919
6/10/22,Malta,35.9375,14.3754,95829,0,723,95106
6/11/22,Malta,35.9375,14.3754,95995,0,724,95271
6/12/22,Malta,35.9375,14.3754,96148,0,726,95422
6/13/22,Malta,35.9375,14.3754,96290,0,727,95563
6/14/22,Malta,35.9375,14.3754,96490,0,728,95762
6/15/22,Malta,35.9375,14.3754,96763,0,728,96035
6/16/22,Malta,35.9375,14.3754,97018,0,728,96290
6/17/22,Malta,35.9375,14.3754,97278,0,728,96550
6/18/22,Malta,35.9375,14.3754,97557,0,730,96827
6/19/22,Malta,35.9375,14.3754,97872,0,730,97142
6/20/22,Malta,35.9375,14.3754,98105,0,730,97375
6/21/22,Malta,35.9375,14.3754,98593,0,735,97858
6/22/22,Malta,35.9375,14.3754,99116,0,736,98380
6/23/22,Malta,35.9375,14.3754,99659,0,738,98921
6/24/22,Malta,35.9375,14.3754,100138,0,740,99398
6/25/22,Malta,35.9375,14.3754,100594,0,740,99854
6/26/22,Malta,35.9375,14.3754,101036,0,740,100296
6/27/22,Malta,35.9375,14.3754,101453,0,740,100713
6/28/22,Malta,35.9375,14.3754,102023,0,740,101283
6/29/22,Malta,35.9375,14.3754,102593,0,740,101853
6/30/22,Malta,35.9375,14.3754,103132,0,741,102391
7/1/22,Malta,35.9375,14.3754,103836,0,744,103092
7/2/22,Malta,35.9375,14.3754,104419,0,747,103672
7/3/22,Malta,35.9375,14.3754,104919,0,748,104171
7/4/22,Malta,35.9375,14.3754,105407,0,748,104659
7/5/22,Malta,35.9375,14.3754,106068,0,751,105317
7/6/22,Malta,35.9375,14.3754,106682,0,752,105930
7/7/22,Malta,35.9375,14.3754,107306,0,753,106553
7/8/22,Malta,35.9375,14.3754,107812,0,754,107058
7/9/22,Malta,35.9375,14.3754,108283,0,756,107527
7/10/22,Malta,35.9375,14.3754,108688,0,759,107929
7/11/22,Malta,35.9375,14.3754,109043,0,762,108281
7/12/22,Malta,35.9375,14.3754,109493,0,763,108730
7/13/22,Malta,35.9375,14.3754,109911,0,766,109145
7/14/22,Malta,35.9375,14.3754,110191,0,768,109423
7/15/22,Malta,35.9375,14.3754,110501,0,768,109733
7/16/22,Malta,35.9375,14.3754,110743,0,772,109971
7/17/22,Malta,35.9375,14.3754,110967,0,772,110195
7/18/22,Malta,35.9375,14.3754,111149,0,773,110376
7/19/22,Malta,35.9375,14.3754,111410,0,777,110633
7/20/22,Malta,35.9375,14.3754,111629,0,778,110851
7/21/22,Malta,35.9375,14.3754,111833,0,780,111053
7/22/22,Malta,35.9375,14.3754,111983,0,783,111200
7/23/22,Malta,35.9375,14.3754,112089,0,785,111304
7/24/22,Malta,35.9375,14.3754,112217,0,785,111432
7/25/22,Malta,35.9375,14.3754,112295,0,786,111509
7/26/22,Malta,35.9375,14.3754,112436,0,787,111649
7/27/22,Malta,35.9375,14.3754,112533,0,789,111744
7/28/22,Malta,35.9375,14.3754,112631,0,792,111839
7/29/22,Malta,35.9375,14.3754,112719,0,792,111927
7/30/22,Malta,35.9375,14.3754,112770,0,793,111977
7/31/22,Malta,35.9375,14.3754,112828,0,794,112034
8/1/22,Malta,35.9375,14.3754,112879,0,794,112085
8/2/22,Malta,35.9375,14.3754,112973,0,794,112179
8/3/22,Malta,35.9375,14.3754,113056,0,795,112261
8/4/22,Malta,35.9375,14.3754,113120,0,795,112325
8/5/22,Malta,35.9375,14.3754,113170,0,795,112375
8/6/22,Malta,35.9375,14.3754,113220,0,795,112425
8/7/22,Malta,35.9375,14.3754,113246,0,795,112451
8/8/22,Malta,35.9375,14.3754,113288,0,795,112493
8/9/22,Malta,35.9375,14.3754,113335,0,796,112539
8/10/22,Malta,35.9375,14.3754,113378,0,797,112581
8/11/22,Malta,35.9375,14.3754,113427,0,797,112630
8/12/22,Malta,35.9375,14.3754,113471,0,797,112674
8/13/22,Malta,35.9375,14.3754,113501,0,797,112704
8/14/22,Malta,35.9375,14.3754,113534,0,797,112737
8/15/22,Malta,35.9375,14.3754,113558,0,797,112761
8/16/22,Malta,35.9375,14.3754,113585,0,797,112788
8/17/22,Malta,35.9375,14.3754,113627,0,798,112829
8/18/22,Malta,35.9375,14.3754,113693,0,798,112895
8/19/22,Malta,35.9375,14.3754,113721,0,799,112922
8/20/22,Malta,35.9375,14.3754,113777,0,799,112978
8/21/22,Malta,35.9375,14.3754,113800,0,799,113001
8/22/22,Malta,35.9375,14.3754,113833,0,799,113034
8/23/22,Malta,35.9375,14.3754,113870,0,799,113071
8/24/22,Malta,35.9375,14.3754,113892,0,799,113093
8/25/22,Malta,35.9375,14.3754,113916,0,799,113117
8/26/22,Malta,35.9375,14.3754,113916,0,799,113117
8/27/22,Malta,35.9375,14.3754,113972,0,801,113171
8/28/22,Malta,35.9375,14.3754,113989,0,801,113188
8/29/22,Malta,35.9375,14.3754,114000,0,801,113199
8/30/22,Malta,35.9375,14.3754,114026,0,801,113225
8/31/22,Malta,35.9375,14.3754,114050,0,801,113249
9/1/22,Malta,35.9375,14.3754,114075,0,801,113274
9/2/22,Malta,35.9375,14.3754,114097,0,801,113296
9/3/22,Malta,35.9375,14.3754,114114,0,801,113313
9/4/22,Malta,35.9375,14.3754,114135,0,802,113333
9/5/22,Malta,35.9375,14.3754,114151,0,802,113349
9/6/22,Malta,35.9375,14.3754,114172,0,802,113370
9/7/22,Malta,35.9375,14.3754,114195,0,802,113393
9/8/22,Malta,35.9375,14.3754,114206,0,802,113404
9/9/22,Malta,35.9375,14.3754,114228,0,802,113426
9/10/22,Malta,35.9375,14.3754,114251,0,802,113449
9/11/22,Malta,35.9375,14.3754,114265,0,802,113463
9/12/22,Malta,35.9375,14.3754,114283,0,803,113480
9/13/22,Malta,35.9375,14.3754,114304,0,803,113501
9/14/22,Malta,35.9375,14.3754,114323,0,803,113520
9/15/22,Malta,35.9375,14.3754,114348,0,803,113545
9/16/22,Malta,35.9375,14.3754,114368,0,803,113565
9/17/22,Malta,35.9375,14.3754,114392,0,803,113589
9/18/22,Malta,35.9375,14.3754,114411,0,804,113607
9/19/22,Malta,35.9375,14.3754,114425,0,804,113621
9/20/22,Malta,35.9375,14.3754,114443,0,804,113639
9/21/22,Malta,35.9375,14.3754,114470,0,804,113666
9/22/22,Malta,35.9375,14.3754,114503,0,804,113699
9/23/22,Malta,35.9375,14.3754,114534,0,804,113730
9/24/22,Malta,35.9375,14.3754,114550,0,804,113746
9/25/22,Malta,35.9375,14.3754,114567,0,804,113763
9/26/22,Malta,35.9375,14.3754,114583,0,804,113779
9/27/22,Malta,35.9375,14.3754,114605,0,804,113801
9/28/22,Malta,35.9375,14.3754,114628,0,806,113822
9/29/22,Malta,35.9375,14.3754,114652,0,806,113846
9/30/22,Malta,35.9375,14.3754,114692,0,806,113886
10/1/22,Malta,35.9375,14.3754,114710,0,806,113904
10/2/22,Malta,35.9375,14.3754,114719,0,806,113913
10/3/22,Malta,35.9375,14.3754,114730,0,806,113924
10/4/22,Malta,35.9375,14.3754,114757,0,806,113951
10/5/22,Malta,35.9375,14.3754,114777,0,806,113971
10/6/22,Malta,35.9375,14.3754,114805,0,806,113999
10/7/22,Malta,35.9375,14.3754,114822,0,806,114016
10/8/22,Malta,35.9375,14.3754,114839,0,806,114033
10/9/22,Malta,35.9375,14.3754,114866,0,806,114060
10/10/22,Malta,35.9375,14.3754,114887,0,806,114081
10/11/22,Malta,35.9375,14.3754,114910,0,806,114104
10/12/22,Malta,35.9375,14.3754,114918,0,806,114112
10/13/22,Malta,35.9375,14.3754,114941,0,806,114135
10/14/22,Malta,35.9375,14.3754,114963,0,806,114157
10/15/22,Malta,35.9375,14.3754,114985,0,806,114179
10/16/22,Malta,35.9375,14.3754,115013,0,806,114207
10/17/22,Malta,35.9375,14.3754,115036,0,806,114230
10/18/22,Malta,35.9375,14.3754,115072,0,806,114266
10/19/22,Malta,35.9375,14.3754,115103,0,806,114297
10/20/22,Malta,35.9375,14.3754,115136,0,807,114329
10/21/22,Malta,35.9375,14.3754,115159,0,807,114352
10/22/22,Malta,35.9375,14.3754,115176,0,808,114368
10/23/22,Malta,35.9375,14.3754,115197,0,808,114389
10/24/22,Malta,35.9375,14.3754,115215,0,808,114407
10/25/22,Malta,35.9375,14.3754,115243,0,808,114435
10/26/22,Malta,35.9375,14.3754,115271,0,808,114463
10/27/22,Malta,35.9375,14.3754,115294,0,808,114486
10/28/22,Malta,35.9375,14.3754,115307,0,808,114499
10/29/22,Malta,35.9375,14.3754,115323,0,808,114515
10/30/22,Malta,35.9375,14.3754,115338,0,808,114530
10/31/22,Malta,35.9375,14.3754,115349,0,808,114541
11/1/22,Malta,35.9375,14.3754,115372,0,808,114564
11/2/22,Malta,35.9375,14.3754,115402,0,808,114594
11/3/22,Malta,35.9375,14.3754,115425,0,808,114617
11/4/22,Malta,35.9375,14.3754,115447,0,808,114639
11/5/22,Malta,35.9375,14.3754,115459,0,808,114651
11/6/22,Malta,35.9375,14.3754,115469,0,808,114661
11/7/22,Malta,35.9375,14.3754,115489,0,808,114681
11/8/22,Malta,35.9375,14.3754,115512,0,808,114704
11/9/22,Malta,35.9375,14.3754,115532,0,808,114724
11/10/22,Malta,35.9375,14.3754,115547,0,808,114739
11/11/22,Malta,35.9375,14.3754,115563,0,808,114755
11/12/22,Malta,35.9375,14.3754,115587,0,808,114779
11/13/22,Malta,35.9375,14.3754,115597,0,808,114789
11/14/22,Malta,35.9375,14.3754,115608,0,808,114800
11/15/22,Malta,35.9375,14.3754,115629,0,808,114821
11/16/22,Malta,35.9375,14.3754,115641,0,808,114833
11/17/22,Malta,35.9375,14.3754,115660,0,808,114852
11/18/22,Malta,35.9375,14.3754,115673,0,808,114865
11/19/22,Malta,35.9375,14.3754,115681,0,808,114873
11/20/22,Malta,35.9375,14.3754,115695,0,808,114887
11/21/22,Malta,35.9375,14.3754,115703,0,808,114895
11/22/22,Malta,35.9375,14.3754,115721,0,808,114913
11/23/22,Malta,35.9375,14.3754,115734,0,809,114925
11/24/22,Malta,35.9375,14.3754,115750,0,809,114941
11/25/22,Malta,35.9375,14.3754,115754,0,809,114945
11/26/22,Malta,35.9375,14.3754,115765,0,809,114956
11/27/22,Malta,35.9375,14.3754,115769,0,809,114960
11/28/22,Malta,35.9375,14.3754,115775,0,809,114966
11/29/22,Malta,35.9375,14.3754,115790,0,809,114981
11/30/22,Malta,35.9375,14.3754,115818,0,809,115009
12/1/22,Malta,35.9375,14.3754,115839,0,809,115030
12/2/22,Malta,35.9375,14.3754,115851,0,809,115042
12/3/22,Malta,35.9375,14.3754,115857,0,809,115048
12/4/22,Malta,35.9375,14.3754,115870,0,809,115061
12/5/22,Malta,35.9375,14.3754,115891,0,809,115082
12/6/22,Malta,35.9375,14.3754,115907,0,809,115098
12/7/22,Malta,35.9375,14.3754,115918,0,809,115109
12/8/22,Malta,35.9375,14.3754,115933,0,809,115124
12/9/22,Malta,35.9375,14.3754,115941,0,809,115132
12/10/22,Malta,35.9375,14.3754,115960,0,809,115151
12/11/22,Malta,35.9375,14.3754,115973,0,809,115164
12/12/22,Malta,35.9375,14.3754,115981,0,809,115172
12/13/22,Malta,35.9375,14.3754,116000,0,809,115191
12/14/22,Malta,35.9375,14.3754,116028,0,811,115217
12/15/22,Malta,35.9375,14.3754,116059,0,811,115248
12/16/22,Malta,35.9375,14.3754,116082,0,811,115271
12/17/22,Malta,35.9375,14.3754,116093,0,811,115282
1/1/22,Marshall Islands,7.1315,171.1845,4,0,0,4
1/2/22,Marshall Islands,7.1315,171.1845,4,0,0,4
1/3/22,Marshall Islands,7.1315,171.1845,4,0,0,4
1/4/22,Marshall Islands,7.1315,171.1845,4,0,0,4
1/5/22,Marshall Islands,7.1315,171.1845,4,0,0,4
1/6/22,Marshall Islands,7.1315,171.1845,7,0,0,7
1/7/22,Marshall Islands,7.1315,171.1845,7,0,0,7
1/8/22,Marshall Islands,7.1315,171.1845,7,0,0,7
1/9/22,Marshall Islands,7.1315,171.1845,7,0,0,7
1/10/22,Marshall Islands,7.1315,171.1845,7,0,0,7
1/11/22,Marshall Islands,7.1315,171.1845,7,0,0,7
1/12/22,Marshall Islands,7.1315,171.1845,7,0,0,7
1/13/22,Marshall Islands,7.1315,171.1845,7,0,0,7
1/14/22,Marshall Islands,7.1315,171.1845,7,0,0,7
1/15/22,Marshall Islands,7.1315,171.1845,7,0,0,7
1/16/22,Marshall Islands,7.1315,171.1845,7,0,0,7
1/17/22,Marshall Islands,7.1315,171.1845,7,0,0,7
1/18/22,Marshall Islands,7.1315,171.1845,7,0,0,7
1/19/22,Marshall Islands,7.1315,171.1845,7,0,0,7
1/20/22,Marshall Islands,7.1315,171.1845,7,0,0,7
1/21/22,Marshall Islands,7.1315,171.1845,7,0,0,7
1/22/22,Marshall Islands,7.1315,171.1845,7,0,0,7
1/23/22,Marshall Islands,7.1315,171.1845,7,0,0,7
1/24/22,Marshall Islands,7.1315,171.1845,7,0,0,7
1/25/22,Marshall Islands,7.1315,171.1845,7,0,0,7
1/26/22,Marshall Islands,7.1315,171.1845,7,0,0,7
1/27/22,Marshall Islands,7.1315,171.1845,7,0,0,7
1/28/22,Marshall Islands,7.1315,171.1845,7,0,0,7
1/29/22,Marshall Islands,7.1315,171.1845,7,0,0,7
1/30/22,Marshall Islands,7.1315,171.1845,7,0,0,7
1/31/22,Marshall Islands,7.1315,171.1845,7,0,0,7
2/1/22,Marshall Islands,7.1315,171.1845,7,0,0,7
2/2/22,Marshall Islands,7.1315,171.1845,7,0,0,7
2/3/22,Marshall Islands,7.1315,171.1845,7,0,0,7
2/4/22,Marshall Islands,7.1315,171.1845,7,0,0,7
2/5/22,Marshall Islands,7.1315,171.1845,7,0,0,7
2/6/22,Marshall Islands,7.1315,171.1845,7,0,0,7
2/7/22,Marshall Islands,7.1315,171.1845,7,0,0,7
2/8/22,Marshall Islands,7.1315,171.1845,7,0,0,7
2/9/22,Marshall Islands,7.1315,171.1845,7,0,0,7
2/10/22,Marshall Islands,7.1315,171.1845,7,0,0,7
2/11/22,Marshall Islands,7.1315,171.1845,7,0,0,7
2/12/22,Marshall Islands,7.1315,171.1845,7,0,0,7
2/13/22,Marshall Islands,7.1315,171.1845,7,0,0,7
2/14/22,Marshall Islands,7.1315,171.1845,7,0,0,7
2/15/22,Marshall Islands,7.1315,171.1845,7,0,0,7
2/16/22,Marshall Islands,7.1315,171.1845,7,0,0,7
2/17/22,Marshall Islands,7.1315,171.1845,7,0,0,7
2/18/22,Marshall Islands,7.1315,171.1845,7,0,0,7
2/19/22,Marshall Islands,7.1315,171.1845,7,0,0,7
2/20/22,Marshall Islands,7.1315,171.1845,7,0,0,7
2/21/22,Marshall Islands,7.1315,171.1845,7,0,0,7
2/22/22,Marshall Islands,7.1315,171.1845,7,0,0,7
2/23/22,Marshall Islands,7.1315,171.1845,7,0,0,7
2/24/22,Marshall Islands,7.1315,171.1845,7,0,0,7
2/25/22,Marshall Islands,7.1315,171.1845,7,0,0,7
2/26/22,Marshall Islands,7.1315,171.1845,7,0,0,7
2/27/22,Marshall Islands,7.1315,171.1845,7,0,0,7
2/28/22,Marshall Islands,7.1315,171.1845,7,0,0,7
3/1/22,Marshall Islands,7.1315,171.1845,7,0,0,7
3/2/22,Marshall Islands,7.1315,171.1845,7,0,0,7
3/3/22,Marshall Islands,7.1315,171.1845,7,0,0,7
3/4/22,Marshall Islands,7.1315,171.1845,7,0,0,7
3/5/22,Marshall Islands,7.1315,171.1845,7,0,0,7
3/6/22,Marshall Islands,7.1315,171.1845,7,0,0,7
3/7/22,Marshall Islands,7.1315,171.1845,7,0,0,7
3/8/22,Marshall Islands,7.1315,171.1845,7,0,0,7
3/9/22,Marshall Islands,7.1315,171.1845,7,0,0,7
3/10/22,Marshall Islands,7.1315,171.1845,7,0,0,7
3/11/22,Marshall Islands,7.1315,171.1845,7,0,0,7
3/12/22,Marshall Islands,7.1315,171.1845,7,0,0,7
3/13/22,Marshall Islands,7.1315,171.1845,7,0,0,7
3/14/22,Marshall Islands,7.1315,171.1845,7,0,0,7
3/15/22,Marshall Islands,7.1315,171.1845,7,0,0,7
3/16/22,Marshall Islands,7.1315,171.1845,7,0,0,7
3/17/22,Marshall Islands,7.1315,171.1845,7,0,0,7
3/18/22,Marshall Islands,7.1315,171.1845,7,0,0,7
3/19/22,Marshall Islands,7.1315,171.1845,7,0,0,7
3/20/22,Marshall Islands,7.1315,171.1845,7,0,0,7
3/21/22,Marshall Islands,7.1315,171.1845,7,0,0,7
3/22/22,Marshall Islands,7.1315,171.1845,7,0,0,7
3/23/22,Marshall Islands,7.1315,171.1845,7,0,0,7
3/24/22,Marshall Islands,7.1315,171.1845,7,0,0,7
3/25/22,Marshall Islands,7.1315,171.1845,7,0,0,7
3/26/22,Marshall Islands,7.1315,171.1845,7,0,0,7
3/27/22,Marshall Islands,7.1315,171.1845,7,0,0,7
3/28/22,Marshall Islands,7.1315,171.1845,7,0,0,7
3/29/22,Marshall Islands,7.1315,171.1845,7,0,0,7
3/30/22,Marshall Islands,7.1315,171.1845,7,0,0,7
3/31/22,Marshall Islands,7.1315,171.1845,7,0,0,7
4/1/22,Marshall Islands,7.1315,171.1845,7,0,0,7
4/2/22,Marshall Islands,7.1315,171.1845,7,0,0,7
4/3/22,Marshall Islands,7.1315,171.1845,7,0,0,7
4/4/22,Marshall Islands,7.1315,171.1845,7,0,0,7
4/5/22,Marshall Islands,7.1315,171.1845,7,0,0,7
4/6/22,Marshall Islands,7.1315,171.1845,7,0,0,7
4/7/22,Marshall Islands,7.1315,171.1845,7,0,0,7
4/8/22,Marshall Islands,7.1315,171.1845,7,0,0,7
4/9/22,Marshall Islands,7.1315,171.1845,7,0,0,7
4/10/22,Marshall Islands,7.1315,171.1845,7,0,0,7
4/11/22,Marshall Islands,7.1315,171.1845,7,0,0,7
4/12/22,Marshall Islands,7.1315,171.1845,7,0,0,7
4/13/22,Marshall Islands,7.1315,171.1845,7,0,0,7
4/14/22,Marshall Islands,7.1315,171.1845,7,0,0,7
4/15/22,Marshall Islands,7.1315,171.1845,7,0,0,7
4/16/22,Marshall Islands,7.1315,171.1845,14,0,0,14
4/17/22,Marshall Islands,7.1315,171.1845,14,0,0,14
4/18/22,Marshall Islands,7.1315,171.1845,14,0,0,14
4/19/22,Marshall Islands,7.1315,171.1845,15,0,0,15
4/20/22,Marshall Islands,7.1315,171.1845,15,0,0,15
4/21/22,Marshall Islands,7.1315,171.1845,15,0,0,15
4/22/22,Marshall Islands,7.1315,171.1845,15,0,0,15
4/23/22,Marshall Islands,7.1315,171.1845,15,0,0,15
4/24/22,Marshall Islands,7.1315,171.1845,15,0,0,15
4/25/22,Marshall Islands,7.1315,171.1845,17,0,0,17
4/26/22,Marshall Islands,7.1315,171.1845,17,0,0,17
4/27/22,Marshall Islands,7.1315,171.1845,17,0,0,17
4/28/22,Marshall Islands,7.1315,171.1845,17,0,0,17
4/29/22,Marshall Islands,7.1315,171.1845,17,0,0,17
4/30/22,Marshall Islands,7.1315,171.1845,17,0,0,17
5/1/22,Marshall Islands,7.1315,171.1845,17,0,0,17
5/2/22,Marshall Islands,7.1315,171.1845,17,0,0,17
5/3/22,Marshall Islands,7.1315,171.1845,17,0,0,17
5/4/22,Marshall Islands,7.1315,171.1845,17,0,0,17
5/5/22,Marshall Islands,7.1315,171.1845,17,0,0,17
5/6/22,Marshall Islands,7.1315,171.1845,17,0,0,17
5/7/22,Marshall Islands,7.1315,171.1845,17,0,0,17
5/8/22,Marshall Islands,7.1315,171.1845,17,0,0,17
5/9/22,Marshall Islands,7.1315,171.1845,17,0,0,17
5/10/22,Marshall Islands,7.1315,171.1845,17,0,0,17
5/11/22,Marshall Islands,7.1315,171.1845,17,0,0,17
5/12/22,Marshall Islands,7.1315,171.1845,17,0,0,17
5/13/22,Marshall Islands,7.1315,171.1845,17,0,0,17
5/14/22,Marshall Islands,7.1315,171.1845,17,0,0,17
5/15/22,Marshall Islands,7.1315,171.1845,17,0,0,17
5/16/22,Marshall Islands,7.1315,171.1845,17,0,0,17
5/17/22,Marshall Islands,7.1315,171.1845,17,0,0,17
5/18/22,Marshall Islands,7.1315,171.1845,17,0,0,17
5/19/22,Marshall Islands,7.1315,171.1845,17,0,0,17
5/20/22,Marshall Islands,7.1315,171.1845,17,0,0,17
5/21/22,Marshall Islands,7.1315,171.1845,17,0,0,17
5/22/22,Marshall Islands,7.1315,171.1845,17,0,0,17
5/23/22,Marshall Islands,7.1315,171.1845,17,0,0,17
5/24/22,Marshall Islands,7.1315,171.1845,17,0,0,17
5/25/22,Marshall Islands,7.1315,171.1845,17,0,0,17
5/26/22,Marshall Islands,7.1315,171.1845,17,0,0,17
5/27/22,Marshall Islands,7.1315,171.1845,17,0,0,17
5/28/22,Marshall Islands,7.1315,171.1845,17,0,0,17
5/29/22,Marshall Islands,7.1315,171.1845,17,0,0,17
5/30/22,Marshall Islands,7.1315,171.1845,17,0,0,17
5/31/22,Marshall Islands,7.1315,171.1845,17,0,0,17
6/1/22,Marshall Islands,7.1315,171.1845,17,0,0,17
6/2/22,Marshall Islands,7.1315,171.1845,17,0,0,17
6/3/22,Marshall Islands,7.1315,171.1845,18,0,0,18
6/4/22,Marshall Islands,7.1315,171.1845,18,0,0,18
6/5/22,Marshall Islands,7.1315,171.1845,18,0,0,18
6/6/22,Marshall Islands,7.1315,171.1845,18,0,0,18
6/7/22,Marshall Islands,7.1315,171.1845,18,0,0,18
6/8/22,Marshall Islands,7.1315,171.1845,18,0,0,18
6/9/22,Marshall Islands,7.1315,171.1845,18,0,0,18
6/10/22,Marshall Islands,7.1315,171.1845,18,0,0,18
6/11/22,Marshall Islands,7.1315,171.1845,18,0,0,18
6/12/22,Marshall Islands,7.1315,171.1845,18,0,0,18
6/13/22,Marshall Islands,7.1315,171.1845,18,0,0,18
6/14/22,Marshall Islands,7.1315,171.1845,18,0,0,18
6/15/22,Marshall Islands,7.1315,171.1845,18,0,0,18
6/16/22,Marshall Islands,7.1315,171.1845,18,0,0,18
6/17/22,Marshall Islands,7.1315,171.1845,18,0,0,18
6/18/22,Marshall Islands,7.1315,171.1845,18,0,0,18
6/19/22,Marshall Islands,7.1315,171.1845,18,0,0,18
6/20/22,Marshall Islands,7.1315,171.1845,18,0,0,18
6/21/22,Marshall Islands,7.1315,171.1845,18,0,0,18
6/22/22,Marshall Islands,7.1315,171.1845,18,0,0,18
6/23/22,Marshall Islands,7.1315,171.1845,18,0,0,18
6/24/22,Marshall Islands,7.1315,171.1845,18,0,0,18
6/25/22,Marshall Islands,7.1315,171.1845,18,0,0,18
6/26/22,Marshall Islands,7.1315,171.1845,18,0,0,18
6/27/22,Marshall Islands,7.1315,171.1845,18,0,0,18
6/28/22,Marshall Islands,7.1315,171.1845,18,0,0,18
6/29/22,Marshall Islands,7.1315,171.1845,18,0,0,18
6/30/22,Marshall Islands,7.1315,171.1845,18,0,0,18
7/1/22,Marshall Islands,7.1315,171.1845,18,0,0,18
7/2/22,Marshall Islands,7.1315,171.1845,26,0,0,26
7/3/22,Marshall Islands,7.1315,171.1845,26,0,0,26
7/4/22,Marshall Islands,7.1315,171.1845,32,0,0,32
7/5/22,Marshall Islands,7.1315,171.1845,32,0,0,32
7/6/22,Marshall Islands,7.1315,171.1845,32,0,0,32
7/7/22,Marshall Islands,7.1315,171.1845,45,0,0,45
7/8/22,Marshall Islands,7.1315,171.1845,45,0,0,45
7/9/22,Marshall Islands,7.1315,171.1845,47,0,0,47
7/10/22,Marshall Islands,7.1315,171.1845,47,0,0,47
7/11/22,Marshall Islands,7.1315,171.1845,47,0,0,47
7/12/22,Marshall Islands,7.1315,171.1845,47,0,0,47
7/13/22,Marshall Islands,7.1315,171.1845,47,0,0,47
7/14/22,Marshall Islands,7.1315,171.1845,49,0,0,49
7/15/22,Marshall Islands,7.1315,171.1845,49,0,0,49
7/16/22,Marshall Islands,7.1315,171.1845,49,0,0,49
7/17/22,Marshall Islands,7.1315,171.1845,49,0,0,49
7/18/22,Marshall Islands,7.1315,171.1845,49,0,0,49
7/19/22,Marshall Islands,7.1315,171.1845,49,0,0,49
7/20/22,Marshall Islands,7.1315,171.1845,58,0,0,58
7/21/22,Marshall Islands,7.1315,171.1845,59,0,0,59
7/22/22,Marshall Islands,7.1315,171.1845,59,0,0,59
7/23/22,Marshall Islands,7.1315,171.1845,59,0,0,59
7/24/22,Marshall Islands,7.1315,171.1845,59,0,0,59
7/25/22,Marshall Islands,7.1315,171.1845,59,0,0,59
7/26/22,Marshall Islands,7.1315,171.1845,59,0,0,59
7/27/22,Marshall Islands,7.1315,171.1845,59,0,0,59
7/28/22,Marshall Islands,7.1315,171.1845,59,0,0,59
7/29/22,Marshall Islands,7.1315,171.1845,59,0,0,59
7/30/22,Marshall Islands,7.1315,171.1845,64,0,0,64
7/31/22,Marshall Islands,7.1315,171.1845,64,0,0,64
8/1/22,Marshall Islands,7.1315,171.1845,66,0,0,66
8/2/22,Marshall Islands,7.1315,171.1845,66,0,0,66
8/3/22,Marshall Islands,7.1315,171.1845,66,0,0,66
8/4/22,Marshall Islands,7.1315,171.1845,68,0,0,68
8/5/22,Marshall Islands,7.1315,171.1845,68,0,0,68
8/6/22,Marshall Islands,7.1315,171.1845,68,0,0,68
8/7/22,Marshall Islands,7.1315,171.1845,70,0,0,70
8/8/22,Marshall Islands,7.1315,171.1845,70,0,0,70
8/9/22,Marshall Islands,7.1315,171.1845,125,0,1,124
8/10/22,Marshall Islands,7.1315,171.1845,189,0,1,188
8/11/22,Marshall Islands,7.1315,171.1845,189,0,1,188
8/12/22,Marshall Islands,7.1315,171.1845,681,0,2,679
8/13/22,Marshall Islands,7.1315,171.1845,681,0,2,679
8/14/22,Marshall Islands,7.1315,171.1845,1250,0,2,1248
8/15/22,Marshall Islands,7.1315,171.1845,3036,0,2,3034
8/16/22,Marshall Islands,7.1315,171.1845,5468,0,6,5462
8/17/22,Marshall Islands,7.1315,171.1845,6606,0,9,6597
8/18/22,Marshall Islands,7.1315,171.1845,8197,0,11,8186
8/19/22,Marshall Islands,7.1315,171.1845,9077,0,13,9064
8/20/22,Marshall Islands,7.1315,171.1845,9912,0,14,9898
8/21/22,Marshall Islands,7.1315,171.1845,9912,0,14,9898
8/22/22,Marshall Islands,7.1315,171.1845,10802,0,14,10788
8/23/22,Marshall Islands,7.1315,171.1845,10802,0,14,10788
8/24/22,Marshall Islands,7.1315,171.1845,13932,0,14,13918
8/25/22,Marshall Islands,7.1315,171.1845,14250,0,15,14235
8/26/22,Marshall Islands,7.1315,171.1845,14506,0,16,14490
8/27/22,Marshall Islands,7.1315,171.1845,14506,0,16,14490
8/28/22,Marshall Islands,7.1315,171.1845,14506,0,16,14490
8/29/22,Marshall Islands,7.1315,171.1845,14907,0,16,14891
8/30/22,Marshall Islands,7.1315,171.1845,15007,0,17,14990
8/31/22,Marshall Islands,7.1315,171.1845,15042,0,17,15025
9/1/22,Marshall Islands,7.1315,171.1845,15058,0,17,15041
9/2/22,Marshall Islands,7.1315,171.1845,15063,0,17,15046
9/3/22,Marshall Islands,7.1315,171.1845,15063,0,17,15046
9/4/22,Marshall Islands,7.1315,171.1845,15063,0,17,15046
9/5/22,Marshall Islands,7.1315,171.1845,15063,0,17,15046
9/6/22,Marshall Islands,7.1315,171.1845,15070,0,17,15053
9/7/22,Marshall Islands,7.1315,171.1845,15071,0,17,15054
9/8/22,Marshall Islands,7.1315,171.1845,15071,0,17,15054
9/9/22,Marshall Islands,7.1315,171.1845,15072,0,17,15055
9/10/22,Marshall Islands,7.1315,171.1845,15072,0,17,15055
9/11/22,Marshall Islands,7.1315,171.1845,15072,0,17,15055
9/12/22,Marshall Islands,7.1315,171.1845,15177,0,17,15160
9/13/22,Marshall Islands,7.1315,171.1845,15177,0,17,15160
9/14/22,Marshall Islands,7.1315,171.1845,15180,0,17,15163
9/15/22,Marshall Islands,7.1315,171.1845,15213,0,17,15196
9/16/22,Marshall Islands,7.1315,171.1845,15213,0,17,15196
9/17/22,Marshall Islands,7.1315,171.1845,15213,0,17,15196
9/18/22,Marshall Islands,7.1315,171.1845,15213,0,17,15196
9/19/22,Marshall Islands,7.1315,171.1845,15213,0,17,15196
9/20/22,Marshall Islands,7.1315,171.1845,15224,0,17,15207
9/21/22,Marshall Islands,7.1315,171.1845,15224,0,17,15207
9/22/22,Marshall Islands,7.1315,171.1845,15224,0,17,15207
9/23/22,Marshall Islands,7.1315,171.1845,15224,0,17,15207
9/24/22,Marshall Islands,7.1315,171.1845,15224,0,17,15207
9/25/22,Marshall Islands,7.1315,171.1845,15224,0,17,15207
9/26/22,Marshall Islands,7.1315,171.1845,15275,0,17,15258
9/27/22,Marshall Islands,7.1315,171.1845,15275,0,17,15258
9/28/22,Marshall Islands,7.1315,171.1845,15275,0,17,15258
9/29/22,Marshall Islands,7.1315,171.1845,15305,0,17,15288
9/30/22,Marshall Islands,7.1315,171.1845,15305,0,17,15288
10/1/22,Marshall Islands,7.1315,171.1845,15305,0,17,15288
10/2/22,Marshall Islands,7.1315,171.1845,15305,0,17,15288
10/3/22,Marshall Islands,7.1315,171.1845,15305,0,17,15288
10/4/22,Marshall Islands,7.1315,171.1845,15305,0,17,15288
10/5/22,Marshall Islands,7.1315,171.1845,15305,0,17,15288
10/6/22,Marshall Islands,7.1315,171.1845,15305,0,17,15288
10/7/22,Marshall Islands,7.1315,171.1845,15305,0,17,15288
10/8/22,Marshall Islands,7.1315,171.1845,15305,0,17,15288
10/9/22,Marshall Islands,7.1315,171.1845,15305,0,17,15288
10/10/22,Marshall Islands,7.1315,171.1845,15305,0,17,15288
10/11/22,Marshall Islands,7.1315,171.1845,15375,0,17,15358
10/12/22,Marshall Islands,7.1315,171.1845,15375,0,17,15358
10/13/22,Marshall Islands,7.1315,171.1845,15375,0,17,15358
10/14/22,Marshall Islands,7.1315,171.1845,15375,0,17,15358
10/15/22,Marshall Islands,7.1315,171.1845,15375,0,17,15358
10/16/22,Marshall Islands,7.1315,171.1845,15375,0,17,15358
10/17/22,Marshall Islands,7.1315,171.1845,15375,0,17,15358
10/18/22,Marshall Islands,7.1315,171.1845,15389,0,17,15372
10/19/22,Marshall Islands,7.1315,171.1845,15389,0,17,15372
10/20/22,Marshall Islands,7.1315,171.1845,15389,0,17,15372
10/21/22,Marshall Islands,7.1315,171.1845,15389,0,17,15372
10/22/22,Marshall Islands,7.1315,171.1845,15389,0,17,15372
10/23/22,Marshall Islands,7.1315,171.1845,15389,0,17,15372
10/24/22,Marshall Islands,7.1315,171.1845,15389,0,17,15372
10/25/22,Marshall Islands,7.1315,171.1845,15389,0,17,15372
10/26/22,Marshall Islands,7.1315,171.1845,15389,0,17,15372
10/27/22,Marshall Islands,7.1315,171.1845,15389,0,17,15372
10/28/22,Marshall Islands,7.1315,171.1845,15389,0,17,15372
10/29/22,Marshall Islands,7.1315,171.1845,15389,0,17,15372
10/30/22,Marshall Islands,7.1315,171.1845,15389,0,17,15372
10/31/22,Marshall Islands,7.1315,171.1845,15389,0,17,15372
11/1/22,Marshall Islands,7.1315,171.1845,15389,0,17,15372
11/2/22,Marshall Islands,7.1315,171.1845,15389,0,17,15372
11/3/22,Marshall Islands,7.1315,171.1845,15389,0,17,15372
11/4/22,Marshall Islands,7.1315,171.1845,15389,0,17,15372
11/5/22,Marshall Islands,7.1315,171.1845,15389,0,17,15372
11/6/22,Marshall Islands,7.1315,171.1845,15389,0,17,15372
11/7/22,Marshall Islands,7.1315,171.1845,15389,0,17,15372
11/8/22,Marshall Islands,7.1315,171.1845,15389,0,17,15372
11/9/22,Marshall Islands,7.1315,171.1845,15389,0,17,15372
11/10/22,Marshall Islands,7.1315,171.1845,15389,0,17,15372
11/11/22,Marshall Islands,7.1315,171.1845,15389,0,17,15372
11/12/22,Marshall Islands,7.1315,171.1845,15389,0,17,15372
11/13/22,Marshall Islands,7.1315,171.1845,15389,0,17,15372
11/14/22,Marshall Islands,7.1315,171.1845,15389,0,17,15372
11/15/22,Marshall Islands,7.1315,171.1845,15389,0,17,15372
11/16/22,Marshall Islands,7.1315,171.1845,15389,0,17,15372
11/17/22,Marshall Islands,7.1315,171.1845,15389,0,17,15372
11/18/22,Marshall Islands,7.1315,171.1845,15389,0,17,15372
11/19/22,Marshall Islands,7.1315,171.1845,15501,0,17,15484
11/20/22,Marshall Islands,7.1315,171.1845,15501,0,17,15484
11/21/22,Marshall Islands,7.1315,171.1845,15501,0,17,15484
11/22/22,Marshall Islands,7.1315,171.1845,15501,0,17,15484
11/23/22,Marshall Islands,7.1315,171.1845,15501,0,17,15484
11/24/22,Marshall Islands,7.1315,171.1845,15501,0,17,15484
11/25/22,Marshall Islands,7.1315,171.1845,15541,0,17,15524
11/26/22,Marshall Islands,7.1315,171.1845,15541,0,17,15524
11/27/22,Marshall Islands,7.1315,171.1845,15541,0,17,15524
11/28/22,Marshall Islands,7.1315,171.1845,15541,0,17,15524
11/29/22,Marshall Islands,7.1315,171.1845,15541,0,17,15524
11/30/22,Marshall Islands,7.1315,171.1845,15541,0,17,15524
12/1/22,Marshall Islands,7.1315,171.1845,15541,0,17,15524
12/2/22,Marshall Islands,7.1315,171.1845,15541,0,17,15524
12/3/22,Marshall Islands,7.1315,171.1845,15541,0,17,15524
12/4/22,Marshall Islands,7.1315,171.1845,15541,0,17,15524
12/5/22,Marshall Islands,7.1315,171.1845,15541,0,17,15524
12/6/22,Marshall Islands,7.1315,171.1845,15541,0,17,15524
12/7/22,Marshall Islands,7.1315,171.1845,15541,0,17,15524
12/8/22,Marshall Islands,7.1315,171.1845,15547,0,17,15530
12/9/22,Marshall Islands,7.1315,171.1845,15547,0,17,15530
12/10/22,Marshall Islands,7.1315,171.1845,15547,0,17,15530
12/11/22,Marshall Islands,7.1315,171.1845,15547,0,17,15530
12/12/22,Marshall Islands,7.1315,171.1845,15547,0,17,15530
12/13/22,Marshall Islands,7.1315,171.1845,15547,0,17,15530
12/14/22,Marshall Islands,7.1315,171.1845,15547,0,17,15530
12/15/22,Marshall Islands,7.1315,171.1845,15547,0,17,15530
12/16/22,Marshall Islands,7.1315,171.1845,15547,0,17,15530
12/17/22,Marshall Islands,7.1315,171.1845,15547,0,17,15530
1/1/22,Mauritania,21.0079,-10.9408,41867,0,870,40997
1/2/22,Mauritania,21.0079,-10.9408,42182,0,872,41310
1/3/22,Mauritania,21.0079,-10.9408,42672,0,872,41800
1/4/22,Mauritania,21.0079,-10.9408,43497,0,874,42623
1/5/22,Mauritania,21.0079,-10.9408,44646,0,876,43770
1/6/22,Mauritania,21.0079,-10.9408,45825,0,880,44945
1/7/22,Mauritania,21.0079,-10.9408,47036,0,881,46155
1/8/22,Mauritania,21.0079,-10.9408,48105,0,885,47220
1/9/22,Mauritania,21.0079,-10.9408,49006,0,886,48120
1/10/22,Mauritania,21.0079,-10.9408,49673,0,888,48785
1/11/22,Mauritania,21.0079,-10.9408,50702,0,891,49811
1/12/22,Mauritania,21.0079,-10.9408,51795,0,893,50902
1/13/22,Mauritania,21.0079,-10.9408,52772,0,895,51877
1/14/22,Mauritania,21.0079,-10.9408,53643,0,900,52743
1/15/22,Mauritania,21.0079,-10.9408,54393,0,903,53490
1/16/22,Mauritania,21.0079,-10.9408,54991,0,908,54083
1/17/22,Mauritania,21.0079,-10.9408,55395,0,909,54486
1/18/22,Mauritania,21.0079,-10.9408,55858,0,911,54947
1/19/22,Mauritania,21.0079,-10.9408,56296,0,914,55382
1/20/22,Mauritania,21.0079,-10.9408,56666,0,916,55750
1/21/22,Mauritania,21.0079,-10.9408,56946,0,920,56026
1/22/22,Mauritania,21.0079,-10.9408,57172,0,924,56248
1/23/22,Mauritania,21.0079,-10.9408,57384,0,927,56457
1/24/22,Mauritania,21.0079,-10.9408,57480,0,932,56548
1/25/22,Mauritania,21.0079,-10.9408,57648,0,934,56714
1/26/22,Mauritania,21.0079,-10.9408,57794,0,937,56857
1/27/22,Mauritania,21.0079,-10.9408,57919,0,940,56979
1/28/22,Mauritania,21.0079,-10.9408,58041,0,945,57096
1/29/22,Mauritania,21.0079,-10.9408,58129,0,949,57180
1/30/22,Mauritania,21.0079,-10.9408,58198,0,953,57245
1/31/22,Mauritania,21.0079,-10.9408,58243,0,953,57290
2/1/22,Mauritania,21.0079,-10.9408,58298,0,956,57342
2/2/22,Mauritania,21.0079,-10.9408,58335,0,959,57376
2/3/22,Mauritania,21.0079,-10.9408,58381,0,962,57419
2/4/22,Mauritania,21.0079,-10.9408,58407,0,962,57445
2/5/22,Mauritania,21.0079,-10.9408,58443,0,964,57479
2/6/22,Mauritania,21.0079,-10.9408,58458,0,967,57491
2/7/22,Mauritania,21.0079,-10.9408,58490,0,969,57521
2/8/22,Mauritania,21.0079,-10.9408,58508,0,969,57539
2/9/22,Mauritania,21.0079,-10.9408,58527,0,971,57556
2/10/22,Mauritania,21.0079,-10.9408,58542,0,971,57571
2/11/22,Mauritania,21.0079,-10.9408,58557,0,971,57586
2/12/22,Mauritania,21.0079,-10.9408,58563,0,972,57591
2/13/22,Mauritania,21.0079,-10.9408,58569,0,972,57597
2/14/22,Mauritania,21.0079,-10.9408,58575,0,973,57602
2/15/22,Mauritania,21.0079,-10.9408,58577,0,973,57604
2/16/22,Mauritania,21.0079,-10.9408,58584,0,973,57611
2/17/22,Mauritania,21.0079,-10.9408,58593,0,975,57618
2/18/22,Mauritania,21.0079,-10.9408,58595,0,976,57619
2/19/22,Mauritania,21.0079,-10.9408,58604,0,976,57628
2/20/22,Mauritania,21.0079,-10.9408,58611,0,976,57635
2/21/22,Mauritania,21.0079,-10.9408,58616,0,977,57639
2/22/22,Mauritania,21.0079,-10.9408,58618,0,977,57641
2/23/22,Mauritania,21.0079,-10.9408,58621,0,977,57644
2/24/22,Mauritania,21.0079,-10.9408,58621,0,977,57644
2/25/22,Mauritania,21.0079,-10.9408,58626,0,978,57648
2/26/22,Mauritania,21.0079,-10.9408,58629,0,979,57650
2/27/22,Mauritania,21.0079,-10.9408,58632,0,979,57653
2/28/22,Mauritania,21.0079,-10.9408,58633,0,979,57654
3/1/22,Mauritania,21.0079,-10.9408,58638,0,979,57659
3/2/22,Mauritania,21.0079,-10.9408,58638,0,979,57659
3/3/22,Mauritania,21.0079,-10.9408,58638,0,979,57659
3/4/22,Mauritania,21.0079,-10.9408,58645,0,980,57665
3/5/22,Mauritania,21.0079,-10.9408,58646,0,980,57666
3/6/22,Mauritania,21.0079,-10.9408,58649,0,980,57669
3/7/22,Mauritania,21.0079,-10.9408,58652,0,980,57672
3/8/22,Mauritania,21.0079,-10.9408,58654,0,980,57674
3/9/22,Mauritania,21.0079,-10.9408,58656,0,981,57675
3/10/22,Mauritania,21.0079,-10.9408,58657,0,981,57676
3/11/22,Mauritania,21.0079,-10.9408,58657,0,981,57676
3/12/22,Mauritania,21.0079,-10.9408,58657,0,981,57676
3/13/22,Mauritania,21.0079,-10.9408,58658,0,981,57677
3/14/22,Mauritania,21.0079,-10.9408,58659,0,981,57678
3/15/22,Mauritania,21.0079,-10.9408,58660,0,981,57679
3/16/22,Mauritania,21.0079,-10.9408,58660,0,981,57679
3/17/22,Mauritania,21.0079,-10.9408,58660,0,981,57679
3/18/22,Mauritania,21.0079,-10.9408,58661,0,981,57680
3/19/22,Mauritania,21.0079,-10.9408,58662,0,981,57681
3/20/22,Mauritania,21.0079,-10.9408,58662,0,981,57681
3/21/22,Mauritania,21.0079,-10.9408,58665,0,981,57684
3/22/22,Mauritania,21.0079,-10.9408,58665,0,981,57684
3/23/22,Mauritania,21.0079,-10.9408,58665,0,981,57684
3/24/22,Mauritania,21.0079,-10.9408,58665,0,981,57684
3/25/22,Mauritania,21.0079,-10.9408,58665,0,981,57684
3/26/22,Mauritania,21.0079,-10.9408,58666,0,982,57684
3/27/22,Mauritania,21.0079,-10.9408,58666,0,982,57684
3/28/22,Mauritania,21.0079,-10.9408,58668,0,982,57686
3/29/22,Mauritania,21.0079,-10.9408,58668,0,982,57686
3/30/22,Mauritania,21.0079,-10.9408,58668,0,982,57686
3/31/22,Mauritania,21.0079,-10.9408,58669,0,982,57687
4/1/22,Mauritania,21.0079,-10.9408,58670,0,982,57688
4/2/22,Mauritania,21.0079,-10.9408,58670,0,982,57688
4/3/22,Mauritania,21.0079,-10.9408,58670,0,982,57688
4/4/22,Mauritania,21.0079,-10.9408,58705,0,982,57723
4/5/22,Mauritania,21.0079,-10.9408,58706,0,982,57724
4/6/22,Mauritania,21.0079,-10.9408,58710,0,982,57728
4/7/22,Mauritania,21.0079,-10.9408,58710,0,982,57728
4/8/22,Mauritania,21.0079,-10.9408,58710,0,982,57728
4/9/22,Mauritania,21.0079,-10.9408,58710,0,982,57728
4/10/22,Mauritania,21.0079,-10.9408,58710,0,982,57728
4/11/22,Mauritania,21.0079,-10.9408,58679,0,982,57697
4/12/22,Mauritania,21.0079,-10.9408,58679,0,982,57697
4/13/22,Mauritania,21.0079,-10.9408,58680,0,982,57698
4/14/22,Mauritania,21.0079,-10.9408,58681,0,982,57699
4/15/22,Mauritania,21.0079,-10.9408,58681,0,982,57699
4/16/22,Mauritania,21.0079,-10.9408,58681,0,982,57699
4/17/22,Mauritania,21.0079,-10.9408,58681,0,982,57699
4/18/22,Mauritania,21.0079,-10.9408,58683,0,982,57701
4/19/22,Mauritania,21.0079,-10.9408,58683,0,982,57701
4/20/22,Mauritania,21.0079,-10.9408,58683,0,982,57701
4/21/22,Mauritania,21.0079,-10.9408,58683,0,982,57701
4/22/22,Mauritania,21.0079,-10.9408,58683,0,982,57701
4/23/22,Mauritania,21.0079,-10.9408,58683,0,982,57701
4/24/22,Mauritania,21.0079,-10.9408,58683,0,982,57701
4/25/22,Mauritania,21.0079,-10.9408,58685,0,982,57703
4/26/22,Mauritania,21.0079,-10.9408,58686,0,982,57704
4/27/22,Mauritania,21.0079,-10.9408,58686,0,982,57704
4/28/22,Mauritania,21.0079,-10.9408,58686,0,982,57704
4/29/22,Mauritania,21.0079,-10.9408,58687,0,982,57705
4/30/22,Mauritania,21.0079,-10.9408,58688,0,982,57706
5/1/22,Mauritania,21.0079,-10.9408,58688,0,982,57706
5/2/22,Mauritania,21.0079,-10.9408,58694,0,982,57712
5/3/22,Mauritania,21.0079,-10.9408,58695,0,982,57713
5/4/22,Mauritania,21.0079,-10.9408,58699,0,982,57717
5/5/22,Mauritania,21.0079,-10.9408,58707,0,982,57725
5/6/22,Mauritania,21.0079,-10.9408,58719,0,982,57737
5/7/22,Mauritania,21.0079,-10.9408,58736,0,982,57754
5/8/22,Mauritania,21.0079,-10.9408,58743,0,982,57761
5/9/22,Mauritania,21.0079,-10.9408,58757,0,982,57775
5/10/22,Mauritania,21.0079,-10.9408,58778,0,982,57796
5/11/22,Mauritania,21.0079,-10.9408,58787,0,982,57805
5/12/22,Mauritania,21.0079,-10.9408,58805,0,982,57823
5/13/22,Mauritania,21.0079,-10.9408,58822,0,982,57840
5/14/22,Mauritania,21.0079,-10.9408,58840,0,982,57858
5/15/22,Mauritania,21.0079,-10.9408,58853,0,982,57871
5/16/22,Mauritania,21.0079,-10.9408,58871,0,982,57889
5/17/22,Mauritania,21.0079,-10.9408,58909,0,982,57927
5/18/22,Mauritania,21.0079,-10.9408,58920,0,982,57938
5/19/22,Mauritania,21.0079,-10.9408,58939,0,982,57957
5/20/22,Mauritania,21.0079,-10.9408,58972,0,982,57990
5/21/22,Mauritania,21.0079,-10.9408,59003,0,982,58021
5/22/22,Mauritania,21.0079,-10.9408,59025,0,982,58043
5/23/22,Mauritania,21.0079,-10.9408,59047,0,982,58065
5/24/22,Mauritania,21.0079,-10.9408,59068,0,982,58086
5/25/22,Mauritania,21.0079,-10.9408,59083,0,982,58101
5/26/22,Mauritania,21.0079,-10.9408,59089,0,982,58107
5/27/22,Mauritania,21.0079,-10.9408,59102,0,982,58120
5/28/22,Mauritania,21.0079,-10.9408,59112,0,982,58130
5/29/22,Mauritania,21.0079,-10.9408,59123,0,982,58141
5/30/22,Mauritania,21.0079,-10.9408,59127,0,982,58145
5/31/22,Mauritania,21.0079,-10.9408,59141,0,982,58159
6/1/22,Mauritania,21.0079,-10.9408,59154,0,982,58172
6/2/22,Mauritania,21.0079,-10.9408,59168,0,982,58186
6/3/22,Mauritania,21.0079,-10.9408,59174,0,982,58192
6/4/22,Mauritania,21.0079,-10.9408,59183,0,982,58201
6/5/22,Mauritania,21.0079,-10.9408,59199,0,982,58217
6/6/22,Mauritania,21.0079,-10.9408,59205,0,982,58223
6/7/22,Mauritania,21.0079,-10.9408,59212,0,982,58230
6/8/22,Mauritania,21.0079,-10.9408,59220,0,982,58238
6/9/22,Mauritania,21.0079,-10.9408,59224,0,982,58242
6/10/22,Mauritania,21.0079,-10.9408,59231,0,982,58249
6/11/22,Mauritania,21.0079,-10.9408,59238,0,982,58256
6/12/22,Mauritania,21.0079,-10.9408,59247,0,982,58265
6/13/22,Mauritania,21.0079,-10.9408,59252,0,982,58270
6/14/22,Mauritania,21.0079,-10.9408,59260,0,982,58278
6/15/22,Mauritania,21.0079,-10.9408,59275,0,982,58293
6/16/22,Mauritania,21.0079,-10.9408,59283,0,982,58301
6/17/22,Mauritania,21.0079,-10.9408,59289,0,982,58307
6/18/22,Mauritania,21.0079,-10.9408,59293,0,982,58311
6/19/22,Mauritania,21.0079,-10.9408,59304,0,982,58322
6/20/22,Mauritania,21.0079,-10.9408,59310,0,982,58328
6/21/22,Mauritania,21.0079,-10.9408,59324,0,982,58342
6/22/22,Mauritania,21.0079,-10.9408,59348,0,982,58366
6/23/22,Mauritania,21.0079,-10.9408,59376,0,982,58394
6/24/22,Mauritania,21.0079,-10.9408,59401,0,982,58419
6/25/22,Mauritania,21.0079,-10.9408,59428,0,982,58446
6/26/22,Mauritania,21.0079,-10.9408,59451,0,982,58469
6/27/22,Mauritania,21.0079,-10.9408,59494,0,982,58512
6/28/22,Mauritania,21.0079,-10.9408,59569,0,982,58587
6/29/22,Mauritania,21.0079,-10.9408,59677,0,982,58695
6/30/22,Mauritania,21.0079,-10.9408,59814,0,983,58831
7/1/22,Mauritania,21.0079,-10.9408,59970,0,983,58987
7/2/22,Mauritania,21.0079,-10.9408,60127,0,984,59143
7/3/22,Mauritania,21.0079,-10.9408,60252,0,984,59268
7/4/22,Mauritania,21.0079,-10.9408,60368,0,984,59384
7/5/22,Mauritania,21.0079,-10.9408,60489,0,984,59505
7/6/22,Mauritania,21.0079,-10.9408,60685,0,984,59701
7/7/22,Mauritania,21.0079,-10.9408,60864,0,986,59878
7/8/22,Mauritania,21.0079,-10.9408,61024,0,986,60038
7/9/22,Mauritania,21.0079,-10.9408,61024,0,986,60038
7/10/22,Mauritania,21.0079,-10.9408,61234,0,986,60248
7/11/22,Mauritania,21.0079,-10.9408,61296,0,986,60310
7/12/22,Mauritania,21.0079,-10.9408,61403,0,986,60417
7/13/22,Mauritania,21.0079,-10.9408,61543,0,986,60557
7/14/22,Mauritania,21.0079,-10.9408,61640,0,986,60654
7/15/22,Mauritania,21.0079,-10.9408,61763,0,986,60777
7/16/22,Mauritania,21.0079,-10.9408,61865,0,986,60879
7/17/22,Mauritania,21.0079,-10.9408,61921,0,986,60935
7/18/22,Mauritania,21.0079,-10.9408,61970,0,989,60981
7/19/22,Mauritania,21.0079,-10.9408,62032,0,989,61043
7/20/22,Mauritania,21.0079,-10.9408,62108,0,989,61119
7/21/22,Mauritania,21.0079,-10.9408,62185,0,989,61196
7/22/22,Mauritania,21.0079,-10.9408,62233,0,989,61244
7/23/22,Mauritania,21.0079,-10.9408,62280,0,989,61291
7/24/22,Mauritania,21.0079,-10.9408,62313,0,990,61323
7/25/22,Mauritania,21.0079,-10.9408,62350,0,990,61360
7/26/22,Mauritania,21.0079,-10.9408,62402,0,990,61412
7/27/22,Mauritania,21.0079,-10.9408,62457,0,991,61466
7/28/22,Mauritania,21.0079,-10.9408,62501,0,991,61510
7/29/22,Mauritania,21.0079,-10.9408,62540,0,991,61549
7/30/22,Mauritania,21.0079,-10.9408,62556,0,991,61565
7/31/22,Mauritania,21.0079,-10.9408,62572,0,992,61580
8/1/22,Mauritania,21.0079,-10.9408,62579,0,992,61587
8/2/22,Mauritania,21.0079,-10.9408,62592,0,992,61600
8/3/22,Mauritania,21.0079,-10.9408,62615,0,992,61623
8/4/22,Mauritania,21.0079,-10.9408,62631,0,992,61639
8/5/22,Mauritania,21.0079,-10.9408,62645,0,992,61653
8/6/22,Mauritania,21.0079,-10.9408,62652,0,992,61660
8/7/22,Mauritania,21.0079,-10.9408,62657,0,992,61665
8/8/22,Mauritania,21.0079,-10.9408,62666,0,992,61674
8/9/22,Mauritania,21.0079,-10.9408,62675,0,992,61683
8/10/22,Mauritania,21.0079,-10.9408,62683,0,992,61691
8/11/22,Mauritania,21.0079,-10.9408,62696,0,992,61704
8/12/22,Mauritania,21.0079,-10.9408,62701,0,992,61709
8/13/22,Mauritania,21.0079,-10.9408,62705,0,992,61713
8/14/22,Mauritania,21.0079,-10.9408,62708,0,992,61716
8/15/22,Mauritania,21.0079,-10.9408,62717,0,992,61725
8/16/22,Mauritania,21.0079,-10.9408,62721,0,992,61729
8/17/22,Mauritania,21.0079,-10.9408,62724,0,992,61732
8/18/22,Mauritania,21.0079,-10.9408,62726,0,992,61734
8/19/22,Mauritania,21.0079,-10.9408,62726,0,992,61734
8/20/22,Mauritania,21.0079,-10.9408,62729,0,992,61737
8/21/22,Mauritania,21.0079,-10.9408,62739,0,992,61747
8/22/22,Mauritania,21.0079,-10.9408,62741,0,992,61749
8/23/22,Mauritania,21.0079,-10.9408,62742,0,992,61750
8/24/22,Mauritania,21.0079,-10.9408,62744,0,992,61752
8/25/22,Mauritania,21.0079,-10.9408,62756,0,992,61764
8/26/22,Mauritania,21.0079,-10.9408,62756,0,992,61764
8/27/22,Mauritania,21.0079,-10.9408,62759,0,992,61767
8/28/22,Mauritania,21.0079,-10.9408,62761,0,992,61769
8/29/22,Mauritania,21.0079,-10.9408,62761,0,992,61769
8/30/22,Mauritania,21.0079,-10.9408,62762,0,992,61770
8/31/22,Mauritania,21.0079,-10.9408,62765,0,993,61772
9/1/22,Mauritania,21.0079,-10.9408,62768,0,993,61775
9/2/22,Mauritania,21.0079,-10.9408,62769,0,993,61776
9/3/22,Mauritania,21.0079,-10.9408,62770,0,993,61777
9/4/22,Mauritania,21.0079,-10.9408,62771,0,993,61778
9/5/22,Mauritania,21.0079,-10.9408,62771,0,993,61778
9/6/22,Mauritania,21.0079,-10.9408,62772,0,993,61779
9/7/22,Mauritania,21.0079,-10.9408,62772,0,993,61779
9/8/22,Mauritania,21.0079,-10.9408,62773,0,993,61780
9/9/22,Mauritania,21.0079,-10.9408,62775,0,993,61782
9/10/22,Mauritania,21.0079,-10.9408,62776,0,993,61783
9/11/22,Mauritania,21.0079,-10.9408,62776,0,993,61783
9/12/22,Mauritania,21.0079,-10.9408,62777,0,993,61784
9/13/22,Mauritania,21.0079,-10.9408,62778,0,993,61785
9/14/22,Mauritania,21.0079,-10.9408,62778,0,993,61785
9/15/22,Mauritania,21.0079,-10.9408,62779,0,994,61785
9/16/22,Mauritania,21.0079,-10.9408,62780,0,994,61786
9/17/22,Mauritania,21.0079,-10.9408,62782,0,994,61788
9/18/22,Mauritania,21.0079,-10.9408,62784,0,994,61790
9/19/22,Mauritania,21.0079,-10.9408,62784,0,994,61790
9/20/22,Mauritania,21.0079,-10.9408,62784,0,994,61790
9/21/22,Mauritania,21.0079,-10.9408,62787,0,994,61793
9/22/22,Mauritania,21.0079,-10.9408,62787,0,994,61793
9/23/22,Mauritania,21.0079,-10.9408,62789,0,994,61795
9/24/22,Mauritania,21.0079,-10.9408,62791,0,994,61797
9/25/22,Mauritania,21.0079,-10.9408,62791,0,994,61797
9/26/22,Mauritania,21.0079,-10.9408,62794,0,994,61800
9/27/22,Mauritania,21.0079,-10.9408,62797,0,994,61803
9/28/22,Mauritania,21.0079,-10.9408,62802,0,994,61808
9/29/22,Mauritania,21.0079,-10.9408,62812,0,995,61817
9/30/22,Mauritania,21.0079,-10.9408,62815,0,995,61820
10/1/22,Mauritania,21.0079,-10.9408,62823,0,995,61828
10/2/22,Mauritania,21.0079,-10.9408,62826,0,995,61831
10/3/22,Mauritania,21.0079,-10.9408,62829,0,995,61834
10/4/22,Mauritania,21.0079,-10.9408,62840,0,995,61845
10/5/22,Mauritania,21.0079,-10.9408,62847,0,995,61852
10/6/22,Mauritania,21.0079,-10.9408,62869,0,995,61874
10/7/22,Mauritania,21.0079,-10.9408,62894,0,995,61899
10/8/22,Mauritania,21.0079,-10.9408,62908,0,995,61913
10/9/22,Mauritania,21.0079,-10.9408,62920,0,995,61925
10/10/22,Mauritania,21.0079,-10.9408,62920,0,995,61925
10/11/22,Mauritania,21.0079,-10.9408,62960,0,995,61965
10/12/22,Mauritania,21.0079,-10.9408,62984,0,995,61989
10/13/22,Mauritania,21.0079,-10.9408,63041,0,995,62046
10/14/22,Mauritania,21.0079,-10.9408,63045,0,995,62050
10/15/22,Mauritania,21.0079,-10.9408,63084,0,995,62089
10/16/22,Mauritania,21.0079,-10.9408,63110,0,995,62115
10/17/22,Mauritania,21.0079,-10.9408,63110,0,995,62115
10/18/22,Mauritania,21.0079,-10.9408,63163,0,995,62168
10/19/22,Mauritania,21.0079,-10.9408,63194,0,995,62199
10/20/22,Mauritania,21.0079,-10.9408,63223,0,997,62226
10/21/22,Mauritania,21.0079,-10.9408,63250,0,997,62253
10/22/22,Mauritania,21.0079,-10.9408,63250,0,997,62253
10/23/22,Mauritania,21.0079,-10.9408,63280,0,997,62283
10/24/22,Mauritania,21.0079,-10.9408,63293,0,997,62296
10/25/22,Mauritania,21.0079,-10.9408,63304,0,997,62307
10/26/22,Mauritania,21.0079,-10.9408,63321,0,997,62324
10/27/22,Mauritania,21.0079,-10.9408,63333,0,997,62336
10/28/22,Mauritania,21.0079,-10.9408,63333,0,997,62336
10/29/22,Mauritania,21.0079,-10.9408,63349,0,997,62352
10/30/22,Mauritania,21.0079,-10.9408,63355,0,997,62358
10/31/22,Mauritania,21.0079,-10.9408,63364,0,997,62367
11/1/22,Mauritania,21.0079,-10.9408,63374,0,997,62377
11/2/22,Mauritania,21.0079,-10.9408,63380,0,997,62383
11/3/22,Mauritania,21.0079,-10.9408,63385,0,997,62388
11/4/22,Mauritania,21.0079,-10.9408,63388,0,997,62391
11/5/22,Mauritania,21.0079,-10.9408,63392,0,997,62395
11/6/22,Mauritania,21.0079,-10.9408,63399,0,997,62402
11/7/22,Mauritania,21.0079,-10.9408,63400,0,997,62403
11/8/22,Mauritania,21.0079,-10.9408,63403,0,997,62406
11/9/22,Mauritania,21.0079,-10.9408,63407,0,997,62410
11/10/22,Mauritania,21.0079,-10.9408,63407,0,997,62410
11/11/22,Mauritania,21.0079,-10.9408,63410,0,997,62413
11/12/22,Mauritania,21.0079,-10.9408,63412,0,997,62415
11/13/22,Mauritania,21.0079,-10.9408,63412,0,997,62415
11/14/22,Mauritania,21.0079,-10.9408,63414,0,997,62417
11/15/22,Mauritania,21.0079,-10.9408,63414,0,997,62417
11/16/22,Mauritania,21.0079,-10.9408,63414,0,997,62417
11/17/22,Mauritania,21.0079,-10.9408,63414,0,997,62417
11/18/22,Mauritania,21.0079,-10.9408,63417,0,997,62420
11/19/22,Mauritania,21.0079,-10.9408,63418,0,997,62421
11/20/22,Mauritania,21.0079,-10.9408,63419,0,997,62422
11/21/22,Mauritania,21.0079,-10.9408,63419,0,997,62422
11/22/22,Mauritania,21.0079,-10.9408,63419,0,997,62422
11/23/22,Mauritania,21.0079,-10.9408,63419,0,997,62422
11/24/22,Mauritania,21.0079,-10.9408,63419,0,997,62422
11/25/22,Mauritania,21.0079,-10.9408,63419,0,997,62422
11/26/22,Mauritania,21.0079,-10.9408,63419,0,997,62422
11/27/22,Mauritania,21.0079,-10.9408,63419,0,997,62422
11/28/22,Mauritania,21.0079,-10.9408,63420,0,997,62423
11/29/22,Mauritania,21.0079,-10.9408,63420,0,997,62423
11/30/22,Mauritania,21.0079,-10.9408,63420,0,997,62423
12/1/22,Mauritania,21.0079,-10.9408,63420,0,997,62423
12/2/22,Mauritania,21.0079,-10.9408,63420,0,997,62423
12/3/22,Mauritania,21.0079,-10.9408,63421,0,997,62424
12/4/22,Mauritania,21.0079,-10.9408,63421,0,997,62424
12/5/22,Mauritania,21.0079,-10.9408,63421,0,997,62424
12/6/22,Mauritania,21.0079,-10.9408,63421,0,997,62424
12/7/22,Mauritania,21.0079,-10.9408,63421,0,997,62424
12/8/22,Mauritania,21.0079,-10.9408,63421,0,997,62424
12/9/22,Mauritania,21.0079,-10.9408,63421,0,997,62424
12/10/22,Mauritania,21.0079,-10.9408,63421,0,997,62424
12/11/22,Mauritania,21.0079,-10.9408,63422,0,997,62425
12/12/22,Mauritania,21.0079,-10.9408,63422,0,997,62425
12/13/22,Mauritania,21.0079,-10.9408,63425,0,997,62428
12/14/22,Mauritania,21.0079,-10.9408,63425,0,997,62428
12/15/22,Mauritania,21.0079,-10.9408,63425,0,997,62428
12/16/22,Mauritania,21.0079,-10.9408,63425,0,997,62428
12/17/22,Mauritania,21.0079,-10.9408,63425,0,997,62428
1/1/22,Mauritius,-20.348404,57.552152,68552,0,786,67766
1/2/22,Mauritius,-20.348404,57.552152,68612,0,786,67826
1/3/22,Mauritius,-20.348404,57.552152,68661,0,786,67875
1/4/22,Mauritius,-20.348404,57.552152,68661,0,786,67875
1/5/22,Mauritius,-20.348404,57.552152,68763,0,786,67977
1/6/22,Mauritius,-20.348404,57.552152,68864,0,786,68078
1/7/22,Mauritius,-20.348404,57.552152,68945,0,786,68159
1/8/22,Mauritius,-20.348404,57.552152,69021,0,786,68235
1/9/22,Mauritius,-20.348404,57.552152,69110,0,786,68324
1/10/22,Mauritius,-20.348404,57.552152,69110,0,786,68324
1/11/22,Mauritius,-20.348404,57.552152,69323,0,786,68537
1/12/22,Mauritius,-20.348404,57.552152,69423,0,786,68637
1/13/22,Mauritius,-20.348404,57.552152,69484,0,786,68698
1/14/22,Mauritius,-20.348404,57.552152,69557,0,786,68771
1/15/22,Mauritius,-20.348404,57.552152,69666,0,786,68880
1/16/22,Mauritius,-20.348404,57.552152,69668,0,786,68882
1/17/22,Mauritius,-20.348404,57.552152,69909,0,786,69123
1/18/22,Mauritius,-20.348404,57.552152,69962,0,786,69176
1/19/22,Mauritius,-20.348404,57.552152,69962,0,786,69176
1/20/22,Mauritius,-20.348404,57.552152,70094,0,786,69308
1/21/22,Mauritius,-20.348404,57.552152,70134,0,786,69348
1/22/22,Mauritius,-20.348404,57.552152,70218,0,786,69432
1/23/22,Mauritius,-20.348404,57.552152,70218,0,786,69432
1/24/22,Mauritius,-20.348404,57.552152,70218,0,786,69432
1/25/22,Mauritius,-20.348404,57.552152,100224,0,822,99402
1/26/22,Mauritius,-20.348404,57.552152,100961,0,822,100139
1/27/22,Mauritius,-20.348404,57.552152,101820,0,822,100998
1/28/22,Mauritius,-20.348404,57.552152,102773,0,822,101951
1/29/22,Mauritius,-20.348404,57.552152,103762,0,822,102940
1/30/22,Mauritius,-20.348404,57.552152,104802,0,822,103980
1/31/22,Mauritius,-20.348404,57.552152,105935,0,822,105113
2/1/22,Mauritius,-20.348404,57.552152,107293,0,822,106471
2/2/22,Mauritius,-20.348404,57.552152,108486,0,822,107664
2/3/22,Mauritius,-20.348404,57.552152,109142,0,822,108320
2/4/22,Mauritius,-20.348404,57.552152,110967,0,822,110145
2/5/22,Mauritius,-20.348404,57.552152,112844,0,822,112022
2/6/22,Mauritius,-20.348404,57.552152,114570,0,822,113748
2/7/22,Mauritius,-20.348404,57.552152,116315,0,841,115474
2/8/22,Mauritius,-20.348404,57.552152,118535,0,841,117694
2/9/22,Mauritius,-20.348404,57.552152,120696,0,841,119855
2/10/22,Mauritius,-20.348404,57.552152,122745,0,841,121904
2/11/22,Mauritius,-20.348404,57.552152,124962,0,841,124121
2/12/22,Mauritius,-20.348404,57.552152,127165,0,841,126324
2/13/22,Mauritius,-20.348404,57.552152,129445,0,841,128604
2/14/22,Mauritius,-20.348404,57.552152,131843,0,841,131002
2/15/22,Mauritius,-20.348404,57.552152,134870,0,841,134029
2/16/22,Mauritius,-20.348404,57.552152,138373,0,878,137495
2/17/22,Mauritius,-20.348404,57.552152,141434,0,878,140556
2/18/22,Mauritius,-20.348404,57.552152,144488,0,878,143610
2/19/22,Mauritius,-20.348404,57.552152,147373,0,878,146495
2/20/22,Mauritius,-20.348404,57.552152,149132,0,878,148254
2/21/22,Mauritius,-20.348404,57.552152,150175,0,878,149297
2/22/22,Mauritius,-20.348404,57.552152,153526,0,895,152631
2/23/22,Mauritius,-20.348404,57.552152,156462,0,895,155567
2/24/22,Mauritius,-20.348404,57.552152,159324,0,895,158429
2/25/22,Mauritius,-20.348404,57.552152,161746,0,895,160851
2/26/22,Mauritius,-20.348404,57.552152,163901,0,895,163006
2/27/22,Mauritius,-20.348404,57.552152,165663,0,895,164768
2/28/22,Mauritius,-20.348404,57.552152,167644,0,904,166740
3/1/22,Mauritius,-20.348404,57.552152,169796,0,904,168892
3/2/22,Mauritius,-20.348404,57.552152,169796,0,904,168892
3/3/22,Mauritius,-20.348404,57.552152,169796,0,904,168892
3/4/22,Mauritius,-20.348404,57.552152,169796,0,904,168892
3/5/22,Mauritius,-20.348404,57.552152,169796,0,904,168892
3/6/22,Mauritius,-20.348404,57.552152,169796,0,904,168892
3/7/22,Mauritius,-20.348404,57.552152,169796,0,904,168892
3/8/22,Mauritius,-20.348404,57.552152,169796,0,904,168892
3/9/22,Mauritius,-20.348404,57.552152,169796,0,904,168892
3/10/22,Mauritius,-20.348404,57.552152,181362,0,934,180428
3/11/22,Mauritius,-20.348404,57.552152,181362,0,934,180428
3/12/22,Mauritius,-20.348404,57.552152,181362,0,934,180428
3/13/22,Mauritius,-20.348404,57.552152,181362,0,934,180428
3/14/22,Mauritius,-20.348404,57.552152,181362,0,934,180428
3/15/22,Mauritius,-20.348404,57.552152,181362,0,934,180428
3/16/22,Mauritius,-20.348404,57.552152,181362,0,934,180428
3/17/22,Mauritius,-20.348404,57.552152,181362,0,934,180428
3/18/22,Mauritius,-20.348404,57.552152,192558,0,934,191624
3/19/22,Mauritius,-20.348404,57.552152,192558,0,934,191624
3/20/22,Mauritius,-20.348404,57.552152,192558,0,934,191624
3/21/22,Mauritius,-20.348404,57.552152,192558,0,934,191624
3/22/22,Mauritius,-20.348404,57.552152,192558,0,934,191624
3/23/22,Mauritius,-20.348404,57.552152,192558,0,934,191624
3/24/22,Mauritius,-20.348404,57.552152,204200,0,968,203232
3/25/22,Mauritius,-20.348404,57.552152,204200,0,968,203232
3/26/22,Mauritius,-20.348404,57.552152,204200,0,968,203232
3/27/22,Mauritius,-20.348404,57.552152,204200,0,968,203232
3/28/22,Mauritius,-20.348404,57.552152,204200,0,968,203232
3/29/22,Mauritius,-20.348404,57.552152,204200,0,968,203232
3/30/22,Mauritius,-20.348404,57.552152,210343,0,968,209375
3/31/22,Mauritius,-20.348404,57.552152,210343,0,968,209375
4/1/22,Mauritius,-20.348404,57.552152,210343,0,968,209375
4/2/22,Mauritius,-20.348404,57.552152,210343,0,968,209375
4/3/22,Mauritius,-20.348404,57.552152,210343,0,968,209375
4/4/22,Mauritius,-20.348404,57.552152,210343,0,968,209375
4/5/22,Mauritius,-20.348404,57.552152,214860,0,985,213875
4/6/22,Mauritius,-20.348404,57.552152,214860,0,985,213875
4/7/22,Mauritius,-20.348404,57.552152,214860,0,985,213875
4/8/22,Mauritius,-20.348404,57.552152,214860,0,985,213875
4/9/22,Mauritius,-20.348404,57.552152,214860,0,985,213875
4/10/22,Mauritius,-20.348404,57.552152,214860,0,985,213875
4/11/22,Mauritius,-20.348404,57.552152,214860,0,985,213875
4/12/22,Mauritius,-20.348404,57.552152,214860,0,985,213875
4/13/22,Mauritius,-20.348404,57.552152,214860,0,985,213875
4/14/22,Mauritius,-20.348404,57.552152,218229,0,990,217239
4/15/22,Mauritius,-20.348404,57.552152,218229,0,990,217239
4/16/22,Mauritius,-20.348404,57.552152,218229,0,990,217239
4/17/22,Mauritius,-20.348404,57.552152,218229,0,990,217239
4/18/22,Mauritius,-20.348404,57.552152,218229,0,990,217239
4/19/22,Mauritius,-20.348404,57.552152,218229,0,990,217239
4/20/22,Mauritius,-20.348404,57.552152,220344,0,990,219354
4/21/22,Mauritius,-20.348404,57.552152,220344,0,990,219354
4/22/22,Mauritius,-20.348404,57.552152,220344,0,990,219354
4/23/22,Mauritius,-20.348404,57.552152,220344,0,990,219354
4/24/22,Mauritius,-20.348404,57.552152,220344,0,990,219354
4/25/22,Mauritius,-20.348404,57.552152,220344,0,990,219354
4/26/22,Mauritius,-20.348404,57.552152,220344,0,990,219354
4/27/22,Mauritius,-20.348404,57.552152,220344,0,990,219354
4/28/22,Mauritius,-20.348404,57.552152,220344,0,990,219354
4/29/22,Mauritius,-20.348404,57.552152,220344,0,990,219354
4/30/22,Mauritius,-20.348404,57.552152,220344,0,990,219354
5/1/22,Mauritius,-20.348404,57.552152,220344,0,990,219354
5/2/22,Mauritius,-20.348404,57.552152,221749,0,992,220757
5/3/22,Mauritius,-20.348404,57.552152,221749,0,992,220757
5/4/22,Mauritius,-20.348404,57.552152,222848,0,996,221852
5/5/22,Mauritius,-20.348404,57.552152,222848,0,996,221852
5/6/22,Mauritius,-20.348404,57.552152,222848,0,996,221852
5/7/22,Mauritius,-20.348404,57.552152,222848,0,996,221852
5/8/22,Mauritius,-20.348404,57.552152,222848,0,996,221852
5/9/22,Mauritius,-20.348404,57.552152,222848,0,996,221852
5/10/22,Mauritius,-20.348404,57.552152,222848,0,996,221852
5/11/22,Mauritius,-20.348404,57.552152,222848,0,996,221852
5/12/22,Mauritius,-20.348404,57.552152,223793,0,996,222797
5/13/22,Mauritius,-20.348404,57.552152,223793,0,996,222797
5/14/22,Mauritius,-20.348404,57.552152,223793,0,996,222797
5/15/22,Mauritius,-20.348404,57.552152,223793,0,996,222797
5/16/22,Mauritius,-20.348404,57.552152,223793,0,996,222797
5/17/22,Mauritius,-20.348404,57.552152,223793,0,996,222797
5/18/22,Mauritius,-20.348404,57.552152,223793,0,996,222797
5/19/22,Mauritius,-20.348404,57.552152,224722,0,996,223726
5/20/22,Mauritius,-20.348404,57.552152,224722,0,996,223726
5/21/22,Mauritius,-20.348404,57.552152,224722,0,996,223726
5/22/22,Mauritius,-20.348404,57.552152,224722,0,996,223726
5/23/22,Mauritius,-20.348404,57.552152,224722,0,996,223726
5/24/22,Mauritius,-20.348404,57.552152,224722,0,996,223726
5/25/22,Mauritius,-20.348404,57.552152,224722,0,996,223726
5/26/22,Mauritius,-20.348404,57.552152,225862,0,996,224866
5/27/22,Mauritius,-20.348404,57.552152,225862,0,996,224866
5/28/22,Mauritius,-20.348404,57.552152,225862,0,996,224866
5/29/22,Mauritius,-20.348404,57.552152,225862,0,996,224866
5/30/22,Mauritius,-20.348404,57.552152,225862,0,996,224866
5/31/22,Mauritius,-20.348404,57.552152,225862,0,996,224866
6/1/22,Mauritius,-20.348404,57.552152,225862,0,996,224866
6/2/22,Mauritius,-20.348404,57.552152,226851,0,996,225855
6/3/22,Mauritius,-20.348404,57.552152,226851,0,996,225855
6/4/22,Mauritius,-20.348404,57.552152,226851,0,996,225855
6/5/22,Mauritius,-20.348404,57.552152,226851,0,996,225855
6/6/22,Mauritius,-20.348404,57.552152,226851,0,996,225855
6/7/22,Mauritius,-20.348404,57.552152,226851,0,996,225855
6/8/22,Mauritius,-20.348404,57.552152,226851,0,996,225855
6/9/22,Mauritius,-20.348404,57.552152,226851,0,996,225855
6/10/22,Mauritius,-20.348404,57.552152,226851,0,996,225855
6/11/22,Mauritius,-20.348404,57.552152,226851,0,996,225855
6/12/22,Mauritius,-20.348404,57.552152,226851,0,996,225855
6/13/22,Mauritius,-20.348404,57.552152,227442,0,1000,226442
6/14/22,Mauritius,-20.348404,57.552152,227442,0,1000,226442
6/15/22,Mauritius,-20.348404,57.552152,227442,0,1000,226442
6/16/22,Mauritius,-20.348404,57.552152,227442,0,1000,226442
6/17/22,Mauritius,-20.348404,57.552152,227442,0,1000,226442
6/18/22,Mauritius,-20.348404,57.552152,227442,0,1000,226442
6/19/22,Mauritius,-20.348404,57.552152,227442,0,1000,226442
6/20/22,Mauritius,-20.348404,57.552152,227442,0,1000,226442
6/21/22,Mauritius,-20.348404,57.552152,227442,0,1001,226441
6/22/22,Mauritius,-20.348404,57.552152,227442,0,1001,226441
6/23/22,Mauritius,-20.348404,57.552152,229479,0,1002,228477
6/24/22,Mauritius,-20.348404,57.552152,229479,0,1002,228477
6/25/22,Mauritius,-20.348404,57.552152,229479,0,1002,228477
6/26/22,Mauritius,-20.348404,57.552152,229479,0,1002,228477
6/27/22,Mauritius,-20.348404,57.552152,229479,0,1002,228477
6/28/22,Mauritius,-20.348404,57.552152,229479,0,1002,228477
6/29/22,Mauritius,-20.348404,57.552152,229479,0,1002,228477
6/30/22,Mauritius,-20.348404,57.552152,231036,0,1003,230033
7/1/22,Mauritius,-20.348404,57.552152,231036,0,1004,230032
7/2/22,Mauritius,-20.348404,57.552152,231036,0,1004,230032
7/3/22,Mauritius,-20.348404,57.552152,231036,0,1004,230032
7/4/22,Mauritius,-20.348404,57.552152,231036,0,1004,230032
7/5/22,Mauritius,-20.348404,57.552152,231036,0,1004,230032
7/6/22,Mauritius,-20.348404,57.552152,231036,0,1004,230032
7/7/22,Mauritius,-20.348404,57.552152,231036,0,1004,230032
7/8/22,Mauritius,-20.348404,57.552152,231036,0,1004,230032
7/9/22,Mauritius,-20.348404,57.552152,231036,0,1008,230028
7/10/22,Mauritius,-20.348404,57.552152,231036,0,1008,230028
7/11/22,Mauritius,-20.348404,57.552152,233082,0,1008,232074
7/12/22,Mauritius,-20.348404,57.552152,233082,0,1008,232074
7/13/22,Mauritius,-20.348404,57.552152,233082,0,1008,232074
7/14/22,Mauritius,-20.348404,57.552152,233082,0,1008,232074
7/15/22,Mauritius,-20.348404,57.552152,233082,0,1008,232074
7/16/22,Mauritius,-20.348404,57.552152,233082,0,1008,232074
7/17/22,Mauritius,-20.348404,57.552152,233082,0,1008,232074
7/18/22,Mauritius,-20.348404,57.552152,236651,0,1008,235643
7/19/22,Mauritius,-20.348404,57.552152,236651,0,1008,235643
7/20/22,Mauritius,-20.348404,57.552152,236651,0,1008,235643
7/21/22,Mauritius,-20.348404,57.552152,236651,0,1008,235643
7/22/22,Mauritius,-20.348404,57.552152,236651,0,1009,235642
7/23/22,Mauritius,-20.348404,57.552152,236651,0,1009,235642
7/24/22,Mauritius,-20.348404,57.552152,236651,0,1009,235642
7/25/22,Mauritius,-20.348404,57.552152,241165,0,1009,240156
7/26/22,Mauritius,-20.348404,57.552152,241165,0,1009,240156
7/27/22,Mauritius,-20.348404,57.552152,241165,0,1009,240156
7/28/22,Mauritius,-20.348404,57.552152,244850,0,1011,243839
7/29/22,Mauritius,-20.348404,57.552152,244850,0,1013,243837
7/30/22,Mauritius,-20.348404,57.552152,244850,0,1013,243837
7/31/22,Mauritius,-20.348404,57.552152,244850,0,1013,243837
8/1/22,Mauritius,-20.348404,57.552152,244850,0,1013,243837
8/2/22,Mauritius,-20.348404,57.552152,244850,0,1013,243837
8/3/22,Mauritius,-20.348404,57.552152,244850,0,1013,243837
8/4/22,Mauritius,-20.348404,57.552152,244850,0,1013,243837
8/5/22,Mauritius,-20.348404,57.552152,248720,0,1015,247705
8/6/22,Mauritius,-20.348404,57.552152,248720,0,1015,247705
8/7/22,Mauritius,-20.348404,57.552152,248720,0,1015,247705
8/8/22,Mauritius,-20.348404,57.552152,248720,0,1015,247705
8/9/22,Mauritius,-20.348404,57.552152,248720,0,1015,247705
8/10/22,Mauritius,-20.348404,57.552152,248720,0,1015,247705
8/11/22,Mauritius,-20.348404,57.552152,248720,0,1015,247705
8/12/22,Mauritius,-20.348404,57.552152,248720,0,1019,247701
8/13/22,Mauritius,-20.348404,57.552152,248720,0,1019,247701
8/14/22,Mauritius,-20.348404,57.552152,248720,0,1019,247701
8/15/22,Mauritius,-20.348404,57.552152,251746,0,1019,250727
8/16/22,Mauritius,-20.348404,57.552152,251746,0,1019,250727
8/17/22,Mauritius,-20.348404,57.552152,251746,0,1019,250727
8/18/22,Mauritius,-20.348404,57.552152,251746,0,1019,250727
8/19/22,Mauritius,-20.348404,57.552152,254400,0,1020,253380
8/20/22,Mauritius,-20.348404,57.552152,254400,0,1020,253380
8/21/22,Mauritius,-20.348404,57.552152,254400,0,1020,253380
8/22/22,Mauritius,-20.348404,57.552152,254400,0,1020,253380
8/23/22,Mauritius,-20.348404,57.552152,254400,0,1020,253380
8/24/22,Mauritius,-20.348404,57.552152,254400,0,1020,253380
8/25/22,Mauritius,-20.348404,57.552152,254400,0,1020,253380
8/26/22,Mauritius,-20.348404,57.552152,254400,0,1022,253378
8/27/22,Mauritius,-20.348404,57.552152,254400,0,1022,253378
8/28/22,Mauritius,-20.348404,57.552152,254400,0,1022,253378
8/29/22,Mauritius,-20.348404,57.552152,254400,0,1022,253378
8/30/22,Mauritius,-20.348404,57.552152,256452,0,1023,255429
8/31/22,Mauritius,-20.348404,57.552152,256452,0,1023,255429
9/1/22,Mauritius,-20.348404,57.552152,256452,0,1023,255429
9/2/22,Mauritius,-20.348404,57.552152,256452,0,1023,255429
9/3/22,Mauritius,-20.348404,57.552152,256452,0,1023,255429
9/4/22,Mauritius,-20.348404,57.552152,256452,0,1023,255429
9/5/22,Mauritius,-20.348404,57.552152,258301,0,1023,257278
9/6/22,Mauritius,-20.348404,57.552152,258301,0,1023,257278
9/7/22,Mauritius,-20.348404,57.552152,258301,0,1023,257278
9/8/22,Mauritius,-20.348404,57.552152,258301,0,1023,257278
9/9/22,Mauritius,-20.348404,57.552152,258301,0,1023,257278
9/10/22,Mauritius,-20.348404,57.552152,258301,0,1023,257278
9/11/22,Mauritius,-20.348404,57.552152,258301,0,1023,257278
9/12/22,Mauritius,-20.348404,57.552152,259730,0,1024,258706
9/13/22,Mauritius,-20.348404,57.552152,260947,0,1024,259923
9/14/22,Mauritius,-20.348404,57.552152,260947,0,1024,259923
9/15/22,Mauritius,-20.348404,57.552152,260947,0,1024,259923
9/16/22,Mauritius,-20.348404,57.552152,260947,0,1024,259923
9/17/22,Mauritius,-20.348404,57.552152,260947,0,1024,259923
9/18/22,Mauritius,-20.348404,57.552152,260947,0,1024,259923
9/19/22,Mauritius,-20.348404,57.552152,260947,0,1024,259923
9/20/22,Mauritius,-20.348404,57.552152,260947,0,1024,259923
9/21/22,Mauritius,-20.348404,57.552152,260947,0,1024,259923
9/22/22,Mauritius,-20.348404,57.552152,260947,0,1024,259923
9/23/22,Mauritius,-20.348404,57.552152,260947,0,1024,259923
9/24/22,Mauritius,-20.348404,57.552152,260947,0,1024,259923
9/25/22,Mauritius,-20.348404,57.552152,260947,0,1024,259923
9/26/22,Mauritius,-20.348404,57.552152,261976,0,1026,260950
9/27/22,Mauritius,-20.348404,57.552152,261976,0,1026,260950
9/28/22,Mauritius,-20.348404,57.552152,261976,0,1026,260950
9/29/22,Mauritius,-20.348404,57.552152,262648,0,1026,261622
9/30/22,Mauritius,-20.348404,57.552152,262648,0,1026,261622
10/1/22,Mauritius,-20.348404,57.552152,262648,0,1026,261622
10/2/22,Mauritius,-20.348404,57.552152,262648,0,1026,261622
10/3/22,Mauritius,-20.348404,57.552152,262648,0,1026,261622
10/4/22,Mauritius,-20.348404,57.552152,262648,0,1026,261622
10/5/22,Mauritius,-20.348404,57.552152,262648,0,1026,261622
10/6/22,Mauritius,-20.348404,57.552152,262648,0,1026,261622
10/7/22,Mauritius,-20.348404,57.552152,262648,0,1027,261621
10/8/22,Mauritius,-20.348404,57.552152,262648,0,1027,261621
10/9/22,Mauritius,-20.348404,57.552152,262648,0,1027,261621
10/10/22,Mauritius,-20.348404,57.552152,263177,0,1028,262149
10/11/22,Mauritius,-20.348404,57.552152,263177,0,1028,262149
10/12/22,Mauritius,-20.348404,57.552152,263177,0,1028,262149
10/13/22,Mauritius,-20.348404,57.552152,263177,0,1028,262149
10/14/22,Mauritius,-20.348404,57.552152,263177,0,1030,262147
10/15/22,Mauritius,-20.348404,57.552152,263177,0,1030,262147
10/16/22,Mauritius,-20.348404,57.552152,263177,0,1030,262147
10/17/22,Mauritius,-20.348404,57.552152,263780,0,1032,262748
10/18/22,Mauritius,-20.348404,57.552152,263780,0,1032,262748
10/19/22,Mauritius,-20.348404,57.552152,263780,0,1032,262748
10/20/22,Mauritius,-20.348404,57.552152,263780,0,1032,262748
10/21/22,Mauritius,-20.348404,57.552152,263780,0,1032,262748
10/22/22,Mauritius,-20.348404,57.552152,263780,0,1032,262748
10/23/22,Mauritius,-20.348404,57.552152,263780,0,1032,262748
10/24/22,Mauritius,-20.348404,57.552152,264465,0,1032,263433
10/25/22,Mauritius,-20.348404,57.552152,264465,0,1032,263433
10/26/22,Mauritius,-20.348404,57.552152,264465,0,1032,263433
10/27/22,Mauritius,-20.348404,57.552152,264465,0,1032,263433
10/28/22,Mauritius,-20.348404,57.552152,264465,0,1032,263433
10/29/22,Mauritius,-20.348404,57.552152,264465,0,1032,263433
10/30/22,Mauritius,-20.348404,57.552152,264465,0,1032,263433
10/31/22,Mauritius,-20.348404,57.552152,265301,0,1032,264269
11/1/22,Mauritius,-20.348404,57.552152,265301,0,1032,264269
11/2/22,Mauritius,-20.348404,57.552152,265301,0,1032,264269
11/3/22,Mauritius,-20.348404,57.552152,265301,0,1032,264269
11/4/22,Mauritius,-20.348404,57.552152,265301,0,1032,264269
11/5/22,Mauritius,-20.348404,57.552152,265301,0,1032,264269
11/6/22,Mauritius,-20.348404,57.552152,265301,0,1032,264269
11/7/22,Mauritius,-20.348404,57.552152,266489,0,1033,265456
11/8/22,Mauritius,-20.348404,57.552152,266489,0,1033,265456
11/9/22,Mauritius,-20.348404,57.552152,266489,0,1033,265456
11/10/22,Mauritius,-20.348404,57.552152,268397,0,1033,267364
11/11/22,Mauritius,-20.348404,57.552152,268397,0,1033,267364
11/12/22,Mauritius,-20.348404,57.552152,268397,0,1033,267364
11/13/22,Mauritius,-20.348404,57.552152,268397,0,1033,267364
11/14/22,Mauritius,-20.348404,57.552152,268397,0,1033,267364
11/15/22,Mauritius,-20.348404,57.552152,268397,0,1033,267364
11/16/22,Mauritius,-20.348404,57.552152,268397,0,1033,267364
11/17/22,Mauritius,-20.348404,57.552152,268397,0,1033,267364
11/18/22,Mauritius,-20.348404,57.552152,268397,0,1033,267364
11/19/22,Mauritius,-20.348404,57.552152,268397,0,1033,267364
11/20/22,Mauritius,-20.348404,57.552152,268397,0,1033,267364
11/21/22,Mauritius,-20.348404,57.552152,268397,0,1033,267364
11/22/22,Mauritius,-20.348404,57.552152,268397,0,1033,267364
11/23/22,Mauritius,-20.348404,57.552152,271867,0,1034,270833
11/24/22,Mauritius,-20.348404,57.552152,271867,0,1034,270833
11/25/22,Mauritius,-20.348404,57.552152,271867,0,1034,270833
11/26/22,Mauritius,-20.348404,57.552152,271867,0,1034,270833
11/27/22,Mauritius,-20.348404,57.552152,271867,0,1034,270833
11/28/22,Mauritius,-20.348404,57.552152,271867,0,1034,270833
11/29/22,Mauritius,-20.348404,57.552152,271867,0,1034,270833
11/30/22,Mauritius,-20.348404,57.552152,276456,0,1034,275422
12/1/22,Mauritius,-20.348404,57.552152,276456,0,1034,275422
12/2/22,Mauritius,-20.348404,57.552152,276456,0,1035,275421
12/3/22,Mauritius,-20.348404,57.552152,276456,0,1035,275421
12/4/22,Mauritius,-20.348404,57.552152,276456,0,1035,275421
12/5/22,Mauritius,-20.348404,57.552152,281163,0,1036,280127
12/6/22,Mauritius,-20.348404,57.552152,281163,0,1036,280127
12/7/22,Mauritius,-20.348404,57.552152,281163,0,1036,280127
12/8/22,Mauritius,-20.348404,57.552152,281163,0,1036,280127
12/9/22,Mauritius,-20.348404,57.552152,281163,0,1036,280127
12/10/22,Mauritius,-20.348404,57.552152,281163,0,1036,280127
12/11/22,Mauritius,-20.348404,57.552152,281163,0,1036,280127
12/12/22,Mauritius,-20.348404,57.552152,284994,0,1038,283956
12/13/22,Mauritius,-20.348404,57.552152,284994,0,1038,283956
12/14/22,Mauritius,-20.348404,57.552152,287999,0,1038,286961
12/15/22,Mauritius,-20.348404,57.552152,287999,0,1038,286961
12/16/22,Mauritius,-20.348404,57.552152,287999,0,1038,286961
12/17/22,Mauritius,-20.348404,57.552152,287999,0,1038,286961
1/1/22,Mexico,23.6345,-102.5528,3988916,0,299525,3689391
1/2/22,Mexico,23.6345,-102.5528,3990587,0,299544,3691043
1/3/22,Mexico,23.6345,-102.5528,3993464,0,299581,3693883
1/4/22,Mexico,23.6345,-102.5528,4008648,0,299711,3708937
1/5/22,Mexico,23.6345,-102.5528,4029274,0,299842,3729432
1/6/22,Mexico,23.6345,-102.5528,4055095,0,299970,3755125
1/7/22,Mexico,23.6345,-102.5528,4083118,0,300101,3783017
1/8/22,Mexico,23.6345,-102.5528,4113789,0,300303,3813486
1/9/22,Mexico,23.6345,-102.5528,4125388,0,300334,3825054
1/10/22,Mexico,23.6345,-102.5528,4125388,0,300334,3825054
1/11/22,Mexico,23.6345,-102.5528,4170066,0,300574,3869492
1/12/22,Mexico,23.6345,-102.5528,4214253,0,300764,3913489
1/13/22,Mexico,23.6345,-102.5528,4257776,0,300912,3956864
1/14/22,Mexico,23.6345,-102.5528,4257776,0,300912,3956864
1/15/22,Mexico,23.6345,-102.5528,4349182,0,301334,4047848
1/16/22,Mexico,23.6345,-102.5528,4368314,0,301410,4066904
1/17/22,Mexico,23.6345,-102.5528,4385415,0,301469,4083946
1/18/22,Mexico,23.6345,-102.5528,4385415,0,301469,4083946
1/19/22,Mexico,23.6345,-102.5528,4495310,0,302112,4193198
1/20/22,Mexico,23.6345,-102.5528,4495310,0,302112,4193198
1/21/22,Mexico,23.6345,-102.5528,4595589,0,302721,4292868
1/22/22,Mexico,23.6345,-102.5528,4595589,0,302721,4292868
1/23/22,Mexico,23.6345,-102.5528,4667829,0,303183,4364646
1/24/22,Mexico,23.6345,-102.5528,4685767,0,303301,4382466
1/25/22,Mexico,23.6345,-102.5528,4730669,0,303776,4426893
1/26/22,Mexico,23.6345,-102.5528,4730669,0,303776,4426893
1/27/22,Mexico,23.6345,-102.5528,4779296,0,304308,4474988
1/28/22,Mexico,23.6345,-102.5528,4873561,0,305240,4568321
1/29/22,Mexico,23.6345,-102.5528,4916143,0,305762,4610381
1/30/22,Mexico,23.6345,-102.5528,4930069,0,305893,4624176
1/31/22,Mexico,23.6345,-102.5528,4942590,0,306091,4636499
2/1/22,Mexico,23.6345,-102.5528,4985689,0,306920,4678769
2/2/22,Mexico,23.6345,-102.5528,4985689,0,306920,4678769
2/3/22,Mexico,23.6345,-102.5528,5027870,0,307493,4720377
2/4/22,Mexico,23.6345,-102.5528,5106048,0,308829,4797219
2/5/22,Mexico,23.6345,-102.5528,5141291,0,309417,4831874
2/6/22,Mexico,23.6345,-102.5528,5151525,0,309546,4841979
2/7/22,Mexico,23.6345,-102.5528,5160767,0,309752,4851015
2/8/22,Mexico,23.6345,-102.5528,5167110,0,309884,4857226
2/9/22,Mexico,23.6345,-102.5528,5192008,0,310627,4881381
2/10/22,Mexico,23.6345,-102.5528,5192008,0,310627,4881381
2/11/22,Mexico,23.6345,-102.5528,5226269,0,311554,4914715
2/12/22,Mexico,23.6345,-102.5528,5283852,0,312697,4971155
2/13/22,Mexico,23.6345,-102.5528,5283852,0,312697,4971155
2/14/22,Mexico,23.6345,-102.5528,5292706,0,312819,4979887
2/15/22,Mexico,23.6345,-102.5528,5300537,0,312965,4987572
2/16/22,Mexico,23.6345,-102.5528,5344840,0,314128,5030712
2/17/22,Mexico,23.6345,-102.5528,5366405,0,314598,5051807
2/18/22,Mexico,23.6345,-102.5528,5366405,0,314598,5051807
2/19/22,Mexico,23.6345,-102.5528,5407711,0,315525,5092186
2/20/22,Mexico,23.6345,-102.5528,5413425,0,315688,5097737
2/21/22,Mexico,23.6345,-102.5528,5413425,0,315688,5097737
2/22/22,Mexico,23.6345,-102.5528,5418257,0,315786,5102471
2/23/22,Mexico,23.6345,-102.5528,5455237,0,316941,5138296
2/24/22,Mexico,23.6345,-102.5528,5473489,0,317303,5156186
2/25/22,Mexico,23.6345,-102.5528,5489127,0,317683,5171444
2/26/22,Mexico,23.6345,-102.5528,5502586,0,318014,5184572
2/27/22,Mexico,23.6345,-102.5528,5506105,0,318086,5188019
2/28/22,Mexico,23.6345,-102.5528,5508629,0,318149,5190480
3/1/22,Mexico,23.6345,-102.5528,5521744,0,318531,5203213
3/2/22,Mexico,23.6345,-102.5528,5521744,0,318531,5203213
3/3/22,Mexico,23.6345,-102.5528,5534086,0,318835,5215251
3/4/22,Mexico,23.6345,-102.5528,5544644,0,319296,5225348
3/5/22,Mexico,23.6345,-102.5528,5554392,0,319604,5234788
3/6/22,Mexico,23.6345,-102.5528,5564985,0,319859,5245126
3/7/22,Mexico,23.6345,-102.5528,5566669,0,319901,5246768
3/8/22,Mexico,23.6345,-102.5528,5575608,0,320166,5255442
3/9/22,Mexico,23.6345,-102.5528,5583993,0,320408,5263585
3/10/22,Mexico,23.6345,-102.5528,5591871,0,320607,5271264
3/11/22,Mexico,23.6345,-102.5528,5591871,0,320607,5271264
3/12/22,Mexico,23.6345,-102.5528,5605636,0,321054,5284582
3/13/22,Mexico,23.6345,-102.5528,5606827,0,321103,5285724
3/14/22,Mexico,23.6345,-102.5528,5607845,0,321115,5286730
3/15/22,Mexico,23.6345,-102.5528,5607845,0,321115,5286730
3/16/22,Mexico,23.6345,-102.5528,5613870,0,321375,5292495
3/17/22,Mexico,23.6345,-102.5528,5624954,0,321806,5303148
3/18/22,Mexico,23.6345,-102.5528,5624954,0,321806,5303148
3/19/22,Mexico,23.6345,-102.5528,5629814,0,321931,5307883
3/20/22,Mexico,23.6345,-102.5528,5633928,0,322072,5311856
3/21/22,Mexico,23.6345,-102.5528,5634829,0,322092,5312737
3/22/22,Mexico,23.6345,-102.5528,5636054,0,322119,5313935
3/23/22,Mexico,23.6345,-102.5528,5636054,0,322119,5313935
3/24/22,Mexico,23.6345,-102.5528,5640305,0,322277,5318028
3/25/22,Mexico,23.6345,-102.5528,5647041,0,322634,5324407
3/26/22,Mexico,23.6345,-102.5528,5647041,0,322634,5324407
3/27/22,Mexico,23.6345,-102.5528,5650896,0,322750,5328146
3/28/22,Mexico,23.6345,-102.5528,5651553,0,322761,5328792
3/29/22,Mexico,23.6345,-102.5528,5654311,0,322845,5331466
3/30/22,Mexico,23.6345,-102.5528,5654311,0,322845,5331466
3/31/22,Mexico,23.6345,-102.5528,5659535,0,323016,5336519
4/1/22,Mexico,23.6345,-102.5528,5662073,0,323127,5338946
4/2/22,Mexico,23.6345,-102.5528,5665376,0,323212,5342164
4/3/22,Mexico,23.6345,-102.5528,5666215,0,323223,5342992
4/4/22,Mexico,23.6345,-102.5528,5666921,0,323235,5343686
4/5/22,Mexico,23.6345,-102.5528,5671144,0,323318,5347826
4/6/22,Mexico,23.6345,-102.5528,5683288,0,323403,5359885
4/7/22,Mexico,23.6345,-102.5528,5715504,0,323508,5391996
4/8/22,Mexico,23.6345,-102.5528,5719829,0,323595,5396234
4/9/22,Mexico,23.6345,-102.5528,5722596,0,323691,5398905
4/10/22,Mexico,23.6345,-102.5528,5722933,0,323725,5399208
4/11/22,Mexico,23.6345,-102.5528,5723214,0,323727,5399487
4/12/22,Mexico,23.6345,-102.5528,5723862,0,323805,5400057
4/13/22,Mexico,23.6345,-102.5528,5724611,0,323848,5400763
4/14/22,Mexico,23.6345,-102.5528,5725075,0,323891,5401184
4/15/22,Mexico,23.6345,-102.5528,5725476,0,323903,5401573
4/16/22,Mexico,23.6345,-102.5528,5726668,0,323938,5402730
4/17/22,Mexico,23.6345,-102.5528,5727668,0,323944,5403724
4/18/22,Mexico,23.6345,-102.5528,5727668,0,323944,5403724
4/19/22,Mexico,23.6345,-102.5528,5729270,0,323973,5405297
4/20/22,Mexico,23.6345,-102.5528,5730560,0,324004,5406556
4/21/22,Mexico,23.6345,-102.5528,5731635,0,324033,5407602
4/22/22,Mexico,23.6345,-102.5528,5731635,0,324033,5407602
4/23/22,Mexico,23.6345,-102.5528,5733428,0,324120,5409308
4/24/22,Mexico,23.6345,-102.5528,5733785,0,324129,5409656
4/25/22,Mexico,23.6345,-102.5528,5733925,0,324134,5409791
4/26/22,Mexico,23.6345,-102.5528,5735115,0,324173,5410942
4/27/22,Mexico,23.6345,-102.5528,5736579,0,324221,5412358
4/28/22,Mexico,23.6345,-102.5528,5737811,0,324254,5413557
4/29/22,Mexico,23.6345,-102.5528,5738769,0,324294,5414475
4/30/22,Mexico,23.6345,-102.5528,5739680,0,324334,5415346
5/1/22,Mexico,23.6345,-102.5528,5739680,0,324334,5415346
5/2/22,Mexico,23.6345,-102.5528,5740080,0,324350,5415730
5/3/22,Mexico,23.6345,-102.5528,5739680,0,324334,5415346
5/4/22,Mexico,23.6345,-102.5528,5739680,0,324334,5415346
5/5/22,Mexico,23.6345,-102.5528,5739680,0,324334,5415346
5/6/22,Mexico,23.6345,-102.5528,5739680,0,324334,5415346
5/7/22,Mexico,23.6345,-102.5528,5739680,0,324334,5415346
5/8/22,Mexico,23.6345,-102.5528,5739680,0,324334,5415346
5/9/22,Mexico,23.6345,-102.5528,5745652,0,324465,5421187
5/10/22,Mexico,23.6345,-102.5528,5745652,0,324465,5421187
5/11/22,Mexico,23.6345,-102.5528,5745652,0,324465,5421187
5/12/22,Mexico,23.6345,-102.5528,5745652,0,324465,5421187
5/13/22,Mexico,23.6345,-102.5528,5745652,0,324465,5421187
5/14/22,Mexico,23.6345,-102.5528,5745652,0,324465,5421187
5/15/22,Mexico,23.6345,-102.5528,5745652,0,324465,5421187
5/16/22,Mexico,23.6345,-102.5528,5752441,0,324617,5427824
5/17/22,Mexico,23.6345,-102.5528,5752441,0,324617,5427824
5/18/22,Mexico,23.6345,-102.5528,5752441,0,324617,5427824
5/19/22,Mexico,23.6345,-102.5528,5752441,0,324617,5427824
5/20/22,Mexico,23.6345,-102.5528,5752441,0,324617,5427824
5/21/22,Mexico,23.6345,-102.5528,5752441,0,324617,5427824
5/22/22,Mexico,23.6345,-102.5528,5752441,0,324617,5427824
5/23/22,Mexico,23.6345,-102.5528,5759773,0,324768,5435005
5/24/22,Mexico,23.6345,-102.5528,5759773,0,324768,5435005
5/25/22,Mexico,23.6345,-102.5528,5759773,0,324768,5435005
5/26/22,Mexico,23.6345,-102.5528,5759773,0,324768,5435005
5/27/22,Mexico,23.6345,-102.5528,5759773,0,324768,5435005
5/28/22,Mexico,23.6345,-102.5528,5759773,0,324768,5435005
5/29/22,Mexico,23.6345,-102.5528,5759773,0,324768,5435005
5/30/22,Mexico,23.6345,-102.5528,5772996,0,324895,5448101
5/31/22,Mexico,23.6345,-102.5528,5775977,0,324922,5451055
6/1/22,Mexico,23.6345,-102.5528,5779027,0,324951,5454076
6/2/22,Mexico,23.6345,-102.5528,5782405,0,324966,5457439
6/3/22,Mexico,23.6345,-102.5528,5782405,0,324966,5457439
6/4/22,Mexico,23.6345,-102.5528,5789401,0,325000,5464401
6/5/22,Mexico,23.6345,-102.5528,5791282,0,325017,5466265
6/6/22,Mexico,23.6345,-102.5528,5792317,0,325023,5467294
6/7/22,Mexico,23.6345,-102.5528,5797427,0,325042,5472385
6/8/22,Mexico,23.6345,-102.5528,5802672,0,325055,5477617
6/9/22,Mexico,23.6345,-102.5528,5802672,0,325055,5477617
6/10/22,Mexico,23.6345,-102.5528,5814866,0,325144,5489722
6/11/22,Mexico,23.6345,-102.5528,5821262,0,325186,5496076
6/12/22,Mexico,23.6345,-102.5528,5823844,0,325194,5498650
6/13/22,Mexico,23.6345,-102.5528,5823844,0,325194,5498650
6/14/22,Mexico,23.6345,-102.5528,5833738,0,325242,5508496
6/15/22,Mexico,23.6345,-102.5528,5843190,0,325271,5517919
6/16/22,Mexico,23.6345,-102.5528,5852596,0,325340,5527256
6/17/22,Mexico,23.6345,-102.5528,5852596,0,325340,5527256
6/18/22,Mexico,23.6345,-102.5528,5852596,0,325340,5527256
6/19/22,Mexico,23.6345,-102.5528,5875705,0,325408,5550297
6/20/22,Mexico,23.6345,-102.5528,5877837,0,325417,5552420
6/21/22,Mexico,23.6345,-102.5528,5891589,0,325458,5566131
6/22/22,Mexico,23.6345,-102.5528,5891589,0,325458,5566131
6/23/22,Mexico,23.6345,-102.5528,5906953,0,325487,5581466
6/24/22,Mexico,23.6345,-102.5528,5923086,0,325511,5597575
6/25/22,Mexico,23.6345,-102.5528,5956732,0,325576,5631156
6/26/22,Mexico,23.6345,-102.5528,5962615,0,325580,5637035
6/27/22,Mexico,23.6345,-102.5528,5965958,0,325596,5640362
6/28/22,Mexico,23.6345,-102.5528,5986917,0,325638,5661279
6/29/22,Mexico,23.6345,-102.5528,5986917,0,325638,5661279
6/30/22,Mexico,23.6345,-102.5528,6034602,0,325716,5708886
7/1/22,Mexico,23.6345,-102.5528,6058689,0,325747,5732942
7/2/22,Mexico,23.6345,-102.5528,6058689,0,325747,5732942
7/3/22,Mexico,23.6345,-102.5528,6089600,0,325788,5763812
7/4/22,Mexico,23.6345,-102.5528,6093835,0,325793,5768042
7/5/22,Mexico,23.6345,-102.5528,6121808,0,325868,5795940
7/6/22,Mexico,23.6345,-102.5528,6152924,0,325928,5826996
7/7/22,Mexico,23.6345,-102.5528,6185219,0,325976,5859243
7/8/22,Mexico,23.6345,-102.5528,6185219,0,325976,5859243
7/9/22,Mexico,23.6345,-102.5528,6249983,0,326077,5923906
7/10/22,Mexico,23.6345,-102.5528,6259325,0,326085,5933240
7/11/22,Mexico,23.6345,-102.5528,6265311,0,326097,5939214
7/12/22,Mexico,23.6345,-102.5528,6301645,0,326189,5975456
7/13/22,Mexico,23.6345,-102.5528,6338991,0,326261,6012730
7/14/22,Mexico,23.6345,-102.5528,6373876,0,326335,6047541
7/15/22,Mexico,23.6345,-102.5528,6408443,0,326420,6082023
7/16/22,Mexico,23.6345,-102.5528,6439616,0,326491,6113125
7/17/22,Mexico,23.6345,-102.5528,6448477,0,326504,6121973
7/18/22,Mexico,23.6345,-102.5528,6448477,0,326504,6121973
7/19/22,Mexico,23.6345,-102.5528,6488358,0,326657,6161701
7/20/22,Mexico,23.6345,-102.5528,6523019,0,326764,6196255
7/21/22,Mexico,23.6345,-102.5528,6556679,0,326879,6229800
7/22/22,Mexico,23.6345,-102.5528,6588854,0,326968,6261886
7/23/22,Mexico,23.6345,-102.5528,6617393,0,327073,6290320
7/24/22,Mexico,23.6345,-102.5528,6624310,0,327089,6297221
7/25/22,Mexico,23.6345,-102.5528,6628541,0,327109,6301432
7/26/22,Mexico,23.6345,-102.5528,6628541,0,327109,6301432
7/27/22,Mexico,23.6345,-102.5528,6686954,0,327412,6359542
7/28/22,Mexico,23.6345,-102.5528,6686954,0,327412,6359542
7/29/22,Mexico,23.6345,-102.5528,6711847,0,327525,6384322
7/30/22,Mexico,23.6345,-102.5528,6711847,0,327525,6384322
7/31/22,Mexico,23.6345,-102.5528,6711847,0,327525,6384322
8/1/22,Mexico,23.6345,-102.5528,6761149,0,327755,6433394
8/2/22,Mexico,23.6345,-102.5528,6782980,0,327883,6455097
8/3/22,Mexico,23.6345,-102.5528,6803190,0,328006,6475184
8/4/22,Mexico,23.6345,-102.5528,6821746,0,328128,6493618
8/5/22,Mexico,23.6345,-102.5528,6821746,0,328128,6493618
8/6/22,Mexico,23.6345,-102.5528,6854180,0,328306,6525874
8/7/22,Mexico,23.6345,-102.5528,6857470,0,328320,6529150
8/8/22,Mexico,23.6345,-102.5528,6859970,0,328342,6531628
8/9/22,Mexico,23.6345,-102.5528,6875708,0,328437,6547271
8/10/22,Mexico,23.6345,-102.5528,6875708,0,328437,6547271
8/11/22,Mexico,23.6345,-102.5528,6875708,0,328437,6547271
8/12/22,Mexico,23.6345,-102.5528,6875708,0,328437,6547271
8/13/22,Mexico,23.6345,-102.5528,6925668,0,328724,6596944
8/14/22,Mexico,23.6345,-102.5528,6927636,0,328732,6598904
8/15/22,Mexico,23.6345,-102.5528,6929003,0,328736,6600267
8/16/22,Mexico,23.6345,-102.5528,6939755,0,328798,6610957
8/17/22,Mexico,23.6345,-102.5528,6949653,0,328871,6620782
8/18/22,Mexico,23.6345,-102.5528,6949653,0,328871,6620782
8/19/22,Mexico,23.6345,-102.5528,6949653,0,328871,6620782
8/20/22,Mexico,23.6345,-102.5528,6949653,0,328871,6620782
8/21/22,Mexico,23.6345,-102.5528,6949653,0,328871,6620782
8/22/22,Mexico,23.6345,-102.5528,6949653,0,328871,6620782
8/23/22,Mexico,23.6345,-102.5528,6986328,0,329174,6657154
8/24/22,Mexico,23.6345,-102.5528,6994309,0,329225,6665084
8/25/22,Mexico,23.6345,-102.5528,7001590,0,329289,6672301
8/26/22,Mexico,23.6345,-102.5528,7001590,0,329289,6672301
8/27/22,Mexico,23.6345,-102.5528,7001590,0,329289,6672301
8/28/22,Mexico,23.6345,-102.5528,7014510,0,329390,6685120
8/29/22,Mexico,23.6345,-102.5528,7014510,0,329390,6685120
8/30/22,Mexico,23.6345,-102.5528,7014510,0,329390,6685120
8/31/22,Mexico,23.6345,-102.5528,7014510,0,329390,6685120
9/1/22,Mexico,23.6345,-102.5528,7032024,0,329536,6702488
9/2/22,Mexico,23.6345,-102.5528,7036371,0,329572,6706799
9/3/22,Mexico,23.6345,-102.5528,7036371,0,329572,6706799
9/4/22,Mexico,23.6345,-102.5528,7041181,0,329622,6711559
9/5/22,Mexico,23.6345,-102.5528,7041181,0,329622,6711559
9/6/22,Mexico,23.6345,-102.5528,7046220,0,329652,6716568
9/7/22,Mexico,23.6345,-102.5528,7046220,0,329652,6716568
9/8/22,Mexico,23.6345,-102.5528,7046220,0,329652,6716568
9/9/22,Mexico,23.6345,-102.5528,7046220,0,329652,6716568
9/10/22,Mexico,23.6345,-102.5528,7056269,0,329736,6726533
9/11/22,Mexico,23.6345,-102.5528,7059489,0,329762,6729727
9/12/22,Mexico,23.6345,-102.5528,7059348,0,329761,6729587
9/13/22,Mexico,23.6345,-102.5528,7059936,0,329767,6730169
9/14/22,Mexico,23.6345,-102.5528,7059936,0,329767,6730169
9/15/22,Mexico,23.6345,-102.5528,7059936,0,329767,6730169
9/16/22,Mexico,23.6345,-102.5528,7059936,0,329767,6730169
9/17/22,Mexico,23.6345,-102.5528,7069764,0,329895,6739869
9/18/22,Mexico,23.6345,-102.5528,7069764,0,329895,6739869
9/19/22,Mexico,23.6345,-102.5528,7069764,0,329895,6739869
9/20/22,Mexico,23.6345,-102.5528,7073203,0,329920,6743283
9/21/22,Mexico,23.6345,-102.5528,7076005,0,329949,6746056
9/22/22,Mexico,23.6345,-102.5528,7076005,0,329949,6746056
9/23/22,Mexico,23.6345,-102.5528,7080152,0,330017,6750135
9/24/22,Mexico,23.6345,-102.5528,7081747,0,330043,6751704
9/25/22,Mexico,23.6345,-102.5528,7081747,0,330043,6751704
9/26/22,Mexico,23.6345,-102.5528,7082034,0,330046,6751988
9/27/22,Mexico,23.6345,-102.5528,7082034,0,330046,6751988
9/28/22,Mexico,23.6345,-102.5528,7082034,0,330046,6751988
9/29/22,Mexico,23.6345,-102.5528,7087812,0,330101,6757711
9/30/22,Mexico,23.6345,-102.5528,7089209,0,330112,6759097
10/1/22,Mexico,23.6345,-102.5528,7090330,0,330131,6760199
10/2/22,Mexico,23.6345,-102.5528,7090330,0,330131,6760199
10/3/22,Mexico,23.6345,-102.5528,7090965,0,330139,6760826
10/4/22,Mexico,23.6345,-102.5528,7090965,0,330139,6760826
10/5/22,Mexico,23.6345,-102.5528,7090965,0,330139,6760826
10/6/22,Mexico,23.6345,-102.5528,7090965,0,330139,6760826
10/7/22,Mexico,23.6345,-102.5528,7095696,0,330202,6765494
10/8/22,Mexico,23.6345,-102.5528,7095696,0,330202,6765494
10/9/22,Mexico,23.6345,-102.5528,7097264,0,330208,6767056
10/10/22,Mexico,23.6345,-102.5528,7097264,0,330208,6767056
10/11/22,Mexico,23.6345,-102.5528,7098525,0,330233,6768292
10/12/22,Mexico,23.6345,-102.5528,7099723,0,330250,6769473
10/13/22,Mexico,23.6345,-102.5528,7100886,0,330254,6770632
10/14/22,Mexico,23.6345,-102.5528,7100886,0,330254,6770632
10/15/22,Mexico,23.6345,-102.5528,7102947,0,330277,6772670
10/16/22,Mexico,23.6345,-102.5528,7102947,0,330277,6772670
10/17/22,Mexico,23.6345,-102.5528,7103339,0,330279,6773060
10/18/22,Mexico,23.6345,-102.5528,7103339,0,330279,6773060
10/19/22,Mexico,23.6345,-102.5528,7103339,0,330279,6773060
10/20/22,Mexico,23.6345,-102.5528,7105565,0,330305,6775260
10/21/22,Mexico,23.6345,-102.5528,7106018,0,330320,6775698
10/22/22,Mexico,23.6345,-102.5528,7106018,0,330320,6775698
10/23/22,Mexico,23.6345,-102.5528,7106865,0,330331,6776534
10/24/22,Mexico,23.6345,-102.5528,7106865,0,330331,6776534
10/25/22,Mexico,23.6345,-102.5528,7107987,0,330341,6777646
10/26/22,Mexico,23.6345,-102.5528,7108686,0,330353,6778333
10/27/22,Mexico,23.6345,-102.5528,7108686,0,330353,6778333
10/28/22,Mexico,23.6345,-102.5528,7108686,0,330353,6778333
10/29/22,Mexico,23.6345,-102.5528,7108686,0,330353,6778333
10/30/22,Mexico,23.6345,-102.5528,7111104,0,330376,6780728
10/31/22,Mexico,23.6345,-102.5528,7110993,0,330392,6780601
11/1/22,Mexico,23.6345,-102.5528,7110993,0,330392,6780601
11/2/22,Mexico,23.6345,-102.5528,7112504,0,330410,6782094
11/3/22,Mexico,23.6345,-102.5528,7112504,0,330410,6782094
11/4/22,Mexico,23.6345,-102.5528,7113658,0,330424,6783234
11/5/22,Mexico,23.6345,-102.5528,7113658,0,330424,6783234
11/6/22,Mexico,23.6345,-102.5528,7113658,0,330424,6783234
11/7/22,Mexico,23.6345,-102.5528,7113429,0,330406,6783023
11/8/22,Mexico,23.6345,-102.5528,7113429,0,330406,6783023
11/9/22,Mexico,23.6345,-102.5528,7115535,0,330417,6785118
11/10/22,Mexico,23.6345,-102.5528,7116424,0,330430,6785994
11/11/22,Mexico,23.6345,-102.5528,7116424,0,330430,6785994
11/12/22,Mexico,23.6345,-102.5528,7116424,0,330430,6785994
11/13/22,Mexico,23.6345,-102.5528,7116424,0,330430,6785994
11/14/22,Mexico,23.6345,-102.5528,7118933,0,330444,6788489
11/15/22,Mexico,23.6345,-102.5528,7118933,0,330444,6788489
11/16/22,Mexico,23.6345,-102.5528,7118933,0,330444,6788489
11/17/22,Mexico,23.6345,-102.5528,7118933,0,330444,6788489
11/18/22,Mexico,23.6345,-102.5528,7118933,0,330444,6788489
11/19/22,Mexico,23.6345,-102.5528,7118933,0,330444,6788489
11/20/22,Mexico,23.6345,-102.5528,7118933,0,330444,6788489
11/21/22,Mexico,23.6345,-102.5528,7118933,0,330444,6788489
11/22/22,Mexico,23.6345,-102.5528,7125443,0,330493,6794950
11/23/22,Mexico,23.6345,-102.5528,7125176,0,330495,6794681
11/24/22,Mexico,23.6345,-102.5528,7125176,0,330495,6794681
11/25/22,Mexico,23.6345,-102.5528,7125176,0,330495,6794681
11/26/22,Mexico,23.6345,-102.5528,7125176,0,330495,6794681
11/27/22,Mexico,23.6345,-102.5528,7125176,0,330495,6794681
11/28/22,Mexico,23.6345,-102.5528,7125176,0,330495,6794681
11/29/22,Mexico,23.6345,-102.5528,7125176,0,330495,6794681
11/30/22,Mexico,23.6345,-102.5528,7125176,0,330495,6794681
12/1/22,Mexico,23.6345,-102.5528,7132792,0,330525,6802267
12/2/22,Mexico,23.6345,-102.5528,7132792,0,330525,6802267
12/3/22,Mexico,23.6345,-102.5528,7132792,0,330525,6802267
12/4/22,Mexico,23.6345,-102.5528,7132792,0,330525,6802267
12/5/22,Mexico,23.6345,-102.5528,7145409,0,330592,6814817
12/6/22,Mexico,23.6345,-102.5528,7148886,0,330602,6818284
12/7/22,Mexico,23.6345,-102.5528,7152852,0,330633,6822219
12/8/22,Mexico,23.6345,-102.5528,7156730,0,330667,6826063
12/9/22,Mexico,23.6345,-102.5528,7156730,0,330667,6826063
12/10/22,Mexico,23.6345,-102.5528,7156730,0,330667,6826063
12/11/22,Mexico,23.6345,-102.5528,7156730,0,330667,6826063
12/12/22,Mexico,23.6345,-102.5528,7164392,0,330701,6833691
12/13/22,Mexico,23.6345,-102.5528,7169653,0,330729,6838924
12/14/22,Mexico,23.6345,-102.5528,7169653,0,330729,6838924
12/15/22,Mexico,23.6345,-102.5528,7174464,0,330743,6843721
12/16/22,Mexico,23.6345,-102.5528,7174464,0,330743,6843721
12/17/22,Mexico,23.6345,-102.5528,7188862,0,330795,6858067
1/1/22,Micronesia,7.4256,150.5508,1,0,0,1
1/2/22,Micronesia,7.4256,150.5508,1,0,0,1
1/3/22,Micronesia,7.4256,150.5508,1,0,0,1
1/4/22,Micronesia,7.4256,150.5508,1,0,0,1
1/5/22,Micronesia,7.4256,150.5508,1,0,0,1
1/6/22,Micronesia,7.4256,150.5508,1,0,0,1
1/7/22,Micronesia,7.4256,150.5508,1,0,0,1
1/8/22,Micronesia,7.4256,150.5508,1,0,0,1
1/9/22,Micronesia,7.4256,150.5508,1,0,0,1
1/10/22,Micronesia,7.4256,150.5508,1,0,0,1
1/11/22,Micronesia,7.4256,150.5508,1,0,0,1
1/12/22,Micronesia,7.4256,150.5508,1,0,0,1
1/13/22,Micronesia,7.4256,150.5508,1,0,0,1
1/14/22,Micronesia,7.4256,150.5508,1,0,0,1
1/15/22,Micronesia,7.4256,150.5508,1,0,0,1
1/16/22,Micronesia,7.4256,150.5508,1,0,0,1
1/17/22,Micronesia,7.4256,150.5508,1,0,0,1
1/18/22,Micronesia,7.4256,150.5508,1,0,0,1
1/19/22,Micronesia,7.4256,150.5508,1,0,0,1
1/20/22,Micronesia,7.4256,150.5508,1,0,0,1
1/21/22,Micronesia,7.4256,150.5508,1,0,0,1
1/22/22,Micronesia,7.4256,150.5508,1,0,0,1
1/23/22,Micronesia,7.4256,150.5508,1,0,0,1
1/24/22,Micronesia,7.4256,150.5508,1,0,0,1
1/25/22,Micronesia,7.4256,150.5508,1,0,0,1
1/26/22,Micronesia,7.4256,150.5508,1,0,0,1
1/27/22,Micronesia,7.4256,150.5508,1,0,0,1
1/28/22,Micronesia,7.4256,150.5508,1,0,0,1
1/29/22,Micronesia,7.4256,150.5508,1,0,0,1
1/30/22,Micronesia,7.4256,150.5508,1,0,0,1
1/31/22,Micronesia,7.4256,150.5508,1,0,0,1
2/1/22,Micronesia,7.4256,150.5508,1,0,0,1
2/2/22,Micronesia,7.4256,150.5508,1,0,0,1
2/3/22,Micronesia,7.4256,150.5508,1,0,0,1
2/4/22,Micronesia,7.4256,150.5508,1,0,0,1
2/5/22,Micronesia,7.4256,150.5508,1,0,0,1
2/6/22,Micronesia,7.4256,150.5508,1,0,0,1
2/7/22,Micronesia,7.4256,150.5508,1,0,0,1
2/8/22,Micronesia,7.4256,150.5508,1,0,0,1
2/9/22,Micronesia,7.4256,150.5508,1,0,0,1
2/10/22,Micronesia,7.4256,150.5508,1,0,0,1
2/11/22,Micronesia,7.4256,150.5508,1,0,0,1
2/12/22,Micronesia,7.4256,150.5508,1,0,0,1
2/13/22,Micronesia,7.4256,150.5508,1,0,0,1
2/14/22,Micronesia,7.4256,150.5508,1,0,0,1
2/15/22,Micronesia,7.4256,150.5508,1,0,0,1
2/16/22,Micronesia,7.4256,150.5508,1,0,0,1
2/17/22,Micronesia,7.4256,150.5508,1,0,0,1
2/18/22,Micronesia,7.4256,150.5508,1,0,0,1
2/19/22,Micronesia,7.4256,150.5508,1,0,0,1
2/20/22,Micronesia,7.4256,150.5508,1,0,0,1
2/21/22,Micronesia,7.4256,150.5508,1,0,0,1
2/22/22,Micronesia,7.4256,150.5508,1,0,0,1
2/23/22,Micronesia,7.4256,150.5508,1,0,0,1
2/24/22,Micronesia,7.4256,150.5508,1,0,0,1
2/25/22,Micronesia,7.4256,150.5508,1,0,0,1
2/26/22,Micronesia,7.4256,150.5508,1,0,0,1
2/27/22,Micronesia,7.4256,150.5508,1,0,0,1
2/28/22,Micronesia,7.4256,150.5508,1,0,0,1
3/1/22,Micronesia,7.4256,150.5508,1,0,0,1
3/2/22,Micronesia,7.4256,150.5508,1,0,0,1
3/3/22,Micronesia,7.4256,150.5508,1,0,0,1
3/4/22,Micronesia,7.4256,150.5508,1,0,0,1
3/5/22,Micronesia,7.4256,150.5508,1,0,0,1
3/6/22,Micronesia,7.4256,150.5508,1,0,0,1
3/7/22,Micronesia,7.4256,150.5508,1,0,0,1
3/8/22,Micronesia,7.4256,150.5508,1,0,0,1
3/9/22,Micronesia,7.4256,150.5508,1,0,0,1
3/10/22,Micronesia,7.4256,150.5508,1,0,0,1
3/11/22,Micronesia,7.4256,150.5508,1,0,0,1
3/12/22,Micronesia,7.4256,150.5508,1,0,0,1
3/13/22,Micronesia,7.4256,150.5508,1,0,0,1
3/14/22,Micronesia,7.4256,150.5508,1,0,0,1
3/15/22,Micronesia,7.4256,150.5508,1,0,0,1
3/16/22,Micronesia,7.4256,150.5508,1,0,0,1
3/17/22,Micronesia,7.4256,150.5508,1,0,0,1
3/18/22,Micronesia,7.4256,150.5508,1,0,0,1
3/19/22,Micronesia,7.4256,150.5508,1,0,0,1
3/20/22,Micronesia,7.4256,150.5508,1,0,0,1
3/21/22,Micronesia,7.4256,150.5508,1,0,0,1
3/22/22,Micronesia,7.4256,150.5508,1,0,0,1
3/23/22,Micronesia,7.4256,150.5508,1,0,0,1
3/24/22,Micronesia,7.4256,150.5508,1,0,0,1
3/25/22,Micronesia,7.4256,150.5508,1,0,0,1
3/26/22,Micronesia,7.4256,150.5508,1,0,0,1
3/27/22,Micronesia,7.4256,150.5508,1,0,0,1
3/28/22,Micronesia,7.4256,150.5508,1,0,0,1
3/29/22,Micronesia,7.4256,150.5508,1,0,0,1
3/30/22,Micronesia,7.4256,150.5508,1,0,0,1
3/31/22,Micronesia,7.4256,150.5508,1,0,0,1
4/1/22,Micronesia,7.4256,150.5508,1,0,0,1
4/2/22,Micronesia,7.4256,150.5508,1,0,0,1
4/3/22,Micronesia,7.4256,150.5508,1,0,0,1
4/4/22,Micronesia,7.4256,150.5508,1,0,0,1
4/5/22,Micronesia,7.4256,150.5508,1,0,0,1
4/6/22,Micronesia,7.4256,150.5508,1,0,0,1
4/7/22,Micronesia,7.4256,150.5508,1,0,0,1
4/8/22,Micronesia,7.4256,150.5508,1,0,0,1
4/9/22,Micronesia,7.4256,150.5508,1,0,0,1
4/10/22,Micronesia,7.4256,150.5508,1,0,0,1
4/11/22,Micronesia,7.4256,150.5508,1,0,0,1
4/12/22,Micronesia,7.4256,150.5508,1,0,0,1
4/13/22,Micronesia,7.4256,150.5508,1,0,0,1
4/14/22,Micronesia,7.4256,150.5508,1,0,0,1
4/15/22,Micronesia,7.4256,150.5508,1,0,0,1
4/16/22,Micronesia,7.4256,150.5508,1,0,0,1
4/17/22,Micronesia,7.4256,150.5508,1,0,0,1
4/18/22,Micronesia,7.4256,150.5508,1,0,0,1
4/19/22,Micronesia,7.4256,150.5508,1,0,0,1
4/20/22,Micronesia,7.4256,150.5508,1,0,0,1
4/21/22,Micronesia,7.4256,150.5508,1,0,0,1
4/22/22,Micronesia,7.4256,150.5508,1,0,0,1
4/23/22,Micronesia,7.4256,150.5508,1,0,0,1
4/24/22,Micronesia,7.4256,150.5508,1,0,0,1
4/25/22,Micronesia,7.4256,150.5508,3,0,0,3
4/26/22,Micronesia,7.4256,150.5508,3,0,0,3
4/27/22,Micronesia,7.4256,150.5508,5,0,0,5
4/28/22,Micronesia,7.4256,150.5508,5,0,0,5
4/29/22,Micronesia,7.4256,150.5508,5,0,0,5
4/30/22,Micronesia,7.4256,150.5508,5,0,0,5
5/1/22,Micronesia,7.4256,150.5508,5,0,0,5
5/2/22,Micronesia,7.4256,150.5508,7,0,0,7
5/3/22,Micronesia,7.4256,150.5508,7,0,0,7
5/4/22,Micronesia,7.4256,150.5508,7,0,0,7
5/5/22,Micronesia,7.4256,150.5508,7,0,0,7
5/6/22,Micronesia,7.4256,150.5508,7,0,0,7
5/7/22,Micronesia,7.4256,150.5508,7,0,0,7
5/8/22,Micronesia,7.4256,150.5508,7,0,0,7
5/9/22,Micronesia,7.4256,150.5508,7,0,0,7
5/10/22,Micronesia,7.4256,150.5508,7,0,0,7
5/11/22,Micronesia,7.4256,150.5508,7,0,0,7
5/12/22,Micronesia,7.4256,150.5508,7,0,0,7
5/13/22,Micronesia,7.4256,150.5508,7,0,0,7
5/14/22,Micronesia,7.4256,150.5508,7,0,0,7
5/15/22,Micronesia,7.4256,150.5508,7,0,0,7
5/16/22,Micronesia,7.4256,150.5508,7,0,0,7
5/17/22,Micronesia,7.4256,150.5508,7,0,0,7
5/18/22,Micronesia,7.4256,150.5508,7,0,0,7
5/19/22,Micronesia,7.4256,150.5508,7,0,0,7
5/20/22,Micronesia,7.4256,150.5508,7,0,0,7
5/21/22,Micronesia,7.4256,150.5508,7,0,0,7
5/22/22,Micronesia,7.4256,150.5508,7,0,0,7
5/23/22,Micronesia,7.4256,150.5508,7,0,0,7
5/24/22,Micronesia,7.4256,150.5508,7,0,0,7
5/25/22,Micronesia,7.4256,150.5508,30,0,0,30
5/26/22,Micronesia,7.4256,150.5508,30,0,0,30
5/27/22,Micronesia,7.4256,150.5508,30,0,0,30
5/28/22,Micronesia,7.4256,150.5508,30,0,0,30
5/29/22,Micronesia,7.4256,150.5508,30,0,0,30
5/30/22,Micronesia,7.4256,150.5508,30,0,0,30
5/31/22,Micronesia,7.4256,150.5508,30,0,0,30
6/1/22,Micronesia,7.4256,150.5508,30,0,0,30
6/2/22,Micronesia,7.4256,150.5508,30,0,0,30
6/3/22,Micronesia,7.4256,150.5508,30,0,0,30
6/4/22,Micronesia,7.4256,150.5508,30,0,0,30
6/5/22,Micronesia,7.4256,150.5508,31,0,0,31
6/6/22,Micronesia,7.4256,150.5508,34,0,0,34
6/7/22,Micronesia,7.4256,150.5508,34,0,0,34
6/8/22,Micronesia,7.4256,150.5508,35,0,0,35
6/9/22,Micronesia,7.4256,150.5508,35,0,0,35
6/10/22,Micronesia,7.4256,150.5508,35,0,0,35
6/11/22,Micronesia,7.4256,150.5508,35,0,0,35
6/12/22,Micronesia,7.4256,150.5508,35,0,0,35
6/13/22,Micronesia,7.4256,150.5508,35,0,0,35
6/14/22,Micronesia,7.4256,150.5508,35,0,0,35
6/15/22,Micronesia,7.4256,150.5508,35,0,0,35
6/16/22,Micronesia,7.4256,150.5508,38,0,0,38
6/17/22,Micronesia,7.4256,150.5508,38,0,0,38
6/18/22,Micronesia,7.4256,150.5508,38,0,0,38
6/19/22,Micronesia,7.4256,150.5508,38,0,0,38
6/20/22,Micronesia,7.4256,150.5508,38,0,0,38
6/21/22,Micronesia,7.4256,150.5508,38,0,0,38
6/22/22,Micronesia,7.4256,150.5508,38,0,0,38
6/23/22,Micronesia,7.4256,150.5508,38,0,0,38
6/24/22,Micronesia,7.4256,150.5508,38,0,0,38
6/25/22,Micronesia,7.4256,150.5508,38,0,0,38
6/26/22,Micronesia,7.4256,150.5508,38,0,0,38
6/27/22,Micronesia,7.4256,150.5508,38,0,0,38
6/28/22,Micronesia,7.4256,150.5508,38,0,0,38
6/29/22,Micronesia,7.4256,150.5508,38,0,0,38
6/30/22,Micronesia,7.4256,150.5508,38,0,0,38
7/1/22,Micronesia,7.4256,150.5508,38,0,0,38
7/2/22,Micronesia,7.4256,150.5508,38,0,0,38
7/3/22,Micronesia,7.4256,150.5508,38,0,0,38
7/4/22,Micronesia,7.4256,150.5508,38,0,0,38
7/5/22,Micronesia,7.4256,150.5508,38,0,0,38
7/6/22,Micronesia,7.4256,150.5508,38,0,0,38
7/7/22,Micronesia,7.4256,150.5508,38,0,0,38
7/8/22,Micronesia,7.4256,150.5508,38,0,0,38
7/9/22,Micronesia,7.4256,150.5508,38,0,0,38
7/10/22,Micronesia,7.4256,150.5508,38,0,0,38
7/11/22,Micronesia,7.4256,150.5508,38,0,0,38
7/12/22,Micronesia,7.4256,150.5508,38,0,0,38
7/13/22,Micronesia,7.4256,150.5508,38,0,0,38
7/14/22,Micronesia,7.4256,150.5508,38,0,0,38
7/15/22,Micronesia,7.4256,150.5508,38,0,0,38
7/16/22,Micronesia,7.4256,150.5508,38,0,0,38
7/17/22,Micronesia,7.4256,150.5508,38,0,0,38
7/18/22,Micronesia,7.4256,150.5508,38,0,0,38
7/19/22,Micronesia,7.4256,150.5508,38,0,0,38
7/20/22,Micronesia,7.4256,150.5508,82,0,0,82
7/21/22,Micronesia,7.4256,150.5508,82,0,0,82
7/22/22,Micronesia,7.4256,150.5508,158,0,0,158
7/23/22,Micronesia,7.4256,150.5508,158,0,0,158
7/24/22,Micronesia,7.4256,150.5508,1012,0,0,1012
7/25/22,Micronesia,7.4256,150.5508,1261,0,1,1260
7/26/22,Micronesia,7.4256,150.5508,2072,0,1,2071
7/27/22,Micronesia,7.4256,150.5508,2769,0,4,2765
7/28/22,Micronesia,7.4256,150.5508,3526,0,4,3522
7/29/22,Micronesia,7.4256,150.5508,4321,0,4,4317
7/30/22,Micronesia,7.4256,150.5508,4321,0,4,4317
7/31/22,Micronesia,7.4256,150.5508,4321,0,4,4317
8/1/22,Micronesia,7.4256,150.5508,4321,0,4,4317
8/2/22,Micronesia,7.4256,150.5508,5444,0,10,5434
8/3/22,Micronesia,7.4256,150.5508,6291,0,11,6280
8/4/22,Micronesia,7.4256,150.5508,6291,0,11,6280
8/5/22,Micronesia,7.4256,150.5508,6507,0,12,6495
8/6/22,Micronesia,7.4256,150.5508,6507,0,12,6495
8/7/22,Micronesia,7.4256,150.5508,6691,0,16,6675
8/8/22,Micronesia,7.4256,150.5508,6850,0,16,6834
8/9/22,Micronesia,7.4256,150.5508,6850,0,16,6834
8/10/22,Micronesia,7.4256,150.5508,7125,0,18,7107
8/11/22,Micronesia,7.4256,150.5508,7136,0,19,7117
8/12/22,Micronesia,7.4256,150.5508,7139,0,19,7120
8/13/22,Micronesia,7.4256,150.5508,7139,0,19,7120
8/14/22,Micronesia,7.4256,150.5508,7139,0,19,7120
8/15/22,Micronesia,7.4256,150.5508,7168,0,19,7149
8/16/22,Micronesia,7.4256,150.5508,7174,0,21,7153
8/17/22,Micronesia,7.4256,150.5508,7196,0,21,7175
8/18/22,Micronesia,7.4256,150.5508,7198,0,21,7177
8/19/22,Micronesia,7.4256,150.5508,7202,0,21,7181
8/20/22,Micronesia,7.4256,150.5508,7202,0,21,7181
8/21/22,Micronesia,7.4256,150.5508,7202,0,21,7181
8/22/22,Micronesia,7.4256,150.5508,7727,0,21,7706
8/23/22,Micronesia,7.4256,150.5508,7263,0,21,7242
8/24/22,Micronesia,7.4256,150.5508,7202,0,22,7180
8/25/22,Micronesia,7.4256,150.5508,7202,0,22,7180
8/26/22,Micronesia,7.4256,150.5508,7202,0,22,7180
8/27/22,Micronesia,7.4256,150.5508,7202,0,22,7180
8/28/22,Micronesia,7.4256,150.5508,7202,0,22,7180
8/29/22,Micronesia,7.4256,150.5508,7202,0,22,7180
8/30/22,Micronesia,7.4256,150.5508,7326,0,26,7300
8/31/22,Micronesia,7.4256,150.5508,7327,0,26,7301
9/1/22,Micronesia,7.4256,150.5508,7856,0,27,7829
9/2/22,Micronesia,7.4256,150.5508,7856,0,27,7829
9/3/22,Micronesia,7.4256,150.5508,7856,0,27,7829
9/4/22,Micronesia,7.4256,150.5508,7856,0,27,7829
9/5/22,Micronesia,7.4256,150.5508,8549,0,27,8522
9/6/22,Micronesia,7.4256,150.5508,8776,0,27,8749
9/7/22,Micronesia,7.4256,150.5508,9037,0,27,9010
9/8/22,Micronesia,7.4256,150.5508,9037,0,27,9010
9/9/22,Micronesia,7.4256,150.5508,9037,0,27,9010
9/10/22,Micronesia,7.4256,150.5508,9037,0,27,9010
9/11/22,Micronesia,7.4256,150.5508,9037,0,27,9010
9/12/22,Micronesia,7.4256,150.5508,9376,0,28,9348
9/13/22,Micronesia,7.4256,150.5508,9463,0,29,9434
9/14/22,Micronesia,7.4256,150.5508,9506,0,29,9477
9/15/22,Micronesia,7.4256,150.5508,9933,0,30,9903
9/16/22,Micronesia,7.4256,150.5508,10010,0,30,9980
9/17/22,Micronesia,7.4256,150.5508,10010,0,30,9980
9/18/22,Micronesia,7.4256,150.5508,10010,0,30,9980
9/19/22,Micronesia,7.4256,150.5508,10010,0,30,9980
9/20/22,Micronesia,7.4256,150.5508,10036,0,31,10005
9/21/22,Micronesia,7.4256,150.5508,10036,0,31,10005
9/22/22,Micronesia,7.4256,150.5508,10057,0,31,10026
9/23/22,Micronesia,7.4256,150.5508,10057,0,31,10026
9/24/22,Micronesia,7.4256,150.5508,10057,0,31,10026
9/25/22,Micronesia,7.4256,150.5508,10057,0,31,10026
9/26/22,Micronesia,7.4256,150.5508,10083,0,31,10052
9/27/22,Micronesia,7.4256,150.5508,10083,0,31,10052
9/28/22,Micronesia,7.4256,150.5508,10814,0,31,10783
9/29/22,Micronesia,7.4256,150.5508,10814,0,31,10783
9/30/22,Micronesia,7.4256,150.5508,10814,0,31,10783
10/1/22,Micronesia,7.4256,150.5508,10814,0,31,10783
10/2/22,Micronesia,7.4256,150.5508,10814,0,31,10783
10/3/22,Micronesia,7.4256,150.5508,14466,0,33,14433
10/4/22,Micronesia,7.4256,150.5508,14466,0,33,14433
10/5/22,Micronesia,7.4256,150.5508,15994,0,33,15961
10/6/22,Micronesia,7.4256,150.5508,18857,0,46,18811
10/7/22,Micronesia,7.4256,150.5508,20833,0,49,20784
10/8/22,Micronesia,7.4256,150.5508,20833,0,49,20784
10/9/22,Micronesia,7.4256,150.5508,20833,0,49,20784
10/10/22,Micronesia,7.4256,150.5508,20833,0,49,20784
10/11/22,Micronesia,7.4256,150.5508,21673,0,51,21622
10/12/22,Micronesia,7.4256,150.5508,21673,0,51,21622
10/13/22,Micronesia,7.4256,150.5508,21673,0,51,21622
10/14/22,Micronesia,7.4256,150.5508,21815,0,55,21760
10/15/22,Micronesia,7.4256,150.5508,21815,0,55,21760
10/16/22,Micronesia,7.4256,150.5508,21815,0,55,21760
10/17/22,Micronesia,7.4256,150.5508,21815,0,55,21760
10/18/22,Micronesia,7.4256,150.5508,21815,0,55,21760
10/19/22,Micronesia,7.4256,150.5508,21815,0,55,21760
10/20/22,Micronesia,7.4256,150.5508,21815,0,55,21760
10/21/22,Micronesia,7.4256,150.5508,21815,0,55,21760
10/22/22,Micronesia,7.4256,150.5508,21815,0,55,21760
10/23/22,Micronesia,7.4256,150.5508,21815,0,55,21760
10/24/22,Micronesia,7.4256,150.5508,21815,0,55,21760
10/25/22,Micronesia,7.4256,150.5508,21815,0,55,21760
10/26/22,Micronesia,7.4256,150.5508,22203,0,55,22148
10/27/22,Micronesia,7.4256,150.5508,22203,0,55,22148
10/28/22,Micronesia,7.4256,150.5508,22203,0,55,22148
10/29/22,Micronesia,7.4256,150.5508,22203,0,55,22148
10/30/22,Micronesia,7.4256,150.5508,22203,0,55,22148
10/31/22,Micronesia,7.4256,150.5508,22203,0,55,22148
11/1/22,Micronesia,7.4256,150.5508,22203,0,55,22148
11/2/22,Micronesia,7.4256,150.5508,22203,0,55,22148
11/3/22,Micronesia,7.4256,150.5508,22203,0,55,22148
11/4/22,Micronesia,7.4256,150.5508,22203,0,55,22148
11/5/22,Micronesia,7.4256,150.5508,22203,0,55,22148
11/6/22,Micronesia,7.4256,150.5508,22203,0,55,22148
11/7/22,Micronesia,7.4256,150.5508,22203,0,58,22145
11/8/22,Micronesia,7.4256,150.5508,22203,0,58,22145
11/9/22,Micronesia,7.4256,150.5508,22203,0,58,22145
11/10/22,Micronesia,7.4256,150.5508,22203,0,58,22145
11/11/22,Micronesia,7.4256,150.5508,22203,0,58,22145
11/12/22,Micronesia,7.4256,150.5508,22203,0,58,22145
11/13/22,Micronesia,7.4256,150.5508,22203,0,58,22145
11/14/22,Micronesia,7.4256,150.5508,22203,0,58,22145
11/15/22,Micronesia,7.4256,150.5508,22203,0,58,22145
11/16/22,Micronesia,7.4256,150.5508,22203,0,58,22145
11/17/22,Micronesia,7.4256,150.5508,22203,0,58,22145
11/18/22,Micronesia,7.4256,150.5508,22203,0,55,22148
11/19/22,Micronesia,7.4256,150.5508,22203,0,55,22148
11/20/22,Micronesia,7.4256,150.5508,22203,0,55,22148
11/21/22,Micronesia,7.4256,150.5508,22203,0,55,22148
11/22/22,Micronesia,7.4256,150.5508,22203,0,55,22148
11/23/22,Micronesia,7.4256,150.5508,22203,0,55,22148
11/24/22,Micronesia,7.4256,150.5508,22203,0,55,22148
11/25/22,Micronesia,7.4256,150.5508,22203,0,58,22145
11/26/22,Micronesia,7.4256,150.5508,22203,0,58,22145
11/27/22,Micronesia,7.4256,150.5508,22203,0,58,22145
11/28/22,Micronesia,7.4256,150.5508,22203,0,58,22145
11/29/22,Micronesia,7.4256,150.5508,22203,0,58,22145
11/30/22,Micronesia,7.4256,150.5508,22203,0,58,22145
12/1/22,Micronesia,7.4256,150.5508,22203,0,58,22145
12/2/22,Micronesia,7.4256,150.5508,22203,0,58,22145
12/3/22,Micronesia,7.4256,150.5508,22203,0,58,22145
12/4/22,Micronesia,7.4256,150.5508,22203,0,58,22145
12/5/22,Micronesia,7.4256,150.5508,22203,0,58,22145
12/6/22,Micronesia,7.4256,150.5508,22203,0,58,22145
12/7/22,Micronesia,7.4256,150.5508,22203,0,58,22145
12/8/22,Micronesia,7.4256,150.5508,22203,0,58,22145
12/9/22,Micronesia,7.4256,150.5508,22203,0,58,22145
12/10/22,Micronesia,7.4256,150.5508,22203,0,58,22145
12/11/22,Micronesia,7.4256,150.5508,22203,0,58,22145
12/12/22,Micronesia,7.4256,150.5508,22203,0,58,22145
12/13/22,Micronesia,7.4256,150.5508,22203,0,58,22145
12/14/22,Micronesia,7.4256,150.5508,22203,0,58,22145
12/15/22,Micronesia,7.4256,150.5508,22203,0,58,22145
12/16/22,Micronesia,7.4256,150.5508,22203,0,58,22145
12/17/22,Micronesia,7.4256,150.5508,22203,0,58,22145
1/1/22,Moldova,47.4116,28.3699,376434,0,10284,366150
1/2/22,Moldova,47.4116,28.3699,376602,0,10290,366312
1/3/22,Moldova,47.4116,28.3699,376844,0,10306,366538
1/4/22,Moldova,47.4116,28.3699,377496,0,10319,367177
1/5/22,Moldova,47.4116,28.3699,378202,0,10328,367874
1/6/22,Moldova,47.4116,28.3699,378904,0,10339,368565
1/7/22,Moldova,47.4116,28.3699,379572,0,10350,369222
1/8/22,Moldova,47.4116,28.3699,379901,0,10356,369545
1/9/22,Moldova,47.4116,28.3699,380290,0,10363,369927
1/10/22,Moldova,47.4116,28.3699,380985,0,10380,370605
1/11/22,Moldova,47.4116,28.3699,382124,0,10397,371727
1/12/22,Moldova,47.4116,28.3699,383544,0,10406,373138
1/13/22,Moldova,47.4116,28.3699,385047,0,10416,374631
1/14/22,Moldova,47.4116,28.3699,386905,0,10427,376478
1/15/22,Moldova,47.4116,28.3699,387920,0,10437,377483
1/16/22,Moldova,47.4116,28.3699,388959,0,10444,378515
1/17/22,Moldova,47.4116,28.3699,390742,0,10452,380290
1/18/22,Moldova,47.4116,28.3699,393423,0,10462,382961
1/19/22,Moldova,47.4116,28.3699,396678,0,10470,386208
1/20/22,Moldova,47.4116,28.3699,400585,0,10488,390097
1/21/22,Moldova,47.4116,28.3699,404556,0,10501,394055
1/22/22,Moldova,47.4116,28.3699,407003,0,10513,396490
1/23/22,Moldova,47.4116,28.3699,409397,0,10522,398875
1/24/22,Moldova,47.4116,28.3699,412231,0,10542,401689
1/25/22,Moldova,47.4116,28.3699,417369,0,10566,406803
1/26/22,Moldova,47.4116,28.3699,423568,0,10587,412981
1/27/22,Moldova,47.4116,28.3699,428934,0,10600,418334
1/28/22,Moldova,47.4116,28.3699,434549,0,10621,423928
1/29/22,Moldova,47.4116,28.3699,438249,0,10635,427614
1/30/22,Moldova,47.4116,28.3699,438249,0,10635,427614
1/31/22,Moldova,47.4116,28.3699,440698,0,10642,430056
2/1/22,Moldova,47.4116,28.3699,445046,0,10666,434380
2/2/22,Moldova,47.4116,28.3699,449840,0,10691,439149
2/3/22,Moldova,47.4116,28.3699,455095,0,10718,444377
2/4/22,Moldova,47.4116,28.3699,460307,0,10734,449573
2/5/22,Moldova,47.4116,28.3699,464234,0,10755,453479
2/6/22,Moldova,47.4116,28.3699,467271,0,10768,456503
2/7/22,Moldova,47.4116,28.3699,468782,0,10776,458006
2/8/22,Moldova,47.4116,28.3699,471524,0,10803,460721
2/9/22,Moldova,47.4116,28.3699,474548,0,10837,463711
2/10/22,Moldova,47.4116,28.3699,477419,0,10866,466553
2/11/22,Moldova,47.4116,28.3699,480289,0,10893,469396
2/12/22,Moldova,47.4116,28.3699,482842,0,10924,471918
2/13/22,Moldova,47.4116,28.3699,484516,0,10940,473576
2/14/22,Moldova,47.4116,28.3699,485563,0,10962,474601
2/15/22,Moldova,47.4116,28.3699,487283,0,10982,476301
2/16/22,Moldova,47.4116,28.3699,488899,0,11009,477890
2/17/22,Moldova,47.4116,28.3699,490751,0,11041,479710
2/18/22,Moldova,47.4116,28.3699,492604,0,11068,481536
2/19/22,Moldova,47.4116,28.3699,494219,0,11093,483126
2/20/22,Moldova,47.4116,28.3699,495184,0,11104,484080
2/21/22,Moldova,47.4116,28.3699,495415,0,11117,484298
2/22/22,Moldova,47.4116,28.3699,496976,0,11136,485840
2/23/22,Moldova,47.4116,28.3699,497946,0,11157,486789
2/24/22,Moldova,47.4116,28.3699,499015,0,11171,487844
2/25/22,Moldova,47.4116,28.3699,500144,0,11185,488959
2/26/22,Moldova,47.4116,28.3699,500812,0,11201,489611
2/27/22,Moldova,47.4116,28.3699,501312,0,11213,490099
2/28/22,Moldova,47.4116,28.3699,501800,0,11216,490584
3/1/22,Moldova,47.4116,28.3699,502386,0,11228,491158
3/2/22,Moldova,47.4116,28.3699,502956,0,11242,491714
3/3/22,Moldova,47.4116,28.3699,503690,0,11254,492436
3/4/22,Moldova,47.4116,28.3699,504307,0,11269,493038
3/5/22,Moldova,47.4116,28.3699,504875,0,11285,493590
3/6/22,Moldova,47.4116,28.3699,505393,0,11292,494101
3/7/22,Moldova,47.4116,28.3699,505644,0,11293,494351
3/8/22,Moldova,47.4116,28.3699,505996,0,11298,494698
3/9/22,Moldova,47.4116,28.3699,506222,0,11304,494918
3/10/22,Moldova,47.4116,28.3699,506681,0,11319,495362
3/11/22,Moldova,47.4116,28.3699,507028,0,11333,495695
3/12/22,Moldova,47.4116,28.3699,507599,0,11339,496260
3/13/22,Moldova,47.4116,28.3699,507994,0,11346,496648
3/14/22,Moldova,47.4116,28.3699,508235,0,11350,496885
3/15/22,Moldova,47.4116,28.3699,508578,0,11357,497221
3/16/22,Moldova,47.4116,28.3699,508917,0,11368,497549
3/17/22,Moldova,47.4116,28.3699,509367,0,11373,497994
3/18/22,Moldova,47.4116,28.3699,509834,0,11378,498456
3/19/22,Moldova,47.4116,28.3699,510206,0,11381,498825
3/20/22,Moldova,47.4116,28.3699,510460,0,11389,499071
3/21/22,Moldova,47.4116,28.3699,510700,0,11389,499311
3/22/22,Moldova,47.4116,28.3699,510973,0,11392,499581
3/23/22,Moldova,47.4116,28.3699,511231,0,11401,499830
3/24/22,Moldova,47.4116,28.3699,511662,0,11408,500254
3/25/22,Moldova,47.4116,28.3699,512047,0,11409,500638
3/26/22,Moldova,47.4116,28.3699,512386,0,11415,500971
3/27/22,Moldova,47.4116,28.3699,512602,0,11417,501185
3/28/22,Moldova,47.4116,28.3699,512638,0,11421,501217
3/29/22,Moldova,47.4116,28.3699,512942,0,11423,501519
3/30/22,Moldova,47.4116,28.3699,513146,0,11428,501718
3/31/22,Moldova,47.4116,28.3699,513442,0,11431,502011
4/1/22,Moldova,47.4116,28.3699,513757,0,11435,502322
4/2/22,Moldova,47.4116,28.3699,514014,0,11445,502569
4/3/22,Moldova,47.4116,28.3699,514199,0,11446,502753
4/4/22,Moldova,47.4116,28.3699,514222,0,11449,502773
4/5/22,Moldova,47.4116,28.3699,514428,0,11452,502976
4/6/22,Moldova,47.4116,28.3699,514650,0,11453,503197
4/7/22,Moldova,47.4116,28.3699,514882,0,11455,503427
4/8/22,Moldova,47.4116,28.3699,515121,0,11460,503661
4/9/22,Moldova,47.4116,28.3699,515312,0,11461,503851
4/10/22,Moldova,47.4116,28.3699,515445,0,11462,503983
4/11/22,Moldova,47.4116,28.3699,515488,0,11470,504018
4/12/22,Moldova,47.4116,28.3699,515649,0,11471,504178
4/13/22,Moldova,47.4116,28.3699,515804,0,11474,504330
4/14/22,Moldova,47.4116,28.3699,516004,0,11477,504527
4/15/22,Moldova,47.4116,28.3699,516164,0,11480,504684
4/16/22,Moldova,47.4116,28.3699,516316,0,11481,504835
4/17/22,Moldova,47.4116,28.3699,516431,0,11481,504950
4/18/22,Moldova,47.4116,28.3699,516444,0,11482,504962
4/19/22,Moldova,47.4116,28.3699,516587,0,11485,505102
4/20/22,Moldova,47.4116,28.3699,516699,0,11487,505212
4/21/22,Moldova,47.4116,28.3699,516864,0,11487,505377
4/22/22,Moldova,47.4116,28.3699,516986,0,11489,505497
4/23/22,Moldova,47.4116,28.3699,516986,0,11489,505497
4/24/22,Moldova,47.4116,28.3699,516986,0,11489,505497
4/25/22,Moldova,47.4116,28.3699,516986,0,11489,505497
4/26/22,Moldova,47.4116,28.3699,516986,0,11489,505497
4/27/22,Moldova,47.4116,28.3699,516986,0,11489,505497
4/28/22,Moldova,47.4116,28.3699,516986,0,11489,505497
4/29/22,Moldova,47.4116,28.3699,516986,0,11489,505497
4/30/22,Moldova,47.4116,28.3699,516986,0,11489,505497
5/1/22,Moldova,47.4116,28.3699,516986,0,11489,505497
5/2/22,Moldova,47.4116,28.3699,516986,0,11489,505497
5/3/22,Moldova,47.4116,28.3699,516986,0,11489,505497
5/4/22,Moldova,47.4116,28.3699,516986,0,11489,505497
5/5/22,Moldova,47.4116,28.3699,517753,0,11503,506250
5/6/22,Moldova,47.4116,28.3699,517753,0,11503,506250
5/7/22,Moldova,47.4116,28.3699,517753,0,11503,506250
5/8/22,Moldova,47.4116,28.3699,517753,0,11503,506250
5/9/22,Moldova,47.4116,28.3699,517753,0,11503,506250
5/10/22,Moldova,47.4116,28.3699,518166,0,11516,506650
5/11/22,Moldova,47.4116,28.3699,518166,0,11516,506650
5/12/22,Moldova,47.4116,28.3699,518166,0,11516,506650
5/13/22,Moldova,47.4116,28.3699,518166,0,11516,506650
5/14/22,Moldova,47.4116,28.3699,518166,0,11516,506650
5/15/22,Moldova,47.4116,28.3699,518166,0,11516,506650
5/16/22,Moldova,47.4116,28.3699,518166,0,11516,506650
5/17/22,Moldova,47.4116,28.3699,518166,0,11516,506650
5/18/22,Moldova,47.4116,28.3699,518492,0,11521,506971
5/19/22,Moldova,47.4116,28.3699,518492,0,11521,506971
5/20/22,Moldova,47.4116,28.3699,518492,0,11521,506971
5/21/22,Moldova,47.4116,28.3699,518492,0,11521,506971
5/22/22,Moldova,47.4116,28.3699,518492,0,11521,506971
5/23/22,Moldova,47.4116,28.3699,518492,0,11521,506971
5/24/22,Moldova,47.4116,28.3699,518793,0,11521,507272
5/25/22,Moldova,47.4116,28.3699,518793,0,11537,507256
5/26/22,Moldova,47.4116,28.3699,518793,0,11537,507256
5/27/22,Moldova,47.4116,28.3699,518793,0,11537,507256
5/28/22,Moldova,47.4116,28.3699,518793,0,11537,507256
5/29/22,Moldova,47.4116,28.3699,518793,0,11537,507256
5/30/22,Moldova,47.4116,28.3699,518793,0,11537,507256
5/31/22,Moldova,47.4116,28.3699,518793,0,11537,507256
6/1/22,Moldova,47.4116,28.3699,518967,0,11544,507423
6/2/22,Moldova,47.4116,28.3699,518967,0,11544,507423
6/3/22,Moldova,47.4116,28.3699,518967,0,11544,507423
6/4/22,Moldova,47.4116,28.3699,518967,0,11544,507423
6/5/22,Moldova,47.4116,28.3699,518967,0,11544,507423
6/6/22,Moldova,47.4116,28.3699,519001,0,11544,507457
6/7/22,Moldova,47.4116,28.3699,519001,0,11544,507457
6/8/22,Moldova,47.4116,28.3699,519228,0,11551,507677
6/9/22,Moldova,47.4116,28.3699,519228,0,11551,507677
6/10/22,Moldova,47.4116,28.3699,519228,0,11551,507677
6/11/22,Moldova,47.4116,28.3699,519228,0,11551,507677
6/12/22,Moldova,47.4116,28.3699,519228,0,11551,507677
6/13/22,Moldova,47.4116,28.3699,519234,0,11554,507680
6/14/22,Moldova,47.4116,28.3699,519234,0,11554,507680
6/15/22,Moldova,47.4116,28.3699,519452,0,11554,507898
6/16/22,Moldova,47.4116,28.3699,519452,0,11554,507898
6/17/22,Moldova,47.4116,28.3699,519452,0,11554,507898
6/18/22,Moldova,47.4116,28.3699,519452,0,11554,507898
6/19/22,Moldova,47.4116,28.3699,519452,0,11554,507898
6/20/22,Moldova,47.4116,28.3699,519452,0,11554,507898
6/21/22,Moldova,47.4116,28.3699,519452,0,11554,507898
6/22/22,Moldova,47.4116,28.3699,519703,0,11563,508140
6/23/22,Moldova,47.4116,28.3699,519741,0,11563,508178
6/24/22,Moldova,47.4116,28.3699,519741,0,11563,508178
6/25/22,Moldova,47.4116,28.3699,519741,0,11563,508178
6/26/22,Moldova,47.4116,28.3699,519741,0,11563,508178
6/27/22,Moldova,47.4116,28.3699,519741,0,11563,508178
6/28/22,Moldova,47.4116,28.3699,520168,0,11567,508601
6/29/22,Moldova,47.4116,28.3699,520321,0,11567,508754
6/30/22,Moldova,47.4116,28.3699,520321,0,11567,508754
7/1/22,Moldova,47.4116,28.3699,520321,0,11567,508754
7/2/22,Moldova,47.4116,28.3699,520321,0,11567,508754
7/3/22,Moldova,47.4116,28.3699,520321,0,11567,508754
7/4/22,Moldova,47.4116,28.3699,520321,0,11567,508754
7/5/22,Moldova,47.4116,28.3699,520321,0,11567,508754
7/6/22,Moldova,47.4116,28.3699,521182,0,11570,509612
7/7/22,Moldova,47.4116,28.3699,521182,0,11570,509612
7/8/22,Moldova,47.4116,28.3699,521182,0,11570,509612
7/9/22,Moldova,47.4116,28.3699,521182,0,11570,509612
7/10/22,Moldova,47.4116,28.3699,521182,0,11570,509612
7/11/22,Moldova,47.4116,28.3699,521182,0,11570,509612
7/12/22,Moldova,47.4116,28.3699,521182,0,11570,509612
7/13/22,Moldova,47.4116,28.3699,523034,0,11584,511450
7/14/22,Moldova,47.4116,28.3699,523034,0,11584,511450
7/15/22,Moldova,47.4116,28.3699,523034,0,11584,511450
7/16/22,Moldova,47.4116,28.3699,523034,0,11584,511450
7/17/22,Moldova,47.4116,28.3699,523034,0,11584,511450
7/18/22,Moldova,47.4116,28.3699,523034,0,11584,511450
7/19/22,Moldova,47.4116,28.3699,523034,0,11584,511450
7/20/22,Moldova,47.4116,28.3699,526394,0,11592,514802
7/21/22,Moldova,47.4116,28.3699,526394,0,11592,514802
7/22/22,Moldova,47.4116,28.3699,526394,0,11592,514802
7/23/22,Moldova,47.4116,28.3699,526394,0,11592,514802
7/24/22,Moldova,47.4116,28.3699,526394,0,11592,514802
7/25/22,Moldova,47.4116,28.3699,526394,0,11592,514802
7/26/22,Moldova,47.4116,28.3699,532187,0,11608,520579
7/27/22,Moldova,47.4116,28.3699,532187,0,11608,520579
7/28/22,Moldova,47.4116,28.3699,532187,0,11608,520579
7/29/22,Moldova,47.4116,28.3699,532187,0,11608,520579
7/30/22,Moldova,47.4116,28.3699,532187,0,11608,520579
7/31/22,Moldova,47.4116,28.3699,532187,0,11608,520579
8/1/22,Moldova,47.4116,28.3699,532187,0,11608,520579
8/2/22,Moldova,47.4116,28.3699,532187,0,11608,520579
8/3/22,Moldova,47.4116,28.3699,541715,0,11630,530085
8/4/22,Moldova,47.4116,28.3699,541715,0,11630,530085
8/5/22,Moldova,47.4116,28.3699,541715,0,11630,530085
8/6/22,Moldova,47.4116,28.3699,541715,0,11630,530085
8/7/22,Moldova,47.4116,28.3699,541715,0,11630,530085
8/8/22,Moldova,47.4116,28.3699,541715,0,11630,530085
8/9/22,Moldova,47.4116,28.3699,541715,0,11630,530085
8/10/22,Moldova,47.4116,28.3699,551862,0,11662,540200
8/11/22,Moldova,47.4116,28.3699,551862,0,11662,540200
8/12/22,Moldova,47.4116,28.3699,551862,0,11662,540200
8/13/22,Moldova,47.4116,28.3699,551862,0,11662,540200
8/14/22,Moldova,47.4116,28.3699,551862,0,11662,540200
8/15/22,Moldova,47.4116,28.3699,551862,0,11662,540200
8/16/22,Moldova,47.4116,28.3699,561196,0,11693,549503
8/17/22,Moldova,47.4116,28.3699,561196,0,11693,549503
8/18/22,Moldova,47.4116,28.3699,561196,0,11693,549503
8/19/22,Moldova,47.4116,28.3699,561196,0,11693,549503
8/20/22,Moldova,47.4116,28.3699,561196,0,11693,549503
8/21/22,Moldova,47.4116,28.3699,561196,0,11693,549503
8/22/22,Moldova,47.4116,28.3699,561196,0,11693,549503
8/23/22,Moldova,47.4116,28.3699,561196,0,11693,549503
8/24/22,Moldova,47.4116,28.3699,569088,0,11725,557363
8/25/22,Moldova,47.4116,28.3699,569088,0,11725,557363
8/26/22,Moldova,47.4116,28.3699,569088,0,11725,557363
8/27/22,Moldova,47.4116,28.3699,569088,0,11725,557363
8/28/22,Moldova,47.4116,28.3699,569088,0,11725,557363
8/29/22,Moldova,47.4116,28.3699,569088,0,11725,557363
8/30/22,Moldova,47.4116,28.3699,569088,0,11725,557363
8/31/22,Moldova,47.4116,28.3699,575052,0,11755,563297
9/1/22,Moldova,47.4116,28.3699,575052,0,11755,563297
9/2/22,Moldova,47.4116,28.3699,575052,0,11755,563297
9/3/22,Moldova,47.4116,28.3699,575052,0,11755,563297
9/4/22,Moldova,47.4116,28.3699,575052,0,11755,563297
9/5/22,Moldova,47.4116,28.3699,575052,0,11755,563297
9/6/22,Moldova,47.4116,28.3699,575052,0,11755,563297
9/7/22,Moldova,47.4116,28.3699,579110,0,11783,567327
9/8/22,Moldova,47.4116,28.3699,579110,0,11783,567327
9/9/22,Moldova,47.4116,28.3699,579110,0,11783,567327
9/10/22,Moldova,47.4116,28.3699,579110,0,11783,567327
9/11/22,Moldova,47.4116,28.3699,579110,0,11783,567327
9/12/22,Moldova,47.4116,28.3699,579110,0,11783,567327
9/13/22,Moldova,47.4116,28.3699,579110,0,11783,567327
9/14/22,Moldova,47.4116,28.3699,583183,0,11808,571375
9/15/22,Moldova,47.4116,28.3699,583183,0,11808,571375
9/16/22,Moldova,47.4116,28.3699,583183,0,11808,571375
9/17/22,Moldova,47.4116,28.3699,583183,0,11808,571375
9/18/22,Moldova,47.4116,28.3699,583183,0,11808,571375
9/19/22,Moldova,47.4116,28.3699,583183,0,11808,571375
9/20/22,Moldova,47.4116,28.3699,586966,0,11821,575145
9/21/22,Moldova,47.4116,28.3699,587023,0,11821,575202
9/22/22,Moldova,47.4116,28.3699,587023,0,11821,575202
9/23/22,Moldova,47.4116,28.3699,587023,0,11821,575202
9/24/22,Moldova,47.4116,28.3699,587023,0,11821,575202
9/25/22,Moldova,47.4116,28.3699,587023,0,11821,575202
9/26/22,Moldova,47.4116,28.3699,587023,0,11821,575202
9/27/22,Moldova,47.4116,28.3699,589437,0,11844,577593
9/28/22,Moldova,47.4116,28.3699,589437,0,11844,577593
9/29/22,Moldova,47.4116,28.3699,589437,0,11844,577593
9/30/22,Moldova,47.4116,28.3699,589437,0,11844,577593
10/1/22,Moldova,47.4116,28.3699,589437,0,11844,577593
10/2/22,Moldova,47.4116,28.3699,589437,0,11844,577593
10/3/22,Moldova,47.4116,28.3699,589437,0,11844,577593
10/4/22,Moldova,47.4116,28.3699,590752,0,11858,578894
10/5/22,Moldova,47.4116,28.3699,590811,0,11858,578953
10/6/22,Moldova,47.4116,28.3699,590811,0,11858,578953
10/7/22,Moldova,47.4116,28.3699,590811,0,11858,578953
10/8/22,Moldova,47.4116,28.3699,590811,0,11858,578953
10/9/22,Moldova,47.4116,28.3699,590811,0,11858,578953
10/10/22,Moldova,47.4116,28.3699,590811,0,11858,578953
10/11/22,Moldova,47.4116,28.3699,591853,0,11870,579983
10/12/22,Moldova,47.4116,28.3699,591912,0,11870,580042
10/13/22,Moldova,47.4116,28.3699,591912,0,11870,580042
10/14/22,Moldova,47.4116,28.3699,591912,0,11870,580042
10/15/22,Moldova,47.4116,28.3699,591912,0,11870,580042
10/16/22,Moldova,47.4116,28.3699,591912,0,11870,580042
10/17/22,Moldova,47.4116,28.3699,591912,0,11870,580042
10/18/22,Moldova,47.4116,28.3699,591912,0,11870,580042
10/19/22,Moldova,47.4116,28.3699,592535,0,11879,580656
10/20/22,Moldova,47.4116,28.3699,592535,0,11878,580657
10/21/22,Moldova,47.4116,28.3699,592535,0,11878,580657
10/22/22,Moldova,47.4116,28.3699,592535,0,11878,580657
10/23/22,Moldova,47.4116,28.3699,592535,0,11878,580657
10/24/22,Moldova,47.4116,28.3699,592535,0,11878,580657
10/25/22,Moldova,47.4116,28.3699,593246,0,11887,581359
10/26/22,Moldova,47.4116,28.3699,593246,0,11887,581359
10/27/22,Moldova,47.4116,28.3699,593246,0,11887,581359
10/28/22,Moldova,47.4116,28.3699,593246,0,11887,581359
10/29/22,Moldova,47.4116,28.3699,593246,0,11887,581359
10/30/22,Moldova,47.4116,28.3699,593246,0,11887,581359
10/31/22,Moldova,47.4116,28.3699,593246,0,11887,581359
11/1/22,Moldova,47.4116,28.3699,593816,0,11894,581922
11/2/22,Moldova,47.4116,28.3699,593816,0,11894,581922
11/3/22,Moldova,47.4116,28.3699,593816,0,11894,581922
11/4/22,Moldova,47.4116,28.3699,593816,0,11894,581922
11/5/22,Moldova,47.4116,28.3699,593816,0,11894,581922
11/6/22,Moldova,47.4116,28.3699,593816,0,11894,581922
11/7/22,Moldova,47.4116,28.3699,593816,0,11894,581922
11/8/22,Moldova,47.4116,28.3699,594163,0,11900,582263
11/9/22,Moldova,47.4116,28.3699,594163,0,11900,582263
11/10/22,Moldova,47.4116,28.3699,594163,0,11900,582263
11/11/22,Moldova,47.4116,28.3699,594163,0,11900,582263
11/12/22,Moldova,47.4116,28.3699,594163,0,11900,582263
11/13/22,Moldova,47.4116,28.3699,594163,0,11900,582263
11/14/22,Moldova,47.4116,28.3699,594163,0,11900,582263
11/15/22,Moldova,47.4116,28.3699,594441,0,11906,582535
11/16/22,Moldova,47.4116,28.3699,594441,0,11906,582535
11/17/22,Moldova,47.4116,28.3699,594441,0,11906,582535
11/18/22,Moldova,47.4116,28.3699,594441,0,11906,582535
11/19/22,Moldova,47.4116,28.3699,594441,0,11906,582535
11/20/22,Moldova,47.4116,28.3699,594441,0,11906,582535
11/21/22,Moldova,47.4116,28.3699,594441,0,11906,582535
11/22/22,Moldova,47.4116,28.3699,594754,0,11913,582841
11/23/22,Moldova,47.4116,28.3699,594754,0,11913,582841
11/24/22,Moldova,47.4116,28.3699,594754,0,11913,582841
11/25/22,Moldova,47.4116,28.3699,594754,0,11913,582841
11/26/22,Moldova,47.4116,28.3699,594754,0,11913,582841
11/27/22,Moldova,47.4116,28.3699,594754,0,11913,582841
11/28/22,Moldova,47.4116,28.3699,594754,0,11913,582841
11/29/22,Moldova,47.4116,28.3699,595073,0,11918,583155
11/30/22,Moldova,47.4116,28.3699,595073,0,11918,583155
12/1/22,Moldova,47.4116,28.3699,595073,0,11918,583155
12/2/22,Moldova,47.4116,28.3699,595073,0,11918,583155
12/3/22,Moldova,47.4116,28.3699,595073,0,11918,583155
12/4/22,Moldova,47.4116,28.3699,595073,0,11918,583155
12/5/22,Moldova,47.4116,28.3699,595073,0,11918,583155
12/6/22,Moldova,47.4116,28.3699,595402,0,11920,583482
12/7/22,Moldova,47.4116,28.3699,595402,0,11920,583482
12/8/22,Moldova,47.4116,28.3699,595402,0,11920,583482
12/9/22,Moldova,47.4116,28.3699,595402,0,11920,583482
12/10/22,Moldova,47.4116,28.3699,595402,0,11920,583482
12/11/22,Moldova,47.4116,28.3699,595402,0,11920,583482
12/12/22,Moldova,47.4116,28.3699,595402,0,11920,583482
12/13/22,Moldova,47.4116,28.3699,595745,0,11922,583823
12/14/22,Moldova,47.4116,28.3699,595745,0,11922,583823
12/15/22,Moldova,47.4116,28.3699,595745,0,11922,583823
12/16/22,Moldova,47.4116,28.3699,595745,0,11922,583823
12/17/22,Moldova,47.4116,28.3699,595745,0,11922,583823
1/1/22,Monaco,43.7333,7.4167,4985,0,39,4946
1/2/22,Monaco,43.7333,7.4167,4985,0,39,4946
1/3/22,Monaco,43.7333,7.4167,4985,0,39,4946
1/4/22,Monaco,43.7333,7.4167,4985,0,39,4946
1/5/22,Monaco,43.7333,7.4167,5492,0,41,5451
1/6/22,Monaco,43.7333,7.4167,5593,0,42,5551
1/7/22,Monaco,43.7333,7.4167,5593,0,42,5551
1/8/22,Monaco,43.7333,7.4167,5593,0,42,5551
1/9/22,Monaco,43.7333,7.4167,5593,0,42,5551
1/10/22,Monaco,43.7333,7.4167,6087,0,42,6045
1/11/22,Monaco,43.7333,7.4167,6165,0,44,6121
1/12/22,Monaco,43.7333,7.4167,6266,0,44,6222
1/13/22,Monaco,43.7333,7.4167,6362,0,44,6318
1/14/22,Monaco,43.7333,7.4167,6485,0,44,6441
1/15/22,Monaco,43.7333,7.4167,6610,0,44,6566
1/16/22,Monaco,43.7333,7.4167,6756,0,44,6712
1/17/22,Monaco,43.7333,7.4167,6837,0,44,6793
1/18/22,Monaco,43.7333,7.4167,6943,0,44,6899
1/19/22,Monaco,43.7333,7.4167,7041,0,44,6997
1/20/22,Monaco,43.7333,7.4167,7160,0,45,7115
1/21/22,Monaco,43.7333,7.4167,7304,0,45,7259
1/22/22,Monaco,43.7333,7.4167,7451,0,45,7406
1/23/22,Monaco,43.7333,7.4167,7583,0,45,7538
1/24/22,Monaco,43.7333,7.4167,7691,0,45,7646
1/25/22,Monaco,43.7333,7.4167,7790,0,46,7744
1/26/22,Monaco,43.7333,7.4167,7790,0,46,7744
1/27/22,Monaco,43.7333,7.4167,7790,0,46,7744
1/28/22,Monaco,43.7333,7.4167,8183,0,46,8137
1/29/22,Monaco,43.7333,7.4167,8183,0,46,8137
1/30/22,Monaco,43.7333,7.4167,8183,0,46,8137
1/31/22,Monaco,43.7333,7.4167,8183,0,47,8136
2/1/22,Monaco,43.7333,7.4167,8183,0,47,8136
2/2/22,Monaco,43.7333,7.4167,8183,0,48,8135
2/3/22,Monaco,43.7333,7.4167,8183,0,48,8135
2/4/22,Monaco,43.7333,7.4167,8703,0,48,8655
2/5/22,Monaco,43.7333,7.4167,8761,0,48,8713
2/6/22,Monaco,43.7333,7.4167,8770,0,48,8722
2/7/22,Monaco,43.7333,7.4167,8770,0,48,8722
2/8/22,Monaco,43.7333,7.4167,8880,0,48,8832
2/9/22,Monaco,43.7333,7.4167,8922,0,49,8873
2/10/22,Monaco,43.7333,7.4167,8956,0,49,8907
2/11/22,Monaco,43.7333,7.4167,8988,0,49,8939
2/12/22,Monaco,43.7333,7.4167,9020,0,49,8971
2/13/22,Monaco,43.7333,7.4167,9020,0,49,8971
2/14/22,Monaco,43.7333,7.4167,9020,0,50,8970
2/15/22,Monaco,43.7333,7.4167,9085,0,50,9035
2/16/22,Monaco,43.7333,7.4167,9111,0,50,9061
2/17/22,Monaco,43.7333,7.4167,9128,0,50,9078
2/18/22,Monaco,43.7333,7.4167,9162,0,51,9111
2/19/22,Monaco,43.7333,7.4167,9186,0,51,9135
2/20/22,Monaco,43.7333,7.4167,9188,0,51,9137
2/21/22,Monaco,43.7333,7.4167,9188,0,51,9137
2/22/22,Monaco,43.7333,7.4167,9267,0,51,9216
2/23/22,Monaco,43.7333,7.4167,9305,0,51,9254
2/24/22,Monaco,43.7333,7.4167,9331,0,51,9280
2/25/22,Monaco,43.7333,7.4167,9359,0,51,9308
2/26/22,Monaco,43.7333,7.4167,9359,0,51,9308
2/27/22,Monaco,43.7333,7.4167,9359,0,51,9308
2/28/22,Monaco,43.7333,7.4167,9359,0,51,9308
3/1/22,Monaco,43.7333,7.4167,9445,0,51,9394
3/2/22,Monaco,43.7333,7.4167,9445,0,51,9394
3/3/22,Monaco,43.7333,7.4167,9445,0,51,9394
3/4/22,Monaco,43.7333,7.4167,9445,0,51,9394
3/5/22,Monaco,43.7333,7.4167,9537,0,51,9486
3/6/22,Monaco,43.7333,7.4167,9539,0,51,9488
3/7/22,Monaco,43.7333,7.4167,9539,0,51,9488
3/8/22,Monaco,43.7333,7.4167,9605,0,51,9554
3/9/22,Monaco,43.7333,7.4167,9654,0,51,9603
3/10/22,Monaco,43.7333,7.4167,9654,0,51,9603
3/11/22,Monaco,43.7333,7.4167,9736,0,51,9685
3/12/22,Monaco,43.7333,7.4167,9777,0,51,9726
3/13/22,Monaco,43.7333,7.4167,9777,0,52,9725
3/14/22,Monaco,43.7333,7.4167,9827,0,52,9775
3/15/22,Monaco,43.7333,7.4167,9901,0,52,9849
3/16/22,Monaco,43.7333,7.4167,9964,0,53,9911
3/17/22,Monaco,43.7333,7.4167,10015,0,54,9961
3/18/22,Monaco,43.7333,7.4167,10063,0,54,10009
3/19/22,Monaco,43.7333,7.4167,10124,0,54,10070
3/20/22,Monaco,43.7333,7.4167,10127,0,54,10073
3/21/22,Monaco,43.7333,7.4167,10175,0,54,10121
3/22/22,Monaco,43.7333,7.4167,10272,0,54,10218
3/23/22,Monaco,43.7333,7.4167,10369,0,54,10315
3/24/22,Monaco,43.7333,7.4167,10431,0,54,10377
3/25/22,Monaco,43.7333,7.4167,10490,0,54,10436
3/26/22,Monaco,43.7333,7.4167,10530,0,54,10476
3/27/22,Monaco,43.7333,7.4167,10530,0,54,10476
3/28/22,Monaco,43.7333,7.4167,10530,0,54,10476
3/29/22,Monaco,43.7333,7.4167,10670,0,54,10616
3/30/22,Monaco,43.7333,7.4167,10721,0,54,10667
3/31/22,Monaco,43.7333,7.4167,10758,0,54,10704
4/1/22,Monaco,43.7333,7.4167,10790,0,54,10736
4/2/22,Monaco,43.7333,7.4167,10838,0,54,10784
4/3/22,Monaco,43.7333,7.4167,10842,0,54,10788
4/4/22,Monaco,43.7333,7.4167,10872,0,54,10818
4/5/22,Monaco,43.7333,7.4167,10943,0,54,10889
4/6/22,Monaco,43.7333,7.4167,11019,0,54,10965
4/7/22,Monaco,43.7333,7.4167,11070,0,54,11016
4/8/22,Monaco,43.7333,7.4167,11127,0,54,11073
4/9/22,Monaco,43.7333,7.4167,11152,0,54,11098
4/10/22,Monaco,43.7333,7.4167,11152,0,54,11098
4/11/22,Monaco,43.7333,7.4167,11194,0,55,11139
4/12/22,Monaco,43.7333,7.4167,11261,0,56,11205
4/13/22,Monaco,43.7333,7.4167,11299,0,56,11243
4/14/22,Monaco,43.7333,7.4167,11341,0,56,11285
4/15/22,Monaco,43.7333,7.4167,11382,0,56,11326
4/16/22,Monaco,43.7333,7.4167,11402,0,56,11346
4/17/22,Monaco,43.7333,7.4167,11406,0,56,11350
4/18/22,Monaco,43.7333,7.4167,11442,0,56,11386
4/19/22,Monaco,43.7333,7.4167,11480,0,56,11424
4/20/22,Monaco,43.7333,7.4167,11520,0,56,11464
4/21/22,Monaco,43.7333,7.4167,11545,0,56,11489
4/22/22,Monaco,43.7333,7.4167,11577,0,56,11521
4/23/22,Monaco,43.7333,7.4167,11604,0,56,11548
4/24/22,Monaco,43.7333,7.4167,11605,0,56,11549
4/25/22,Monaco,43.7333,7.4167,11632,0,57,11575
4/26/22,Monaco,43.7333,7.4167,11677,0,57,11620
4/27/22,Monaco,43.7333,7.4167,11712,0,57,11655
4/28/22,Monaco,43.7333,7.4167,11736,0,57,11679
4/29/22,Monaco,43.7333,7.4167,11762,0,57,11705
4/30/22,Monaco,43.7333,7.4167,11770,0,57,11713
5/1/22,Monaco,43.7333,7.4167,11771,0,57,11714
5/2/22,Monaco,43.7333,7.4167,11801,0,57,11744
5/3/22,Monaco,43.7333,7.4167,11824,0,57,11767
5/4/22,Monaco,43.7333,7.4167,11869,0,57,11812
5/5/22,Monaco,43.7333,7.4167,11898,0,57,11841
5/6/22,Monaco,43.7333,7.4167,11917,0,57,11860
5/7/22,Monaco,43.7333,7.4167,11925,0,57,11868
5/8/22,Monaco,43.7333,7.4167,11925,0,57,11868
5/9/22,Monaco,43.7333,7.4167,11946,0,57,11889
5/10/22,Monaco,43.7333,7.4167,11972,0,57,11915
5/11/22,Monaco,43.7333,7.4167,11985,0,57,11928
5/12/22,Monaco,43.7333,7.4167,12000,0,57,11943
5/13/22,Monaco,43.7333,7.4167,12002,0,57,11945
5/14/22,Monaco,43.7333,7.4167,12004,0,57,11947
5/15/22,Monaco,43.7333,7.4167,12006,0,57,11949
5/16/22,Monaco,43.7333,7.4167,12035,0,57,11978
5/17/22,Monaco,43.7333,7.4167,12060,0,57,12003
5/18/22,Monaco,43.7333,7.4167,12071,0,57,12014
5/19/22,Monaco,43.7333,7.4167,12085,0,57,12028
5/20/22,Monaco,43.7333,7.4167,12099,0,57,12042
5/21/22,Monaco,43.7333,7.4167,12109,0,57,12052
5/22/22,Monaco,43.7333,7.4167,12023,0,57,11966
5/23/22,Monaco,43.7333,7.4167,12124,0,57,12067
5/24/22,Monaco,43.7333,7.4167,12137,0,57,12080
5/25/22,Monaco,43.7333,7.4167,12152,0,57,12095
5/26/22,Monaco,43.7333,7.4167,12162,0,57,12105
5/27/22,Monaco,43.7333,7.4167,12162,0,57,12105
5/28/22,Monaco,43.7333,7.4167,12168,0,57,12111
5/29/22,Monaco,43.7333,7.4167,12170,0,57,12113
5/30/22,Monaco,43.7333,7.4167,12186,0,57,12129
5/31/22,Monaco,43.7333,7.4167,12216,0,57,12159
6/1/22,Monaco,43.7333,7.4167,12230,0,57,12173
6/2/22,Monaco,43.7333,7.4167,12258,0,57,12201
6/3/22,Monaco,43.7333,7.4167,12284,0,57,12227
6/4/22,Monaco,43.7333,7.4167,12300,0,57,12243
6/5/22,Monaco,43.7333,7.4167,12306,0,57,12249
6/6/22,Monaco,43.7333,7.4167,12319,0,57,12262
6/7/22,Monaco,43.7333,7.4167,12360,0,57,12303
6/8/22,Monaco,43.7333,7.4167,12387,0,57,12330
6/9/22,Monaco,43.7333,7.4167,12420,0,57,12363
6/10/22,Monaco,43.7333,7.4167,12451,0,57,12394
6/11/22,Monaco,43.7333,7.4167,12486,0,57,12429
6/12/22,Monaco,43.7333,7.4167,12489,0,57,12432
6/13/22,Monaco,43.7333,7.4167,12514,0,57,12457
6/14/22,Monaco,43.7333,7.4167,12514,0,57,12457
6/15/22,Monaco,43.7333,7.4167,12550,0,57,12493
6/16/22,Monaco,43.7333,7.4167,12581,0,57,12524
6/17/22,Monaco,43.7333,7.4167,12581,0,57,12524
6/18/22,Monaco,43.7333,7.4167,12616,0,57,12559
6/19/22,Monaco,43.7333,7.4167,12616,0,57,12559
6/20/22,Monaco,43.7333,7.4167,12616,0,57,12559
6/21/22,Monaco,43.7333,7.4167,12672,0,57,12615
6/22/22,Monaco,43.7333,7.4167,12715,0,57,12658
6/23/22,Monaco,43.7333,7.4167,12746,0,57,12689
6/24/22,Monaco,43.7333,7.4167,12769,0,57,12712
6/25/22,Monaco,43.7333,7.4167,12808,0,57,12751
6/26/22,Monaco,43.7333,7.4167,12808,0,57,12751
6/27/22,Monaco,43.7333,7.4167,12887,0,57,12830
6/28/22,Monaco,43.7333,7.4167,12887,0,57,12830
6/29/22,Monaco,43.7333,7.4167,12945,0,58,12887
6/30/22,Monaco,43.7333,7.4167,13006,0,58,12948
7/1/22,Monaco,43.7333,7.4167,13047,0,58,12989
7/2/22,Monaco,43.7333,7.4167,13100,0,58,13042
7/3/22,Monaco,43.7333,7.4167,13100,0,58,13042
7/4/22,Monaco,43.7333,7.4167,13100,0,59,13041
7/5/22,Monaco,43.7333,7.4167,13197,0,59,13138
7/6/22,Monaco,43.7333,7.4167,13267,0,59,13208
7/7/22,Monaco,43.7333,7.4167,13358,0,59,13299
7/8/22,Monaco,43.7333,7.4167,13414,0,59,13355
7/9/22,Monaco,43.7333,7.4167,13480,0,59,13421
7/10/22,Monaco,43.7333,7.4167,13480,0,59,13421
7/11/22,Monaco,43.7333,7.4167,13480,0,59,13421
7/12/22,Monaco,43.7333,7.4167,13576,0,60,13516
7/13/22,Monaco,43.7333,7.4167,13645,0,60,13585
7/14/22,Monaco,43.7333,7.4167,13696,0,60,13636
7/15/22,Monaco,43.7333,7.4167,13739,0,60,13679
7/16/22,Monaco,43.7333,7.4167,13739,0,60,13679
7/17/22,Monaco,43.7333,7.4167,13739,0,60,13679
7/18/22,Monaco,43.7333,7.4167,13779,0,61,13718
7/19/22,Monaco,43.7333,7.4167,13845,0,61,13784
7/20/22,Monaco,43.7333,7.4167,13887,0,61,13826
7/21/22,Monaco,43.7333,7.4167,13914,0,61,13853
7/22/22,Monaco,43.7333,7.4167,13964,0,61,13903
7/23/22,Monaco,43.7333,7.4167,13964,0,61,13903
7/24/22,Monaco,43.7333,7.4167,13964,0,61,13903
7/25/22,Monaco,43.7333,7.4167,13964,0,61,13903
7/26/22,Monaco,43.7333,7.4167,13995,0,61,13934
7/27/22,Monaco,43.7333,7.4167,14014,0,61,13953
7/28/22,Monaco,43.7333,7.4167,14037,0,61,13976
7/29/22,Monaco,43.7333,7.4167,14059,0,61,13998
7/30/22,Monaco,43.7333,7.4167,14059,0,61,13998
7/31/22,Monaco,43.7333,7.4167,14059,0,61,13998
8/1/22,Monaco,43.7333,7.4167,14129,0,61,14068
8/2/22,Monaco,43.7333,7.4167,14129,0,61,14068
8/3/22,Monaco,43.7333,7.4167,14138,0,61,14077
8/4/22,Monaco,43.7333,7.4167,14157,0,61,14096
8/5/22,Monaco,43.7333,7.4167,14174,0,61,14113
8/6/22,Monaco,43.7333,7.4167,14174,0,61,14113
8/7/22,Monaco,43.7333,7.4167,14174,0,61,14113
8/8/22,Monaco,43.7333,7.4167,14198,0,61,14137
8/9/22,Monaco,43.7333,7.4167,14218,0,61,14157
8/10/22,Monaco,43.7333,7.4167,14218,0,61,14157
8/11/22,Monaco,43.7333,7.4167,14266,0,61,14205
8/12/22,Monaco,43.7333,7.4167,14277,0,61,14216
8/13/22,Monaco,43.7333,7.4167,14277,0,61,14216
8/14/22,Monaco,43.7333,7.4167,14277,0,61,14216
8/15/22,Monaco,43.7333,7.4167,14277,0,61,14216
8/16/22,Monaco,43.7333,7.4167,14277,0,61,14216
8/17/22,Monaco,43.7333,7.4167,14299,0,61,14238
8/18/22,Monaco,43.7333,7.4167,14299,0,61,14238
8/19/22,Monaco,43.7333,7.4167,14309,0,61,14248
8/20/22,Monaco,43.7333,7.4167,14309,0,61,14248
8/21/22,Monaco,43.7333,7.4167,14309,0,61,14248
8/22/22,Monaco,43.7333,7.4167,14323,0,61,14262
8/23/22,Monaco,43.7333,7.4167,14333,0,61,14272
8/24/22,Monaco,43.7333,7.4167,14341,0,61,14280
8/25/22,Monaco,43.7333,7.4167,14357,0,61,14296
8/26/22,Monaco,43.7333,7.4167,14363,0,61,14302
8/27/22,Monaco,43.7333,7.4167,14363,0,61,14302
8/28/22,Monaco,43.7333,7.4167,14363,0,61,14302
8/29/22,Monaco,43.7333,7.4167,14363,0,61,14302
8/30/22,Monaco,43.7333,7.4167,14375,0,61,14314
8/31/22,Monaco,43.7333,7.4167,14379,0,61,14318
9/1/22,Monaco,43.7333,7.4167,14384,0,61,14323
9/2/22,Monaco,43.7333,7.4167,14398,0,61,14337
9/3/22,Monaco,43.7333,7.4167,14404,0,61,14343
9/4/22,Monaco,43.7333,7.4167,14404,0,61,14343
9/5/22,Monaco,43.7333,7.4167,14404,0,61,14343
9/6/22,Monaco,43.7333,7.4167,14412,0,63,14349
9/7/22,Monaco,43.7333,7.4167,14417,0,63,14354
9/8/22,Monaco,43.7333,7.4167,14424,0,63,14361
9/9/22,Monaco,43.7333,7.4167,14436,0,63,14373
9/10/22,Monaco,43.7333,7.4167,14436,0,63,14373
9/11/22,Monaco,43.7333,7.4167,14436,0,63,14373
9/12/22,Monaco,43.7333,7.4167,14436,0,63,14373
9/13/22,Monaco,43.7333,7.4167,14451,0,63,14388
9/14/22,Monaco,43.7333,7.4167,14451,0,63,14388
9/15/22,Monaco,43.7333,7.4167,14471,0,63,14408
9/16/22,Monaco,43.7333,7.4167,14501,0,63,14438
9/17/22,Monaco,43.7333,7.4167,14501,0,63,14438
9/18/22,Monaco,43.7333,7.4167,14501,0,63,14438
9/19/22,Monaco,43.7333,7.4167,14501,0,63,14438
9/20/22,Monaco,43.7333,7.4167,14521,0,63,14458
9/21/22,Monaco,43.7333,7.4167,14527,0,63,14464
9/22/22,Monaco,43.7333,7.4167,14532,0,63,14469
9/23/22,Monaco,43.7333,7.4167,14541,0,63,14478
9/24/22,Monaco,43.7333,7.4167,14554,0,63,14491
9/25/22,Monaco,43.7333,7.4167,14554,0,63,14491
9/26/22,Monaco,43.7333,7.4167,14572,0,63,14509
9/27/22,Monaco,43.7333,7.4167,14586,0,63,14523
9/28/22,Monaco,43.7333,7.4167,14608,0,63,14545
9/29/22,Monaco,43.7333,7.4167,14608,0,63,14545
9/30/22,Monaco,43.7333,7.4167,14622,0,63,14559
10/1/22,Monaco,43.7333,7.4167,14622,0,63,14559
10/2/22,Monaco,43.7333,7.4167,14622,0,63,14559
10/3/22,Monaco,43.7333,7.4167,14622,0,63,14559
10/4/22,Monaco,43.7333,7.4167,14666,0,63,14603
10/5/22,Monaco,43.7333,7.4167,14677,0,63,14614
10/6/22,Monaco,43.7333,7.4167,14689,0,63,14626
10/7/22,Monaco,43.7333,7.4167,14708,0,63,14645
10/8/22,Monaco,43.7333,7.4167,14717,0,63,14654
10/9/22,Monaco,43.7333,7.4167,14717,0,63,14654
10/10/22,Monaco,43.7333,7.4167,14717,0,63,14654
10/11/22,Monaco,43.7333,7.4167,14764,0,63,14701
10/12/22,Monaco,43.7333,7.4167,14774,0,63,14711
10/13/22,Monaco,43.7333,7.4167,14782,0,63,14719
10/14/22,Monaco,43.7333,7.4167,14782,0,63,14719
10/15/22,Monaco,43.7333,7.4167,14790,0,63,14727
10/16/22,Monaco,43.7333,7.4167,14790,0,63,14727
10/17/22,Monaco,43.7333,7.4167,14808,0,63,14745
10/18/22,Monaco,43.7333,7.4167,14808,0,63,14745
10/19/22,Monaco,43.7333,7.4167,14852,0,63,14789
10/20/22,Monaco,43.7333,7.4167,14873,0,63,14810
10/21/22,Monaco,43.7333,7.4167,14885,0,63,14822
10/22/22,Monaco,43.7333,7.4167,14885,0,63,14822
10/23/22,Monaco,43.7333,7.4167,14885,0,63,14822
10/24/22,Monaco,43.7333,7.4167,14885,0,64,14821
10/25/22,Monaco,43.7333,7.4167,14913,0,64,14849
10/26/22,Monaco,43.7333,7.4167,14926,0,65,14861
10/27/22,Monaco,43.7333,7.4167,14936,0,65,14871
10/28/22,Monaco,43.7333,7.4167,14936,0,65,14871
10/29/22,Monaco,43.7333,7.4167,14948,0,65,14883
10/30/22,Monaco,43.7333,7.4167,14948,0,65,14883
10/31/22,Monaco,43.7333,7.4167,14963,0,65,14898
11/1/22,Monaco,43.7333,7.4167,14963,0,65,14898
11/2/22,Monaco,43.7333,7.4167,14963,0,65,14898
11/3/22,Monaco,43.7333,7.4167,14988,0,65,14923
11/4/22,Monaco,43.7333,7.4167,15005,0,65,14940
11/5/22,Monaco,43.7333,7.4167,15005,0,65,14940
11/6/22,Monaco,43.7333,7.4167,15005,0,65,14940
11/7/22,Monaco,43.7333,7.4167,15005,0,65,14940
11/8/22,Monaco,43.7333,7.4167,15027,0,65,14962
11/9/22,Monaco,43.7333,7.4167,15057,0,65,14992
11/10/22,Monaco,43.7333,7.4167,15057,0,65,14992
11/11/22,Monaco,43.7333,7.4167,15071,0,65,15006
11/12/22,Monaco,43.7333,7.4167,15071,0,65,15006
11/13/22,Monaco,43.7333,7.4167,15071,0,65,15006
11/14/22,Monaco,43.7333,7.4167,15112,0,65,15047
11/15/22,Monaco,43.7333,7.4167,15137,0,65,15072
11/16/22,Monaco,43.7333,7.4167,15137,0,65,15072
11/17/22,Monaco,43.7333,7.4167,15165,0,65,15100
11/18/22,Monaco,43.7333,7.4167,15195,0,65,15130
11/19/22,Monaco,43.7333,7.4167,15195,0,65,15130
11/20/22,Monaco,43.7333,7.4167,15195,0,65,15130
11/21/22,Monaco,43.7333,7.4167,15236,0,65,15171
11/22/22,Monaco,43.7333,7.4167,15261,0,65,15196
11/23/22,Monaco,43.7333,7.4167,15261,0,65,15196
11/24/22,Monaco,43.7333,7.4167,15285,0,65,15220
11/25/22,Monaco,43.7333,7.4167,15285,0,65,15220
11/26/22,Monaco,43.7333,7.4167,15339,0,65,15274
11/27/22,Monaco,43.7333,7.4167,15339,0,65,15274
11/28/22,Monaco,43.7333,7.4167,15339,0,65,15274
11/29/22,Monaco,43.7333,7.4167,15389,0,65,15324
11/30/22,Monaco,43.7333,7.4167,15442,0,65,15377
12/1/22,Monaco,43.7333,7.4167,15472,0,65,15407
12/2/22,Monaco,43.7333,7.4167,15509,0,65,15444
12/3/22,Monaco,43.7333,7.4167,15540,0,65,15475
12/4/22,Monaco,43.7333,7.4167,15540,0,65,15475
12/5/22,Monaco,43.7333,7.4167,15598,0,65,15533
12/6/22,Monaco,43.7333,7.4167,15643,0,65,15578
12/7/22,Monaco,43.7333,7.4167,15674,0,65,15609
12/8/22,Monaco,43.7333,7.4167,15674,0,65,15609
12/9/22,Monaco,43.7333,7.4167,15713,0,65,15648
12/10/22,Monaco,43.7333,7.4167,15713,0,65,15648
12/11/22,Monaco,43.7333,7.4167,15713,0,65,15648
12/12/22,Monaco,43.7333,7.4167,15713,0,65,15648
12/13/22,Monaco,43.7333,7.4167,15784,0,65,15719
12/14/22,Monaco,43.7333,7.4167,15784,0,65,15719
12/15/22,Monaco,43.7333,7.4167,15816,0,65,15751
12/16/22,Monaco,43.7333,7.4167,15833,0,65,15768
12/17/22,Monaco,43.7333,7.4167,15833,0,65,15768
1/1/22,Mongolia,46.8625,103.8467,693119,0,1986,691133
1/2/22,Mongolia,46.8625,103.8467,693546,0,1987,691559
1/3/22,Mongolia,46.8625,103.8467,693849,0,1987,691862
1/4/22,Mongolia,46.8625,103.8467,695196,0,1989,693207
1/5/22,Mongolia,46.8625,103.8467,695941,0,1992,693949
1/6/22,Mongolia,46.8625,103.8467,697810,0,1994,695816
1/7/22,Mongolia,46.8625,103.8467,699811,0,1995,697816
1/8/22,Mongolia,46.8625,103.8467,702164,0,1997,700167
1/9/22,Mongolia,46.8625,103.8467,703592,0,1997,701595
1/10/22,Mongolia,46.8625,103.8467,705986,0,2001,703985
1/11/22,Mongolia,46.8625,103.8467,709429,0,2001,707428
1/12/22,Mongolia,46.8625,103.8467,712651,0,2003,710648
1/13/22,Mongolia,46.8625,103.8467,715261,0,2006,713255
1/14/22,Mongolia,46.8625,103.8467,721541,0,2009,719532
1/15/22,Mongolia,46.8625,103.8467,729889,0,2011,727878
1/16/22,Mongolia,46.8625,103.8467,736978,0,2012,734966
1/17/22,Mongolia,46.8625,103.8467,741682,0,2013,739669
1/18/22,Mongolia,46.8625,103.8467,747322,0,2016,745306
1/19/22,Mongolia,46.8625,103.8467,756393,0,2016,754377
1/20/22,Mongolia,46.8625,103.8467,760834,0,2019,758815
1/21/22,Mongolia,46.8625,103.8467,771893,0,2020,769873
1/22/22,Mongolia,46.8625,103.8467,780162,0,2020,778142
1/23/22,Mongolia,46.8625,103.8467,789680,0,2020,787660
1/24/22,Mongolia,46.8625,103.8467,794908,0,2021,792887
1/25/22,Mongolia,46.8625,103.8467,799779,0,2025,797754
1/26/22,Mongolia,46.8625,103.8467,812089,0,2027,810062
1/27/22,Mongolia,46.8625,103.8467,819857,0,2029,817828
1/28/22,Mongolia,46.8625,103.8467,827753,0,2031,825722
1/29/22,Mongolia,46.8625,103.8467,834399,0,2031,832368
1/30/22,Mongolia,46.8625,103.8467,837124,0,2034,835090
1/31/22,Mongolia,46.8625,103.8467,841848,0,2036,839812
2/1/22,Mongolia,46.8625,103.8467,846940,0,2040,844900
2/2/22,Mongolia,46.8625,103.8467,849668,0,2042,847626
2/3/22,Mongolia,46.8625,103.8467,853140,0,2043,851097
2/4/22,Mongolia,46.8625,103.8467,855079,0,2045,853034
2/5/22,Mongolia,46.8625,103.8467,858376,0,2049,856327
2/6/22,Mongolia,46.8625,103.8467,860116,0,2052,858064
2/7/22,Mongolia,46.8625,103.8467,860976,0,2055,858921
2/8/22,Mongolia,46.8625,103.8467,860976,0,2055,858921
2/9/22,Mongolia,46.8625,103.8467,863372,0,2059,861313
2/10/22,Mongolia,46.8625,103.8467,864564,0,2062,862502
2/11/22,Mongolia,46.8625,103.8467,875440,0,2065,873375
2/12/22,Mongolia,46.8625,103.8467,875440,0,2067,873373
2/13/22,Mongolia,46.8625,103.8467,875440,0,2072,873368
2/14/22,Mongolia,46.8625,103.8467,885554,0,2074,883480
2/15/22,Mongolia,46.8625,103.8467,888363,0,2076,886287
2/16/22,Mongolia,46.8625,103.8467,891267,0,2077,889190
2/17/22,Mongolia,46.8625,103.8467,893721,0,2077,891644
2/18/22,Mongolia,46.8625,103.8467,893721,0,2080,891641
2/19/22,Mongolia,46.8625,103.8467,893721,0,2085,891636
2/20/22,Mongolia,46.8625,103.8467,893721,0,2087,891634
2/21/22,Mongolia,46.8625,103.8467,899002,0,2087,896915
2/22/22,Mongolia,46.8625,103.8467,899706,0,2087,897619
2/23/22,Mongolia,46.8625,103.8467,903150,0,2089,901061
2/24/22,Mongolia,46.8625,103.8467,904231,0,2091,902140
2/25/22,Mongolia,46.8625,103.8467,905968,0,2095,903873
2/26/22,Mongolia,46.8625,103.8467,905968,0,2095,903873
2/27/22,Mongolia,46.8625,103.8467,905968,0,2096,903872
2/28/22,Mongolia,46.8625,103.8467,908157,0,2096,906061
3/1/22,Mongolia,46.8625,103.8467,908157,0,2098,906059
3/2/22,Mongolia,46.8625,103.8467,909379,0,2099,907280
3/3/22,Mongolia,46.8625,103.8467,910377,0,2100,908277
3/4/22,Mongolia,46.8625,103.8467,911183,0,2101,909082
3/5/22,Mongolia,46.8625,103.8467,911183,0,2101,909082
3/6/22,Mongolia,46.8625,103.8467,911183,0,2102,909081
3/7/22,Mongolia,46.8625,103.8467,913255,0,2104,911151
3/8/22,Mongolia,46.8625,103.8467,913444,0,2104,911340
3/9/22,Mongolia,46.8625,103.8467,914016,0,2104,911912
3/10/22,Mongolia,46.8625,103.8467,914536,0,2105,912431
3/11/22,Mongolia,46.8625,103.8467,914536,0,2105,912431
3/12/22,Mongolia,46.8625,103.8467,914536,0,2105,912431
3/13/22,Mongolia,46.8625,103.8467,914536,0,2105,912431
3/14/22,Mongolia,46.8625,103.8467,915811,0,2105,913706
3/15/22,Mongolia,46.8625,103.8467,915908,0,2105,913803
3/16/22,Mongolia,46.8625,103.8467,916126,0,2105,914021
3/17/22,Mongolia,46.8625,103.8467,916445,0,2105,914340
3/18/22,Mongolia,46.8625,103.8467,916723,0,2106,914617
3/19/22,Mongolia,46.8625,103.8467,917174,0,2108,915066
3/20/22,Mongolia,46.8625,103.8467,917213,0,2108,915105
3/21/22,Mongolia,46.8625,103.8467,917213,0,2108,915105
3/22/22,Mongolia,46.8625,103.8467,917406,0,2108,915298
3/23/22,Mongolia,46.8625,103.8467,917579,0,2108,915471
3/24/22,Mongolia,46.8625,103.8467,917634,0,2108,915526
3/25/22,Mongolia,46.8625,103.8467,917737,0,2108,915629
3/26/22,Mongolia,46.8625,103.8467,917810,0,2108,915702
3/27/22,Mongolia,46.8625,103.8467,917835,0,2108,915727
3/28/22,Mongolia,46.8625,103.8467,918904,0,2108,916796
3/29/22,Mongolia,46.8625,103.8467,918991,0,2108,916883
3/30/22,Mongolia,46.8625,103.8467,919076,0,2108,916968
3/31/22,Mongolia,46.8625,103.8467,919188,0,2108,917080
4/1/22,Mongolia,46.8625,103.8467,919315,0,2108,917207
4/2/22,Mongolia,46.8625,103.8467,919398,0,2108,917290
4/3/22,Mongolia,46.8625,103.8467,919463,0,2108,917355
4/4/22,Mongolia,46.8625,103.8467,919544,0,2108,917436
4/5/22,Mongolia,46.8625,103.8467,919625,0,2108,917517
4/6/22,Mongolia,46.8625,103.8467,919712,0,2108,917604
4/7/22,Mongolia,46.8625,103.8467,919784,0,2108,917676
4/8/22,Mongolia,46.8625,103.8467,919870,0,2108,917762
4/9/22,Mongolia,46.8625,103.8467,919937,0,2108,917829
4/10/22,Mongolia,46.8625,103.8467,919989,0,2108,917881
4/11/22,Mongolia,46.8625,103.8467,920004,0,2108,917896
4/12/22,Mongolia,46.8625,103.8467,920044,0,2108,917936
4/13/22,Mongolia,46.8625,103.8467,920089,0,2108,917981
4/14/22,Mongolia,46.8625,103.8467,920119,0,2108,918011
4/15/22,Mongolia,46.8625,103.8467,920160,0,2108,918052
4/16/22,Mongolia,46.8625,103.8467,920183,0,2108,918075
4/17/22,Mongolia,46.8625,103.8467,920206,0,2108,918098
4/18/22,Mongolia,46.8625,103.8467,920206,0,2108,918098
4/19/22,Mongolia,46.8625,103.8467,920240,0,2108,918132
4/20/22,Mongolia,46.8625,103.8467,920291,0,2108,918183
4/21/22,Mongolia,46.8625,103.8467,920332,0,2108,918224
4/22/22,Mongolia,46.8625,103.8467,920361,0,2108,918253
4/23/22,Mongolia,46.8625,103.8467,920391,0,2108,918283
4/24/22,Mongolia,46.8625,103.8467,920421,0,2108,918313
4/25/22,Mongolia,46.8625,103.8467,920436,0,2108,918328
4/26/22,Mongolia,46.8625,103.8467,920486,0,2108,918378
4/27/22,Mongolia,46.8625,103.8467,920553,0,2108,918445
4/28/22,Mongolia,46.8625,103.8467,920595,0,2108,918487
4/29/22,Mongolia,46.8625,103.8467,920671,0,2110,918561
4/30/22,Mongolia,46.8625,103.8467,920781,0,2110,918671
5/1/22,Mongolia,46.8625,103.8467,920781,0,2110,918671
5/2/22,Mongolia,46.8625,103.8467,921425,0,2110,919315
5/3/22,Mongolia,46.8625,103.8467,921425,0,2110,919315
5/4/22,Mongolia,46.8625,103.8467,921425,0,2110,919315
5/5/22,Mongolia,46.8625,103.8467,921425,0,2110,919315
5/6/22,Mongolia,46.8625,103.8467,921425,0,2110,919315
5/7/22,Mongolia,46.8625,103.8467,921425,0,2110,919315
5/8/22,Mongolia,46.8625,103.8467,921425,0,2110,919315
5/9/22,Mongolia,46.8625,103.8467,922227,0,2111,920116
5/10/22,Mongolia,46.8625,103.8467,922227,0,2111,920116
5/11/22,Mongolia,46.8625,103.8467,922227,0,2111,920116
5/12/22,Mongolia,46.8625,103.8467,922227,0,2111,920116
5/13/22,Mongolia,46.8625,103.8467,922227,0,2112,920115
5/14/22,Mongolia,46.8625,103.8467,922227,0,2113,920114
5/15/22,Mongolia,46.8625,103.8467,922227,0,2113,920114
5/16/22,Mongolia,46.8625,103.8467,922227,0,2113,920114
5/17/22,Mongolia,46.8625,103.8467,922227,0,2113,920114
5/18/22,Mongolia,46.8625,103.8467,924035,0,2114,921921
5/19/22,Mongolia,46.8625,103.8467,924035,0,2114,921921
5/20/22,Mongolia,46.8625,103.8467,924035,0,2114,921921
5/21/22,Mongolia,46.8625,103.8467,924035,0,2114,921921
5/22/22,Mongolia,46.8625,103.8467,922618,0,2114,920504
5/23/22,Mongolia,46.8625,103.8467,924035,0,2114,921921
5/24/22,Mongolia,46.8625,103.8467,924035,0,2114,921921
5/25/22,Mongolia,46.8625,103.8467,924035,0,2114,921921
5/26/22,Mongolia,46.8625,103.8467,924035,0,2114,921921
5/27/22,Mongolia,46.8625,103.8467,924035,0,2114,921921
5/28/22,Mongolia,46.8625,103.8467,924035,0,2114,921921
5/29/22,Mongolia,46.8625,103.8467,925073,0,2115,922958
5/30/22,Mongolia,46.8625,103.8467,925073,0,2115,922958
5/31/22,Mongolia,46.8625,103.8467,925073,0,2115,922958
6/1/22,Mongolia,46.8625,103.8467,925073,0,2115,922958
6/2/22,Mongolia,46.8625,103.8467,925149,0,2115,923034
6/3/22,Mongolia,46.8625,103.8467,925227,0,2115,923112
6/4/22,Mongolia,46.8625,103.8467,925433,0,2115,923318
6/5/22,Mongolia,46.8625,103.8467,926282,0,2115,924167
6/6/22,Mongolia,46.8625,103.8467,927272,0,2115,925157
6/7/22,Mongolia,46.8625,103.8467,927272,0,2115,925157
6/8/22,Mongolia,46.8625,103.8467,927272,0,2115,925157
6/9/22,Mongolia,46.8625,103.8467,927272,0,2116,925156
6/10/22,Mongolia,46.8625,103.8467,927272,0,2116,925156
6/11/22,Mongolia,46.8625,103.8467,927272,0,2116,925156
6/12/22,Mongolia,46.8625,103.8467,927272,0,2116,925156
6/13/22,Mongolia,46.8625,103.8467,928013,0,2116,925897
6/14/22,Mongolia,46.8625,103.8467,928013,0,2116,925897
6/15/22,Mongolia,46.8625,103.8467,928013,0,2116,925897
6/16/22,Mongolia,46.8625,103.8467,928013,0,2116,925897
6/17/22,Mongolia,46.8625,103.8467,928013,0,2116,925897
6/18/22,Mongolia,46.8625,103.8467,928013,0,2116,925897
6/19/22,Mongolia,46.8625,103.8467,928586,0,2116,926470
6/20/22,Mongolia,46.8625,103.8467,928586,0,2116,926470
6/21/22,Mongolia,46.8625,103.8467,928586,0,2116,926470
6/22/22,Mongolia,46.8625,103.8467,928586,0,2116,926470
6/23/22,Mongolia,46.8625,103.8467,928586,0,2116,926470
6/24/22,Mongolia,46.8625,103.8467,928586,0,2116,926470
6/25/22,Mongolia,46.8625,103.8467,928586,0,2116,926470
6/26/22,Mongolia,46.8625,103.8467,928586,0,2116,926470
6/27/22,Mongolia,46.8625,103.8467,928586,0,2116,926470
6/28/22,Mongolia,46.8625,103.8467,928586,0,2116,926470
6/29/22,Mongolia,46.8625,103.8467,928586,0,2118,926468
6/30/22,Mongolia,46.8625,103.8467,928586,0,2118,926468
7/1/22,Mongolia,46.8625,103.8467,928878,0,2118,926760
7/2/22,Mongolia,46.8625,103.8467,928981,0,2118,926863
7/3/22,Mongolia,46.8625,103.8467,928981,0,2118,926863
7/4/22,Mongolia,46.8625,103.8467,928981,0,2118,926863
7/5/22,Mongolia,46.8625,103.8467,928981,0,2118,926863
7/6/22,Mongolia,46.8625,103.8467,929311,0,2118,927193
7/7/22,Mongolia,46.8625,103.8467,929543,0,2119,927424
7/8/22,Mongolia,46.8625,103.8467,929653,0,2119,927534
7/9/22,Mongolia,46.8625,103.8467,929653,0,2119,927534
7/10/22,Mongolia,46.8625,103.8467,929653,0,2119,927534
7/11/22,Mongolia,46.8625,103.8467,929653,0,2119,927534
7/12/22,Mongolia,46.8625,103.8467,929653,0,2119,927534
7/13/22,Mongolia,46.8625,103.8467,930327,0,2119,928208
7/14/22,Mongolia,46.8625,103.8467,930418,0,2119,928299
7/15/22,Mongolia,46.8625,103.8467,930677,0,2119,928558
7/16/22,Mongolia,46.8625,103.8467,930677,0,2119,928558
7/17/22,Mongolia,46.8625,103.8467,930677,0,2119,928558
7/18/22,Mongolia,46.8625,103.8467,930677,0,2119,928558
7/19/22,Mongolia,46.8625,103.8467,932058,0,2119,929939
7/20/22,Mongolia,46.8625,103.8467,933241,0,2119,931122
7/21/22,Mongolia,46.8625,103.8467,934357,0,2119,932238
7/22/22,Mongolia,46.8625,103.8467,934357,0,2119,932238
7/23/22,Mongolia,46.8625,103.8467,934357,0,2119,932238
7/24/22,Mongolia,46.8625,103.8467,934357,0,2119,932238
7/25/22,Mongolia,46.8625,103.8467,937971,0,2119,935852
7/26/22,Mongolia,46.8625,103.8467,937971,0,2119,935852
7/27/22,Mongolia,46.8625,103.8467,939010,0,2119,936891
7/28/22,Mongolia,46.8625,103.8467,942186,0,2119,940067
7/29/22,Mongolia,46.8625,103.8467,943690,0,2119,941571
7/30/22,Mongolia,46.8625,103.8467,943690,0,2119,941571
7/31/22,Mongolia,46.8625,103.8467,943690,0,2119,941571
8/1/22,Mongolia,46.8625,103.8467,943690,0,2119,941571
8/2/22,Mongolia,46.8625,103.8467,948421,0,2119,946302
8/3/22,Mongolia,46.8625,103.8467,951735,0,2120,949615
8/4/22,Mongolia,46.8625,103.8467,951735,0,2120,949615
8/5/22,Mongolia,46.8625,103.8467,954305,0,2121,952184
8/6/22,Mongolia,46.8625,103.8467,954305,0,2121,952184
8/7/22,Mongolia,46.8625,103.8467,954305,0,2121,952184
8/8/22,Mongolia,46.8625,103.8467,961171,0,2123,959048
8/9/22,Mongolia,46.8625,103.8467,962494,0,2123,960371
8/10/22,Mongolia,46.8625,103.8467,964649,0,2123,962526
8/11/22,Mongolia,46.8625,103.8467,966423,0,2123,964300
8/12/22,Mongolia,46.8625,103.8467,966423,0,2123,964300
8/13/22,Mongolia,46.8625,103.8467,966423,0,2123,964300
8/14/22,Mongolia,46.8625,103.8467,966423,0,2123,964300
8/15/22,Mongolia,46.8625,103.8467,970534,0,2123,968411
8/16/22,Mongolia,46.8625,103.8467,970534,0,2123,968411
8/17/22,Mongolia,46.8625,103.8467,972443,0,2124,970319
8/18/22,Mongolia,46.8625,103.8467,973272,0,2124,971148
8/19/22,Mongolia,46.8625,103.8467,973272,0,2124,971148
8/20/22,Mongolia,46.8625,103.8467,973272,0,2124,971148
8/21/22,Mongolia,46.8625,103.8467,973272,0,2124,971148
8/22/22,Mongolia,46.8625,103.8467,974233,0,2125,972108
8/23/22,Mongolia,46.8625,103.8467,976114,0,2125,973989
8/24/22,Mongolia,46.8625,103.8467,976751,0,2125,974626
8/25/22,Mongolia,46.8625,103.8467,976751,0,2125,974626
8/26/22,Mongolia,46.8625,103.8467,976751,0,2125,974626
8/27/22,Mongolia,46.8625,103.8467,976751,0,2125,974626
8/28/22,Mongolia,46.8625,103.8467,976751,0,2125,974626
8/29/22,Mongolia,46.8625,103.8467,976751,0,2125,974626
8/30/22,Mongolia,46.8625,103.8467,978960,0,2128,976832
8/31/22,Mongolia,46.8625,103.8467,978960,0,2128,976832
9/1/22,Mongolia,46.8625,103.8467,979985,0,2129,977856
9/2/22,Mongolia,46.8625,103.8467,979985,0,2129,977856
9/3/22,Mongolia,46.8625,103.8467,979985,0,2129,977856
9/4/22,Mongolia,46.8625,103.8467,979985,0,2129,977856
9/5/22,Mongolia,46.8625,103.8467,980283,0,2129,978154
9/6/22,Mongolia,46.8625,103.8467,980442,0,2129,978313
9/7/22,Mongolia,46.8625,103.8467,980442,0,2129,978313
9/8/22,Mongolia,46.8625,103.8467,980442,0,2129,978313
9/9/22,Mongolia,46.8625,103.8467,980442,0,2129,978313
9/10/22,Mongolia,46.8625,103.8467,980442,0,2129,978313
9/11/22,Mongolia,46.8625,103.8467,980442,0,2129,978313
9/12/22,Mongolia,46.8625,103.8467,981200,0,2130,979070
9/13/22,Mongolia,46.8625,103.8467,981200,0,2130,979070
9/14/22,Mongolia,46.8625,103.8467,981618,0,2130,979488
9/15/22,Mongolia,46.8625,103.8467,981618,0,2130,979488
9/16/22,Mongolia,46.8625,103.8467,981963,0,2130,979833
9/17/22,Mongolia,46.8625,103.8467,981963,0,2130,979833
9/18/22,Mongolia,46.8625,103.8467,981963,0,2130,979833
9/19/22,Mongolia,46.8625,103.8467,981963,0,2130,979833
9/20/22,Mongolia,46.8625,103.8467,982347,0,2131,980216
9/21/22,Mongolia,46.8625,103.8467,982478,0,2131,980347
9/22/22,Mongolia,46.8625,103.8467,982478,0,2131,980347
9/23/22,Mongolia,46.8625,103.8467,982551,0,2131,980420
9/24/22,Mongolia,46.8625,103.8467,982551,0,2131,980420
9/25/22,Mongolia,46.8625,103.8467,982551,0,2131,980420
9/26/22,Mongolia,46.8625,103.8467,982726,0,2131,980595
9/27/22,Mongolia,46.8625,103.8467,982726,0,2131,980595
9/28/22,Mongolia,46.8625,103.8467,982864,0,2131,980733
9/29/22,Mongolia,46.8625,103.8467,982864,0,2131,980733
9/30/22,Mongolia,46.8625,103.8467,982864,0,2131,980733
10/1/22,Mongolia,46.8625,103.8467,982864,0,2131,980733
10/2/22,Mongolia,46.8625,103.8467,982864,0,2131,980733
10/3/22,Mongolia,46.8625,103.8467,983004,0,2131,980873
10/4/22,Mongolia,46.8625,103.8467,983275,0,2131,981144
10/5/22,Mongolia,46.8625,103.8467,983334,0,2131,981203
10/6/22,Mongolia,46.8625,103.8467,983430,0,2131,981299
10/7/22,Mongolia,46.8625,103.8467,983515,0,2131,981384
10/8/22,Mongolia,46.8625,103.8467,983515,0,2131,981384
10/9/22,Mongolia,46.8625,103.8467,983515,0,2131,981384
10/10/22,Mongolia,46.8625,103.8467,983610,0,2131,981479
10/11/22,Mongolia,46.8625,103.8467,983778,0,2131,981647
10/12/22,Mongolia,46.8625,103.8467,983845,0,2131,981714
10/13/22,Mongolia,46.8625,103.8467,983896,0,2131,981765
10/14/22,Mongolia,46.8625,103.8467,983958,0,2131,981827
10/15/22,Mongolia,46.8625,103.8467,983958,0,2131,981827
10/16/22,Mongolia,46.8625,103.8467,983958,0,2131,981827
10/17/22,Mongolia,46.8625,103.8467,983988,0,2131,981857
10/18/22,Mongolia,46.8625,103.8467,984109,0,2131,981978
10/19/22,Mongolia,46.8625,103.8467,984144,0,2131,982013
10/20/22,Mongolia,46.8625,103.8467,984184,0,2131,982053
10/21/22,Mongolia,46.8625,103.8467,984253,0,2131,982122
10/22/22,Mongolia,46.8625,103.8467,984253,0,2131,982122
10/23/22,Mongolia,46.8625,103.8467,984253,0,2131,982122
10/24/22,Mongolia,46.8625,103.8467,984253,0,2131,982122
10/25/22,Mongolia,46.8625,103.8467,984477,0,2131,982346
10/26/22,Mongolia,46.8625,103.8467,984506,0,2131,982375
10/27/22,Mongolia,46.8625,103.8467,984614,0,2131,982483
10/28/22,Mongolia,46.8625,103.8467,984614,0,2131,982483
10/29/22,Mongolia,46.8625,103.8467,984614,0,2131,982483
10/30/22,Mongolia,46.8625,103.8467,984614,0,2131,982483
10/31/22,Mongolia,46.8625,103.8467,984823,0,2131,982692
11/1/22,Mongolia,46.8625,103.8467,984823,0,2131,982692
11/2/22,Mongolia,46.8625,103.8467,985112,0,2131,982981
11/3/22,Mongolia,46.8625,103.8467,985282,0,2131,983151
11/4/22,Mongolia,46.8625,103.8467,985445,0,2131,983314
11/5/22,Mongolia,46.8625,103.8467,985445,0,2131,983314
11/6/22,Mongolia,46.8625,103.8467,985445,0,2131,983314
11/7/22,Mongolia,46.8625,103.8467,985652,0,2131,983521
11/8/22,Mongolia,46.8625,103.8467,986190,0,2131,984059
11/9/22,Mongolia,46.8625,103.8467,986599,0,2131,984468
11/10/22,Mongolia,46.8625,103.8467,986599,0,2131,984468
11/11/22,Mongolia,46.8625,103.8467,986599,0,2131,984468
11/12/22,Mongolia,46.8625,103.8467,986599,0,2131,984468
11/13/22,Mongolia,46.8625,103.8467,986599,0,2131,984468
11/14/22,Mongolia,46.8625,103.8467,988054,0,2132,985922
11/15/22,Mongolia,46.8625,103.8467,988054,0,2132,985922
11/16/22,Mongolia,46.8625,103.8467,988303,0,2132,986171
11/17/22,Mongolia,46.8625,103.8467,988879,0,2132,986747
11/18/22,Mongolia,46.8625,103.8467,989320,0,2133,987187
11/19/22,Mongolia,46.8625,103.8467,989320,0,2133,987187
11/20/22,Mongolia,46.8625,103.8467,989320,0,2133,987187
11/21/22,Mongolia,46.8625,103.8467,989713,0,2133,987580
11/22/22,Mongolia,46.8625,103.8467,990731,0,2134,988597
11/23/22,Mongolia,46.8625,103.8467,990994,0,2134,988860
11/24/22,Mongolia,46.8625,103.8467,991461,0,2134,989327
11/25/22,Mongolia,46.8625,103.8467,991824,0,2134,989690
11/26/22,Mongolia,46.8625,103.8467,991824,0,2134,989690
11/27/22,Mongolia,46.8625,103.8467,991824,0,2134,989690
11/28/22,Mongolia,46.8625,103.8467,992101,0,2134,989967
11/29/22,Mongolia,46.8625,103.8467,992634,0,2134,990500
11/30/22,Mongolia,46.8625,103.8467,992767,0,2134,990633
12/1/22,Mongolia,46.8625,103.8467,993037,0,2135,990902
12/2/22,Mongolia,46.8625,103.8467,993372,0,2135,991237
12/3/22,Mongolia,46.8625,103.8467,993372,0,2135,991237
12/4/22,Mongolia,46.8625,103.8467,993372,0,2135,991237
12/5/22,Mongolia,46.8625,103.8467,993372,0,2135,991237
12/6/22,Mongolia,46.8625,103.8467,993705,0,2135,991570
12/7/22,Mongolia,46.8625,103.8467,993779,0,2135,991644
12/8/22,Mongolia,46.8625,103.8467,993910,0,2135,991775
12/9/22,Mongolia,46.8625,103.8467,993997,0,2135,991862
12/10/22,Mongolia,46.8625,103.8467,993997,0,2135,991862
12/11/22,Mongolia,46.8625,103.8467,993997,0,2135,991862
12/12/22,Mongolia,46.8625,103.8467,994079,0,2135,991944
12/13/22,Mongolia,46.8625,103.8467,1006851,0,2135,1004716
12/14/22,Mongolia,46.8625,103.8467,1006929,0,2135,1004794
12/15/22,Mongolia,46.8625,103.8467,1006929,0,2135,1004794
12/16/22,Mongolia,46.8625,103.8467,1007025,0,2135,1004890
12/17/22,Mongolia,46.8625,103.8467,1007025,0,2135,1004890
1/1/22,Montenegro,42.708678,19.37439,171873,0,2414,169459
1/2/22,Montenegro,42.708678,19.37439,173161,0,2416,170745
1/3/22,Montenegro,42.708678,19.37439,174865,0,2420,172445
1/4/22,Montenegro,42.708678,19.37439,177455,0,2422,175033
1/5/22,Montenegro,42.708678,19.37439,180260,0,2428,177832
1/6/22,Montenegro,42.708678,19.37439,183220,0,2428,180792
1/7/22,Montenegro,42.708678,19.37439,185606,0,2433,183173
1/8/22,Montenegro,42.708678,19.37439,187825,0,2434,185391
1/9/22,Montenegro,42.708678,19.37439,190279,0,2442,187837
1/10/22,Montenegro,42.708678,19.37439,192171,0,2448,189723
1/11/22,Montenegro,42.708678,19.37439,194695,0,2453,192242
1/12/22,Montenegro,42.708678,19.37439,196640,0,2457,194183
1/13/22,Montenegro,42.708678,19.37439,198857,0,2460,196397
1/14/22,Montenegro,42.708678,19.37439,200535,0,2465,198070
1/15/22,Montenegro,42.708678,19.37439,202348,0,2466,199882
1/16/22,Montenegro,42.708678,19.37439,203746,0,2474,201272
1/17/22,Montenegro,42.708678,19.37439,204862,0,2479,202383
1/18/22,Montenegro,42.708678,19.37439,206676,0,2485,204191
1/19/22,Montenegro,42.708678,19.37439,208171,0,2493,205678
1/20/22,Montenegro,42.708678,19.37439,209719,0,2496,207223
1/21/22,Montenegro,42.708678,19.37439,210931,0,2505,208426
1/22/22,Montenegro,42.708678,19.37439,212144,0,2507,209637
1/23/22,Montenegro,42.708678,19.37439,213140,0,2513,210627
1/24/22,Montenegro,42.708678,19.37439,213896,0,2524,211372
1/25/22,Montenegro,42.708678,19.37439,215017,0,2530,212487
1/26/22,Montenegro,42.708678,19.37439,215950,0,2535,213415
1/27/22,Montenegro,42.708678,19.37439,216856,0,2541,214315
1/28/22,Montenegro,42.708678,19.37439,217752,0,2546,215206
1/29/22,Montenegro,42.708678,19.37439,218637,0,2552,216085
1/30/22,Montenegro,42.708678,19.37439,219303,0,2555,216748
1/31/22,Montenegro,42.708678,19.37439,219775,0,2564,217211
2/1/22,Montenegro,42.708678,19.37439,220597,0,2568,218029
2/2/22,Montenegro,42.708678,19.37439,221214,0,2582,218632
2/3/22,Montenegro,42.708678,19.37439,221902,0,2591,219311
2/4/22,Montenegro,42.708678,19.37439,222434,0,2596,219838
2/5/22,Montenegro,42.708678,19.37439,222961,0,2599,220362
2/6/22,Montenegro,42.708678,19.37439,223462,0,2601,220861
2/7/22,Montenegro,42.708678,19.37439,223774,0,2610,221164
2/8/22,Montenegro,42.708678,19.37439,224368,0,2613,221755
2/9/22,Montenegro,42.708678,19.37439,224793,0,2622,222171
2/10/22,Montenegro,42.708678,19.37439,225253,0,2624,222629
2/11/22,Montenegro,42.708678,19.37439,225740,0,2632,223108
2/12/22,Montenegro,42.708678,19.37439,226142,0,2634,223508
2/13/22,Montenegro,42.708678,19.37439,226467,0,2635,223832
2/14/22,Montenegro,42.708678,19.37439,226692,0,2638,224054
2/15/22,Montenegro,42.708678,19.37439,227045,0,2641,224404
2/16/22,Montenegro,42.708678,19.37439,227473,0,2644,224829
2/17/22,Montenegro,42.708678,19.37439,227859,0,2646,225213
2/18/22,Montenegro,42.708678,19.37439,228182,0,2650,225532
2/19/22,Montenegro,42.708678,19.37439,228522,0,2655,225867
2/20/22,Montenegro,42.708678,19.37439,228771,0,2658,226113
2/21/22,Montenegro,42.708678,19.37439,228956,0,2666,226290
2/22/22,Montenegro,42.708678,19.37439,229222,0,2669,226553
2/23/22,Montenegro,42.708678,19.37439,229430,0,2670,226760
2/24/22,Montenegro,42.708678,19.37439,229630,0,2672,226958
2/25/22,Montenegro,42.708678,19.37439,229836,0,2674,227162
2/26/22,Montenegro,42.708678,19.37439,230011,0,2674,227337
2/27/22,Montenegro,42.708678,19.37439,230120,0,2676,227444
2/28/22,Montenegro,42.708678,19.37439,230207,0,2680,227527
3/1/22,Montenegro,42.708678,19.37439,230363,0,2682,227681
3/2/22,Montenegro,42.708678,19.37439,230512,0,2682,227830
3/3/22,Montenegro,42.708678,19.37439,230631,0,2682,227949
3/4/22,Montenegro,42.708678,19.37439,230759,0,2684,228075
3/5/22,Montenegro,42.708678,19.37439,230887,0,2685,228202
3/6/22,Montenegro,42.708678,19.37439,230958,0,2685,228273
3/7/22,Montenegro,42.708678,19.37439,231011,0,2686,228325
3/8/22,Montenegro,42.708678,19.37439,231115,0,2689,228426
3/9/22,Montenegro,42.708678,19.37439,231227,0,2690,228537
3/10/22,Montenegro,42.708678,19.37439,231313,0,2692,228621
3/11/22,Montenegro,42.708678,19.37439,231391,0,2692,228699
3/12/22,Montenegro,42.708678,19.37439,231488,0,2692,228796
3/13/22,Montenegro,42.708678,19.37439,231557,0,2693,228864
3/14/22,Montenegro,42.708678,19.37439,231613,0,2693,228920
3/15/22,Montenegro,42.708678,19.37439,231719,0,2695,229024
3/16/22,Montenegro,42.708678,19.37439,231816,0,2695,229121
3/17/22,Montenegro,42.708678,19.37439,231927,0,2696,229231
3/18/22,Montenegro,42.708678,19.37439,232038,0,2696,229342
3/19/22,Montenegro,42.708678,19.37439,232117,0,2696,229421
3/20/22,Montenegro,42.708678,19.37439,232193,0,2696,229497
3/21/22,Montenegro,42.708678,19.37439,232249,0,2696,229553
3/22/22,Montenegro,42.708678,19.37439,232376,0,2696,229680
3/23/22,Montenegro,42.708678,19.37439,232462,0,2696,229766
3/24/22,Montenegro,42.708678,19.37439,232561,0,2698,229863
3/25/22,Montenegro,42.708678,19.37439,232626,0,2698,229928
3/26/22,Montenegro,42.708678,19.37439,232727,0,2698,230029
3/27/22,Montenegro,42.708678,19.37439,232777,0,2698,230079
3/28/22,Montenegro,42.708678,19.37439,232832,0,2699,230133
3/29/22,Montenegro,42.708678,19.37439,232924,0,2700,230224
3/30/22,Montenegro,42.708678,19.37439,233010,0,2702,230308
3/31/22,Montenegro,42.708678,19.37439,233102,0,2702,230400
4/1/22,Montenegro,42.708678,19.37439,233179,0,2704,230475
4/2/22,Montenegro,42.708678,19.37439,233265,0,2705,230560
4/3/22,Montenegro,42.708678,19.37439,233326,0,2705,230621
4/4/22,Montenegro,42.708678,19.37439,233365,0,2706,230659
4/5/22,Montenegro,42.708678,19.37439,233453,0,2706,230747
4/6/22,Montenegro,42.708678,19.37439,233523,0,2706,230817
4/7/22,Montenegro,42.708678,19.37439,233582,0,2706,230876
4/8/22,Montenegro,42.708678,19.37439,233640,0,2706,230934
4/9/22,Montenegro,42.708678,19.37439,233692,0,2706,230986
4/10/22,Montenegro,42.708678,19.37439,233721,0,2706,231015
4/11/22,Montenegro,42.708678,19.37439,233750,0,2706,231044
4/12/22,Montenegro,42.708678,19.37439,233834,0,2708,231126
4/13/22,Montenegro,42.708678,19.37439,233908,0,2708,231200
4/14/22,Montenegro,42.708678,19.37439,233980,0,2709,231271
4/15/22,Montenegro,42.708678,19.37439,234051,0,2709,231342
4/16/22,Montenegro,42.708678,19.37439,234137,0,2709,231428
4/17/22,Montenegro,42.708678,19.37439,234218,0,2709,231509
4/18/22,Montenegro,42.708678,19.37439,234251,0,2709,231542
4/19/22,Montenegro,42.708678,19.37439,234336,0,2709,231627
4/20/22,Montenegro,42.708678,19.37439,234405,0,2710,231695
4/21/22,Montenegro,42.708678,19.37439,234472,0,2711,231761
4/22/22,Montenegro,42.708678,19.37439,234549,0,2711,231838
4/23/22,Montenegro,42.708678,19.37439,234619,0,2713,231906
4/24/22,Montenegro,42.708678,19.37439,234707,0,2713,231994
4/25/22,Montenegro,42.708678,19.37439,234760,0,2713,232047
4/26/22,Montenegro,42.708678,19.37439,234876,0,2714,232162
4/27/22,Montenegro,42.708678,19.37439,234957,0,2714,232243
4/28/22,Montenegro,42.708678,19.37439,235062,0,2714,232348
4/29/22,Montenegro,42.708678,19.37439,235151,0,2714,232437
4/30/22,Montenegro,42.708678,19.37439,235228,0,2714,232514
5/1/22,Montenegro,42.708678,19.37439,235292,0,2715,232577
5/2/22,Montenegro,42.708678,19.37439,235338,0,2715,232623
5/3/22,Montenegro,42.708678,19.37439,235403,0,2716,232687
5/4/22,Montenegro,42.708678,19.37439,235484,0,2716,232768
5/5/22,Montenegro,42.708678,19.37439,235549,0,2717,232832
5/6/22,Montenegro,42.708678,19.37439,235644,0,2717,232927
5/7/22,Montenegro,42.708678,19.37439,235726,0,2717,233009
5/8/22,Montenegro,42.708678,19.37439,235795,0,2717,233078
5/9/22,Montenegro,42.708678,19.37439,235837,0,2717,233120
5/10/22,Montenegro,42.708678,19.37439,235945,0,2717,233228
5/11/22,Montenegro,42.708678,19.37439,236006,0,2718,233288
5/12/22,Montenegro,42.708678,19.37439,236076,0,2718,233358
5/13/22,Montenegro,42.708678,19.37439,236153,0,2718,233435
5/14/22,Montenegro,42.708678,19.37439,236212,0,2718,233494
5/15/22,Montenegro,42.708678,19.37439,236277,0,2719,233558
5/16/22,Montenegro,42.708678,19.37439,236320,0,2719,233601
5/17/22,Montenegro,42.708678,19.37439,236414,0,2719,233695
5/18/22,Montenegro,42.708678,19.37439,236489,0,2719,233770
5/19/22,Montenegro,42.708678,19.37439,236569,0,2719,233850
5/20/22,Montenegro,42.708678,19.37439,236569,0,2719,233850
5/21/22,Montenegro,42.708678,19.37439,236688,0,2719,233969
5/22/22,Montenegro,42.708678,19.37439,236721,0,2719,234002
5/23/22,Montenegro,42.708678,19.37439,236762,0,2719,234043
5/24/22,Montenegro,42.708678,19.37439,236803,0,2719,234084
5/25/22,Montenegro,42.708678,19.37439,236862,0,2719,234143
5/26/22,Montenegro,42.708678,19.37439,236924,0,2719,234205
5/27/22,Montenegro,42.708678,19.37439,237000,0,2720,234280
5/28/22,Montenegro,42.708678,19.37439,237042,0,2720,234322
5/29/22,Montenegro,42.708678,19.37439,237099,0,2720,234379
5/30/22,Montenegro,42.708678,19.37439,237148,0,2720,234428
5/31/22,Montenegro,42.708678,19.37439,237223,0,2720,234503
6/1/22,Montenegro,42.708678,19.37439,237287,0,2720,234567
6/2/22,Montenegro,42.708678,19.37439,237355,0,2720,234635
6/3/22,Montenegro,42.708678,19.37439,237421,0,2720,234701
6/4/22,Montenegro,42.708678,19.37439,237486,0,2720,234766
6/5/22,Montenegro,42.708678,19.37439,237534,0,2720,234814
6/6/22,Montenegro,42.708678,19.37439,237563,0,2720,234843
6/7/22,Montenegro,42.708678,19.37439,237634,0,2720,234914
6/8/22,Montenegro,42.708678,19.37439,237688,0,2720,234968
6/9/22,Montenegro,42.708678,19.37439,237737,0,2721,235016
6/10/22,Montenegro,42.708678,19.37439,237793,0,2722,235071
6/11/22,Montenegro,42.708678,19.37439,237848,0,2722,235126
6/12/22,Montenegro,42.708678,19.37439,237901,0,2722,235179
6/13/22,Montenegro,42.708678,19.37439,237945,0,2722,235223
6/14/22,Montenegro,42.708678,19.37439,238043,0,2722,235321
6/15/22,Montenegro,42.708678,19.37439,238123,0,2722,235401
6/16/22,Montenegro,42.708678,19.37439,238217,0,2722,235495
6/17/22,Montenegro,42.708678,19.37439,238315,0,2722,235593
6/18/22,Montenegro,42.708678,19.37439,238416,0,2723,235693
6/19/22,Montenegro,42.708678,19.37439,238486,0,2723,235763
6/20/22,Montenegro,42.708678,19.37439,238549,0,2723,235826
6/21/22,Montenegro,42.708678,19.37439,238662,0,2723,235939
6/22/22,Montenegro,42.708678,19.37439,238807,0,2723,236084
6/23/22,Montenegro,42.708678,19.37439,238925,0,2723,236202
6/24/22,Montenegro,42.708678,19.37439,239107,0,2724,236383
6/25/22,Montenegro,42.708678,19.37439,239291,0,2724,236567
6/26/22,Montenegro,42.708678,19.37439,239458,0,2724,236734
6/27/22,Montenegro,42.708678,19.37439,239552,0,2725,236827
6/28/22,Montenegro,42.708678,19.37439,239552,0,2725,236827
6/29/22,Montenegro,42.708678,19.37439,239989,0,2729,237260
6/30/22,Montenegro,42.708678,19.37439,240222,0,2729,237493
7/1/22,Montenegro,42.708678,19.37439,240472,0,2729,237743
7/2/22,Montenegro,42.708678,19.37439,240743,0,2729,238014
7/3/22,Montenegro,42.708678,19.37439,241003,0,2729,238274
7/4/22,Montenegro,42.708678,19.37439,241190,0,2729,238461
7/5/22,Montenegro,42.708678,19.37439,241623,0,2729,238894
7/6/22,Montenegro,42.708678,19.37439,241850,0,2729,239121
7/7/22,Montenegro,42.708678,19.37439,242333,0,2729,239604
7/8/22,Montenegro,42.708678,19.37439,242705,0,2729,239976
7/9/22,Montenegro,42.708678,19.37439,243076,0,2729,240347
7/10/22,Montenegro,42.708678,19.37439,243476,0,2729,240747
7/11/22,Montenegro,42.708678,19.37439,243768,0,2729,241039
7/12/22,Montenegro,42.708678,19.37439,244337,0,2730,241607
7/13/22,Montenegro,42.708678,19.37439,244903,0,2730,242173
7/14/22,Montenegro,42.708678,19.37439,245369,0,2730,242639
7/15/22,Montenegro,42.708678,19.37439,245896,0,2730,243166
7/16/22,Montenegro,42.708678,19.37439,246589,0,2730,243859
7/17/22,Montenegro,42.708678,19.37439,247179,0,2730,244449
7/18/22,Montenegro,42.708678,19.37439,247609,0,2732,244877
7/19/22,Montenegro,42.708678,19.37439,248535,0,2734,245801
7/20/22,Montenegro,42.708678,19.37439,249304,0,2735,246569
7/21/22,Montenegro,42.708678,19.37439,250173,0,2736,247437
7/22/22,Montenegro,42.708678,19.37439,251066,0,2736,248330
7/23/22,Montenegro,42.708678,19.37439,252016,0,2736,249280
7/24/22,Montenegro,42.708678,19.37439,252727,0,2738,249989
7/25/22,Montenegro,42.708678,19.37439,253365,0,2739,250626
7/26/22,Montenegro,42.708678,19.37439,254578,0,2742,251836
7/27/22,Montenegro,42.708678,19.37439,255580,0,2742,252838
7/28/22,Montenegro,42.708678,19.37439,256524,0,2742,253782
7/29/22,Montenegro,42.708678,19.37439,257546,0,2743,254803
7/30/22,Montenegro,42.708678,19.37439,258533,0,2743,255790
7/31/22,Montenegro,42.708678,19.37439,259349,0,2746,256603
8/1/22,Montenegro,42.708678,19.37439,259972,0,2748,257224
8/2/22,Montenegro,42.708678,19.37439,261025,0,2749,258276
8/3/22,Montenegro,42.708678,19.37439,261934,0,2751,259183
8/4/22,Montenegro,42.708678,19.37439,262808,0,2753,260055
8/5/22,Montenegro,42.708678,19.37439,263658,0,2753,260905
8/6/22,Montenegro,42.708678,19.37439,264464,0,2754,261710
8/7/22,Montenegro,42.708678,19.37439,265184,0,2755,262429
8/8/22,Montenegro,42.708678,19.37439,265655,0,2755,262900
8/9/22,Montenegro,42.708678,19.37439,266422,0,2756,263666
8/10/22,Montenegro,42.708678,19.37439,267211,0,2756,264455
8/11/22,Montenegro,42.708678,19.37439,267938,0,2758,265180
8/12/22,Montenegro,42.708678,19.37439,268579,0,2758,265821
8/13/22,Montenegro,42.708678,19.37439,269213,0,2758,266455
8/14/22,Montenegro,42.708678,19.37439,269719,0,2759,266960
8/15/22,Montenegro,42.708678,19.37439,270063,0,2763,267300
8/16/22,Montenegro,42.708678,19.37439,270693,0,2763,267930
8/17/22,Montenegro,42.708678,19.37439,271241,0,2764,268477
8/18/22,Montenegro,42.708678,19.37439,271733,0,2764,268969
8/19/22,Montenegro,42.708678,19.37439,272180,0,2765,269415
8/20/22,Montenegro,42.708678,19.37439,272609,0,2765,269844
8/21/22,Montenegro,42.708678,19.37439,272929,0,2766,270163
8/22/22,Montenegro,42.708678,19.37439,273185,0,2767,270418
8/23/22,Montenegro,42.708678,19.37439,273563,0,2768,270795
8/24/22,Montenegro,42.708678,19.37439,273893,0,2769,271124
8/25/22,Montenegro,42.708678,19.37439,274218,0,2770,271448
8/26/22,Montenegro,42.708678,19.37439,274491,0,2770,271721
8/27/22,Montenegro,42.708678,19.37439,274744,0,2771,271973
8/28/22,Montenegro,42.708678,19.37439,274950,0,2771,272179
8/29/22,Montenegro,42.708678,19.37439,275096,0,2772,272324
8/30/22,Montenegro,42.708678,19.37439,275338,0,2773,272565
8/31/22,Montenegro,42.708678,19.37439,275538,0,2773,272765
9/1/22,Montenegro,42.708678,19.37439,275791,0,2773,273018
9/2/22,Montenegro,42.708678,19.37439,275988,0,2777,273211
9/3/22,Montenegro,42.708678,19.37439,276179,0,2778,273401
9/4/22,Montenegro,42.708678,19.37439,276337,0,2778,273559
9/5/22,Montenegro,42.708678,19.37439,276440,0,2778,273662
9/6/22,Montenegro,42.708678,19.37439,276636,0,2778,273858
9/7/22,Montenegro,42.708678,19.37439,276790,0,2778,274012
9/8/22,Montenegro,42.708678,19.37439,276929,0,2778,274151
9/9/22,Montenegro,42.708678,19.37439,277061,0,2778,274283
9/10/22,Montenegro,42.708678,19.37439,277191,0,2778,274413
9/11/22,Montenegro,42.708678,19.37439,277341,0,2778,274563
9/12/22,Montenegro,42.708678,19.37439,277440,0,2778,274662
9/13/22,Montenegro,42.708678,19.37439,277643,0,2778,274865
9/14/22,Montenegro,42.708678,19.37439,277812,0,2778,275034
9/15/22,Montenegro,42.708678,19.37439,277976,0,2778,275198
9/16/22,Montenegro,42.708678,19.37439,278134,0,2778,275356
9/17/22,Montenegro,42.708678,19.37439,278252,0,2779,275473
9/18/22,Montenegro,42.708678,19.37439,278386,0,2779,275607
9/19/22,Montenegro,42.708678,19.37439,278509,0,2780,275729
9/20/22,Montenegro,42.708678,19.37439,278690,0,2780,275910
9/21/22,Montenegro,42.708678,19.37439,278848,0,2780,276068
9/22/22,Montenegro,42.708678,19.37439,278992,0,2780,276212
9/23/22,Montenegro,42.708678,19.37439,279134,0,2781,276353
9/24/22,Montenegro,42.708678,19.37439,279281,0,2781,276500
9/25/22,Montenegro,42.708678,19.37439,279403,0,2781,276622
9/26/22,Montenegro,42.708678,19.37439,279494,0,2781,276713
9/27/22,Montenegro,42.708678,19.37439,279663,0,2781,276882
9/28/22,Montenegro,42.708678,19.37439,279847,0,2781,277066
9/29/22,Montenegro,42.708678,19.37439,280002,0,2781,277221
9/30/22,Montenegro,42.708678,19.37439,280182,0,2782,277400
10/1/22,Montenegro,42.708678,19.37439,280360,0,2782,277578
10/2/22,Montenegro,42.708678,19.37439,280488,0,2782,277706
10/3/22,Montenegro,42.708678,19.37439,280557,0,2782,277775
10/4/22,Montenegro,42.708678,19.37439,280715,0,2782,277933
10/5/22,Montenegro,42.708678,19.37439,280822,0,2782,278040
10/6/22,Montenegro,42.708678,19.37439,280913,0,2782,278131
10/7/22,Montenegro,42.708678,19.37439,281023,0,2782,278241
10/8/22,Montenegro,42.708678,19.37439,281114,0,2782,278332
10/9/22,Montenegro,42.708678,19.37439,281205,0,2782,278423
10/10/22,Montenegro,42.708678,19.37439,281268,0,2782,278486
10/11/22,Montenegro,42.708678,19.37439,281395,0,2782,278613
10/12/22,Montenegro,42.708678,19.37439,281497,0,2782,278715
10/13/22,Montenegro,42.708678,19.37439,281599,0,2782,278817
10/14/22,Montenegro,42.708678,19.37439,281694,0,2782,278912
10/15/22,Montenegro,42.708678,19.37439,281765,0,2784,278981
10/16/22,Montenegro,42.708678,19.37439,281835,0,2784,279051
10/17/22,Montenegro,42.708678,19.37439,281890,0,2784,279106
10/18/22,Montenegro,42.708678,19.37439,281979,0,2784,279195
10/19/22,Montenegro,42.708678,19.37439,282052,0,2784,279268
10/20/22,Montenegro,42.708678,19.37439,282124,0,2784,279340
10/21/22,Montenegro,42.708678,19.37439,282185,0,2785,279400
10/22/22,Montenegro,42.708678,19.37439,282241,0,2785,279456
10/23/22,Montenegro,42.708678,19.37439,282282,0,2785,279497
10/24/22,Montenegro,42.708678,19.37439,282314,0,2785,279529
10/25/22,Montenegro,42.708678,19.37439,282403,0,2785,279618
10/26/22,Montenegro,42.708678,19.37439,282472,0,2785,279687
10/27/22,Montenegro,42.708678,19.37439,282549,0,2785,279764
10/28/22,Montenegro,42.708678,19.37439,282617,0,2785,279832
10/29/22,Montenegro,42.708678,19.37439,282676,0,2785,279891
10/30/22,Montenegro,42.708678,19.37439,282730,0,2785,279945
10/31/22,Montenegro,42.708678,19.37439,282764,0,2786,279978
11/1/22,Montenegro,42.708678,19.37439,282843,0,2786,280057
11/2/22,Montenegro,42.708678,19.37439,282911,0,2787,280124
11/3/22,Montenegro,42.708678,19.37439,282973,0,2787,280186
11/4/22,Montenegro,42.708678,19.37439,283011,0,2787,280224
11/5/22,Montenegro,42.708678,19.37439,283055,0,2787,280268
11/6/22,Montenegro,42.708678,19.37439,283089,0,2787,280302
11/7/22,Montenegro,42.708678,19.37439,283117,0,2787,280330
11/8/22,Montenegro,42.708678,19.37439,283146,0,2787,280359
11/9/22,Montenegro,42.708678,19.37439,283192,0,2787,280405
11/10/22,Montenegro,42.708678,19.37439,283240,0,2788,280452
11/11/22,Montenegro,42.708678,19.37439,283268,0,2788,280480
11/12/22,Montenegro,42.708678,19.37439,283300,0,2788,280512
11/13/22,Montenegro,42.708678,19.37439,283320,0,2788,280532
11/14/22,Montenegro,42.708678,19.37439,283343,0,2788,280555
11/15/22,Montenegro,42.708678,19.37439,283383,0,2788,280595
11/16/22,Montenegro,42.708678,19.37439,283410,0,2788,280622
11/17/22,Montenegro,42.708678,19.37439,283443,0,2788,280655
11/18/22,Montenegro,42.708678,19.37439,283468,0,2789,280679
11/19/22,Montenegro,42.708678,19.37439,283488,0,2789,280699
11/20/22,Montenegro,42.708678,19.37439,283500,0,2789,280711
11/21/22,Montenegro,42.708678,19.37439,283512,0,2789,280723
11/22/22,Montenegro,42.708678,19.37439,283536,0,2789,280747
11/23/22,Montenegro,42.708678,19.37439,283566,0,2789,280777
11/24/22,Montenegro,42.708678,19.37439,283586,0,2789,280797
11/25/22,Montenegro,42.708678,19.37439,283607,0,2789,280818
11/26/22,Montenegro,42.708678,19.37439,283628,0,2789,280839
11/27/22,Montenegro,42.708678,19.37439,283644,0,2789,280855
11/28/22,Montenegro,42.708678,19.37439,283663,0,2789,280874
11/29/22,Montenegro,42.708678,19.37439,283663,0,2789,280874
11/30/22,Montenegro,42.708678,19.37439,283719,0,2790,280929
12/1/22,Montenegro,42.708678,19.37439,283750,0,2790,280960
12/2/22,Montenegro,42.708678,19.37439,283771,0,2790,280981
12/3/22,Montenegro,42.708678,19.37439,283799,0,2790,281009
12/4/22,Montenegro,42.708678,19.37439,283818,0,2790,281028
12/5/22,Montenegro,42.708678,19.37439,283844,0,2790,281054
12/6/22,Montenegro,42.708678,19.37439,283895,0,2790,281105
12/7/22,Montenegro,42.708678,19.37439,283942,0,2790,281152
12/8/22,Montenegro,42.708678,19.37439,283979,0,2790,281189
12/9/22,Montenegro,42.708678,19.37439,284026,0,2790,281236
12/10/22,Montenegro,42.708678,19.37439,284068,0,2790,281278
12/11/22,Montenegro,42.708678,19.37439,284111,0,2790,281321
12/12/22,Montenegro,42.708678,19.37439,284137,0,2790,281347
12/13/22,Montenegro,42.708678,19.37439,284176,0,2790,281386
12/14/22,Montenegro,42.708678,19.37439,284224,0,2790,281434
12/15/22,Montenegro,42.708678,19.37439,284258,0,2790,281468
12/16/22,Montenegro,42.708678,19.37439,284298,0,2790,281508
12/17/22,Montenegro,42.708678,19.37439,284326,0,2790,281536
1/1/22,Morocco,31.7917,-7.0926,965420,0,14851,950569
1/2/22,Morocco,31.7917,-7.0926,966777,0,14855,951922
1/3/22,Morocco,31.7917,-7.0926,967662,0,14862,952800
1/4/22,Morocco,31.7917,-7.0926,971961,0,14867,957094
1/5/22,Morocco,31.7917,-7.0926,977579,0,14872,962707
1/6/22,Morocco,31.7917,-7.0926,983629,0,14883,968746
1/7/22,Morocco,31.7917,-7.0926,990057,0,14896,975161
1/8/22,Morocco,31.7917,-7.0926,997121,0,14904,982217
1/9/22,Morocco,31.7917,-7.0926,1002084,0,14911,987173
1/10/22,Morocco,31.7917,-7.0926,1004706,0,14915,989791
1/11/22,Morocco,31.7917,-7.0926,1012042,0,14927,997115
1/12/22,Morocco,31.7917,-7.0926,1017560,0,14935,1002625
1/13/22,Morocco,31.7917,-7.0926,1025898,0,14945,1010953
1/14/22,Morocco,31.7917,-7.0926,1034399,0,14954,1019445
1/15/22,Morocco,31.7917,-7.0926,1043225,0,14963,1028262
1/16/22,Morocco,31.7917,-7.0926,1048653,0,14976,1033677
1/17/22,Morocco,31.7917,-7.0926,1051830,0,14994,1036836
1/18/22,Morocco,31.7917,-7.0926,1059586,0,15012,1044574
1/19/22,Morocco,31.7917,-7.0926,1068941,0,15025,1053916
1/20/22,Morocco,31.7917,-7.0926,1078002,0,15047,1062955
1/21/22,Morocco,31.7917,-7.0926,1086340,0,15082,1071258
1/22/22,Morocco,31.7917,-7.0926,1093978,0,15113,1078865
1/23/22,Morocco,31.7917,-7.0926,1098413,0,15132,1083281
1/24/22,Morocco,31.7917,-7.0926,1101163,0,15167,1085996
1/25/22,Morocco,31.7917,-7.0926,1107525,0,15201,1092324
1/26/22,Morocco,31.7917,-7.0926,1114527,0,15237,1099290
1/27/22,Morocco,31.7917,-7.0926,1120087,0,15270,1104817
1/28/22,Morocco,31.7917,-7.0926,1124986,0,15300,1109686
1/29/22,Morocco,31.7917,-7.0926,1129140,0,15328,1113812
1/30/22,Morocco,31.7917,-7.0926,1131395,0,15362,1116033
1/31/22,Morocco,31.7917,-7.0926,1132716,0,15400,1117316
2/1/22,Morocco,31.7917,-7.0926,1135796,0,15435,1120361
2/2/22,Morocco,31.7917,-7.0926,1138847,0,15464,1123383
2/3/22,Morocco,31.7917,-7.0926,1141708,0,15515,1126193
2/4/22,Morocco,31.7917,-7.0926,1143974,0,15540,1128434
2/5/22,Morocco,31.7917,-7.0926,1146041,0,15575,1130466
2/6/22,Morocco,31.7917,-7.0926,1147243,0,15593,1131650
2/7/22,Morocco,31.7917,-7.0926,1147964,0,15617,1132347
2/8/22,Morocco,31.7917,-7.0926,1149582,0,15657,1133925
2/9/22,Morocco,31.7917,-7.0926,1151081,0,15698,1135383
2/10/22,Morocco,31.7917,-7.0926,1152414,0,15727,1136687
2/11/22,Morocco,31.7917,-7.0926,1153562,0,15747,1137815
2/12/22,Morocco,31.7917,-7.0926,1154531,0,15766,1138765
2/13/22,Morocco,31.7917,-7.0926,1155165,0,15781,1139384
2/14/22,Morocco,31.7917,-7.0926,1155534,0,15802,1139732
2/15/22,Morocco,31.7917,-7.0926,1156356,0,15820,1140536
2/16/22,Morocco,31.7917,-7.0926,1157001,0,15833,1141168
2/17/22,Morocco,31.7917,-7.0926,1157637,0,15855,1141782
2/18/22,Morocco,31.7917,-7.0926,1158145,0,15870,1142275
2/19/22,Morocco,31.7917,-7.0926,1158669,0,15881,1142788
2/20/22,Morocco,31.7917,-7.0926,1158967,0,15894,1143073
2/21/22,Morocco,31.7917,-7.0926,1159157,0,15916,1143241
2/22/22,Morocco,31.7917,-7.0926,1159584,0,15922,1143662
2/23/22,Morocco,31.7917,-7.0926,1159941,0,15938,1144003
2/24/22,Morocco,31.7917,-7.0926,1160303,0,15952,1144351
2/25/22,Morocco,31.7917,-7.0926,1160562,0,15960,1144602
2/26/22,Morocco,31.7917,-7.0926,1160750,0,15970,1144780
2/27/22,Morocco,31.7917,-7.0926,1160892,0,15978,1144914
2/28/22,Morocco,31.7917,-7.0926,1160975,0,15988,1144987
3/1/22,Morocco,31.7917,-7.0926,1161131,0,15994,1145137
3/2/22,Morocco,31.7917,-7.0926,1161290,0,16002,1145288
3/3/22,Morocco,31.7917,-7.0926,1161392,0,16006,1145386
3/4/22,Morocco,31.7917,-7.0926,1161506,0,16009,1145497
3/5/22,Morocco,31.7917,-7.0926,1161586,0,16015,1145571
3/6/22,Morocco,31.7917,-7.0926,1161646,0,16017,1145629
3/7/22,Morocco,31.7917,-7.0926,1161698,0,16022,1145676
3/8/22,Morocco,31.7917,-7.0926,1161776,0,16029,1145747
3/9/22,Morocco,31.7917,-7.0926,1161848,0,16029,1145819
3/10/22,Morocco,31.7917,-7.0926,1161925,0,16033,1145892
3/11/22,Morocco,31.7917,-7.0926,1161980,0,16034,1145946
3/12/22,Morocco,31.7917,-7.0926,1162040,0,16036,1146004
3/13/22,Morocco,31.7917,-7.0926,1162096,0,16039,1146057
3/14/22,Morocco,31.7917,-7.0926,1162125,0,16043,1146082
3/15/22,Morocco,31.7917,-7.0926,1162236,0,16046,1146190
3/16/22,Morocco,31.7917,-7.0926,1162288,0,16048,1146240
3/17/22,Morocco,31.7917,-7.0926,1162322,0,16050,1146272
3/18/22,Morocco,31.7917,-7.0926,1162374,0,16050,1146324
3/19/22,Morocco,31.7917,-7.0926,1162444,0,16051,1146393
3/20/22,Morocco,31.7917,-7.0926,1162497,0,16052,1146445
3/21/22,Morocco,31.7917,-7.0926,1162539,0,16052,1146487
3/22/22,Morocco,31.7917,-7.0926,1162626,0,16053,1146573
3/23/22,Morocco,31.7917,-7.0926,1162686,0,16055,1146631
3/24/22,Morocco,31.7917,-7.0926,1162764,0,16056,1146708
3/25/22,Morocco,31.7917,-7.0926,1162841,0,16056,1146785
3/26/22,Morocco,31.7917,-7.0926,1162923,0,16057,1146866
3/27/22,Morocco,31.7917,-7.0926,1162974,0,16057,1146917
3/28/22,Morocco,31.7917,-7.0926,1163012,0,16058,1146954
3/29/22,Morocco,31.7917,-7.0926,1163109,0,16059,1147050
3/30/22,Morocco,31.7917,-7.0926,1163214,0,16060,1147154
3/31/22,Morocco,31.7917,-7.0926,1163274,0,16060,1147214
4/1/22,Morocco,31.7917,-7.0926,1163359,0,16060,1147299
4/2/22,Morocco,31.7917,-7.0926,1163472,0,16060,1147412
4/3/22,Morocco,31.7917,-7.0926,1163526,0,16060,1147466
4/4/22,Morocco,31.7917,-7.0926,1163561,0,16060,1147501
4/5/22,Morocco,31.7917,-7.0926,1163656,0,16061,1147595
4/6/22,Morocco,31.7917,-7.0926,1163726,0,16061,1147665
4/7/22,Morocco,31.7917,-7.0926,1163806,0,16061,1147745
4/8/22,Morocco,31.7917,-7.0926,1163888,0,16061,1147827
4/9/22,Morocco,31.7917,-7.0926,1163962,0,16061,1147901
4/10/22,Morocco,31.7917,-7.0926,1164030,0,16061,1147969
4/11/22,Morocco,31.7917,-7.0926,1164052,0,16061,1147991
4/12/22,Morocco,31.7917,-7.0926,1164135,0,16061,1148074
4/13/22,Morocco,31.7917,-7.0926,1164189,0,16061,1148128
4/14/22,Morocco,31.7917,-7.0926,1164259,0,16061,1148198
4/15/22,Morocco,31.7917,-7.0926,1164296,0,16062,1148234
4/16/22,Morocco,31.7917,-7.0926,1164345,0,16062,1148283
4/17/22,Morocco,31.7917,-7.0926,1164381,0,16063,1148318
4/18/22,Morocco,31.7917,-7.0926,1164411,0,16064,1148347
4/19/22,Morocco,31.7917,-7.0926,1164467,0,16064,1148403
4/20/22,Morocco,31.7917,-7.0926,1164507,0,16064,1148443
4/21/22,Morocco,31.7917,-7.0926,1164567,0,16064,1148503
4/22/22,Morocco,31.7917,-7.0926,1164614,0,16064,1148550
4/23/22,Morocco,31.7917,-7.0926,1164670,0,16065,1148605
4/24/22,Morocco,31.7917,-7.0926,1164700,0,16065,1148635
4/25/22,Morocco,31.7917,-7.0926,1164717,0,16066,1148651
4/26/22,Morocco,31.7917,-7.0926,1164774,0,16066,1148708
4/27/22,Morocco,31.7917,-7.0926,1164825,0,16068,1148757
4/28/22,Morocco,31.7917,-7.0926,1164865,0,16069,1148796
4/29/22,Morocco,31.7917,-7.0926,1164907,0,16069,1148838
4/30/22,Morocco,31.7917,-7.0926,1164953,0,16069,1148884
5/1/22,Morocco,31.7917,-7.0926,1164973,0,16069,1148904
5/2/22,Morocco,31.7917,-7.0926,1164984,0,16069,1148915
5/3/22,Morocco,31.7917,-7.0926,1165004,0,16069,1148935
5/4/22,Morocco,31.7917,-7.0926,1165026,0,16069,1148957
5/5/22,Morocco,31.7917,-7.0926,1165084,0,16069,1149015
5/6/22,Morocco,31.7917,-7.0926,1165151,0,16070,1149081
5/7/22,Morocco,31.7917,-7.0926,1165206,0,16070,1149136
5/8/22,Morocco,31.7917,-7.0926,1165247,0,16070,1149177
5/9/22,Morocco,31.7917,-7.0926,1165283,0,16071,1149212
5/10/22,Morocco,31.7917,-7.0926,1165366,0,16071,1149295
5/11/22,Morocco,31.7917,-7.0926,1165455,0,16071,1149384
5/12/22,Morocco,31.7917,-7.0926,1165552,0,16071,1149481
5/13/22,Morocco,31.7917,-7.0926,1165625,0,16071,1149554
5/14/22,Morocco,31.7917,-7.0926,1165706,0,16071,1149635
5/15/22,Morocco,31.7917,-7.0926,1165795,0,16071,1149724
5/16/22,Morocco,31.7917,-7.0926,1165849,0,16072,1149777
5/17/22,Morocco,31.7917,-7.0926,1165984,0,16074,1149910
5/18/22,Morocco,31.7917,-7.0926,1166100,0,16075,1150025
5/19/22,Morocco,31.7917,-7.0926,1166224,0,16075,1150149
5/20/22,Morocco,31.7917,-7.0926,1166377,0,16075,1150302
5/21/22,Morocco,31.7917,-7.0926,1166530,0,16075,1150455
5/22/22,Morocco,31.7917,-7.0926,1166628,0,16075,1150553
5/23/22,Morocco,31.7917,-7.0926,1166716,0,16075,1150641
5/24/22,Morocco,31.7917,-7.0926,1166916,0,16075,1150841
5/25/22,Morocco,31.7917,-7.0926,1167086,0,16076,1151010
5/26/22,Morocco,31.7917,-7.0926,1167325,0,16076,1151249
5/27/22,Morocco,31.7917,-7.0926,1167527,0,16076,1151451
5/28/22,Morocco,31.7917,-7.0926,1167732,0,16076,1151656
5/29/22,Morocco,31.7917,-7.0926,1167894,0,16076,1151818
5/30/22,Morocco,31.7917,-7.0926,1167983,0,16076,1151907
5/31/22,Morocco,31.7917,-7.0926,1168303,0,16076,1152227
6/1/22,Morocco,31.7917,-7.0926,1168664,0,16077,1152587
6/2/22,Morocco,31.7917,-7.0926,1169057,0,16078,1152979
6/3/22,Morocco,31.7917,-7.0926,1169482,0,16078,1153404
6/4/22,Morocco,31.7917,-7.0926,1169920,0,16079,1153841
6/5/22,Morocco,31.7917,-7.0926,1170194,0,16080,1154114
6/6/22,Morocco,31.7917,-7.0926,1170427,0,16080,1154347
6/7/22,Morocco,31.7917,-7.0926,1171034,0,16082,1154952
6/8/22,Morocco,31.7917,-7.0926,1171972,0,16082,1155890
6/9/22,Morocco,31.7917,-7.0926,1172938,0,16082,1156856
6/10/22,Morocco,31.7917,-7.0926,1174028,0,16082,1157946
6/11/22,Morocco,31.7917,-7.0926,1175104,0,16082,1159022
6/12/22,Morocco,31.7917,-7.0926,1175604,0,16082,1159522
6/13/22,Morocco,31.7917,-7.0926,1176165,0,16082,1160083
6/14/22,Morocco,31.7917,-7.0926,1177842,0,16083,1161759
6/15/22,Morocco,31.7917,-7.0926,1179474,0,16085,1163389
6/16/22,Morocco,31.7917,-7.0926,1181042,0,16085,1164957
6/17/22,Morocco,31.7917,-7.0926,1182776,0,16085,1166691
6/18/22,Morocco,31.7917,-7.0926,1184732,0,16086,1168646
6/19/22,Morocco,31.7917,-7.0926,1185990,0,16087,1169903
6/20/22,Morocco,31.7917,-7.0926,1186597,0,16087,1170510
6/21/22,Morocco,31.7917,-7.0926,1189656,0,16087,1173569
6/22/22,Morocco,31.7917,-7.0926,1192797,0,16092,1176705
6/23/22,Morocco,31.7917,-7.0926,1195883,0,16094,1179789
6/24/22,Morocco,31.7917,-7.0926,1199226,0,16097,1183129
6/25/22,Morocco,31.7917,-7.0926,1202461,0,16098,1186363
6/26/22,Morocco,31.7917,-7.0926,1204578,0,16101,1188477
6/27/22,Morocco,31.7917,-7.0926,1205293,0,16101,1189192
6/28/22,Morocco,31.7917,-7.0926,1209302,0,16104,1193198
6/29/22,Morocco,31.7917,-7.0926,1212906,0,16107,1196799
6/30/22,Morocco,31.7917,-7.0926,1216909,0,16109,1200800
7/1/22,Morocco,31.7917,-7.0926,1220279,0,16113,1204166
7/2/22,Morocco,31.7917,-7.0926,1223585,0,16116,1207469
7/3/22,Morocco,31.7917,-7.0926,1225305,0,16117,1209188
7/4/22,Morocco,31.7917,-7.0926,1226246,0,16120,1210126
7/5/22,Morocco,31.7917,-7.0926,1230095,0,16131,1213964
7/6/22,Morocco,31.7917,-7.0926,1233138,0,16133,1217005
7/7/22,Morocco,31.7917,-7.0926,1235920,0,16142,1219778
7/8/22,Morocco,31.7917,-7.0926,1238371,0,16147,1222224
7/9/22,Morocco,31.7917,-7.0926,1240847,0,16151,1224696
7/10/22,Morocco,31.7917,-7.0926,1241967,0,16156,1225811
7/11/22,Morocco,31.7917,-7.0926,1242241,0,16157,1226084
7/12/22,Morocco,31.7917,-7.0926,1242828,0,16160,1226668
7/13/22,Morocco,31.7917,-7.0926,1244892,0,16165,1228727
7/14/22,Morocco,31.7917,-7.0926,1246835,0,16167,1230668
7/15/22,Morocco,31.7917,-7.0926,1248856,0,16173,1232683
7/16/22,Morocco,31.7917,-7.0926,1250510,0,16178,1234332
7/17/22,Morocco,31.7917,-7.0926,1251297,0,16184,1235113
7/18/22,Morocco,31.7917,-7.0926,1251766,0,16189,1235577
7/19/22,Morocco,31.7917,-7.0926,1253341,0,16193,1237148
7/20/22,Morocco,31.7917,-7.0926,1254550,0,16198,1238352
7/21/22,Morocco,31.7917,-7.0926,1255681,0,16204,1239477
7/22/22,Morocco,31.7917,-7.0926,1256523,0,16209,1240314
7/23/22,Morocco,31.7917,-7.0926,1257320,0,16211,1241109
7/24/22,Morocco,31.7917,-7.0926,1257764,0,16213,1241551
7/25/22,Morocco,31.7917,-7.0926,1258018,0,16215,1241803
7/26/22,Morocco,31.7917,-7.0926,1258761,0,16224,1242537
7/27/22,Morocco,31.7917,-7.0926,1259420,0,16226,1243194
7/28/22,Morocco,31.7917,-7.0926,1259974,0,16228,1243746
7/29/22,Morocco,31.7917,-7.0926,1260405,0,16233,1244172
7/30/22,Morocco,31.7917,-7.0926,1260759,0,16234,1244525
7/31/22,Morocco,31.7917,-7.0926,1260978,0,16237,1244741
8/1/22,Morocco,31.7917,-7.0926,1261125,0,16238,1244887
8/2/22,Morocco,31.7917,-7.0926,1261499,0,16242,1245257
8/3/22,Morocco,31.7917,-7.0926,1261816,0,16248,1245568
8/4/22,Morocco,31.7917,-7.0926,1262082,0,16250,1245832
8/5/22,Morocco,31.7917,-7.0926,1262300,0,16254,1246046
8/6/22,Morocco,31.7917,-7.0926,1262501,0,16256,1246245
8/7/22,Morocco,31.7917,-7.0926,1262622,0,16257,1246365
8/8/22,Morocco,31.7917,-7.0926,1262696,0,16259,1246437
8/9/22,Morocco,31.7917,-7.0926,1262887,0,16260,1246627
8/10/22,Morocco,31.7917,-7.0926,1263035,0,16262,1246773
8/11/22,Morocco,31.7917,-7.0926,1263164,0,16264,1246900
8/12/22,Morocco,31.7917,-7.0926,1263256,0,16267,1246989
8/13/22,Morocco,31.7917,-7.0926,1263373,0,16268,1247105
8/14/22,Morocco,31.7917,-7.0926,1263453,0,16269,1247184
8/15/22,Morocco,31.7917,-7.0926,1263491,0,16269,1247222
8/16/22,Morocco,31.7917,-7.0926,1263591,0,16269,1247322
8/17/22,Morocco,31.7917,-7.0926,1263700,0,16269,1247431
8/18/22,Morocco,31.7917,-7.0926,1263779,0,16269,1247510
8/19/22,Morocco,31.7917,-7.0926,1263865,0,16269,1247596
8/20/22,Morocco,31.7917,-7.0926,1263943,0,16270,1247673
8/21/22,Morocco,31.7917,-7.0926,1263985,0,16270,1247715
8/22/22,Morocco,31.7917,-7.0926,1264010,0,16270,1247740
8/23/22,Morocco,31.7917,-7.0926,1264068,0,16270,1247798
8/24/22,Morocco,31.7917,-7.0926,1264130,0,16270,1247860
8/25/22,Morocco,31.7917,-7.0926,1264200,0,16271,1247929
8/26/22,Morocco,31.7917,-7.0926,1264237,0,16271,1247966
8/27/22,Morocco,31.7917,-7.0926,1264286,0,16271,1248015
8/28/22,Morocco,31.7917,-7.0926,1264316,0,16271,1248045
8/29/22,Morocco,31.7917,-7.0926,1264342,0,16272,1248070
8/30/22,Morocco,31.7917,-7.0926,1264388,0,16273,1248115
8/31/22,Morocco,31.7917,-7.0926,1264435,0,16273,1248162
9/1/22,Morocco,31.7917,-7.0926,1264468,0,16273,1248195
9/2/22,Morocco,31.7917,-7.0926,1264495,0,16274,1248221
9/3/22,Morocco,31.7917,-7.0926,1264531,0,16274,1248257
9/4/22,Morocco,31.7917,-7.0926,1264549,0,16274,1248275
9/5/22,Morocco,31.7917,-7.0926,1264556,0,16274,1248282
9/6/22,Morocco,31.7917,-7.0926,1264580,0,16274,1248306
9/7/22,Morocco,31.7917,-7.0926,1264597,0,16275,1248322
9/8/22,Morocco,31.7917,-7.0926,1264609,0,16275,1248334
9/9/22,Morocco,31.7917,-7.0926,1264622,0,16275,1248347
9/10/22,Morocco,31.7917,-7.0926,1264648,0,16276,1248372
9/11/22,Morocco,31.7917,-7.0926,1264659,0,16276,1248383
9/12/22,Morocco,31.7917,-7.0926,1264664,0,16276,1248388
9/13/22,Morocco,31.7917,-7.0926,1264690,0,16276,1248414
9/14/22,Morocco,31.7917,-7.0926,1264711,0,16276,1248435
9/15/22,Morocco,31.7917,-7.0926,1264731,0,16276,1248455
9/16/22,Morocco,31.7917,-7.0926,1264743,0,16276,1248467
9/17/22,Morocco,31.7917,-7.0926,1264762,0,16277,1248485
9/18/22,Morocco,31.7917,-7.0926,1264779,0,16277,1248502
9/19/22,Morocco,31.7917,-7.0926,1264785,0,16277,1248508
9/20/22,Morocco,31.7917,-7.0926,1264807,0,16277,1248530
9/21/22,Morocco,31.7917,-7.0926,1264822,0,16278,1248544
9/22/22,Morocco,31.7917,-7.0926,1264840,0,16278,1248562
9/23/22,Morocco,31.7917,-7.0926,1264850,0,16278,1248572
9/24/22,Morocco,31.7917,-7.0926,1264872,0,16278,1248594
9/25/22,Morocco,31.7917,-7.0926,1264879,0,16278,1248601
9/26/22,Morocco,31.7917,-7.0926,1264883,0,16278,1248605
9/27/22,Morocco,31.7917,-7.0926,1264903,0,16278,1248625
9/28/22,Morocco,31.7917,-7.0926,1264920,0,16278,1248642
9/29/22,Morocco,31.7917,-7.0926,1264935,0,16278,1248657
9/30/22,Morocco,31.7917,-7.0926,1264945,0,16278,1248667
10/1/22,Morocco,31.7917,-7.0926,1264961,0,16278,1248683
10/2/22,Morocco,31.7917,-7.0926,1264972,0,16278,1248694
10/3/22,Morocco,31.7917,-7.0926,1264978,0,16278,1248700
10/4/22,Morocco,31.7917,-7.0926,1265008,0,16278,1248730
10/5/22,Morocco,31.7917,-7.0926,1265032,0,16278,1248754
10/6/22,Morocco,31.7917,-7.0926,1265032,0,16278,1248754
10/7/22,Morocco,31.7917,-7.0926,1265072,0,16278,1248794
10/8/22,Morocco,31.7917,-7.0926,1265086,0,16278,1248808
10/9/22,Morocco,31.7917,-7.0926,1265093,0,16278,1248815
10/10/22,Morocco,31.7917,-7.0926,1265103,0,16278,1248825
10/11/22,Morocco,31.7917,-7.0926,1265115,0,16278,1248837
10/12/22,Morocco,31.7917,-7.0926,1265138,0,16278,1248860
10/13/22,Morocco,31.7917,-7.0926,1265162,0,16278,1248884
10/14/22,Morocco,31.7917,-7.0926,1265180,0,16278,1248902
10/15/22,Morocco,31.7917,-7.0926,1265201,0,16278,1248923
10/16/22,Morocco,31.7917,-7.0926,1265220,0,16279,1248941
10/17/22,Morocco,31.7917,-7.0926,1265232,0,16279,1248953
10/18/22,Morocco,31.7917,-7.0926,1265265,0,16280,1248985
10/19/22,Morocco,31.7917,-7.0926,1265301,0,16280,1249021
10/20/22,Morocco,31.7917,-7.0926,1265332,0,16280,1249052
10/21/22,Morocco,31.7917,-7.0926,1265363,0,16280,1249083
10/22/22,Morocco,31.7917,-7.0926,1265382,0,16280,1249102
10/23/22,Morocco,31.7917,-7.0926,1265389,0,16280,1249109
10/24/22,Morocco,31.7917,-7.0926,1265396,0,16280,1249116
10/25/22,Morocco,31.7917,-7.0926,1265431,0,16281,1249150
10/26/22,Morocco,31.7917,-7.0926,1265477,0,16281,1249196
10/27/22,Morocco,31.7917,-7.0926,1265523,0,16281,1249242
10/28/22,Morocco,31.7917,-7.0926,1265549,0,16281,1249268
10/29/22,Morocco,31.7917,-7.0926,1265572,0,16281,1249291
10/30/22,Morocco,31.7917,-7.0926,1265589,0,16281,1249308
10/31/22,Morocco,31.7917,-7.0926,1265601,0,16281,1249320
11/1/22,Morocco,31.7917,-7.0926,1265650,0,16281,1249369
11/2/22,Morocco,31.7917,-7.0926,1265732,0,16281,1249451
11/3/22,Morocco,31.7917,-7.0926,1265788,0,16281,1249507
11/4/22,Morocco,31.7917,-7.0926,1265876,0,16281,1249595
11/5/22,Morocco,31.7917,-7.0926,1265965,0,16281,1249684
11/6/22,Morocco,31.7917,-7.0926,1265998,0,16282,1249716
11/7/22,Morocco,31.7917,-7.0926,1266009,0,16282,1249727
11/8/22,Morocco,31.7917,-7.0926,1266104,0,16282,1249822
11/9/22,Morocco,31.7917,-7.0926,1266231,0,16283,1249948
11/10/22,Morocco,31.7917,-7.0926,1266350,0,16283,1250067
11/11/22,Morocco,31.7917,-7.0926,1266458,0,16283,1250175
11/12/22,Morocco,31.7917,-7.0926,1266561,0,16283,1250278
11/13/22,Morocco,31.7917,-7.0926,1266617,0,16283,1250334
11/14/22,Morocco,31.7917,-7.0926,1266639,0,16283,1250356
11/15/22,Morocco,31.7917,-7.0926,1266788,0,16283,1250505
11/16/22,Morocco,31.7917,-7.0926,1266917,0,16283,1250634
11/17/22,Morocco,31.7917,-7.0926,1267039,0,16283,1250756
11/18/22,Morocco,31.7917,-7.0926,1267177,0,16283,1250894
11/19/22,Morocco,31.7917,-7.0926,1267266,0,16283,1250983
11/20/22,Morocco,31.7917,-7.0926,1267315,0,16283,1251032
11/21/22,Morocco,31.7917,-7.0926,1267350,0,16283,1251067
11/22/22,Morocco,31.7917,-7.0926,1267597,0,16283,1251314
11/23/22,Morocco,31.7917,-7.0926,1267816,0,16283,1251533
11/24/22,Morocco,31.7917,-7.0926,1267966,0,16283,1251683
11/25/22,Morocco,31.7917,-7.0926,1268136,0,16284,1251852
11/26/22,Morocco,31.7917,-7.0926,1268295,0,16284,1252011
11/27/22,Morocco,31.7917,-7.0926,1268396,0,16284,1252112
11/28/22,Morocco,31.7917,-7.0926,1268440,0,16284,1252156
11/29/22,Morocco,31.7917,-7.0926,1268639,0,16284,1252355
11/30/22,Morocco,31.7917,-7.0926,1268823,0,16284,1252539
12/1/22,Morocco,31.7917,-7.0926,1269002,0,16284,1252718
12/2/22,Morocco,31.7917,-7.0926,1269151,0,16284,1252867
12/3/22,Morocco,31.7917,-7.0926,1269296,0,16285,1253011
12/4/22,Morocco,31.7917,-7.0926,1269345,0,16285,1253060
12/5/22,Morocco,31.7917,-7.0926,1269391,0,16285,1253106
12/6/22,Morocco,31.7917,-7.0926,1269570,0,16286,1253284
12/7/22,Morocco,31.7917,-7.0926,1269717,0,16287,1253430
12/8/22,Morocco,31.7917,-7.0926,1269851,0,16287,1253564
12/9/22,Morocco,31.7917,-7.0926,1270007,0,16287,1253720
12/10/22,Morocco,31.7917,-7.0926,1270119,0,16288,1253831
12/11/22,Morocco,31.7917,-7.0926,1270161,0,16288,1253873
12/12/22,Morocco,31.7917,-7.0926,1270179,0,16288,1253891
12/13/22,Morocco,31.7917,-7.0926,1270318,0,16289,1254029
12/14/22,Morocco,31.7917,-7.0926,1270466,0,16290,1254176
12/15/22,Morocco,31.7917,-7.0926,1270588,0,16291,1254297
12/16/22,Morocco,31.7917,-7.0926,1270699,0,16294,1254405
12/17/22,Morocco,31.7917,-7.0926,1270782,0,16294,1254488
1/1/22,Mozambique,-18.6657,35.5296,191722,0,2012,189710
1/2/22,Mozambique,-18.6657,35.5296,192453,0,2019,190434
1/3/22,Mozambique,-18.6657,35.5296,193371,0,2031,191340
1/4/22,Mozambique,-18.6657,35.5296,196346,0,2042,194304
1/5/22,Mozambique,-18.6657,35.5296,199940,0,2050,197890
1/6/22,Mozambique,-18.6657,35.5296,203241,0,2065,201176
1/7/22,Mozambique,-18.6657,35.5296,206272,0,2075,204197
1/8/22,Mozambique,-18.6657,35.5296,209389,0,2077,207312
1/9/22,Mozambique,-18.6657,35.5296,210399,0,2085,208314
1/10/22,Mozambique,-18.6657,35.5296,210991,0,2096,208895
1/11/22,Mozambique,-18.6657,35.5296,212859,0,2099,210760
1/12/22,Mozambique,-18.6657,35.5296,214807,0,2105,212702
1/13/22,Mozambique,-18.6657,35.5296,216559,0,2109,214450
1/14/22,Mozambique,-18.6657,35.5296,217821,0,2117,215704
1/15/22,Mozambique,-18.6657,35.5296,218797,0,2123,216674
1/16/22,Mozambique,-18.6657,35.5296,219081,0,2127,216954
1/17/22,Mozambique,-18.6657,35.5296,219390,0,2132,217258
1/18/22,Mozambique,-18.6657,35.5296,220241,0,2136,218105
1/19/22,Mozambique,-18.6657,35.5296,220908,0,2140,218768
1/20/22,Mozambique,-18.6657,35.5296,221432,0,2146,219286
1/21/22,Mozambique,-18.6657,35.5296,221975,0,2149,219826
1/22/22,Mozambique,-18.6657,35.5296,222415,0,2153,220262
1/23/22,Mozambique,-18.6657,35.5296,222596,0,2157,220439
1/24/22,Mozambique,-18.6657,35.5296,222652,0,2159,220493
1/25/22,Mozambique,-18.6657,35.5296,222892,0,2161,220731
1/26/22,Mozambique,-18.6657,35.5296,223112,0,2163,220949
1/27/22,Mozambique,-18.6657,35.5296,223413,0,2164,221249
1/28/22,Mozambique,-18.6657,35.5296,223612,0,2165,221447
1/29/22,Mozambique,-18.6657,35.5296,223738,0,2167,221571
1/30/22,Mozambique,-18.6657,35.5296,223811,0,2170,221641
1/31/22,Mozambique,-18.6657,35.5296,223827,0,2173,221654
2/1/22,Mozambique,-18.6657,35.5296,223949,0,2174,221775
2/2/22,Mozambique,-18.6657,35.5296,224043,0,2180,221863
2/3/22,Mozambique,-18.6657,35.5296,224143,0,2180,221963
2/4/22,Mozambique,-18.6657,35.5296,224224,0,2183,222041
2/5/22,Mozambique,-18.6657,35.5296,224309,0,2183,222126
2/6/22,Mozambique,-18.6657,35.5296,224339,0,2183,222156
2/7/22,Mozambique,-18.6657,35.5296,224347,0,2183,222164
2/8/22,Mozambique,-18.6657,35.5296,224434,0,2185,222249
2/9/22,Mozambique,-18.6657,35.5296,224494,0,2186,222308
2/10/22,Mozambique,-18.6657,35.5296,224559,0,2188,222371
2/11/22,Mozambique,-18.6657,35.5296,224603,0,2188,222415
2/12/22,Mozambique,-18.6657,35.5296,224653,0,2189,222464
2/13/22,Mozambique,-18.6657,35.5296,224703,0,2189,222514
2/14/22,Mozambique,-18.6657,35.5296,224719,0,2189,222530
2/15/22,Mozambique,-18.6657,35.5296,224767,0,2189,222578
2/16/22,Mozambique,-18.6657,35.5296,224791,0,2189,222602
2/17/22,Mozambique,-18.6657,35.5296,224815,0,2189,222626
2/18/22,Mozambique,-18.6657,35.5296,224841,0,2189,222652
2/19/22,Mozambique,-18.6657,35.5296,224882,0,2189,222693
2/20/22,Mozambique,-18.6657,35.5296,224903,0,2189,222714
2/21/22,Mozambique,-18.6657,35.5296,224920,0,2189,222731
2/22/22,Mozambique,-18.6657,35.5296,224937,0,2190,222747
2/23/22,Mozambique,-18.6657,35.5296,224983,0,2191,222792
2/24/22,Mozambique,-18.6657,35.5296,224999,0,2192,222807
2/25/22,Mozambique,-18.6657,35.5296,225018,0,2192,222826
2/26/22,Mozambique,-18.6657,35.5296,225036,0,2192,222844
2/27/22,Mozambique,-18.6657,35.5296,225038,0,2192,222846
2/28/22,Mozambique,-18.6657,35.5296,225047,0,2192,222855
3/1/22,Mozambique,-18.6657,35.5296,225063,0,2192,222871
3/2/22,Mozambique,-18.6657,35.5296,225080,0,2193,222887
3/3/22,Mozambique,-18.6657,35.5296,225100,0,2194,222906
3/4/22,Mozambique,-18.6657,35.5296,225121,0,2195,222926
3/5/22,Mozambique,-18.6657,35.5296,225135,0,2196,222939
3/6/22,Mozambique,-18.6657,35.5296,225140,0,2196,222944
3/7/22,Mozambique,-18.6657,35.5296,225140,0,2196,222944
3/8/22,Mozambique,-18.6657,35.5296,225150,0,2197,222953
3/9/22,Mozambique,-18.6657,35.5296,225159,0,2198,222961
3/10/22,Mozambique,-18.6657,35.5296,225162,0,2198,222964
3/11/22,Mozambique,-18.6657,35.5296,225165,0,2198,222967
3/12/22,Mozambique,-18.6657,35.5296,225173,0,2198,222975
3/13/22,Mozambique,-18.6657,35.5296,225179,0,2198,222981
3/14/22,Mozambique,-18.6657,35.5296,225179,0,2198,222981
3/15/22,Mozambique,-18.6657,35.5296,225188,0,2198,222990
3/16/22,Mozambique,-18.6657,35.5296,225194,0,2198,222996
3/17/22,Mozambique,-18.6657,35.5296,225200,0,2199,223001
3/18/22,Mozambique,-18.6657,35.5296,225201,0,2199,223002
3/19/22,Mozambique,-18.6657,35.5296,225206,0,2199,223007
3/20/22,Mozambique,-18.6657,35.5296,225210,0,2200,223010
3/21/22,Mozambique,-18.6657,35.5296,225211,0,2200,223011
3/22/22,Mozambique,-18.6657,35.5296,225215,0,2200,223015
3/23/22,Mozambique,-18.6657,35.5296,225220,0,2200,223020
3/24/22,Mozambique,-18.6657,35.5296,225223,0,2200,223023
3/25/22,Mozambique,-18.6657,35.5296,225231,0,2200,223031
3/26/22,Mozambique,-18.6657,35.5296,225237,0,2200,223037
3/27/22,Mozambique,-18.6657,35.5296,225239,0,2200,223039
3/28/22,Mozambique,-18.6657,35.5296,225239,0,2200,223039
3/29/22,Mozambique,-18.6657,35.5296,225244,0,2200,223044
3/30/22,Mozambique,-18.6657,35.5296,225249,0,2200,223049
3/31/22,Mozambique,-18.6657,35.5296,225256,0,2200,223056
4/1/22,Mozambique,-18.6657,35.5296,225261,0,2200,223061
4/2/22,Mozambique,-18.6657,35.5296,225264,0,2200,223064
4/3/22,Mozambique,-18.6657,35.5296,225266,0,2200,223066
4/4/22,Mozambique,-18.6657,35.5296,225267,0,2200,223067
4/5/22,Mozambique,-18.6657,35.5296,225268,0,2200,223068
4/6/22,Mozambique,-18.6657,35.5296,225272,0,2200,223072
4/7/22,Mozambique,-18.6657,35.5296,225275,0,2200,223075
4/8/22,Mozambique,-18.6657,35.5296,225277,0,2200,223077
4/9/22,Mozambique,-18.6657,35.5296,225280,0,2200,223080
4/10/22,Mozambique,-18.6657,35.5296,225293,0,2200,223093
4/11/22,Mozambique,-18.6657,35.5296,225296,0,2200,223096
4/12/22,Mozambique,-18.6657,35.5296,225301,0,2200,223101
4/13/22,Mozambique,-18.6657,35.5296,225304,0,2200,223104
4/14/22,Mozambique,-18.6657,35.5296,225314,0,2200,223114
4/15/22,Mozambique,-18.6657,35.5296,225316,0,2200,223116
4/16/22,Mozambique,-18.6657,35.5296,225323,0,2200,223123
4/17/22,Mozambique,-18.6657,35.5296,225329,0,2200,223129
4/18/22,Mozambique,-18.6657,35.5296,225332,0,2201,223131
4/19/22,Mozambique,-18.6657,35.5296,225338,0,2201,223137
4/20/22,Mozambique,-18.6657,35.5296,225345,0,2201,223144
4/21/22,Mozambique,-18.6657,35.5296,225351,0,2201,223150
4/22/22,Mozambique,-18.6657,35.5296,225352,0,2201,223151
4/23/22,Mozambique,-18.6657,35.5296,225358,0,2201,223157
4/24/22,Mozambique,-18.6657,35.5296,225365,0,2201,223164
4/25/22,Mozambique,-18.6657,35.5296,225366,0,2201,223165
4/26/22,Mozambique,-18.6657,35.5296,225367,0,2201,223166
4/27/22,Mozambique,-18.6657,35.5296,225375,0,2201,223174
4/28/22,Mozambique,-18.6657,35.5296,225379,0,2201,223178
4/29/22,Mozambique,-18.6657,35.5296,225383,0,2201,223182
4/30/22,Mozambique,-18.6657,35.5296,225384,0,2201,223183
5/1/22,Mozambique,-18.6657,35.5296,225386,0,2201,223185
5/2/22,Mozambique,-18.6657,35.5296,225387,0,2201,223186
5/3/22,Mozambique,-18.6657,35.5296,225387,0,2201,223186
5/4/22,Mozambique,-18.6657,35.5296,225400,0,2201,223199
5/5/22,Mozambique,-18.6657,35.5296,225407,0,2201,223206
5/6/22,Mozambique,-18.6657,35.5296,225409,0,2201,223208
5/7/22,Mozambique,-18.6657,35.5296,225419,0,2201,223218
5/8/22,Mozambique,-18.6657,35.5296,225426,0,2201,223225
5/9/22,Mozambique,-18.6657,35.5296,225430,0,2201,223229
5/10/22,Mozambique,-18.6657,35.5296,225440,0,2201,223239
5/11/22,Mozambique,-18.6657,35.5296,225451,0,2201,223250
5/12/22,Mozambique,-18.6657,35.5296,225470,0,2201,223269
5/13/22,Mozambique,-18.6657,35.5296,225485,0,2201,223284
5/14/22,Mozambique,-18.6657,35.5296,225493,0,2201,223292
5/15/22,Mozambique,-18.6657,35.5296,225498,0,2201,223297
5/16/22,Mozambique,-18.6657,35.5296,225503,0,2201,223302
5/17/22,Mozambique,-18.6657,35.5296,225519,0,2201,223318
5/18/22,Mozambique,-18.6657,35.5296,225539,0,2201,223338
5/19/22,Mozambique,-18.6657,35.5296,225546,0,2201,223345
5/20/22,Mozambique,-18.6657,35.5296,225557,0,2201,223356
5/21/22,Mozambique,-18.6657,35.5296,225563,0,2201,223362
5/22/22,Mozambique,-18.6657,35.5296,225577,0,2201,223376
5/23/22,Mozambique,-18.6657,35.5296,225586,0,2203,223383
5/24/22,Mozambique,-18.6657,35.5296,225600,0,2203,223397
5/25/22,Mozambique,-18.6657,35.5296,225626,0,2203,223423
5/26/22,Mozambique,-18.6657,35.5296,225648,0,2203,223445
5/27/22,Mozambique,-18.6657,35.5296,225676,0,2203,223473
5/28/22,Mozambique,-18.6657,35.5296,225701,0,2203,223498
5/29/22,Mozambique,-18.6657,35.5296,225706,0,2203,223503
5/30/22,Mozambique,-18.6657,35.5296,225709,0,2203,223506
5/31/22,Mozambique,-18.6657,35.5296,225754,0,2203,223551
6/1/22,Mozambique,-18.6657,35.5296,225781,0,2203,223578
6/2/22,Mozambique,-18.6657,35.5296,225781,0,2203,223578
6/3/22,Mozambique,-18.6657,35.5296,225835,0,2203,223632
6/4/22,Mozambique,-18.6657,35.5296,225933,0,2203,223730
6/5/22,Mozambique,-18.6657,35.5296,225933,0,2203,223730
6/6/22,Mozambique,-18.6657,35.5296,225984,0,2204,223780
6/7/22,Mozambique,-18.6657,35.5296,226065,0,2204,223861
6/8/22,Mozambique,-18.6657,35.5296,226148,0,2206,223942
6/9/22,Mozambique,-18.6657,35.5296,226233,0,2206,224027
6/10/22,Mozambique,-18.6657,35.5296,226325,0,2206,224119
6/11/22,Mozambique,-18.6657,35.5296,226428,0,2206,224222
6/12/22,Mozambique,-18.6657,35.5296,226463,0,2206,224257
6/13/22,Mozambique,-18.6657,35.5296,226481,0,2206,224275
6/14/22,Mozambique,-18.6657,35.5296,226631,0,2208,224423
6/15/22,Mozambique,-18.6657,35.5296,226749,0,2208,224541
6/16/22,Mozambique,-18.6657,35.5296,226877,0,2209,224668
6/17/22,Mozambique,-18.6657,35.5296,226975,0,2209,224766
6/18/22,Mozambique,-18.6657,35.5296,227083,0,2209,224874
6/19/22,Mozambique,-18.6657,35.5296,227127,0,2209,224918
6/20/22,Mozambique,-18.6657,35.5296,227161,0,2210,224951
6/21/22,Mozambique,-18.6657,35.5296,227255,0,2211,225044
6/22/22,Mozambique,-18.6657,35.5296,227351,0,2212,225139
6/23/22,Mozambique,-18.6657,35.5296,227435,0,2212,225223
6/24/22,Mozambique,-18.6657,35.5296,227527,0,2212,225315
6/25/22,Mozambique,-18.6657,35.5296,227616,0,2212,225404
6/26/22,Mozambique,-18.6657,35.5296,227644,0,2212,225432
6/27/22,Mozambique,-18.6657,35.5296,227660,0,2212,225448
6/28/22,Mozambique,-18.6657,35.5296,227725,0,2212,225513
6/29/22,Mozambique,-18.6657,35.5296,227819,0,2212,225607
6/30/22,Mozambique,-18.6657,35.5296,227919,0,2212,225707
7/1/22,Mozambique,-18.6657,35.5296,228022,0,2212,225810
7/2/22,Mozambique,-18.6657,35.5296,228130,0,2212,225918
7/3/22,Mozambique,-18.6657,35.5296,228183,0,2212,225971
7/4/22,Mozambique,-18.6657,35.5296,228226,0,2212,226014
7/5/22,Mozambique,-18.6657,35.5296,228317,0,2213,226104
7/6/22,Mozambique,-18.6657,35.5296,228404,0,2213,226191
7/7/22,Mozambique,-18.6657,35.5296,228479,0,2214,226265
7/8/22,Mozambique,-18.6657,35.5296,228562,0,2214,226348
7/9/22,Mozambique,-18.6657,35.5296,228639,0,2214,226425
7/10/22,Mozambique,-18.6657,35.5296,228677,0,2214,226463
7/11/22,Mozambique,-18.6657,35.5296,228679,0,2213,226466
7/12/22,Mozambique,-18.6657,35.5296,228769,0,2214,226555
7/13/22,Mozambique,-18.6657,35.5296,228840,0,2214,226626
7/14/22,Mozambique,-18.6657,35.5296,228887,0,2215,226672
7/15/22,Mozambique,-18.6657,35.5296,228972,0,2215,226757
7/16/22,Mozambique,-18.6657,35.5296,229020,0,2215,226805
7/17/22,Mozambique,-18.6657,35.5296,229038,0,2215,226823
7/18/22,Mozambique,-18.6657,35.5296,229077,0,2215,226862
7/19/22,Mozambique,-18.6657,35.5296,229117,0,2215,226902
7/20/22,Mozambique,-18.6657,35.5296,229160,0,2215,226945
7/21/22,Mozambique,-18.6657,35.5296,229252,0,2215,227037
7/22/22,Mozambique,-18.6657,35.5296,229285,0,2215,227070
7/23/22,Mozambique,-18.6657,35.5296,229351,0,2215,227136
7/24/22,Mozambique,-18.6657,35.5296,229375,0,2215,227160
7/25/22,Mozambique,-18.6657,35.5296,229387,0,2215,227172
7/26/22,Mozambique,-18.6657,35.5296,229411,0,2215,227196
7/27/22,Mozambique,-18.6657,35.5296,229443,0,2215,227228
7/28/22,Mozambique,-18.6657,35.5296,229483,0,2215,227268
7/29/22,Mozambique,-18.6657,35.5296,229524,0,2215,227309
7/30/22,Mozambique,-18.6657,35.5296,229564,0,2215,227349
7/31/22,Mozambique,-18.6657,35.5296,229580,0,2215,227365
8/1/22,Mozambique,-18.6657,35.5296,229601,0,2215,227386
8/2/22,Mozambique,-18.6657,35.5296,229623,0,2215,227408
8/3/22,Mozambique,-18.6657,35.5296,229645,0,2216,227429
8/4/22,Mozambique,-18.6657,35.5296,229674,0,2216,227458
8/5/22,Mozambique,-18.6657,35.5296,229696,0,2216,227480
8/6/22,Mozambique,-18.6657,35.5296,229739,0,2216,227523
8/7/22,Mozambique,-18.6657,35.5296,229755,0,2216,227539
8/8/22,Mozambique,-18.6657,35.5296,229759,0,2216,227543
8/9/22,Mozambique,-18.6657,35.5296,229777,0,2216,227561
8/10/22,Mozambique,-18.6657,35.5296,229777,0,2216,227561
8/11/22,Mozambique,-18.6657,35.5296,229836,0,2218,227618
8/12/22,Mozambique,-18.6657,35.5296,229836,0,2218,227618
8/13/22,Mozambique,-18.6657,35.5296,229859,0,2219,227640
8/14/22,Mozambique,-18.6657,35.5296,229887,0,2219,227668
8/15/22,Mozambique,-18.6657,35.5296,229890,0,2219,227671
8/16/22,Mozambique,-18.6657,35.5296,229909,0,2219,227690
8/17/22,Mozambique,-18.6657,35.5296,229932,0,2219,227713
8/18/22,Mozambique,-18.6657,35.5296,229932,0,2219,227713
8/19/22,Mozambique,-18.6657,35.5296,229975,0,2219,227756
8/20/22,Mozambique,-18.6657,35.5296,229992,0,2219,227773
8/21/22,Mozambique,-18.6657,35.5296,230001,0,2219,227782
8/22/22,Mozambique,-18.6657,35.5296,230004,0,2219,227785
8/23/22,Mozambique,-18.6657,35.5296,230009,0,2219,227790
8/24/22,Mozambique,-18.6657,35.5296,230009,0,2219,227790
8/25/22,Mozambique,-18.6657,35.5296,230019,0,2219,227800
8/26/22,Mozambique,-18.6657,35.5296,230053,0,2219,227834
8/27/22,Mozambique,-18.6657,35.5296,230064,0,2219,227845
8/28/22,Mozambique,-18.6657,35.5296,230068,0,2219,227849
8/29/22,Mozambique,-18.6657,35.5296,230069,0,2219,227850
8/30/22,Mozambique,-18.6657,35.5296,230076,0,2220,227856
8/31/22,Mozambique,-18.6657,35.5296,230076,0,2220,227856
9/1/22,Mozambique,-18.6657,35.5296,230095,0,2220,227875
9/2/22,Mozambique,-18.6657,35.5296,230113,0,2220,227893
9/3/22,Mozambique,-18.6657,35.5296,230113,0,2220,227893
9/4/22,Mozambique,-18.6657,35.5296,230129,0,2221,227908
9/5/22,Mozambique,-18.6657,35.5296,230130,0,2221,227909
9/6/22,Mozambique,-18.6657,35.5296,230137,0,2221,227916
9/7/22,Mozambique,-18.6657,35.5296,230145,0,2221,227924
9/8/22,Mozambique,-18.6657,35.5296,230150,0,2221,227929
9/9/22,Mozambique,-18.6657,35.5296,230157,0,2221,227936
9/10/22,Mozambique,-18.6657,35.5296,230171,0,2221,227950
9/11/22,Mozambique,-18.6657,35.5296,230172,0,2221,227951
9/12/22,Mozambique,-18.6657,35.5296,230174,0,2222,227952
9/13/22,Mozambique,-18.6657,35.5296,230180,0,2222,227958
9/14/22,Mozambique,-18.6657,35.5296,230184,0,2222,227962
9/15/22,Mozambique,-18.6657,35.5296,230184,0,2222,227962
9/16/22,Mozambique,-18.6657,35.5296,230192,0,2222,227970
9/17/22,Mozambique,-18.6657,35.5296,230219,0,2222,227997
9/18/22,Mozambique,-18.6657,35.5296,230219,0,2222,227997
9/19/22,Mozambique,-18.6657,35.5296,230219,0,2222,227997
9/20/22,Mozambique,-18.6657,35.5296,230219,0,2222,227997
9/21/22,Mozambique,-18.6657,35.5296,230219,0,2222,227997
9/22/22,Mozambique,-18.6657,35.5296,230219,0,2222,227997
9/23/22,Mozambique,-18.6657,35.5296,230219,0,2222,227997
9/24/22,Mozambique,-18.6657,35.5296,230219,0,2222,227997
9/25/22,Mozambique,-18.6657,35.5296,230219,0,2222,227997
9/26/22,Mozambique,-18.6657,35.5296,230219,0,2222,227997
9/27/22,Mozambique,-18.6657,35.5296,230219,0,2222,227997
9/28/22,Mozambique,-18.6657,35.5296,230219,0,2222,227997
9/29/22,Mozambique,-18.6657,35.5296,230312,0,2222,228090
9/30/22,Mozambique,-18.6657,35.5296,230312,0,2222,228090
10/1/22,Mozambique,-18.6657,35.5296,230312,0,2222,228090
10/2/22,Mozambique,-18.6657,35.5296,230312,0,2222,228090
10/3/22,Mozambique,-18.6657,35.5296,230312,0,2222,228090
10/4/22,Mozambique,-18.6657,35.5296,230312,0,2222,228090
10/5/22,Mozambique,-18.6657,35.5296,230312,0,2222,228090
10/6/22,Mozambique,-18.6657,35.5296,230312,0,2222,228090
10/7/22,Mozambique,-18.6657,35.5296,230312,0,2222,228090
10/8/22,Mozambique,-18.6657,35.5296,230312,0,2222,228090
10/9/22,Mozambique,-18.6657,35.5296,230312,0,2222,228090
10/10/22,Mozambique,-18.6657,35.5296,230312,0,2222,228090
10/11/22,Mozambique,-18.6657,35.5296,230370,0,2224,228146
10/12/22,Mozambique,-18.6657,35.5296,230370,0,2224,228146
10/13/22,Mozambique,-18.6657,35.5296,230370,0,2224,228146
10/14/22,Mozambique,-18.6657,35.5296,230370,0,2224,228146
10/15/22,Mozambique,-18.6657,35.5296,230370,0,2224,228146
10/16/22,Mozambique,-18.6657,35.5296,230370,0,2224,228146
10/17/22,Mozambique,-18.6657,35.5296,230370,0,2224,228146
10/18/22,Mozambique,-18.6657,35.5296,230370,0,2224,228146
10/19/22,Mozambique,-18.6657,35.5296,230370,0,2224,228146
10/20/22,Mozambique,-18.6657,35.5296,230370,0,2224,228146
10/21/22,Mozambique,-18.6657,35.5296,230370,0,2224,228146
10/22/22,Mozambique,-18.6657,35.5296,230370,0,2224,228146
10/23/22,Mozambique,-18.6657,35.5296,230370,0,2224,228146
10/24/22,Mozambique,-18.6657,35.5296,230431,0,2224,228207
10/25/22,Mozambique,-18.6657,35.5296,230431,0,2224,228207
10/26/22,Mozambique,-18.6657,35.5296,230431,0,2224,228207
10/27/22,Mozambique,-18.6657,35.5296,230431,0,2224,228207
10/28/22,Mozambique,-18.6657,35.5296,230431,0,2224,228207
10/29/22,Mozambique,-18.6657,35.5296,230431,0,2224,228207
10/30/22,Mozambique,-18.6657,35.5296,230431,0,2224,228207
10/31/22,Mozambique,-18.6657,35.5296,230475,0,2224,228251
11/1/22,Mozambique,-18.6657,35.5296,230475,0,2224,228251
11/2/22,Mozambique,-18.6657,35.5296,230475,0,2224,228251
11/3/22,Mozambique,-18.6657,35.5296,230475,0,2224,228251
11/4/22,Mozambique,-18.6657,35.5296,230475,0,2224,228251
11/5/22,Mozambique,-18.6657,35.5296,230475,0,2224,228251
11/6/22,Mozambique,-18.6657,35.5296,230475,0,2224,228251
11/7/22,Mozambique,-18.6657,35.5296,230475,0,2224,228251
11/8/22,Mozambique,-18.6657,35.5296,230475,0,2224,228251
11/9/22,Mozambique,-18.6657,35.5296,230475,0,2224,228251
11/10/22,Mozambique,-18.6657,35.5296,230475,0,2224,228251
11/11/22,Mozambique,-18.6657,35.5296,230475,0,2224,228251
11/12/22,Mozambique,-18.6657,35.5296,230475,0,2224,228251
11/13/22,Mozambique,-18.6657,35.5296,230475,0,2224,228251
11/14/22,Mozambique,-18.6657,35.5296,230543,0,2224,228319
11/15/22,Mozambique,-18.6657,35.5296,230543,0,2224,228319
11/16/22,Mozambique,-18.6657,35.5296,230543,0,2224,228319
11/17/22,Mozambique,-18.6657,35.5296,230543,0,2224,228319
11/18/22,Mozambique,-18.6657,35.5296,230543,0,2224,228319
11/19/22,Mozambique,-18.6657,35.5296,230543,0,2224,228319
11/20/22,Mozambique,-18.6657,35.5296,230543,0,2224,228319
11/21/22,Mozambique,-18.6657,35.5296,230590,0,2224,228366
11/22/22,Mozambique,-18.6657,35.5296,230590,0,2224,228366
11/23/22,Mozambique,-18.6657,35.5296,230590,0,2224,228366
11/24/22,Mozambique,-18.6657,35.5296,230590,0,2224,228366
11/25/22,Mozambique,-18.6657,35.5296,230590,0,2224,228366
11/26/22,Mozambique,-18.6657,35.5296,230590,0,2224,228366
11/27/22,Mozambique,-18.6657,35.5296,230590,0,2224,228366
11/28/22,Mozambique,-18.6657,35.5296,230590,0,2224,228366
11/29/22,Mozambique,-18.6657,35.5296,230624,0,2226,228398
11/30/22,Mozambique,-18.6657,35.5296,230624,0,2226,228398
12/1/22,Mozambique,-18.6657,35.5296,230624,0,2226,228398
12/2/22,Mozambique,-18.6657,35.5296,230624,0,2226,228398
12/3/22,Mozambique,-18.6657,35.5296,230624,0,2226,228398
12/4/22,Mozambique,-18.6657,35.5296,230624,0,2226,228398
12/5/22,Mozambique,-18.6657,35.5296,230624,0,2226,228398
12/6/22,Mozambique,-18.6657,35.5296,230624,0,2226,228398
12/7/22,Mozambique,-18.6657,35.5296,230624,0,2226,228398
12/8/22,Mozambique,-18.6657,35.5296,230624,0,2226,228398
12/9/22,Mozambique,-18.6657,35.5296,230624,0,2226,228398
12/10/22,Mozambique,-18.6657,35.5296,230624,0,2226,228398
12/11/22,Mozambique,-18.6657,35.5296,230624,0,2226,228398
12/12/22,Mozambique,-18.6657,35.5296,230816,0,2229,228587
12/13/22,Mozambique,-18.6657,35.5296,230816,0,2229,228587
12/14/22,Mozambique,-18.6657,35.5296,230816,0,2229,228587
12/15/22,Mozambique,-18.6657,35.5296,230816,0,2229,228587
12/16/22,Mozambique,-18.6657,35.5296,230816,0,2229,228587
12/17/22,Mozambique,-18.6657,35.5296,230816,0,2229,228587
1/1/22,MS Zaandam,0.0,0.0,9,0,2,7
1/2/22,MS Zaandam,0.0,0.0,9,0,2,7
1/3/22,MS Zaandam,0.0,0.0,9,0,2,7
1/4/22,MS Zaandam,0.0,0.0,9,0,2,7
1/5/22,MS Zaandam,0.0,0.0,9,0,2,7
1/6/22,MS Zaandam,0.0,0.0,9,0,2,7
1/7/22,MS Zaandam,0.0,0.0,9,0,2,7
1/8/22,MS Zaandam,0.0,0.0,9,0,2,7
1/9/22,MS Zaandam,0.0,0.0,9,0,2,7
1/10/22,MS Zaandam,0.0,0.0,9,0,2,7
1/11/22,MS Zaandam,0.0,0.0,9,0,2,7
1/12/22,MS Zaandam,0.0,0.0,9,0,2,7
1/13/22,MS Zaandam,0.0,0.0,9,0,2,7
1/14/22,MS Zaandam,0.0,0.0,9,0,2,7
1/15/22,MS Zaandam,0.0,0.0,9,0,2,7
1/16/22,MS Zaandam,0.0,0.0,9,0,2,7
1/17/22,MS Zaandam,0.0,0.0,9,0,2,7
1/18/22,MS Zaandam,0.0,0.0,9,0,2,7
1/19/22,MS Zaandam,0.0,0.0,9,0,2,7
1/20/22,MS Zaandam,0.0,0.0,9,0,2,7
1/21/22,MS Zaandam,0.0,0.0,9,0,2,7
1/22/22,MS Zaandam,0.0,0.0,9,0,2,7
1/23/22,MS Zaandam,0.0,0.0,9,0,2,7
1/24/22,MS Zaandam,0.0,0.0,9,0,2,7
1/25/22,MS Zaandam,0.0,0.0,9,0,2,7
1/26/22,MS Zaandam,0.0,0.0,9,0,2,7
1/27/22,MS Zaandam,0.0,0.0,9,0,2,7
1/28/22,MS Zaandam,0.0,0.0,9,0,2,7
1/29/22,MS Zaandam,0.0,0.0,9,0,2,7
1/30/22,MS Zaandam,0.0,0.0,9,0,2,7
1/31/22,MS Zaandam,0.0,0.0,9,0,2,7
2/1/22,MS Zaandam,0.0,0.0,9,0,2,7
2/2/22,MS Zaandam,0.0,0.0,9,0,2,7
2/3/22,MS Zaandam,0.0,0.0,9,0,2,7
2/4/22,MS Zaandam,0.0,0.0,9,0,2,7
2/5/22,MS Zaandam,0.0,0.0,9,0,2,7
2/6/22,MS Zaandam,0.0,0.0,9,0,2,7
2/7/22,MS Zaandam,0.0,0.0,9,0,2,7
2/8/22,MS Zaandam,0.0,0.0,9,0,2,7
2/9/22,MS Zaandam,0.0,0.0,9,0,2,7
2/10/22,MS Zaandam,0.0,0.0,9,0,2,7
2/11/22,MS Zaandam,0.0,0.0,9,0,2,7
2/12/22,MS Zaandam,0.0,0.0,9,0,2,7
2/13/22,MS Zaandam,0.0,0.0,9,0,2,7
2/14/22,MS Zaandam,0.0,0.0,9,0,2,7
2/15/22,MS Zaandam,0.0,0.0,9,0,2,7
2/16/22,MS Zaandam,0.0,0.0,9,0,2,7
2/17/22,MS Zaandam,0.0,0.0,9,0,2,7
2/18/22,MS Zaandam,0.0,0.0,9,0,2,7
2/19/22,MS Zaandam,0.0,0.0,9,0,2,7
2/20/22,MS Zaandam,0.0,0.0,9,0,2,7
2/21/22,MS Zaandam,0.0,0.0,9,0,2,7
2/22/22,MS Zaandam,0.0,0.0,9,0,2,7
2/23/22,MS Zaandam,0.0,0.0,9,0,2,7
2/24/22,MS Zaandam,0.0,0.0,9,0,2,7
2/25/22,MS Zaandam,0.0,0.0,9,0,2,7
2/26/22,MS Zaandam,0.0,0.0,9,0,2,7
2/27/22,MS Zaandam,0.0,0.0,9,0,2,7
2/28/22,MS Zaandam,0.0,0.0,9,0,2,7
3/1/22,MS Zaandam,0.0,0.0,9,0,2,7
3/2/22,MS Zaandam,0.0,0.0,9,0,2,7
3/3/22,MS Zaandam,0.0,0.0,9,0,2,7
3/4/22,MS Zaandam,0.0,0.0,9,0,2,7
3/5/22,MS Zaandam,0.0,0.0,9,0,2,7
3/6/22,MS Zaandam,0.0,0.0,9,0,2,7
3/7/22,MS Zaandam,0.0,0.0,9,0,2,7
3/8/22,MS Zaandam,0.0,0.0,9,0,2,7
3/9/22,MS Zaandam,0.0,0.0,9,0,2,7
3/10/22,MS Zaandam,0.0,0.0,9,0,2,7
3/11/22,MS Zaandam,0.0,0.0,9,0,2,7
3/12/22,MS Zaandam,0.0,0.0,9,0,2,7
3/13/22,MS Zaandam,0.0,0.0,9,0,2,7
3/14/22,MS Zaandam,0.0,0.0,9,0,2,7
3/15/22,MS Zaandam,0.0,0.0,9,0,2,7
3/16/22,MS Zaandam,0.0,0.0,9,0,2,7
3/17/22,MS Zaandam,0.0,0.0,9,0,2,7
3/18/22,MS Zaandam,0.0,0.0,9,0,2,7
3/19/22,MS Zaandam,0.0,0.0,9,0,2,7
3/20/22,MS Zaandam,0.0,0.0,9,0,2,7
3/21/22,MS Zaandam,0.0,0.0,9,0,2,7
3/22/22,MS Zaandam,0.0,0.0,9,0,2,7
3/23/22,MS Zaandam,0.0,0.0,9,0,2,7
3/24/22,MS Zaandam,0.0,0.0,9,0,2,7
3/25/22,MS Zaandam,0.0,0.0,9,0,2,7
3/26/22,MS Zaandam,0.0,0.0,9,0,2,7
3/27/22,MS Zaandam,0.0,0.0,9,0,2,7
3/28/22,MS Zaandam,0.0,0.0,9,0,2,7
3/29/22,MS Zaandam,0.0,0.0,9,0,2,7
3/30/22,MS Zaandam,0.0,0.0,9,0,2,7
3/31/22,MS Zaandam,0.0,0.0,9,0,2,7
4/1/22,MS Zaandam,0.0,0.0,9,0,2,7
4/2/22,MS Zaandam,0.0,0.0,9,0,2,7
4/3/22,MS Zaandam,0.0,0.0,9,0,2,7
4/4/22,MS Zaandam,0.0,0.0,9,0,2,7
4/5/22,MS Zaandam,0.0,0.0,9,0,2,7
4/6/22,MS Zaandam,0.0,0.0,9,0,2,7
4/7/22,MS Zaandam,0.0,0.0,9,0,2,7
4/8/22,MS Zaandam,0.0,0.0,9,0,2,7
4/9/22,MS Zaandam,0.0,0.0,9,0,2,7
4/10/22,MS Zaandam,0.0,0.0,9,0,2,7
4/11/22,MS Zaandam,0.0,0.0,9,0,2,7
4/12/22,MS Zaandam,0.0,0.0,9,0,2,7
4/13/22,MS Zaandam,0.0,0.0,9,0,2,7
4/14/22,MS Zaandam,0.0,0.0,9,0,2,7
4/15/22,MS Zaandam,0.0,0.0,9,0,2,7
4/16/22,MS Zaandam,0.0,0.0,9,0,2,7
4/17/22,MS Zaandam,0.0,0.0,9,0,2,7
4/18/22,MS Zaandam,0.0,0.0,9,0,2,7
4/19/22,MS Zaandam,0.0,0.0,9,0,2,7
4/20/22,MS Zaandam,0.0,0.0,9,0,2,7
4/21/22,MS Zaandam,0.0,0.0,9,0,2,7
4/22/22,MS Zaandam,0.0,0.0,9,0,2,7
4/23/22,MS Zaandam,0.0,0.0,9,0,2,7
4/24/22,MS Zaandam,0.0,0.0,9,0,2,7
4/25/22,MS Zaandam,0.0,0.0,9,0,2,7
4/26/22,MS Zaandam,0.0,0.0,9,0,2,7
4/27/22,MS Zaandam,0.0,0.0,9,0,2,7
4/28/22,MS Zaandam,0.0,0.0,9,0,2,7
4/29/22,MS Zaandam,0.0,0.0,9,0,2,7
4/30/22,MS Zaandam,0.0,0.0,9,0,2,7
5/1/22,MS Zaandam,0.0,0.0,9,0,2,7
5/2/22,MS Zaandam,0.0,0.0,9,0,2,7
5/3/22,MS Zaandam,0.0,0.0,9,0,2,7
5/4/22,MS Zaandam,0.0,0.0,9,0,2,7
5/5/22,MS Zaandam,0.0,0.0,9,0,2,7
5/6/22,MS Zaandam,0.0,0.0,9,0,2,7
5/7/22,MS Zaandam,0.0,0.0,9,0,2,7
5/8/22,MS Zaandam,0.0,0.0,9,0,2,7
5/9/22,MS Zaandam,0.0,0.0,9,0,2,7
5/10/22,MS Zaandam,0.0,0.0,9,0,2,7
5/11/22,MS Zaandam,0.0,0.0,9,0,2,7
5/12/22,MS Zaandam,0.0,0.0,9,0,2,7
5/13/22,MS Zaandam,0.0,0.0,9,0,2,7
5/14/22,MS Zaandam,0.0,0.0,9,0,2,7
5/15/22,MS Zaandam,0.0,0.0,9,0,2,7
5/16/22,MS Zaandam,0.0,0.0,9,0,2,7
5/17/22,MS Zaandam,0.0,0.0,9,0,2,7
5/18/22,MS Zaandam,0.0,0.0,9,0,2,7
5/19/22,MS Zaandam,0.0,0.0,9,0,2,7
5/20/22,MS Zaandam,0.0,0.0,9,0,2,7
5/21/22,MS Zaandam,0.0,0.0,9,0,2,7
5/22/22,MS Zaandam,0.0,0.0,9,0,2,7
5/23/22,MS Zaandam,0.0,0.0,9,0,2,7
5/24/22,MS Zaandam,0.0,0.0,9,0,2,7
5/25/22,MS Zaandam,0.0,0.0,9,0,2,7
5/26/22,MS Zaandam,0.0,0.0,9,0,2,7
5/27/22,MS Zaandam,0.0,0.0,9,0,2,7
5/28/22,MS Zaandam,0.0,0.0,9,0,2,7
5/29/22,MS Zaandam,0.0,0.0,9,0,2,7
5/30/22,MS Zaandam,0.0,0.0,9,0,2,7
5/31/22,MS Zaandam,0.0,0.0,9,0,2,7
6/1/22,MS Zaandam,0.0,0.0,9,0,2,7
6/2/22,MS Zaandam,0.0,0.0,9,0,2,7
6/3/22,MS Zaandam,0.0,0.0,9,0,2,7
6/4/22,MS Zaandam,0.0,0.0,9,0,2,7
6/5/22,MS Zaandam,0.0,0.0,9,0,2,7
6/6/22,MS Zaandam,0.0,0.0,9,0,2,7
6/7/22,MS Zaandam,0.0,0.0,9,0,2,7
6/8/22,MS Zaandam,0.0,0.0,9,0,2,7
6/9/22,MS Zaandam,0.0,0.0,9,0,2,7
6/10/22,MS Zaandam,0.0,0.0,9,0,2,7
6/11/22,MS Zaandam,0.0,0.0,9,0,2,7
6/12/22,MS Zaandam,0.0,0.0,9,0,2,7
6/13/22,MS Zaandam,0.0,0.0,9,0,2,7
6/14/22,MS Zaandam,0.0,0.0,9,0,2,7
6/15/22,MS Zaandam,0.0,0.0,9,0,2,7
6/16/22,MS Zaandam,0.0,0.0,9,0,2,7
6/17/22,MS Zaandam,0.0,0.0,9,0,2,7
6/18/22,MS Zaandam,0.0,0.0,9,0,2,7
6/19/22,MS Zaandam,0.0,0.0,9,0,2,7
6/20/22,MS Zaandam,0.0,0.0,9,0,2,7
6/21/22,MS Zaandam,0.0,0.0,9,0,2,7
6/22/22,MS Zaandam,0.0,0.0,9,0,2,7
6/23/22,MS Zaandam,0.0,0.0,9,0,2,7
6/24/22,MS Zaandam,0.0,0.0,9,0,2,7
6/25/22,MS Zaandam,0.0,0.0,9,0,2,7
6/26/22,MS Zaandam,0.0,0.0,9,0,2,7
6/27/22,MS Zaandam,0.0,0.0,9,0,2,7
6/28/22,MS Zaandam,0.0,0.0,9,0,2,7
6/29/22,MS Zaandam,0.0,0.0,9,0,2,7
6/30/22,MS Zaandam,0.0,0.0,9,0,2,7
7/1/22,MS Zaandam,0.0,0.0,9,0,2,7
7/2/22,MS Zaandam,0.0,0.0,9,0,2,7
7/3/22,MS Zaandam,0.0,0.0,9,0,2,7
7/4/22,MS Zaandam,0.0,0.0,9,0,2,7
7/5/22,MS Zaandam,0.0,0.0,9,0,2,7
7/6/22,MS Zaandam,0.0,0.0,9,0,2,7
7/7/22,MS Zaandam,0.0,0.0,9,0,2,7
7/8/22,MS Zaandam,0.0,0.0,9,0,2,7
7/9/22,MS Zaandam,0.0,0.0,9,0,2,7
7/10/22,MS Zaandam,0.0,0.0,9,0,2,7
7/11/22,MS Zaandam,0.0,0.0,9,0,2,7
7/12/22,MS Zaandam,0.0,0.0,9,0,2,7
7/13/22,MS Zaandam,0.0,0.0,9,0,2,7
7/14/22,MS Zaandam,0.0,0.0,9,0,2,7
7/15/22,MS Zaandam,0.0,0.0,9,0,2,7
7/16/22,MS Zaandam,0.0,0.0,9,0,2,7
7/17/22,MS Zaandam,0.0,0.0,9,0,2,7
7/18/22,MS Zaandam,0.0,0.0,9,0,2,7
7/19/22,MS Zaandam,0.0,0.0,9,0,2,7
7/20/22,MS Zaandam,0.0,0.0,9,0,2,7
7/21/22,MS Zaandam,0.0,0.0,9,0,2,7
7/22/22,MS Zaandam,0.0,0.0,9,0,2,7
7/23/22,MS Zaandam,0.0,0.0,9,0,2,7
7/24/22,MS Zaandam,0.0,0.0,9,0,2,7
7/25/22,MS Zaandam,0.0,0.0,9,0,2,7
7/26/22,MS Zaandam,0.0,0.0,9,0,2,7
7/27/22,MS Zaandam,0.0,0.0,9,0,2,7
7/28/22,MS Zaandam,0.0,0.0,9,0,2,7
7/29/22,MS Zaandam,0.0,0.0,9,0,2,7
7/30/22,MS Zaandam,0.0,0.0,9,0,2,7
7/31/22,MS Zaandam,0.0,0.0,9,0,2,7
8/1/22,MS Zaandam,0.0,0.0,9,0,2,7
8/2/22,MS Zaandam,0.0,0.0,9,0,2,7
8/3/22,MS Zaandam,0.0,0.0,9,0,2,7
8/4/22,MS Zaandam,0.0,0.0,9,0,2,7
8/5/22,MS Zaandam,0.0,0.0,9,0,2,7
8/6/22,MS Zaandam,0.0,0.0,9,0,2,7
8/7/22,MS Zaandam,0.0,0.0,9,0,2,7
8/8/22,MS Zaandam,0.0,0.0,9,0,2,7
8/9/22,MS Zaandam,0.0,0.0,9,0,2,7
8/10/22,MS Zaandam,0.0,0.0,9,0,2,7
8/11/22,MS Zaandam,0.0,0.0,9,0,2,7
8/12/22,MS Zaandam,0.0,0.0,9,0,2,7
8/13/22,MS Zaandam,0.0,0.0,9,0,2,7
8/14/22,MS Zaandam,0.0,0.0,9,0,2,7
8/15/22,MS Zaandam,0.0,0.0,9,0,2,7
8/16/22,MS Zaandam,0.0,0.0,9,0,2,7
8/17/22,MS Zaandam,0.0,0.0,9,0,2,7
8/18/22,MS Zaandam,0.0,0.0,9,0,2,7
8/19/22,MS Zaandam,0.0,0.0,9,0,2,7
8/20/22,MS Zaandam,0.0,0.0,9,0,2,7
8/21/22,MS Zaandam,0.0,0.0,9,0,2,7
8/22/22,MS Zaandam,0.0,0.0,9,0,2,7
8/23/22,MS Zaandam,0.0,0.0,9,0,2,7
8/24/22,MS Zaandam,0.0,0.0,9,0,2,7
8/25/22,MS Zaandam,0.0,0.0,9,0,2,7
8/26/22,MS Zaandam,0.0,0.0,9,0,2,7
8/27/22,MS Zaandam,0.0,0.0,9,0,2,7
8/28/22,MS Zaandam,0.0,0.0,9,0,2,7
8/29/22,MS Zaandam,0.0,0.0,9,0,2,7
8/30/22,MS Zaandam,0.0,0.0,9,0,2,7
8/31/22,MS Zaandam,0.0,0.0,9,0,2,7
9/1/22,MS Zaandam,0.0,0.0,9,0,2,7
9/2/22,MS Zaandam,0.0,0.0,9,0,2,7
9/3/22,MS Zaandam,0.0,0.0,9,0,2,7
9/4/22,MS Zaandam,0.0,0.0,9,0,2,7
9/5/22,MS Zaandam,0.0,0.0,9,0,2,7
9/6/22,MS Zaandam,0.0,0.0,9,0,2,7
9/7/22,MS Zaandam,0.0,0.0,9,0,2,7
9/8/22,MS Zaandam,0.0,0.0,9,0,2,7
9/9/22,MS Zaandam,0.0,0.0,9,0,2,7
9/10/22,MS Zaandam,0.0,0.0,9,0,2,7
9/11/22,MS Zaandam,0.0,0.0,9,0,2,7
9/12/22,MS Zaandam,0.0,0.0,9,0,2,7
9/13/22,MS Zaandam,0.0,0.0,9,0,2,7
9/14/22,MS Zaandam,0.0,0.0,9,0,2,7
9/15/22,MS Zaandam,0.0,0.0,9,0,2,7
9/16/22,MS Zaandam,0.0,0.0,9,0,2,7
9/17/22,MS Zaandam,0.0,0.0,9,0,2,7
9/18/22,MS Zaandam,0.0,0.0,9,0,2,7
9/19/22,MS Zaandam,0.0,0.0,9,0,2,7
9/20/22,MS Zaandam,0.0,0.0,9,0,2,7
9/21/22,MS Zaandam,0.0,0.0,9,0,2,7
9/22/22,MS Zaandam,0.0,0.0,9,0,2,7
9/23/22,MS Zaandam,0.0,0.0,9,0,2,7
9/24/22,MS Zaandam,0.0,0.0,9,0,2,7
9/25/22,MS Zaandam,0.0,0.0,9,0,2,7
9/26/22,MS Zaandam,0.0,0.0,9,0,2,7
9/27/22,MS Zaandam,0.0,0.0,9,0,2,7
9/28/22,MS Zaandam,0.0,0.0,9,0,2,7
9/29/22,MS Zaandam,0.0,0.0,9,0,2,7
9/30/22,MS Zaandam,0.0,0.0,9,0,2,7
10/1/22,MS Zaandam,0.0,0.0,9,0,2,7
10/2/22,MS Zaandam,0.0,0.0,9,0,2,7
10/3/22,MS Zaandam,0.0,0.0,9,0,2,7
10/4/22,MS Zaandam,0.0,0.0,9,0,2,7
10/5/22,MS Zaandam,0.0,0.0,9,0,2,7
10/6/22,MS Zaandam,0.0,0.0,9,0,2,7
10/7/22,MS Zaandam,0.0,0.0,9,0,2,7
10/8/22,MS Zaandam,0.0,0.0,9,0,2,7
10/9/22,MS Zaandam,0.0,0.0,9,0,2,7
10/10/22,MS Zaandam,0.0,0.0,9,0,2,7
10/11/22,MS Zaandam,0.0,0.0,9,0,2,7
10/12/22,MS Zaandam,0.0,0.0,9,0,2,7
10/13/22,MS Zaandam,0.0,0.0,9,0,2,7
10/14/22,MS Zaandam,0.0,0.0,9,0,2,7
10/15/22,MS Zaandam,0.0,0.0,9,0,2,7
10/16/22,MS Zaandam,0.0,0.0,9,0,2,7
10/17/22,MS Zaandam,0.0,0.0,9,0,2,7
10/18/22,MS Zaandam,0.0,0.0,9,0,2,7
10/19/22,MS Zaandam,0.0,0.0,9,0,2,7
10/20/22,MS Zaandam,0.0,0.0,9,0,2,7
10/21/22,MS Zaandam,0.0,0.0,9,0,2,7
10/22/22,MS Zaandam,0.0,0.0,9,0,2,7
10/23/22,MS Zaandam,0.0,0.0,9,0,2,7
10/24/22,MS Zaandam,0.0,0.0,9,0,2,7
10/25/22,MS Zaandam,0.0,0.0,9,0,2,7
10/26/22,MS Zaandam,0.0,0.0,9,0,2,7
10/27/22,MS Zaandam,0.0,0.0,9,0,2,7
10/28/22,MS Zaandam,0.0,0.0,9,0,2,7
10/29/22,MS Zaandam,0.0,0.0,9,0,2,7
10/30/22,MS Zaandam,0.0,0.0,9,0,2,7
10/31/22,MS Zaandam,0.0,0.0,9,0,2,7
11/1/22,MS Zaandam,0.0,0.0,9,0,2,7
11/2/22,MS Zaandam,0.0,0.0,9,0,2,7
11/3/22,MS Zaandam,0.0,0.0,9,0,2,7
11/4/22,MS Zaandam,0.0,0.0,9,0,2,7
11/5/22,MS Zaandam,0.0,0.0,9,0,2,7
11/6/22,MS Zaandam,0.0,0.0,9,0,2,7
11/7/22,MS Zaandam,0.0,0.0,9,0,2,7
11/8/22,MS Zaandam,0.0,0.0,9,0,2,7
11/9/22,MS Zaandam,0.0,0.0,9,0,2,7
11/10/22,MS Zaandam,0.0,0.0,9,0,2,7
11/11/22,MS Zaandam,0.0,0.0,9,0,2,7
11/12/22,MS Zaandam,0.0,0.0,9,0,2,7
11/13/22,MS Zaandam,0.0,0.0,9,0,2,7
11/14/22,MS Zaandam,0.0,0.0,9,0,2,7
11/15/22,MS Zaandam,0.0,0.0,9,0,2,7
11/16/22,MS Zaandam,0.0,0.0,9,0,2,7
11/17/22,MS Zaandam,0.0,0.0,9,0,2,7
11/18/22,MS Zaandam,0.0,0.0,9,0,2,7
11/19/22,MS Zaandam,0.0,0.0,9,0,2,7
11/20/22,MS Zaandam,0.0,0.0,9,0,2,7
11/21/22,MS Zaandam,0.0,0.0,9,0,2,7
11/22/22,MS Zaandam,0.0,0.0,9,0,2,7
11/23/22,MS Zaandam,0.0,0.0,9,0,2,7
11/24/22,MS Zaandam,0.0,0.0,9,0,2,7
11/25/22,MS Zaandam,0.0,0.0,9,0,2,7
11/26/22,MS Zaandam,0.0,0.0,9,0,2,7
11/27/22,MS Zaandam,0.0,0.0,9,0,2,7
11/28/22,MS Zaandam,0.0,0.0,9,0,2,7
11/29/22,MS Zaandam,0.0,0.0,9,0,2,7
11/30/22,MS Zaandam,0.0,0.0,9,0,2,7
12/1/22,MS Zaandam,0.0,0.0,9,0,2,7
12/2/22,MS Zaandam,0.0,0.0,9,0,2,7
12/3/22,MS Zaandam,0.0,0.0,9,0,2,7
12/4/22,MS Zaandam,0.0,0.0,9,0,2,7
12/5/22,MS Zaandam,0.0,0.0,9,0,2,7
12/6/22,MS Zaandam,0.0,0.0,9,0,2,7
12/7/22,MS Zaandam,0.0,0.0,9,0,2,7
12/8/22,MS Zaandam,0.0,0.0,9,0,2,7
12/9/22,MS Zaandam,0.0,0.0,9,0,2,7
12/10/22,MS Zaandam,0.0,0.0,9,0,2,7
12/11/22,MS Zaandam,0.0,0.0,9,0,2,7
12/12/22,MS Zaandam,0.0,0.0,9,0,2,7
12/13/22,MS Zaandam,0.0,0.0,9,0,2,7
12/14/22,MS Zaandam,0.0,0.0,9,0,2,7
12/15/22,MS Zaandam,0.0,0.0,9,0,2,7
12/16/22,MS Zaandam,0.0,0.0,9,0,2,7
12/17/22,MS Zaandam,0.0,0.0,9,0,2,7
1/1/22,Namibia,-22.9576,18.4904,148839,0,3645,145194
1/2/22,Namibia,-22.9576,18.4904,149478,0,3655,145823
1/3/22,Namibia,-22.9576,18.4904,149741,0,3656,146085
1/4/22,Namibia,-22.9576,18.4904,150145,0,3656,146489
1/5/22,Namibia,-22.9576,18.4904,150540,0,3672,146868
1/6/22,Namibia,-22.9576,18.4904,151000,0,3686,147314
1/7/22,Namibia,-22.9576,18.4904,151517,0,3698,147819
1/8/22,Namibia,-22.9576,18.4904,151957,0,3705,148252
1/9/22,Namibia,-22.9576,18.4904,152390,0,3724,148666
1/10/22,Namibia,-22.9576,18.4904,152826,0,3726,149100
1/11/22,Namibia,-22.9576,18.4904,152982,0,3735,149247
1/12/22,Namibia,-22.9576,18.4904,153290,0,3761,149529
1/13/22,Namibia,-22.9576,18.4904,153611,0,3783,149828
1/14/22,Namibia,-22.9576,18.4904,153969,0,3804,150165
1/15/22,Namibia,-22.9576,18.4904,154261,0,3814,150447
1/16/22,Namibia,-22.9576,18.4904,154378,0,3821,150557
1/17/22,Namibia,-22.9576,18.4904,154536,0,3823,150713
1/18/22,Namibia,-22.9576,18.4904,154664,0,3833,150831
1/19/22,Namibia,-22.9576,18.4904,154756,0,3864,150892
1/20/22,Namibia,-22.9576,18.4904,154897,0,3884,151013
1/21/22,Namibia,-22.9576,18.4904,155027,0,3902,151125
1/22/22,Namibia,-22.9576,18.4904,155198,0,3914,151284
1/23/22,Namibia,-22.9576,18.4904,155255,0,3914,151341
1/24/22,Namibia,-22.9576,18.4904,155255,0,3914,151341
1/25/22,Namibia,-22.9576,18.4904,155424,0,3924,151500
1/26/22,Namibia,-22.9576,18.4904,155502,0,3937,151565
1/27/22,Namibia,-22.9576,18.4904,155623,0,3947,151676
1/28/22,Namibia,-22.9576,18.4904,155722,0,3962,151760
1/29/22,Namibia,-22.9576,18.4904,155783,0,3963,151820
1/30/22,Namibia,-22.9576,18.4904,155840,0,3967,151873
1/31/22,Namibia,-22.9576,18.4904,155899,0,3967,151932
2/1/22,Namibia,-22.9576,18.4904,155942,0,3969,151973
2/2/22,Namibia,-22.9576,18.4904,156044,0,3973,152071
2/3/22,Namibia,-22.9576,18.4904,156102,0,3973,152129
2/4/22,Namibia,-22.9576,18.4904,156187,0,3974,152213
2/5/22,Namibia,-22.9576,18.4904,156301,0,3977,152324
2/6/22,Namibia,-22.9576,18.4904,156371,0,3980,152391
2/7/22,Namibia,-22.9576,18.4904,156444,0,3980,152464
2/8/22,Namibia,-22.9576,18.4904,156482,0,3982,152500
2/9/22,Namibia,-22.9576,18.4904,156519,0,3984,152535
2/10/22,Namibia,-22.9576,18.4904,156563,0,3988,152575
2/11/22,Namibia,-22.9576,18.4904,156604,0,3991,152613
2/12/22,Namibia,-22.9576,18.4904,156765,0,3993,152772
2/13/22,Namibia,-22.9576,18.4904,156765,0,3993,152772
2/14/22,Namibia,-22.9576,18.4904,156810,0,3995,152815
2/15/22,Namibia,-22.9576,18.4904,156843,0,3995,152848
2/16/22,Namibia,-22.9576,18.4904,156872,0,3996,152876
2/17/22,Namibia,-22.9576,18.4904,156913,0,3997,152916
2/18/22,Namibia,-22.9576,18.4904,156936,0,3999,152937
2/19/22,Namibia,-22.9576,18.4904,156982,0,4001,152981
2/20/22,Namibia,-22.9576,18.4904,157010,0,4002,153008
2/21/22,Namibia,-22.9576,18.4904,157034,0,4002,153032
2/22/22,Namibia,-22.9576,18.4904,157034,0,4002,153032
2/23/22,Namibia,-22.9576,18.4904,157060,0,4002,153058
2/24/22,Namibia,-22.9576,18.4904,157106,0,4006,153100
2/25/22,Namibia,-22.9576,18.4904,157133,0,4007,153126
2/26/22,Namibia,-22.9576,18.4904,157193,0,4007,153186
2/27/22,Namibia,-22.9576,18.4904,157210,0,4007,153203
2/28/22,Namibia,-22.9576,18.4904,157225,0,4007,153218
3/1/22,Namibia,-22.9576,18.4904,157225,0,4007,153218
3/2/22,Namibia,-22.9576,18.4904,157275,0,4009,153266
3/3/22,Namibia,-22.9576,18.4904,157284,0,4010,153274
3/4/22,Namibia,-22.9576,18.4904,157311,0,4013,153298
3/5/22,Namibia,-22.9576,18.4904,157324,0,4013,153311
3/6/22,Namibia,-22.9576,18.4904,157338,0,4013,153325
3/7/22,Namibia,-22.9576,18.4904,157350,0,4014,153336
3/8/22,Namibia,-22.9576,18.4904,157358,0,4014,153344
3/9/22,Namibia,-22.9576,18.4904,157366,0,4014,153352
3/10/22,Namibia,-22.9576,18.4904,157366,0,4014,153352
3/11/22,Namibia,-22.9576,18.4904,157383,0,4014,153369
3/12/22,Namibia,-22.9576,18.4904,157383,0,4014,153369
3/13/22,Namibia,-22.9576,18.4904,157438,0,4014,153424
3/14/22,Namibia,-22.9576,18.4904,157438,0,4014,153424
3/15/22,Namibia,-22.9576,18.4904,157458,0,4014,153444
3/16/22,Namibia,-22.9576,18.4904,157471,0,4014,153457
3/17/22,Namibia,-22.9576,18.4904,157489,0,4014,153475
3/18/22,Namibia,-22.9576,18.4904,157503,0,4014,153489
3/19/22,Namibia,-22.9576,18.4904,157516,0,4015,153501
3/20/22,Namibia,-22.9576,18.4904,157523,0,4016,153507
3/21/22,Namibia,-22.9576,18.4904,157523,0,4016,153507
3/22/22,Namibia,-22.9576,18.4904,157545,0,4016,153529
3/23/22,Namibia,-22.9576,18.4904,157552,0,4016,153536
3/24/22,Namibia,-22.9576,18.4904,157566,0,4017,153549
3/25/22,Namibia,-22.9576,18.4904,157576,0,4018,153558
3/26/22,Namibia,-22.9576,18.4904,157576,0,4018,153558
3/27/22,Namibia,-22.9576,18.4904,157611,0,4019,153592
3/28/22,Namibia,-22.9576,18.4904,157615,0,4019,153596
3/29/22,Namibia,-22.9576,18.4904,157622,0,4019,153603
3/30/22,Namibia,-22.9576,18.4904,157622,0,4019,153603
3/31/22,Namibia,-22.9576,18.4904,157646,0,4019,153627
4/1/22,Namibia,-22.9576,18.4904,157646,0,4019,153627
4/2/22,Namibia,-22.9576,18.4904,157646,0,4019,153627
4/3/22,Namibia,-22.9576,18.4904,157646,0,4019,153627
4/4/22,Namibia,-22.9576,18.4904,157764,0,4020,153744
4/5/22,Namibia,-22.9576,18.4904,157776,0,4020,153756
4/6/22,Namibia,-22.9576,18.4904,157806,0,4020,153786
4/7/22,Namibia,-22.9576,18.4904,157825,0,4020,153805
4/8/22,Namibia,-22.9576,18.4904,157841,0,4021,153820
4/9/22,Namibia,-22.9576,18.4904,157858,0,4021,153837
4/10/22,Namibia,-22.9576,18.4904,157896,0,4021,153875
4/11/22,Namibia,-22.9576,18.4904,157896,0,4021,153875
4/12/22,Namibia,-22.9576,18.4904,157903,0,4021,153882
4/13/22,Namibia,-22.9576,18.4904,157914,0,4021,153893
4/14/22,Namibia,-22.9576,18.4904,158001,0,4022,153979
4/15/22,Namibia,-22.9576,18.4904,158001,0,4022,153979
4/16/22,Namibia,-22.9576,18.4904,158074,0,4022,154052
4/17/22,Namibia,-22.9576,18.4904,158074,0,4022,154052
4/18/22,Namibia,-22.9576,18.4904,158074,0,4022,154052
4/19/22,Namibia,-22.9576,18.4904,158112,0,4022,154090
4/20/22,Namibia,-22.9576,18.4904,158112,0,4022,154090
4/21/22,Namibia,-22.9576,18.4904,158112,0,4022,154090
4/22/22,Namibia,-22.9576,18.4904,158280,0,4023,154257
4/23/22,Namibia,-22.9576,18.4904,158332,0,4023,154309
4/24/22,Namibia,-22.9576,18.4904,158358,0,4025,154333
4/25/22,Namibia,-22.9576,18.4904,158379,0,4025,154354
4/26/22,Namibia,-22.9576,18.4904,158427,0,4025,154402
4/27/22,Namibia,-22.9576,18.4904,158480,0,4025,154455
4/28/22,Namibia,-22.9576,18.4904,158545,0,4025,154520
4/29/22,Namibia,-22.9576,18.4904,158649,0,4025,154624
4/30/22,Namibia,-22.9576,18.4904,158649,0,4025,154624
5/1/22,Namibia,-22.9576,18.4904,158811,0,4025,154786
5/2/22,Namibia,-22.9576,18.4904,158811,0,4025,154786
5/3/22,Namibia,-22.9576,18.4904,158874,0,4025,154849
5/4/22,Namibia,-22.9576,18.4904,158940,0,4025,154915
5/5/22,Namibia,-22.9576,18.4904,158989,0,4026,154963
5/6/22,Namibia,-22.9576,18.4904,159052,0,4026,155026
5/7/22,Namibia,-22.9576,18.4904,159136,0,4026,155110
5/8/22,Namibia,-22.9576,18.4904,159219,0,4027,155192
5/9/22,Namibia,-22.9576,18.4904,159278,0,4027,155251
5/10/22,Namibia,-22.9576,18.4904,159311,0,4028,155283
5/11/22,Namibia,-22.9576,18.4904,159503,0,4028,155475
5/12/22,Namibia,-22.9576,18.4904,159503,0,4028,155475
5/13/22,Namibia,-22.9576,18.4904,159503,0,4028,155475
5/14/22,Namibia,-22.9576,18.4904,160074,0,4028,156046
5/15/22,Namibia,-22.9576,18.4904,160074,0,4028,156046
5/16/22,Namibia,-22.9576,18.4904,160074,0,4028,156046
5/17/22,Namibia,-22.9576,18.4904,160438,0,4030,156408
5/18/22,Namibia,-22.9576,18.4904,160640,0,4031,156609
5/19/22,Namibia,-22.9576,18.4904,160640,0,4031,156609
5/20/22,Namibia,-22.9576,18.4904,160640,0,4031,156609
5/21/22,Namibia,-22.9576,18.4904,160640,0,4031,156609
5/22/22,Namibia,-22.9576,18.4904,164850,0,4032,160818
5/23/22,Namibia,-22.9576,18.4904,164953,0,4033,160920
5/24/22,Namibia,-22.9576,18.4904,165117,0,4034,161083
5/25/22,Namibia,-22.9576,18.4904,165346,0,4035,161311
5/26/22,Namibia,-22.9576,18.4904,165346,0,4035,161311
5/27/22,Namibia,-22.9576,18.4904,165797,0,4035,161762
5/28/22,Namibia,-22.9576,18.4904,165797,0,4035,161762
5/29/22,Namibia,-22.9576,18.4904,165797,0,4035,161762
5/30/22,Namibia,-22.9576,18.4904,166189,0,4037,162152
5/31/22,Namibia,-22.9576,18.4904,166363,0,4038,162325
6/1/22,Namibia,-22.9576,18.4904,166659,0,4038,162621
6/2/22,Namibia,-22.9576,18.4904,166859,0,4038,162821
6/3/22,Namibia,-22.9576,18.4904,166859,0,4038,162821
6/4/22,Namibia,-22.9576,18.4904,166859,0,4038,162821
6/5/22,Namibia,-22.9576,18.4904,167498,0,4040,163458
6/6/22,Namibia,-22.9576,18.4904,167565,0,4040,163525
6/7/22,Namibia,-22.9576,18.4904,167565,0,4040,163525
6/8/22,Namibia,-22.9576,18.4904,167565,0,4040,163525
6/9/22,Namibia,-22.9576,18.4904,167565,0,4040,163525
6/10/22,Namibia,-22.9576,18.4904,167565,0,4042,163523
6/11/22,Namibia,-22.9576,18.4904,168320,0,4048,164272
6/12/22,Namibia,-22.9576,18.4904,168403,0,4049,164354
6/13/22,Namibia,-22.9576,18.4904,168448,0,4049,164399
6/14/22,Namibia,-22.9576,18.4904,168448,0,4049,164399
6/15/22,Namibia,-22.9576,18.4904,168591,0,4052,164539
6/16/22,Namibia,-22.9576,18.4904,168695,0,4054,164641
6/17/22,Namibia,-22.9576,18.4904,168761,0,4054,164707
6/18/22,Namibia,-22.9576,18.4904,168851,0,4056,164795
6/19/22,Namibia,-22.9576,18.4904,168868,0,4056,164812
6/20/22,Namibia,-22.9576,18.4904,168904,0,4056,164848
6/21/22,Namibia,-22.9576,18.4904,168904,0,4056,164848
6/22/22,Namibia,-22.9576,18.4904,168904,0,4056,164848
6/23/22,Namibia,-22.9576,18.4904,169007,0,4058,164949
6/24/22,Namibia,-22.9576,18.4904,169007,0,4058,164949
6/25/22,Namibia,-22.9576,18.4904,169076,0,4061,165015
6/26/22,Namibia,-22.9576,18.4904,169076,0,4061,165015
6/27/22,Namibia,-22.9576,18.4904,169076,0,4061,165015
6/28/22,Namibia,-22.9576,18.4904,169076,0,4061,165015
6/29/22,Namibia,-22.9576,18.4904,169076,0,4061,165015
6/30/22,Namibia,-22.9576,18.4904,169179,0,4064,165115
7/1/22,Namibia,-22.9576,18.4904,169203,0,4064,165139
7/2/22,Namibia,-22.9576,18.4904,169203,0,4064,165139
7/3/22,Namibia,-22.9576,18.4904,169230,0,4065,165165
7/4/22,Namibia,-22.9576,18.4904,169247,0,4065,165182
7/5/22,Namibia,-22.9576,18.4904,169253,0,4065,165188
7/6/22,Namibia,-22.9576,18.4904,169253,0,4065,165188
7/7/22,Namibia,-22.9576,18.4904,169253,0,4065,165188
7/8/22,Namibia,-22.9576,18.4904,169253,0,4065,165188
7/9/22,Namibia,-22.9576,18.4904,169253,0,4065,165188
7/10/22,Namibia,-22.9576,18.4904,169253,0,4065,165188
7/11/22,Namibia,-22.9576,18.4904,169253,0,4065,165188
7/12/22,Namibia,-22.9576,18.4904,169253,0,4068,165185
7/13/22,Namibia,-22.9576,18.4904,169253,0,4068,165185
7/14/22,Namibia,-22.9576,18.4904,169253,0,4068,165185
7/15/22,Namibia,-22.9576,18.4904,169253,0,4068,165185
7/16/22,Namibia,-22.9576,18.4904,169253,0,4068,165185
7/17/22,Namibia,-22.9576,18.4904,169253,0,4068,165185
7/18/22,Namibia,-22.9576,18.4904,169253,0,4068,165185
7/19/22,Namibia,-22.9576,18.4904,169253,0,4069,165184
7/20/22,Namibia,-22.9576,18.4904,169253,0,4069,165184
7/21/22,Namibia,-22.9576,18.4904,169253,0,4069,165184
7/22/22,Namibia,-22.9576,18.4904,169253,0,4069,165184
7/23/22,Namibia,-22.9576,18.4904,169253,0,4069,165184
7/24/22,Namibia,-22.9576,18.4904,169253,0,4069,165184
7/25/22,Namibia,-22.9576,18.4904,169253,0,4069,165184
7/26/22,Namibia,-22.9576,18.4904,169253,0,4069,165184
7/27/22,Namibia,-22.9576,18.4904,169253,0,4069,165184
7/28/22,Namibia,-22.9576,18.4904,169253,0,4069,165184
7/29/22,Namibia,-22.9576,18.4904,169253,0,4072,165181
7/30/22,Namibia,-22.9576,18.4904,169253,0,4072,165181
7/31/22,Namibia,-22.9576,18.4904,169253,0,4072,165181
8/1/22,Namibia,-22.9576,18.4904,169253,0,4072,165181
8/2/22,Namibia,-22.9576,18.4904,169253,0,4072,165181
8/3/22,Namibia,-22.9576,18.4904,169253,0,4072,165181
8/4/22,Namibia,-22.9576,18.4904,169253,0,4072,165181
8/5/22,Namibia,-22.9576,18.4904,169253,0,4072,165181
8/6/22,Namibia,-22.9576,18.4904,169253,0,4072,165181
8/7/22,Namibia,-22.9576,18.4904,169253,0,4072,165181
8/8/22,Namibia,-22.9576,18.4904,169253,0,4072,165181
8/9/22,Namibia,-22.9576,18.4904,169253,0,4072,165181
8/10/22,Namibia,-22.9576,18.4904,169253,0,4073,165180
8/11/22,Namibia,-22.9576,18.4904,169253,0,4073,165180
8/12/22,Namibia,-22.9576,18.4904,169253,0,4073,165180
8/13/22,Namibia,-22.9576,18.4904,169253,0,4073,165180
8/14/22,Namibia,-22.9576,18.4904,169253,0,4073,165180
8/15/22,Namibia,-22.9576,18.4904,169253,0,4073,165180
8/16/22,Namibia,-22.9576,18.4904,169253,0,4074,165179
8/17/22,Namibia,-22.9576,18.4904,169253,0,4074,165179
8/18/22,Namibia,-22.9576,18.4904,169253,0,4074,165179
8/19/22,Namibia,-22.9576,18.4904,169253,0,4074,165179
8/20/22,Namibia,-22.9576,18.4904,169253,0,4074,165179
8/21/22,Namibia,-22.9576,18.4904,169253,0,4074,165179
8/22/22,Namibia,-22.9576,18.4904,169253,0,4074,165179
8/23/22,Namibia,-22.9576,18.4904,169253,0,4074,165179
8/24/22,Namibia,-22.9576,18.4904,169253,0,4074,165179
8/25/22,Namibia,-22.9576,18.4904,169253,0,4074,165179
8/26/22,Namibia,-22.9576,18.4904,169253,0,4074,165179
8/27/22,Namibia,-22.9576,18.4904,169253,0,4074,165179
8/28/22,Namibia,-22.9576,18.4904,169253,0,4074,165179
8/29/22,Namibia,-22.9576,18.4904,169253,0,4074,165179
8/30/22,Namibia,-22.9576,18.4904,169253,0,4074,165179
8/31/22,Namibia,-22.9576,18.4904,169253,0,4077,165176
9/1/22,Namibia,-22.9576,18.4904,169253,0,4077,165176
9/2/22,Namibia,-22.9576,18.4904,169253,0,4077,165176
9/3/22,Namibia,-22.9576,18.4904,169253,0,4077,165176
9/4/22,Namibia,-22.9576,18.4904,169253,0,4077,165176
9/5/22,Namibia,-22.9576,18.4904,169253,0,4077,165176
9/6/22,Namibia,-22.9576,18.4904,169253,0,4077,165176
9/7/22,Namibia,-22.9576,18.4904,169253,0,4077,165176
9/8/22,Namibia,-22.9576,18.4904,169253,0,4077,165176
9/9/22,Namibia,-22.9576,18.4904,169253,0,4077,165176
9/10/22,Namibia,-22.9576,18.4904,169253,0,4077,165176
9/11/22,Namibia,-22.9576,18.4904,169253,0,4077,165176
9/12/22,Namibia,-22.9576,18.4904,169253,0,4077,165176
9/13/22,Namibia,-22.9576,18.4904,169253,0,4077,165176
9/14/22,Namibia,-22.9576,18.4904,169253,0,4077,165176
9/15/22,Namibia,-22.9576,18.4904,169253,0,4077,165176
9/16/22,Namibia,-22.9576,18.4904,169253,0,4077,165176
9/17/22,Namibia,-22.9576,18.4904,169253,0,4077,165176
9/18/22,Namibia,-22.9576,18.4904,169253,0,4077,165176
9/19/22,Namibia,-22.9576,18.4904,169253,0,4077,165176
9/20/22,Namibia,-22.9576,18.4904,169253,0,4077,165176
9/21/22,Namibia,-22.9576,18.4904,169253,0,4077,165176
9/22/22,Namibia,-22.9576,18.4904,169253,0,4080,165173
9/23/22,Namibia,-22.9576,18.4904,169253,0,4080,165173
9/24/22,Namibia,-22.9576,18.4904,169253,0,4080,165173
9/25/22,Namibia,-22.9576,18.4904,169253,0,4080,165173
9/26/22,Namibia,-22.9576,18.4904,169253,0,4080,165173
9/27/22,Namibia,-22.9576,18.4904,169253,0,4080,165173
9/28/22,Namibia,-22.9576,18.4904,169253,0,4080,165173
9/29/22,Namibia,-22.9576,18.4904,169253,0,4080,165173
9/30/22,Namibia,-22.9576,18.4904,169253,0,4080,165173
10/1/22,Namibia,-22.9576,18.4904,169253,0,4080,165173
10/2/22,Namibia,-22.9576,18.4904,169253,0,4080,165173
10/3/22,Namibia,-22.9576,18.4904,169253,0,4080,165173
10/4/22,Namibia,-22.9576,18.4904,169253,0,4080,165173
10/5/22,Namibia,-22.9576,18.4904,169253,0,4080,165173
10/6/22,Namibia,-22.9576,18.4904,169253,0,4080,165173
10/7/22,Namibia,-22.9576,18.4904,169253,0,4080,165173
10/8/22,Namibia,-22.9576,18.4904,169253,0,4080,165173
10/9/22,Namibia,-22.9576,18.4904,169253,0,4080,165173
10/10/22,Namibia,-22.9576,18.4904,169253,0,4080,165173
10/11/22,Namibia,-22.9576,18.4904,169253,0,4080,165173
10/12/22,Namibia,-22.9576,18.4904,169253,0,4080,165173
10/13/22,Namibia,-22.9576,18.4904,169253,0,4080,165173
10/14/22,Namibia,-22.9576,18.4904,169253,0,4080,165173
10/15/22,Namibia,-22.9576,18.4904,169253,0,4080,165173
10/16/22,Namibia,-22.9576,18.4904,169253,0,4080,165173
10/17/22,Namibia,-22.9576,18.4904,169874,0,4080,165794
10/18/22,Namibia,-22.9576,18.4904,169253,0,4080,165173
10/19/22,Namibia,-22.9576,18.4904,169253,0,4080,165173
10/20/22,Namibia,-22.9576,18.4904,169874,0,4080,165794
10/21/22,Namibia,-22.9576,18.4904,169874,0,4080,165794
10/22/22,Namibia,-22.9576,18.4904,169874,0,4080,165794
10/23/22,Namibia,-22.9576,18.4904,169874,0,4080,165794
10/24/22,Namibia,-22.9576,18.4904,169253,0,4080,165173
10/25/22,Namibia,-22.9576,18.4904,169908,0,4080,165828
10/26/22,Namibia,-22.9576,18.4904,169908,0,4080,165828
10/27/22,Namibia,-22.9576,18.4904,169908,0,4080,165828
10/28/22,Namibia,-22.9576,18.4904,169908,0,4080,165828
10/29/22,Namibia,-22.9576,18.4904,169908,0,4080,165828
10/30/22,Namibia,-22.9576,18.4904,169908,0,4080,165828
10/31/22,Namibia,-22.9576,18.4904,169908,0,4080,165828
11/1/22,Namibia,-22.9576,18.4904,169946,0,4080,165866
11/2/22,Namibia,-22.9576,18.4904,169946,0,4080,165866
11/3/22,Namibia,-22.9576,18.4904,169946,0,4080,165866
11/4/22,Namibia,-22.9576,18.4904,169946,0,4080,165866
11/5/22,Namibia,-22.9576,18.4904,169946,0,4080,165866
11/6/22,Namibia,-22.9576,18.4904,169946,0,4080,165866
11/7/22,Namibia,-22.9576,18.4904,169946,0,4080,165866
11/8/22,Namibia,-22.9576,18.4904,169946,0,4080,165866
11/9/22,Namibia,-22.9576,18.4904,169946,0,4080,165866
11/10/22,Namibia,-22.9576,18.4904,169946,0,4080,165866
11/11/22,Namibia,-22.9576,18.4904,169946,0,4080,165866
11/12/22,Namibia,-22.9576,18.4904,169946,0,4080,165866
11/13/22,Namibia,-22.9576,18.4904,169946,0,4080,165866
11/14/22,Namibia,-22.9576,18.4904,169946,0,4080,165866
11/15/22,Namibia,-22.9576,18.4904,169946,0,4080,165866
11/16/22,Namibia,-22.9576,18.4904,169946,0,4080,165866
11/17/22,Namibia,-22.9576,18.4904,169946,0,4080,165866
11/18/22,Namibia,-22.9576,18.4904,169946,0,4080,165866
11/19/22,Namibia,-22.9576,18.4904,169946,0,4080,165866
11/20/22,Namibia,-22.9576,18.4904,169946,0,4080,165866
11/21/22,Namibia,-22.9576,18.4904,169946,0,4080,165866
11/22/22,Namibia,-22.9576,18.4904,169946,0,4080,165866
11/23/22,Namibia,-22.9576,18.4904,169946,0,4080,165866
11/24/22,Namibia,-22.9576,18.4904,169946,0,4080,165866
11/25/22,Namibia,-22.9576,18.4904,169946,0,4080,165866
11/26/22,Namibia,-22.9576,18.4904,169946,0,4080,165866
11/27/22,Namibia,-22.9576,18.4904,169946,0,4080,165866
11/28/22,Namibia,-22.9576,18.4904,169946,0,4080,165866
11/29/22,Namibia,-22.9576,18.4904,169946,0,4080,165866
11/30/22,Namibia,-22.9576,18.4904,169946,0,4080,165866
12/1/22,Namibia,-22.9576,18.4904,169946,0,4080,165866
12/2/22,Namibia,-22.9576,18.4904,169946,0,4080,165866
12/3/22,Namibia,-22.9576,18.4904,169946,0,4080,165866
12/4/22,Namibia,-22.9576,18.4904,169946,0,4080,165866
12/5/22,Namibia,-22.9576,18.4904,169946,0,4080,165866
12/6/22,Namibia,-22.9576,18.4904,169946,0,4080,165866
12/7/22,Namibia,-22.9576,18.4904,169946,0,4080,165866
12/8/22,Namibia,-22.9576,18.4904,169946,0,4080,165866
12/9/22,Namibia,-22.9576,18.4904,169946,0,4080,165866
12/10/22,Namibia,-22.9576,18.4904,169946,0,4080,165866
12/11/22,Namibia,-22.9576,18.4904,169946,0,4080,165866
12/12/22,Namibia,-22.9576,18.4904,169946,0,4080,165866
12/13/22,Namibia,-22.9576,18.4904,169946,0,4080,165866
12/14/22,Namibia,-22.9576,18.4904,169946,0,4080,165866
12/15/22,Namibia,-22.9576,18.4904,169946,0,4080,165866
12/16/22,Namibia,-22.9576,18.4904,169946,0,4080,165866
12/17/22,Namibia,-22.9576,18.4904,169946,0,4080,165866
1/1/22,Nauru,-0.5228,166.9315,0,0,0,0
1/2/22,Nauru,-0.5228,166.9315,0,0,0,0
1/3/22,Nauru,-0.5228,166.9315,0,0,0,0
1/4/22,Nauru,-0.5228,166.9315,0,0,0,0
1/5/22,Nauru,-0.5228,166.9315,0,0,0,0
1/6/22,Nauru,-0.5228,166.9315,0,0,0,0
1/7/22,Nauru,-0.5228,166.9315,0,0,0,0
1/8/22,Nauru,-0.5228,166.9315,0,0,0,0
1/9/22,Nauru,-0.5228,166.9315,0,0,0,0
1/10/22,Nauru,-0.5228,166.9315,0,0,0,0
1/11/22,Nauru,-0.5228,166.9315,0,0,0,0
1/12/22,Nauru,-0.5228,166.9315,0,0,0,0
1/13/22,Nauru,-0.5228,166.9315,0,0,0,0
1/14/22,Nauru,-0.5228,166.9315,0,0,0,0
1/15/22,Nauru,-0.5228,166.9315,0,0,0,0
1/16/22,Nauru,-0.5228,166.9315,0,0,0,0
1/17/22,Nauru,-0.5228,166.9315,0,0,0,0
1/18/22,Nauru,-0.5228,166.9315,0,0,0,0
1/19/22,Nauru,-0.5228,166.9315,0,0,0,0
1/20/22,Nauru,-0.5228,166.9315,0,0,0,0
1/21/22,Nauru,-0.5228,166.9315,0,0,0,0
1/22/22,Nauru,-0.5228,166.9315,0,0,0,0
1/23/22,Nauru,-0.5228,166.9315,0,0,0,0
1/24/22,Nauru,-0.5228,166.9315,0,0,0,0
1/25/22,Nauru,-0.5228,166.9315,0,0,0,0
1/26/22,Nauru,-0.5228,166.9315,0,0,0,0
1/27/22,Nauru,-0.5228,166.9315,0,0,0,0
1/28/22,Nauru,-0.5228,166.9315,0,0,0,0
1/29/22,Nauru,-0.5228,166.9315,0,0,0,0
1/30/22,Nauru,-0.5228,166.9315,0,0,0,0
1/31/22,Nauru,-0.5228,166.9315,0,0,0,0
2/1/22,Nauru,-0.5228,166.9315,0,0,0,0
2/2/22,Nauru,-0.5228,166.9315,0,0,0,0
2/3/22,Nauru,-0.5228,166.9315,0,0,0,0
2/4/22,Nauru,-0.5228,166.9315,0,0,0,0
2/5/22,Nauru,-0.5228,166.9315,0,0,0,0
2/6/22,Nauru,-0.5228,166.9315,0,0,0,0
2/7/22,Nauru,-0.5228,166.9315,0,0,0,0
2/8/22,Nauru,-0.5228,166.9315,0,0,0,0
2/9/22,Nauru,-0.5228,166.9315,0,0,0,0
2/10/22,Nauru,-0.5228,166.9315,0,0,0,0
2/11/22,Nauru,-0.5228,166.9315,0,0,0,0
2/12/22,Nauru,-0.5228,166.9315,0,0,0,0
2/13/22,Nauru,-0.5228,166.9315,0,0,0,0
2/14/22,Nauru,-0.5228,166.9315,0,0,0,0
2/15/22,Nauru,-0.5228,166.9315,0,0,0,0
2/16/22,Nauru,-0.5228,166.9315,0,0,0,0
2/17/22,Nauru,-0.5228,166.9315,0,0,0,0
2/18/22,Nauru,-0.5228,166.9315,0,0,0,0
2/19/22,Nauru,-0.5228,166.9315,0,0,0,0
2/20/22,Nauru,-0.5228,166.9315,0,0,0,0
2/21/22,Nauru,-0.5228,166.9315,0,0,0,0
2/22/22,Nauru,-0.5228,166.9315,0,0,0,0
2/23/22,Nauru,-0.5228,166.9315,0,0,0,0
2/24/22,Nauru,-0.5228,166.9315,0,0,0,0
2/25/22,Nauru,-0.5228,166.9315,0,0,0,0
2/26/22,Nauru,-0.5228,166.9315,0,0,0,0
2/27/22,Nauru,-0.5228,166.9315,0,0,0,0
2/28/22,Nauru,-0.5228,166.9315,0,0,0,0
3/1/22,Nauru,-0.5228,166.9315,0,0,0,0
3/2/22,Nauru,-0.5228,166.9315,0,0,0,0
3/3/22,Nauru,-0.5228,166.9315,0,0,0,0
3/4/22,Nauru,-0.5228,166.9315,0,0,0,0
3/5/22,Nauru,-0.5228,166.9315,0,0,0,0
3/6/22,Nauru,-0.5228,166.9315,0,0,0,0
3/7/22,Nauru,-0.5228,166.9315,0,0,0,0
3/8/22,Nauru,-0.5228,166.9315,0,0,0,0
3/9/22,Nauru,-0.5228,166.9315,0,0,0,0
3/10/22,Nauru,-0.5228,166.9315,0,0,0,0
3/11/22,Nauru,-0.5228,166.9315,0,0,0,0
3/12/22,Nauru,-0.5228,166.9315,0,0,0,0
3/13/22,Nauru,-0.5228,166.9315,0,0,0,0
3/14/22,Nauru,-0.5228,166.9315,0,0,0,0
3/15/22,Nauru,-0.5228,166.9315,0,0,0,0
3/16/22,Nauru,-0.5228,166.9315,0,0,0,0
3/17/22,Nauru,-0.5228,166.9315,0,0,0,0
3/18/22,Nauru,-0.5228,166.9315,0,0,0,0
3/19/22,Nauru,-0.5228,166.9315,0,0,0,0
3/20/22,Nauru,-0.5228,166.9315,0,0,0,0
3/21/22,Nauru,-0.5228,166.9315,0,0,0,0
3/22/22,Nauru,-0.5228,166.9315,0,0,0,0
3/23/22,Nauru,-0.5228,166.9315,0,0,0,0
3/24/22,Nauru,-0.5228,166.9315,0,0,0,0
3/25/22,Nauru,-0.5228,166.9315,0,0,0,0
3/26/22,Nauru,-0.5228,166.9315,0,0,0,0
3/27/22,Nauru,-0.5228,166.9315,0,0,0,0
3/28/22,Nauru,-0.5228,166.9315,0,0,0,0
3/29/22,Nauru,-0.5228,166.9315,0,0,0,0
3/30/22,Nauru,-0.5228,166.9315,0,0,0,0
3/31/22,Nauru,-0.5228,166.9315,0,0,0,0
4/1/22,Nauru,-0.5228,166.9315,0,0,0,0
4/2/22,Nauru,-0.5228,166.9315,0,0,0,0
4/3/22,Nauru,-0.5228,166.9315,0,0,0,0
4/4/22,Nauru,-0.5228,166.9315,2,0,0,2
4/5/22,Nauru,-0.5228,166.9315,2,0,0,2
4/6/22,Nauru,-0.5228,166.9315,2,0,0,2
4/7/22,Nauru,-0.5228,166.9315,3,0,0,3
4/8/22,Nauru,-0.5228,166.9315,3,0,0,3
4/9/22,Nauru,-0.5228,166.9315,3,0,0,3
4/10/22,Nauru,-0.5228,166.9315,3,0,0,3
4/11/22,Nauru,-0.5228,166.9315,3,0,0,3
4/12/22,Nauru,-0.5228,166.9315,3,0,0,3
4/13/22,Nauru,-0.5228,166.9315,3,0,0,3
4/14/22,Nauru,-0.5228,166.9315,3,0,0,3
4/15/22,Nauru,-0.5228,166.9315,3,0,0,3
4/16/22,Nauru,-0.5228,166.9315,3,0,0,3
4/17/22,Nauru,-0.5228,166.9315,3,0,0,3
4/18/22,Nauru,-0.5228,166.9315,3,0,0,3
4/19/22,Nauru,-0.5228,166.9315,3,0,0,3
4/20/22,Nauru,-0.5228,166.9315,3,0,0,3
4/21/22,Nauru,-0.5228,166.9315,3,0,0,3
4/22/22,Nauru,-0.5228,166.9315,3,0,0,3
4/23/22,Nauru,-0.5228,166.9315,3,0,0,3
4/24/22,Nauru,-0.5228,166.9315,3,0,0,3
4/25/22,Nauru,-0.5228,166.9315,3,0,0,3
4/26/22,Nauru,-0.5228,166.9315,3,0,0,3
4/27/22,Nauru,-0.5228,166.9315,3,0,0,3
4/28/22,Nauru,-0.5228,166.9315,3,0,0,3
4/29/22,Nauru,-0.5228,166.9315,3,0,0,3
4/30/22,Nauru,-0.5228,166.9315,3,0,0,3
5/1/22,Nauru,-0.5228,166.9315,3,0,0,3
5/2/22,Nauru,-0.5228,166.9315,3,0,0,3
5/3/22,Nauru,-0.5228,166.9315,3,0,0,3
5/4/22,Nauru,-0.5228,166.9315,3,0,0,3
5/5/22,Nauru,-0.5228,166.9315,3,0,0,3
5/6/22,Nauru,-0.5228,166.9315,3,0,0,3
5/7/22,Nauru,-0.5228,166.9315,3,0,0,3
5/8/22,Nauru,-0.5228,166.9315,3,0,0,3
5/9/22,Nauru,-0.5228,166.9315,3,0,0,3
5/10/22,Nauru,-0.5228,166.9315,3,0,0,3
5/11/22,Nauru,-0.5228,166.9315,3,0,0,3
5/12/22,Nauru,-0.5228,166.9315,3,0,0,3
5/13/22,Nauru,-0.5228,166.9315,3,0,0,3
5/14/22,Nauru,-0.5228,166.9315,3,0,0,3
5/15/22,Nauru,-0.5228,166.9315,3,0,0,3
5/16/22,Nauru,-0.5228,166.9315,3,0,0,3
5/17/22,Nauru,-0.5228,166.9315,3,0,0,3
5/18/22,Nauru,-0.5228,166.9315,3,0,0,3
5/19/22,Nauru,-0.5228,166.9315,3,0,0,3
5/20/22,Nauru,-0.5228,166.9315,3,0,0,3
5/21/22,Nauru,-0.5228,166.9315,3,0,0,3
5/22/22,Nauru,-0.5228,166.9315,3,0,0,3
5/23/22,Nauru,-0.5228,166.9315,3,0,0,3
5/24/22,Nauru,-0.5228,166.9315,3,0,0,3
5/25/22,Nauru,-0.5228,166.9315,3,0,0,3
5/26/22,Nauru,-0.5228,166.9315,3,0,0,3
5/27/22,Nauru,-0.5228,166.9315,3,0,0,3
5/28/22,Nauru,-0.5228,166.9315,3,0,0,3
5/29/22,Nauru,-0.5228,166.9315,3,0,0,3
5/30/22,Nauru,-0.5228,166.9315,3,0,0,3
5/31/22,Nauru,-0.5228,166.9315,3,0,0,3
6/1/22,Nauru,-0.5228,166.9315,3,0,0,3
6/2/22,Nauru,-0.5228,166.9315,3,0,0,3
6/3/22,Nauru,-0.5228,166.9315,3,0,0,3
6/4/22,Nauru,-0.5228,166.9315,3,0,0,3
6/5/22,Nauru,-0.5228,166.9315,3,0,0,3
6/6/22,Nauru,-0.5228,166.9315,3,0,0,3
6/7/22,Nauru,-0.5228,166.9315,3,0,0,3
6/8/22,Nauru,-0.5228,166.9315,3,0,0,3
6/9/22,Nauru,-0.5228,166.9315,3,0,0,3
6/10/22,Nauru,-0.5228,166.9315,3,0,0,3
6/11/22,Nauru,-0.5228,166.9315,3,0,0,3
6/12/22,Nauru,-0.5228,166.9315,3,0,0,3
6/13/22,Nauru,-0.5228,166.9315,3,0,0,3
6/14/22,Nauru,-0.5228,166.9315,3,0,0,3
6/15/22,Nauru,-0.5228,166.9315,3,0,0,3
6/16/22,Nauru,-0.5228,166.9315,3,0,0,3
6/17/22,Nauru,-0.5228,166.9315,3,0,0,3
6/18/22,Nauru,-0.5228,166.9315,3,0,0,3
6/19/22,Nauru,-0.5228,166.9315,13,0,0,13
6/20/22,Nauru,-0.5228,166.9315,350,0,0,350
6/21/22,Nauru,-0.5228,166.9315,401,0,0,401
6/22/22,Nauru,-0.5228,166.9315,683,0,0,683
6/23/22,Nauru,-0.5228,166.9315,874,0,0,874
6/24/22,Nauru,-0.5228,166.9315,874,0,0,874
6/25/22,Nauru,-0.5228,166.9315,874,0,0,874
6/26/22,Nauru,-0.5228,166.9315,2115,0,0,2115
6/27/22,Nauru,-0.5228,166.9315,2405,0,0,2405
6/28/22,Nauru,-0.5228,166.9315,2793,0,0,2793
6/29/22,Nauru,-0.5228,166.9315,3174,0,0,3174
6/30/22,Nauru,-0.5228,166.9315,3394,0,0,3394
7/1/22,Nauru,-0.5228,166.9315,3394,0,0,3394
7/2/22,Nauru,-0.5228,166.9315,3571,0,1,3570
7/3/22,Nauru,-0.5228,166.9315,3970,0,1,3969
7/4/22,Nauru,-0.5228,166.9315,4120,0,1,4119
7/5/22,Nauru,-0.5228,166.9315,4335,0,1,4334
7/6/22,Nauru,-0.5228,166.9315,4335,0,1,4334
7/7/22,Nauru,-0.5228,166.9315,4335,0,1,4334
7/8/22,Nauru,-0.5228,166.9315,4335,0,1,4334
7/9/22,Nauru,-0.5228,166.9315,4335,0,1,4334
7/10/22,Nauru,-0.5228,166.9315,4335,0,1,4334
7/11/22,Nauru,-0.5228,166.9315,4335,0,1,4334
7/12/22,Nauru,-0.5228,166.9315,4335,0,1,4334
7/13/22,Nauru,-0.5228,166.9315,4335,0,1,4334
7/14/22,Nauru,-0.5228,166.9315,4335,0,1,4334
7/15/22,Nauru,-0.5228,166.9315,4335,0,1,4334
7/16/22,Nauru,-0.5228,166.9315,4335,0,1,4334
7/17/22,Nauru,-0.5228,166.9315,4335,0,1,4334
7/18/22,Nauru,-0.5228,166.9315,4381,0,1,4380
7/19/22,Nauru,-0.5228,166.9315,4395,0,1,4394
7/20/22,Nauru,-0.5228,166.9315,4395,0,1,4394
7/21/22,Nauru,-0.5228,166.9315,4402,0,1,4401
7/22/22,Nauru,-0.5228,166.9315,4402,0,1,4401
7/23/22,Nauru,-0.5228,166.9315,4402,0,1,4401
7/24/22,Nauru,-0.5228,166.9315,4402,0,1,4401
7/25/22,Nauru,-0.5228,166.9315,4402,0,1,4401
7/26/22,Nauru,-0.5228,166.9315,4405,0,1,4404
7/27/22,Nauru,-0.5228,166.9315,4407,0,1,4406
7/28/22,Nauru,-0.5228,166.9315,4407,0,1,4406
7/29/22,Nauru,-0.5228,166.9315,4407,0,1,4406
7/30/22,Nauru,-0.5228,166.9315,4407,0,1,4406
7/31/22,Nauru,-0.5228,166.9315,4407,0,1,4406
8/1/22,Nauru,-0.5228,166.9315,4407,0,1,4406
8/2/22,Nauru,-0.5228,166.9315,4407,0,1,4406
8/3/22,Nauru,-0.5228,166.9315,4407,0,1,4406
8/4/22,Nauru,-0.5228,166.9315,4407,0,1,4406
8/5/22,Nauru,-0.5228,166.9315,4409,0,1,4408
8/6/22,Nauru,-0.5228,166.9315,4409,0,1,4408
8/7/22,Nauru,-0.5228,166.9315,4409,0,1,4408
8/8/22,Nauru,-0.5228,166.9315,4409,0,1,4408
8/9/22,Nauru,-0.5228,166.9315,4602,0,1,4601
8/10/22,Nauru,-0.5228,166.9315,4604,0,1,4603
8/11/22,Nauru,-0.5228,166.9315,4604,0,1,4603
8/12/22,Nauru,-0.5228,166.9315,4605,0,1,4604
8/13/22,Nauru,-0.5228,166.9315,4605,0,1,4604
8/14/22,Nauru,-0.5228,166.9315,4605,0,1,4604
8/15/22,Nauru,-0.5228,166.9315,4608,0,1,4607
8/16/22,Nauru,-0.5228,166.9315,4608,0,1,4607
8/17/22,Nauru,-0.5228,166.9315,4608,0,1,4607
8/18/22,Nauru,-0.5228,166.9315,4608,0,1,4607
8/19/22,Nauru,-0.5228,166.9315,4610,0,1,4609
8/20/22,Nauru,-0.5228,166.9315,4610,0,1,4609
8/21/22,Nauru,-0.5228,166.9315,4610,0,1,4609
8/22/22,Nauru,-0.5228,166.9315,4610,0,1,4609
8/23/22,Nauru,-0.5228,166.9315,4610,0,1,4609
8/24/22,Nauru,-0.5228,166.9315,4610,0,1,4609
8/25/22,Nauru,-0.5228,166.9315,4610,0,1,4609
8/26/22,Nauru,-0.5228,166.9315,4610,0,1,4609
8/27/22,Nauru,-0.5228,166.9315,4610,0,1,4609
8/28/22,Nauru,-0.5228,166.9315,4610,0,1,4609
8/29/22,Nauru,-0.5228,166.9315,4610,0,1,4609
8/30/22,Nauru,-0.5228,166.9315,4610,0,1,4609
8/31/22,Nauru,-0.5228,166.9315,4610,0,1,4609
9/1/22,Nauru,-0.5228,166.9315,4610,0,1,4609
9/2/22,Nauru,-0.5228,166.9315,4610,0,1,4609
9/3/22,Nauru,-0.5228,166.9315,4610,0,1,4609
9/4/22,Nauru,-0.5228,166.9315,4610,0,1,4609
9/5/22,Nauru,-0.5228,166.9315,4610,0,1,4609
9/6/22,Nauru,-0.5228,166.9315,4610,0,1,4609
9/7/22,Nauru,-0.5228,166.9315,4610,0,1,4609
9/8/22,Nauru,-0.5228,166.9315,4610,0,1,4609
9/9/22,Nauru,-0.5228,166.9315,4610,0,1,4609
9/10/22,Nauru,-0.5228,166.9315,4610,0,1,4609
9/11/22,Nauru,-0.5228,166.9315,4610,0,1,4609
9/12/22,Nauru,-0.5228,166.9315,4610,0,1,4609
9/13/22,Nauru,-0.5228,166.9315,4611,0,1,4610
9/14/22,Nauru,-0.5228,166.9315,4611,0,1,4610
9/15/22,Nauru,-0.5228,166.9315,4611,0,1,4610
9/16/22,Nauru,-0.5228,166.9315,4611,0,1,4610
9/17/22,Nauru,-0.5228,166.9315,4611,0,1,4610
9/18/22,Nauru,-0.5228,166.9315,4611,0,1,4610
9/19/22,Nauru,-0.5228,166.9315,4611,0,1,4610
9/20/22,Nauru,-0.5228,166.9315,4611,0,1,4610
9/21/22,Nauru,-0.5228,166.9315,4611,0,1,4610
9/22/22,Nauru,-0.5228,166.9315,4611,0,1,4610
9/23/22,Nauru,-0.5228,166.9315,4611,0,1,4610
9/24/22,Nauru,-0.5228,166.9315,4611,0,1,4610
9/25/22,Nauru,-0.5228,166.9315,4611,0,1,4610
9/26/22,Nauru,-0.5228,166.9315,4611,0,1,4610
9/27/22,Nauru,-0.5228,166.9315,4611,0,1,4610
9/28/22,Nauru,-0.5228,166.9315,4611,0,1,4610
9/29/22,Nauru,-0.5228,166.9315,4611,0,1,4610
9/30/22,Nauru,-0.5228,166.9315,4611,0,1,4610
10/1/22,Nauru,-0.5228,166.9315,4611,0,1,4610
10/2/22,Nauru,-0.5228,166.9315,4611,0,1,4610
10/3/22,Nauru,-0.5228,166.9315,4611,0,1,4610
10/4/22,Nauru,-0.5228,166.9315,4611,0,1,4610
10/5/22,Nauru,-0.5228,166.9315,4611,0,1,4610
10/6/22,Nauru,-0.5228,166.9315,4611,0,1,4610
10/7/22,Nauru,-0.5228,166.9315,4611,0,1,4610
10/8/22,Nauru,-0.5228,166.9315,4611,0,1,4610
10/9/22,Nauru,-0.5228,166.9315,4611,0,1,4610
10/10/22,Nauru,-0.5228,166.9315,4611,0,1,4610
10/11/22,Nauru,-0.5228,166.9315,4611,0,1,4610
10/12/22,Nauru,-0.5228,166.9315,4611,0,1,4610
10/13/22,Nauru,-0.5228,166.9315,4611,0,1,4610
10/14/22,Nauru,-0.5228,166.9315,4611,0,1,4610
10/15/22,Nauru,-0.5228,166.9315,4611,0,1,4610
10/16/22,Nauru,-0.5228,166.9315,4611,0,1,4610
10/17/22,Nauru,-0.5228,166.9315,4611,0,1,4610
10/18/22,Nauru,-0.5228,166.9315,4611,0,1,4610
10/19/22,Nauru,-0.5228,166.9315,4611,0,1,4610
10/20/22,Nauru,-0.5228,166.9315,4611,0,1,4610
10/21/22,Nauru,-0.5228,166.9315,4611,0,1,4610
10/22/22,Nauru,-0.5228,166.9315,4611,0,1,4610
10/23/22,Nauru,-0.5228,166.9315,4611,0,1,4610
10/24/22,Nauru,-0.5228,166.9315,4611,0,1,4610
10/25/22,Nauru,-0.5228,166.9315,4611,0,1,4610
10/26/22,Nauru,-0.5228,166.9315,4611,0,1,4610
10/27/22,Nauru,-0.5228,166.9315,4611,0,1,4610
10/28/22,Nauru,-0.5228,166.9315,4611,0,1,4610
10/29/22,Nauru,-0.5228,166.9315,4611,0,1,4610
10/30/22,Nauru,-0.5228,166.9315,4611,0,1,4610
10/31/22,Nauru,-0.5228,166.9315,4611,0,1,4610
11/1/22,Nauru,-0.5228,166.9315,4611,0,1,4610
11/2/22,Nauru,-0.5228,166.9315,4611,0,1,4610
11/3/22,Nauru,-0.5228,166.9315,4611,0,1,4610
11/4/22,Nauru,-0.5228,166.9315,4611,0,1,4610
11/5/22,Nauru,-0.5228,166.9315,4611,0,1,4610
11/6/22,Nauru,-0.5228,166.9315,4611,0,1,4610
11/7/22,Nauru,-0.5228,166.9315,4611,0,1,4610
11/8/22,Nauru,-0.5228,166.9315,4611,0,1,4610
11/9/22,Nauru,-0.5228,166.9315,4611,0,1,4610
11/10/22,Nauru,-0.5228,166.9315,4611,0,1,4610
11/11/22,Nauru,-0.5228,166.9315,4611,0,1,4610
11/12/22,Nauru,-0.5228,166.9315,4611,0,1,4610
11/13/22,Nauru,-0.5228,166.9315,4611,0,1,4610
11/14/22,Nauru,-0.5228,166.9315,4618,0,1,4617
11/15/22,Nauru,-0.5228,166.9315,4618,0,1,4617
11/16/22,Nauru,-0.5228,166.9315,4618,0,1,4617
11/17/22,Nauru,-0.5228,166.9315,4618,0,1,4617
11/18/22,Nauru,-0.5228,166.9315,4618,0,1,4617
11/19/22,Nauru,-0.5228,166.9315,4618,0,1,4617
11/20/22,Nauru,-0.5228,166.9315,4618,0,1,4617
11/21/22,Nauru,-0.5228,166.9315,4621,0,1,4620
11/22/22,Nauru,-0.5228,166.9315,4621,0,1,4620
11/23/22,Nauru,-0.5228,166.9315,4621,0,1,4620
11/24/22,Nauru,-0.5228,166.9315,4621,0,1,4620
11/25/22,Nauru,-0.5228,166.9315,4621,0,1,4620
11/26/22,Nauru,-0.5228,166.9315,4621,0,1,4620
11/27/22,Nauru,-0.5228,166.9315,4621,0,1,4620
11/28/22,Nauru,-0.5228,166.9315,4621,0,1,4620
11/29/22,Nauru,-0.5228,166.9315,4621,0,1,4620
11/30/22,Nauru,-0.5228,166.9315,4621,0,1,4620
12/1/22,Nauru,-0.5228,166.9315,4621,0,1,4620
12/2/22,Nauru,-0.5228,166.9315,4621,0,1,4620
12/3/22,Nauru,-0.5228,166.9315,4621,0,1,4620
12/4/22,Nauru,-0.5228,166.9315,4621,0,1,4620
12/5/22,Nauru,-0.5228,166.9315,4621,0,1,4620
12/6/22,Nauru,-0.5228,166.9315,4621,0,1,4620
12/7/22,Nauru,-0.5228,166.9315,4621,0,1,4620
12/8/22,Nauru,-0.5228,166.9315,4621,0,1,4620
12/9/22,Nauru,-0.5228,166.9315,4621,0,1,4620
12/10/22,Nauru,-0.5228,166.9315,4621,0,1,4620
12/11/22,Nauru,-0.5228,166.9315,4621,0,1,4620
12/12/22,Nauru,-0.5228,166.9315,4621,0,1,4620
12/13/22,Nauru,-0.5228,166.9315,4621,0,1,4620
12/14/22,Nauru,-0.5228,166.9315,4621,0,1,4620
12/15/22,Nauru,-0.5228,166.9315,4621,0,1,4620
12/16/22,Nauru,-0.5228,166.9315,4621,0,1,4620
12/17/22,Nauru,-0.5228,166.9315,4621,0,1,4620
1/1/22,Nepal,28.1667,84.25,828773,0,11594,817179
1/2/22,Nepal,28.1667,84.25,828986,0,11596,817390
1/3/22,Nepal,28.1667,84.25,829277,0,11598,817679
1/4/22,Nepal,28.1667,84.25,829632,0,11601,818031
1/5/22,Nepal,28.1667,84.25,830002,0,11601,818401
1/6/22,Nepal,28.1667,84.25,830480,0,11602,818878
1/7/22,Nepal,28.1667,84.25,831052,0,11602,819450
1/8/22,Nepal,28.1667,84.25,831748,0,11602,820146
1/9/22,Nepal,28.1667,84.25,832589,0,11604,820985
1/10/22,Nepal,28.1667,84.25,833946,0,11606,822340
1/11/22,Nepal,28.1667,84.25,835927,0,11607,824320
1/12/22,Nepal,28.1667,84.25,838375,0,11609,826766
1/13/22,Nepal,28.1667,84.25,841297,0,11610,829687
1/14/22,Nepal,28.1667,84.25,845501,0,11613,833888
1/15/22,Nepal,28.1667,84.25,849204,0,11617,837587
1/16/22,Nepal,28.1667,84.25,853738,0,11620,842118
1/17/22,Nepal,28.1667,84.25,859485,0,11623,847862
1/18/22,Nepal,28.1667,84.25,868215,0,11624,856591
1/19/22,Nepal,28.1667,84.25,877717,0,11628,866089
1/20/22,Nepal,28.1667,84.25,887769,0,11632,876137
1/21/22,Nepal,28.1667,84.25,896584,0,11635,884949
1/22/22,Nepal,28.1667,84.25,904796,0,11651,893145
1/23/22,Nepal,28.1667,84.25,910394,0,11655,898739
1/24/22,Nepal,28.1667,84.25,918448,0,11659,906789
1/25/22,Nepal,28.1667,84.25,927880,0,11667,916213
1/26/22,Nepal,28.1667,84.25,933451,0,11672,921779
1/27/22,Nepal,28.1667,84.25,939267,0,11687,927580
1/28/22,Nepal,28.1667,84.25,944074,0,11697,932377
1/29/22,Nepal,28.1667,84.25,947392,0,11703,935689
1/30/22,Nepal,28.1667,84.25,950441,0,11735,938706
1/31/22,Nepal,28.1667,84.25,953913,0,11743,942170
2/1/22,Nepal,28.1667,84.25,957570,0,11752,945818
2/2/22,Nepal,28.1667,84.25,959775,0,11764,948011
2/3/22,Nepal,28.1667,84.25,962517,0,11778,950739
2/4/22,Nepal,28.1667,84.25,964119,0,11794,952325
2/5/22,Nepal,28.1667,84.25,965222,0,11803,953419
2/6/22,Nepal,28.1667,84.25,966405,0,11814,954591
2/7/22,Nepal,28.1667,84.25,967427,0,11827,955600
2/8/22,Nepal,28.1667,84.25,968611,0,11838,956773
2/9/22,Nepal,28.1667,84.25,970462,0,11852,958610
2/10/22,Nepal,28.1667,84.25,971475,0,11864,959611
2/11/22,Nepal,28.1667,84.25,972141,0,11878,960263
2/12/22,Nepal,28.1667,84.25,972632,0,11882,960750
2/13/22,Nepal,28.1667,84.25,973059,0,11892,961167
2/14/22,Nepal,28.1667,84.25,973541,0,11900,961641
2/15/22,Nepal,28.1667,84.25,974039,0,11902,962137
2/16/22,Nepal,28.1667,84.25,974493,0,11905,962588
2/17/22,Nepal,28.1667,84.25,974857,0,11911,962946
2/18/22,Nepal,28.1667,84.25,975132,0,11913,963219
2/19/22,Nepal,28.1667,84.25,975330,0,11917,963413
2/20/22,Nepal,28.1667,84.25,975559,0,11921,963638
2/21/22,Nepal,28.1667,84.25,975806,0,11925,963881
2/22/22,Nepal,28.1667,84.25,976105,0,11928,964177
2/23/22,Nepal,28.1667,84.25,976361,0,11930,964431
2/24/22,Nepal,28.1667,84.25,976512,0,11931,964581
2/25/22,Nepal,28.1667,84.25,976670,0,11932,964738
2/26/22,Nepal,28.1667,84.25,976771,0,11934,964837
2/27/22,Nepal,28.1667,84.25,976865,0,11935,964930
2/28/22,Nepal,28.1667,84.25,976984,0,11936,965048
3/1/22,Nepal,28.1667,84.25,977076,0,11938,965138
3/2/22,Nepal,28.1667,84.25,977199,0,11941,965258
3/3/22,Nepal,28.1667,84.25,977269,0,11944,965325
3/4/22,Nepal,28.1667,84.25,977380,0,11945,965435
3/5/22,Nepal,28.1667,84.25,977447,0,11945,965502
3/6/22,Nepal,28.1667,84.25,977501,0,11947,965554
3/7/22,Nepal,28.1667,84.25,977567,0,11948,965619
3/8/22,Nepal,28.1667,84.25,977641,0,11949,965692
3/9/22,Nepal,28.1667,84.25,977709,0,11949,965760
3/10/22,Nepal,28.1667,84.25,977786,0,11949,965837
3/11/22,Nepal,28.1667,84.25,977848,0,11950,965898
3/12/22,Nepal,28.1667,84.25,977878,0,11950,965928
3/13/22,Nepal,28.1667,84.25,977937,0,11950,965987
3/14/22,Nepal,28.1667,84.25,977987,0,11950,966037
3/15/22,Nepal,28.1667,84.25,978044,0,11950,966094
3/16/22,Nepal,28.1667,84.25,978085,0,11950,966135
3/17/22,Nepal,28.1667,84.25,978107,0,11950,966157
3/18/22,Nepal,28.1667,84.25,978119,0,11950,966169
3/19/22,Nepal,28.1667,84.25,978127,0,11950,966177
3/20/22,Nepal,28.1667,84.25,978155,0,11950,966205
3/21/22,Nepal,28.1667,84.25,978196,0,11950,966246
3/22/22,Nepal,28.1667,84.25,978231,0,11951,966280
3/23/22,Nepal,28.1667,84.25,978265,0,11951,966314
3/24/22,Nepal,28.1667,84.25,978297,0,11951,966346
3/25/22,Nepal,28.1667,84.25,978309,0,11951,966358
3/26/22,Nepal,28.1667,84.25,978317,0,11951,966366
3/27/22,Nepal,28.1667,84.25,978332,0,11951,966381
3/28/22,Nepal,28.1667,84.25,978347,0,11951,966396
3/29/22,Nepal,28.1667,84.25,978377,0,11951,966426
3/30/22,Nepal,28.1667,84.25,978402,0,11951,966451
3/31/22,Nepal,28.1667,84.25,978426,0,11951,966475
4/1/22,Nepal,28.1667,84.25,978442,0,11951,966491
4/2/22,Nepal,28.1667,84.25,978452,0,11951,966501
4/3/22,Nepal,28.1667,84.25,978475,0,11951,966524
4/4/22,Nepal,28.1667,84.25,978507,0,11951,966556
4/5/22,Nepal,28.1667,84.25,978528,0,11951,966577
4/6/22,Nepal,28.1667,84.25,978538,0,11951,966587
4/7/22,Nepal,28.1667,84.25,978545,0,11951,966594
4/8/22,Nepal,28.1667,84.25,978556,0,11951,966605
4/9/22,Nepal,28.1667,84.25,978568,0,11951,966617
4/10/22,Nepal,28.1667,84.25,978571,0,11951,966620
4/11/22,Nepal,28.1667,84.25,978593,0,11951,966642
4/12/22,Nepal,28.1667,84.25,978616,0,11951,966665
4/13/22,Nepal,28.1667,84.25,978631,0,11951,966680
4/14/22,Nepal,28.1667,84.25,978634,0,11951,966683
4/15/22,Nepal,28.1667,84.25,978648,0,11951,966697
4/16/22,Nepal,28.1667,84.25,978654,0,11951,966703
4/17/22,Nepal,28.1667,84.25,978665,0,11951,966714
4/18/22,Nepal,28.1667,84.25,978674,0,11951,966723
4/19/22,Nepal,28.1667,84.25,978684,0,11951,966733
4/20/22,Nepal,28.1667,84.25,978693,0,11951,966742
4/21/22,Nepal,28.1667,84.25,978705,0,11951,966754
4/22/22,Nepal,28.1667,84.25,978714,0,11951,966763
4/23/22,Nepal,28.1667,84.25,978732,0,11951,966781
4/24/22,Nepal,28.1667,84.25,978743,0,11951,966792
4/25/22,Nepal,28.1667,84.25,978762,0,11951,966811
4/26/22,Nepal,28.1667,84.25,978770,0,11951,966819
4/27/22,Nepal,28.1667,84.25,978778,0,11951,966827
4/28/22,Nepal,28.1667,84.25,978793,0,11951,966842
4/29/22,Nepal,28.1667,84.25,978806,0,11951,966855
4/30/22,Nepal,28.1667,84.25,978810,0,11951,966859
5/1/22,Nepal,28.1667,84.25,978828,0,11951,966877
5/2/22,Nepal,28.1667,84.25,978836,0,11951,966885
5/3/22,Nepal,28.1667,84.25,978865,0,11951,966914
5/4/22,Nepal,28.1667,84.25,978884,0,11952,966932
5/5/22,Nepal,28.1667,84.25,978899,0,11952,966947
5/6/22,Nepal,28.1667,84.25,978914,0,11952,966962
5/7/22,Nepal,28.1667,84.25,978925,0,11952,966973
5/8/22,Nepal,28.1667,84.25,978942,0,11952,966990
5/9/22,Nepal,28.1667,84.25,978948,0,11952,966996
5/10/22,Nepal,28.1667,84.25,978960,0,11952,967008
5/11/22,Nepal,28.1667,84.25,978978,0,11952,967026
5/12/22,Nepal,28.1667,84.25,978982,0,11952,967030
5/13/22,Nepal,28.1667,84.25,978989,0,11952,967037
5/14/22,Nepal,28.1667,84.25,978991,0,11952,967039
5/15/22,Nepal,28.1667,84.25,978998,0,11952,967046
5/16/22,Nepal,28.1667,84.25,979004,0,11952,967052
5/17/22,Nepal,28.1667,84.25,979022,0,11952,967070
5/18/22,Nepal,28.1667,84.25,979028,0,11952,967076
5/19/22,Nepal,28.1667,84.25,979040,0,11952,967088
5/20/22,Nepal,28.1667,84.25,979051,0,11952,967099
5/21/22,Nepal,28.1667,84.25,979062,0,11952,967110
5/22/22,Nepal,28.1667,84.25,979068,0,11952,967116
5/23/22,Nepal,28.1667,84.25,979076,0,11952,967124
5/24/22,Nepal,28.1667,84.25,979087,0,11952,967135
5/25/22,Nepal,28.1667,84.25,979091,0,11952,967139
5/26/22,Nepal,28.1667,84.25,979105,0,11952,967153
5/27/22,Nepal,28.1667,84.25,979113,0,11952,967161
5/28/22,Nepal,28.1667,84.25,979118,0,11952,967166
5/29/22,Nepal,28.1667,84.25,979127,0,11952,967175
5/30/22,Nepal,28.1667,84.25,979132,0,11952,967180
5/31/22,Nepal,28.1667,84.25,979140,0,11952,967188
6/1/22,Nepal,28.1667,84.25,979152,0,11952,967200
6/2/22,Nepal,28.1667,84.25,979163,0,11952,967211
6/3/22,Nepal,28.1667,84.25,979182,0,11952,967230
6/4/22,Nepal,28.1667,84.25,979190,0,11952,967238
6/5/22,Nepal,28.1667,84.25,979199,0,11952,967247
6/6/22,Nepal,28.1667,84.25,979206,0,11952,967254
6/7/22,Nepal,28.1667,84.25,979213,0,11952,967261
6/8/22,Nepal,28.1667,84.25,979223,0,11952,967271
6/9/22,Nepal,28.1667,84.25,979235,0,11952,967283
6/10/22,Nepal,28.1667,84.25,979242,0,11952,967290
6/11/22,Nepal,28.1667,84.25,979251,0,11952,967299
6/12/22,Nepal,28.1667,84.25,979262,0,11952,967310
6/13/22,Nepal,28.1667,84.25,979271,0,11952,967319
6/14/22,Nepal,28.1667,84.25,979278,0,11952,967326
6/15/22,Nepal,28.1667,84.25,979297,0,11952,967345
6/16/22,Nepal,28.1667,84.25,979309,0,11952,967357
6/17/22,Nepal,28.1667,84.25,979333,0,11952,967381
6/18/22,Nepal,28.1667,84.25,979344,0,11952,967392
6/19/22,Nepal,28.1667,84.25,979362,0,11952,967410
6/20/22,Nepal,28.1667,84.25,979382,0,11952,967430
6/21/22,Nepal,28.1667,84.25,979396,0,11952,967444
6/22/22,Nepal,28.1667,84.25,979424,0,11952,967472
6/23/22,Nepal,28.1667,84.25,979457,0,11952,967505
6/24/22,Nepal,28.1667,84.25,979489,0,11952,967537
6/25/22,Nepal,28.1667,84.25,979512,0,11952,967560
6/26/22,Nepal,28.1667,84.25,979533,0,11952,967581
6/27/22,Nepal,28.1667,84.25,979569,0,11952,967617
6/28/22,Nepal,28.1667,84.25,979607,0,11952,967655
6/29/22,Nepal,28.1667,84.25,979658,0,11952,967706
6/30/22,Nepal,28.1667,84.25,979694,0,11952,967742
7/1/22,Nepal,28.1667,84.25,979729,0,11952,967777
7/2/22,Nepal,28.1667,84.25,979762,0,11952,967810
7/3/22,Nepal,28.1667,84.25,979801,0,11952,967849
7/4/22,Nepal,28.1667,84.25,979835,0,11952,967883
7/5/22,Nepal,28.1667,84.25,979908,0,11952,967956
7/6/22,Nepal,28.1667,84.25,979998,0,11952,968046
7/7/22,Nepal,28.1667,84.25,980058,0,11952,968106
7/8/22,Nepal,28.1667,84.25,980141,0,11952,968189
7/9/22,Nepal,28.1667,84.25,980213,0,11952,968261
7/10/22,Nepal,28.1667,84.25,980317,0,11952,968365
7/11/22,Nepal,28.1667,84.25,980446,0,11952,968494
7/12/22,Nepal,28.1667,84.25,980590,0,11952,968638
7/13/22,Nepal,28.1667,84.25,980767,0,11952,968815
7/14/22,Nepal,28.1667,84.25,980981,0,11952,969029
7/15/22,Nepal,28.1667,84.25,981142,0,11952,969190
7/16/22,Nepal,28.1667,84.25,981294,0,11952,969342
7/17/22,Nepal,28.1667,84.25,981408,0,11953,969455
7/18/22,Nepal,28.1667,84.25,981794,0,11954,969840
7/19/22,Nepal,28.1667,84.25,982062,0,11954,970108
7/20/22,Nepal,28.1667,84.25,982402,0,11954,970448
7/21/22,Nepal,28.1667,84.25,982719,0,11954,970765
7/22/22,Nepal,28.1667,84.25,983103,0,11954,971149
7/23/22,Nepal,28.1667,84.25,983319,0,11954,971365
7/24/22,Nepal,28.1667,84.25,983622,0,11954,971668
7/25/22,Nepal,28.1667,84.25,984075,0,11957,972118
7/26/22,Nepal,28.1667,84.25,984475,0,11959,972516
7/27/22,Nepal,28.1667,84.25,984893,0,11960,972933
7/28/22,Nepal,28.1667,84.25,985417,0,11962,973455
7/29/22,Nepal,28.1667,84.25,985808,0,11964,973844
7/30/22,Nepal,28.1667,84.25,986100,0,11966,974134
7/31/22,Nepal,28.1667,84.25,986596,0,11967,974629
8/1/22,Nepal,28.1667,84.25,987228,0,11968,975260
8/2/22,Nepal,28.1667,84.25,987737,0,11968,975769
8/3/22,Nepal,28.1667,84.25,988327,0,11968,976359
8/4/22,Nepal,28.1667,84.25,988821,0,11969,976852
8/5/22,Nepal,28.1667,84.25,989350,0,11970,977380
8/6/22,Nepal,28.1667,84.25,989676,0,11971,977705
8/7/22,Nepal,28.1667,84.25,990127,0,11971,978156
8/8/22,Nepal,28.1667,84.25,990625,0,11972,978653
8/9/22,Nepal,28.1667,84.25,991185,0,11974,979211
8/10/22,Nepal,28.1667,84.25,991681,0,11977,979704
8/11/22,Nepal,28.1667,84.25,992146,0,11982,980164
8/12/22,Nepal,28.1667,84.25,992565,0,11984,980581
8/13/22,Nepal,28.1667,84.25,992727,0,11986,980741
8/14/22,Nepal,28.1667,84.25,993032,0,11988,981044
8/15/22,Nepal,28.1667,84.25,993459,0,11989,981470
8/16/22,Nepal,28.1667,84.25,993858,0,11990,981868
8/17/22,Nepal,28.1667,84.25,994389,0,11990,982399
8/18/22,Nepal,28.1667,84.25,994613,0,11990,982623
8/19/22,Nepal,28.1667,84.25,994859,0,11990,982869
8/20/22,Nepal,28.1667,84.25,995039,0,11992,983047
8/21/22,Nepal,28.1667,84.25,995241,0,11992,983249
8/22/22,Nepal,28.1667,84.25,995646,0,11993,983653
8/23/22,Nepal,28.1667,84.25,995989,0,11994,983995
8/24/22,Nepal,28.1667,84.25,996231,0,11995,984236
8/25/22,Nepal,28.1667,84.25,996442,0,11998,984444
8/26/22,Nepal,28.1667,84.25,996605,0,11999,984606
8/27/22,Nepal,28.1667,84.25,996670,0,11999,984671
8/28/22,Nepal,28.1667,84.25,996834,0,12000,984834
8/29/22,Nepal,28.1667,84.25,996979,0,12000,984979
8/30/22,Nepal,28.1667,84.25,997122,0,12000,985122
8/31/22,Nepal,28.1667,84.25,997346,0,12001,985345
9/1/22,Nepal,28.1667,84.25,997526,0,12002,985524
9/2/22,Nepal,28.1667,84.25,997660,0,12005,985655
9/3/22,Nepal,28.1667,84.25,997752,0,12007,985745
9/4/22,Nepal,28.1667,84.25,997868,0,12007,985861
9/5/22,Nepal,28.1667,84.25,997990,0,12007,985983
9/6/22,Nepal,28.1667,84.25,998167,0,12007,986160
9/7/22,Nepal,28.1667,84.25,998295,0,12009,986286
9/8/22,Nepal,28.1667,84.25,998432,0,12010,986422
9/9/22,Nepal,28.1667,84.25,998542,0,12012,986530
9/10/22,Nepal,28.1667,84.25,998654,0,12012,986642
9/11/22,Nepal,28.1667,84.25,998743,0,12014,986729
9/12/22,Nepal,28.1667,84.25,998870,0,12015,986855
9/13/22,Nepal,28.1667,84.25,998957,0,12015,986942
9/14/22,Nepal,28.1667,84.25,999046,0,12015,987031
9/15/22,Nepal,28.1667,84.25,999121,0,12015,987106
9/16/22,Nepal,28.1667,84.25,999181,0,12016,987165
9/17/22,Nepal,28.1667,84.25,999216,0,12016,987200
9/18/22,Nepal,28.1667,84.25,999241,0,12016,987225
9/19/22,Nepal,28.1667,84.25,999316,0,12016,987300
9/20/22,Nepal,28.1667,84.25,999355,0,12016,987339
9/21/22,Nepal,28.1667,84.25,999394,0,12016,987378
9/22/22,Nepal,28.1667,84.25,999453,0,12016,987437
9/23/22,Nepal,28.1667,84.25,999506,0,12016,987490
9/24/22,Nepal,28.1667,84.25,999535,0,12017,987518
9/25/22,Nepal,28.1667,84.25,999575,0,12017,987558
9/26/22,Nepal,28.1667,84.25,999614,0,12017,987597
9/27/22,Nepal,28.1667,84.25,999656,0,12017,987639
9/28/22,Nepal,28.1667,84.25,999687,0,12018,987669
9/29/22,Nepal,28.1667,84.25,999712,0,12018,987694
9/30/22,Nepal,28.1667,84.25,999742,0,12018,987724
10/1/22,Nepal,28.1667,84.25,999759,0,12018,987741
10/2/22,Nepal,28.1667,84.25,999759,0,12018,987741
10/3/22,Nepal,28.1667,84.25,999789,0,12018,987771
10/4/22,Nepal,28.1667,84.25,999829,0,12018,987811
10/5/22,Nepal,28.1667,84.25,999839,0,12018,987821
10/6/22,Nepal,28.1667,84.25,999849,0,12018,987831
10/7/22,Nepal,28.1667,84.25,999860,0,12018,987842
10/8/22,Nepal,28.1667,84.25,999866,0,12018,987848
10/9/22,Nepal,28.1667,84.25,999886,0,12018,987868
10/10/22,Nepal,28.1667,84.25,999911,0,12018,987893
10/11/22,Nepal,28.1667,84.25,999946,0,12018,987928
10/12/22,Nepal,28.1667,84.25,999991,0,12018,987973
10/13/22,Nepal,28.1667,84.25,1000036,0,12018,988018
10/14/22,Nepal,28.1667,84.25,1000078,0,12018,988060
10/15/22,Nepal,28.1667,84.25,1000123,0,12018,988105
10/16/22,Nepal,28.1667,84.25,1000151,0,12018,988133
10/17/22,Nepal,28.1667,84.25,1000191,0,12018,988173
10/18/22,Nepal,28.1667,84.25,1000233,0,12018,988215
10/19/22,Nepal,28.1667,84.25,1000275,0,12018,988257
10/20/22,Nepal,28.1667,84.25,1000325,0,12018,988307
10/21/22,Nepal,28.1667,84.25,1000373,0,12018,988355
10/22/22,Nepal,28.1667,84.25,1000416,0,12018,988398
10/23/22,Nepal,28.1667,84.25,1000455,0,12018,988437
10/24/22,Nepal,28.1667,84.25,1000495,0,12019,988476
10/25/22,Nepal,28.1667,84.25,1000509,0,12019,988490
10/26/22,Nepal,28.1667,84.25,1000523,0,12019,988504
10/27/22,Nepal,28.1667,84.25,1000526,0,12019,988507
10/28/22,Nepal,28.1667,84.25,1000538,0,12019,988519
10/29/22,Nepal,28.1667,84.25,1000541,0,12019,988522
10/30/22,Nepal,28.1667,84.25,1000550,0,12019,988531
10/31/22,Nepal,28.1667,84.25,1000556,0,12019,988537
11/1/22,Nepal,28.1667,84.25,1000585,0,12019,988566
11/2/22,Nepal,28.1667,84.25,1000631,0,12019,988612
11/3/22,Nepal,28.1667,84.25,1000676,0,12019,988657
11/4/22,Nepal,28.1667,84.25,1000698,0,12019,988679
11/5/22,Nepal,28.1667,84.25,1000708,0,12019,988689
11/6/22,Nepal,28.1667,84.25,1000734,0,12019,988715
11/7/22,Nepal,28.1667,84.25,1000749,0,12019,988730
11/8/22,Nepal,28.1667,84.25,1000759,0,12019,988740
11/9/22,Nepal,28.1667,84.25,1000766,0,12019,988747
11/10/22,Nepal,28.1667,84.25,1000775,0,12019,988756
11/11/22,Nepal,28.1667,84.25,1000784,0,12019,988765
11/12/22,Nepal,28.1667,84.25,1000792,0,12019,988773
11/13/22,Nepal,28.1667,84.25,1000806,0,12019,988787
11/14/22,Nepal,28.1667,84.25,1000814,0,12019,988795
11/15/22,Nepal,28.1667,84.25,1000826,0,12019,988807
11/16/22,Nepal,28.1667,84.25,1000834,0,12019,988815
11/17/22,Nepal,28.1667,84.25,1000838,0,12019,988819
11/18/22,Nepal,28.1667,84.25,1000846,0,12019,988827
11/19/22,Nepal,28.1667,84.25,1000849,0,12019,988830
11/20/22,Nepal,28.1667,84.25,1000851,0,12019,988832
11/21/22,Nepal,28.1667,84.25,1000855,0,12019,988836
11/22/22,Nepal,28.1667,84.25,1000859,0,12019,988840
11/23/22,Nepal,28.1667,84.25,1000863,0,12019,988844
11/24/22,Nepal,28.1667,84.25,1000865,0,12019,988846
11/25/22,Nepal,28.1667,84.25,1000875,0,12019,988856
11/26/22,Nepal,28.1667,84.25,1000875,0,12019,988856
11/27/22,Nepal,28.1667,84.25,1000878,0,12019,988859
11/28/22,Nepal,28.1667,84.25,1000884,0,12019,988865
11/29/22,Nepal,28.1667,84.25,1000885,0,12019,988866
11/30/22,Nepal,28.1667,84.25,1000889,0,12019,988870
12/1/22,Nepal,28.1667,84.25,1000894,0,12019,988875
12/2/22,Nepal,28.1667,84.25,1000900,0,12019,988881
12/3/22,Nepal,28.1667,84.25,1000903,0,12019,988884
12/4/22,Nepal,28.1667,84.25,1000909,0,12019,988890
12/5/22,Nepal,28.1667,84.25,1000911,0,12019,988892
12/6/22,Nepal,28.1667,84.25,1000912,0,12019,988893
12/7/22,Nepal,28.1667,84.25,1000921,0,12019,988902
12/8/22,Nepal,28.1667,84.25,1000924,0,12019,988905
12/9/22,Nepal,28.1667,84.25,1000929,0,12019,988910
12/10/22,Nepal,28.1667,84.25,1000930,0,12019,988911
12/11/22,Nepal,28.1667,84.25,1000932,0,12019,988913
12/12/22,Nepal,28.1667,84.25,1000939,0,12019,988920
12/13/22,Nepal,28.1667,84.25,1000941,0,12019,988922
12/14/22,Nepal,28.1667,84.25,1000942,0,12019,988923
12/15/22,Nepal,28.1667,84.25,1000945,0,12019,988926
12/16/22,Nepal,28.1667,84.25,1000945,0,12019,988926
12/17/22,Nepal,28.1667,84.25,1000945,0,12019,988926
1/1/22,Netherlands,52.1326,5.2913,3217646,0,21419,3196227
1/2/22,Netherlands,52.1326,5.2913,3233140,0,21425,3211715
1/3/22,Netherlands,52.1326,5.2913,3252649,0,21439,3231210
1/4/22,Netherlands,52.1326,5.2913,3279437,0,21458,3257979
1/5/22,Netherlands,52.1326,5.2913,3306721,0,21497,3285224
1/6/22,Netherlands,52.1326,5.2913,3344040,0,21511,3322529
1/7/22,Netherlands,52.1326,5.2913,3374488,0,21536,3352952
1/8/22,Netherlands,52.1326,5.2913,3408735,0,21545,3387190
1/9/22,Netherlands,52.1326,5.2913,3438179,0,21553,3416626
1/10/22,Netherlands,52.1326,5.2913,3468379,0,21563,3446816
1/11/22,Netherlands,52.1326,5.2913,3502126,0,21584,3480542
1/12/22,Netherlands,52.1326,5.2913,3537795,0,21595,3516200
1/13/22,Netherlands,52.1326,5.2913,3574787,0,21610,3553177
1/14/22,Netherlands,52.1326,5.2913,3609340,0,21628,3587712
1/15/22,Netherlands,52.1326,5.2913,3646279,0,21634,3624645
1/16/22,Netherlands,52.1326,5.2913,3689011,0,21642,3667369
1/17/22,Netherlands,52.1326,5.2913,3690448,0,21651,3668797
1/18/22,Netherlands,52.1326,5.2913,3760998,0,21652,3739346
1/19/22,Netherlands,52.1326,5.2913,3801409,0,21674,3779735
1/20/22,Netherlands,52.1326,5.2913,3860272,0,21689,3838583
1/21/22,Netherlands,52.1326,5.2913,3907184,0,21702,3885482
1/22/22,Netherlands,52.1326,5.2913,3973076,0,21716,3951360
1/23/22,Netherlands,52.1326,5.2913,4038129,0,21723,4016406
1/24/22,Netherlands,52.1326,5.2913,4092539,0,21733,4070806
1/25/22,Netherlands,52.1326,5.2913,4151652,0,21747,4129905
1/26/22,Netherlands,52.1326,5.2913,4216631,0,21760,4194871
1/27/22,Netherlands,52.1326,5.2913,4291147,0,21777,4269370
1/28/22,Netherlands,52.1326,5.2913,4330881,0,21788,4309093
1/29/22,Netherlands,52.1326,5.2913,4406331,0,21797,4384534
1/30/22,Netherlands,52.1326,5.2913,4518767,0,21800,4496967
1/31/22,Netherlands,52.1326,5.2913,4624716,0,21809,4602907
2/1/22,Netherlands,52.1326,5.2913,4692028,0,21827,4670201
2/2/22,Netherlands,52.1326,5.2913,4775147,0,21840,4753307
2/3/22,Netherlands,52.1326,5.2913,4844257,0,21854,4822403
2/4/22,Netherlands,52.1326,5.2913,4884578,0,21862,4862716
2/5/22,Netherlands,52.1326,5.2913,4979650,0,21874,4957776
2/6/22,Netherlands,52.1326,5.2913,5057376,0,21883,5035493
2/7/22,Netherlands,52.1326,5.2913,5437874,0,21890,5415984
2/8/22,Netherlands,52.1326,5.2913,5524628,0,21892,5502736
2/9/22,Netherlands,52.1326,5.2913,5611596,0,21901,5589695
2/10/22,Netherlands,52.1326,5.2913,5692388,0,21917,5670471
2/11/22,Netherlands,52.1326,5.2913,5762879,0,21940,5740939
2/12/22,Netherlands,52.1326,5.2913,5823167,0,21955,5801212
2/13/22,Netherlands,52.1326,5.2913,5878252,0,21964,5856288
2/14/22,Netherlands,52.1326,5.2913,5931816,0,21973,5909843
2/15/22,Netherlands,52.1326,5.2913,5995805,0,21987,5973818
2/16/22,Netherlands,52.1326,5.2913,6052272,0,22005,6030267
2/17/22,Netherlands,52.1326,5.2913,6101680,0,22022,6079658
2/18/22,Netherlands,52.1326,5.2913,6135372,0,22038,6113334
2/19/22,Netherlands,52.1326,5.2913,6171884,0,22049,6149835
2/20/22,Netherlands,52.1326,5.2913,6207905,0,22057,6185848
2/21/22,Netherlands,52.1326,5.2913,6242623,0,22076,6220547
2/22/22,Netherlands,52.1326,5.2913,6242693,0,22095,6220598
2/23/22,Netherlands,52.1326,5.2913,6283336,0,22106,6261230
2/24/22,Netherlands,52.1326,5.2913,6324585,0,22119,6302466
2/25/22,Netherlands,52.1326,5.2913,6362177,0,22127,6340050
2/26/22,Netherlands,52.1326,5.2913,6395100,0,22133,6372967
2/27/22,Netherlands,52.1326,5.2913,6422501,0,22136,6400365
2/28/22,Netherlands,52.1326,5.2913,6451397,0,22142,6429255
3/1/22,Netherlands,52.1326,5.2913,6487920,0,22158,6465762
3/2/22,Netherlands,52.1326,5.2913,6536471,0,22170,6514301
3/3/22,Netherlands,52.1326,5.2913,6594832,0,22178,6572654
3/4/22,Netherlands,52.1326,5.2913,6663249,0,22191,6641058
3/5/22,Netherlands,52.1326,5.2913,6730457,0,22200,6708257
3/6/22,Netherlands,52.1326,5.2913,6797256,0,22204,6775052
3/7/22,Netherlands,52.1326,5.2913,6861716,0,22204,6839512
3/8/22,Netherlands,52.1326,5.2913,6928013,0,22216,6905797
3/9/22,Netherlands,52.1326,5.2913,7002259,0,22226,6980033
3/10/22,Netherlands,52.1326,5.2913,7076777,0,22267,7054510
3/11/22,Netherlands,52.1326,5.2913,7146301,0,22281,7124020
3/12/22,Netherlands,52.1326,5.2913,7206350,0,22292,7184058
3/13/22,Netherlands,52.1326,5.2913,7258692,0,22300,7236392
3/14/22,Netherlands,52.1326,5.2913,7304612,0,22306,7282306
3/15/22,Netherlands,52.1326,5.2913,7357595,0,22318,7335277
3/16/22,Netherlands,52.1326,5.2913,7417982,0,22329,7395653
3/17/22,Netherlands,52.1326,5.2913,7471677,0,22348,7449329
3/18/22,Netherlands,52.1326,5.2913,7526190,0,22367,7503823
3/19/22,Netherlands,52.1326,5.2913,7567650,0,22378,7545272
3/20/22,Netherlands,52.1326,5.2913,7602473,0,22386,7580087
3/21/22,Netherlands,52.1326,5.2913,7634694,0,22389,7612305
3/22/22,Netherlands,52.1326,5.2913,7675252,0,22414,7652838
3/23/22,Netherlands,52.1326,5.2913,7718040,0,22430,7695610
3/24/22,Netherlands,52.1326,5.2913,7757138,0,22445,7734693
3/25/22,Netherlands,52.1326,5.2913,7792582,0,22467,7770115
3/26/22,Netherlands,52.1326,5.2913,7820824,0,22487,7798337
3/27/22,Netherlands,52.1326,5.2913,7845856,0,22494,7823362
3/28/22,Netherlands,52.1326,5.2913,7867412,0,22504,7844908
3/29/22,Netherlands,52.1326,5.2913,7898395,0,22520,7875875
3/30/22,Netherlands,52.1326,5.2913,7926384,0,22557,7903827
3/31/22,Netherlands,52.1326,5.2913,7951853,0,22583,7929270
4/1/22,Netherlands,52.1326,5.2913,7974049,0,22591,7951458
4/2/22,Netherlands,52.1326,5.2913,7991000,0,22605,7968395
4/3/22,Netherlands,52.1326,5.2913,8003377,0,22611,7980766
4/4/22,Netherlands,52.1326,5.2913,8014427,0,22621,7991806
4/5/22,Netherlands,52.1326,5.2913,8028475,0,22635,8005840
4/6/22,Netherlands,52.1326,5.2913,8041708,0,22656,8019052
4/7/22,Netherlands,52.1326,5.2913,8054589,0,22665,8031924
4/8/22,Netherlands,52.1326,5.2913,8066022,0,22681,8043341
4/9/22,Netherlands,52.1326,5.2913,8075930,0,22697,8053233
4/10/22,Netherlands,52.1326,5.2913,8083108,0,22699,8060409
4/11/22,Netherlands,52.1326,5.2913,8089752,0,22702,8067050
4/12/22,Netherlands,52.1326,5.2913,8096401,0,22718,8073683
4/13/22,Netherlands,52.1326,5.2913,8101578,0,22741,8078837
4/14/22,Netherlands,52.1326,5.2913,8106357,0,22751,8083606
4/15/22,Netherlands,52.1326,5.2913,8110496,0,22759,8087737
4/16/22,Netherlands,52.1326,5.2913,8114337,0,22763,8091574
4/17/22,Netherlands,52.1326,5.2913,8117175,0,22764,8094411
4/18/22,Netherlands,52.1326,5.2913,8119285,0,22766,8096519
4/19/22,Netherlands,52.1326,5.2913,8121967,0,22770,8099197
4/20/22,Netherlands,52.1326,5.2913,8125697,0,22840,8102857
4/21/22,Netherlands,52.1326,5.2913,8128733,0,22800,8105933
4/22/22,Netherlands,52.1326,5.2913,8131494,0,22809,8108685
4/23/22,Netherlands,52.1326,5.2913,8133776,0,22821,8110955
4/24/22,Netherlands,52.1326,5.2913,8135366,0,22826,8112540
4/25/22,Netherlands,52.1326,5.2913,8136891,0,22832,8114059
4/26/22,Netherlands,52.1326,5.2913,8138755,0,22839,8115916
4/27/22,Netherlands,52.1326,5.2913,8140717,0,22842,8117875
4/28/22,Netherlands,52.1326,5.2913,8141965,0,22844,8119121
4/29/22,Netherlands,52.1326,5.2913,8144000,0,22849,8121151
4/30/22,Netherlands,52.1326,5.2913,8145596,0,22855,8122741
5/1/22,Netherlands,52.1326,5.2913,8146887,0,22859,8124028
5/2/22,Netherlands,52.1326,5.2913,8148198,0,22862,8125336
5/3/22,Netherlands,52.1326,5.2913,8150001,0,22868,8127133
5/4/22,Netherlands,52.1326,5.2913,8151922,0,22872,8129050
5/5/22,Netherlands,52.1326,5.2913,8153591,0,22875,8130716
5/6/22,Netherlands,52.1326,5.2913,8155118,0,22876,8132242
5/7/22,Netherlands,52.1326,5.2913,8156837,0,22881,8133956
5/8/22,Netherlands,52.1326,5.2913,8158071,0,22883,8135188
5/9/22,Netherlands,52.1326,5.2913,8159227,0,22886,8136341
5/10/22,Netherlands,52.1326,5.2913,8160810,0,22889,8137921
5/11/22,Netherlands,52.1326,5.2913,8162498,0,22895,8139603
5/12/22,Netherlands,52.1326,5.2913,8163926,0,22900,8141026
5/13/22,Netherlands,52.1326,5.2913,8165892,0,22901,8142991
5/14/22,Netherlands,52.1326,5.2913,8167219,0,22903,8144316
5/15/22,Netherlands,52.1326,5.2913,8168227,0,22903,8145324
5/16/22,Netherlands,52.1326,5.2913,8169091,0,22903,8146188
5/17/22,Netherlands,52.1326,5.2913,8170403,0,22906,8147497
5/18/22,Netherlands,52.1326,5.2913,8171992,0,22907,8149085
5/19/22,Netherlands,52.1326,5.2913,8173428,0,22911,8150517
5/20/22,Netherlands,52.1326,5.2913,8175239,0,22916,8152323
5/21/22,Netherlands,52.1326,5.2913,8176417,0,22917,8153500
5/22/22,Netherlands,52.1326,5.2913,8177181,0,22917,8154264
5/23/22,Netherlands,52.1326,5.2913,8177944,0,22917,8155027
5/24/22,Netherlands,52.1326,5.2913,8179134,0,22919,8156215
5/25/22,Netherlands,52.1326,5.2913,8180573,0,22925,8157648
5/26/22,Netherlands,52.1326,5.2913,8181630,0,22924,8158706
5/27/22,Netherlands,52.1326,5.2913,8183245,0,22925,8160320
5/28/22,Netherlands,52.1326,5.2913,8184136,0,22928,8161208
5/29/22,Netherlands,52.1326,5.2913,8184962,0,22929,8162033
5/30/22,Netherlands,52.1326,5.2913,8185964,0,22929,8163035
5/31/22,Netherlands,52.1326,5.2913,8187211,0,22933,8164278
6/1/22,Netherlands,52.1326,5.2913,8189023,0,22935,8166088
6/2/22,Netherlands,52.1326,5.2913,8190558,0,22936,8167622
6/3/22,Netherlands,52.1326,5.2913,8192641,0,22939,8169702
6/4/22,Netherlands,52.1326,5.2913,8194254,0,22940,8171314
6/5/22,Netherlands,52.1326,5.2913,8195493,0,22940,8172553
6/6/22,Netherlands,52.1326,5.2913,8196517,0,22940,8173577
6/7/22,Netherlands,52.1326,5.2913,8198019,0,22940,8175079
6/8/22,Netherlands,52.1326,5.2913,8200146,0,22941,8177205
6/9/22,Netherlands,52.1326,5.2913,8202575,0,22945,8179630
6/10/22,Netherlands,52.1326,5.2913,8205566,0,22947,8182619
6/11/22,Netherlands,52.1326,5.2913,8205566,0,22947,8182619
6/12/22,Netherlands,52.1326,5.2913,8205566,0,22947,8182619
6/13/22,Netherlands,52.1326,5.2913,8211768,0,22951,8188817
6/14/22,Netherlands,52.1326,5.2913,8214642,0,22951,8191691
6/15/22,Netherlands,52.1326,5.2913,8218556,0,22956,8195600
6/16/22,Netherlands,52.1326,5.2913,8222722,0,22961,8199761
6/17/22,Netherlands,52.1326,5.2913,8227221,0,22962,8204259
6/18/22,Netherlands,52.1326,5.2913,8227221,0,22962,8204259
6/19/22,Netherlands,52.1326,5.2913,8227221,0,22962,8204259
6/20/22,Netherlands,52.1326,5.2913,8237473,0,22964,8214509
6/21/22,Netherlands,52.1326,5.2913,8242305,0,22966,8219339
6/22/22,Netherlands,52.1326,5.2913,8247488,0,22970,8224518
6/23/22,Netherlands,52.1326,5.2913,8252995,0,22972,8230023
6/24/22,Netherlands,52.1326,5.2913,8258161,0,22976,8235185
6/25/22,Netherlands,52.1326,5.2913,8258577,0,22976,8235601
6/26/22,Netherlands,52.1326,5.2913,8258577,0,22976,8235601
6/27/22,Netherlands,52.1326,5.2913,8271456,0,22980,8248476
6/28/22,Netherlands,52.1326,5.2913,8277287,0,22984,8254303
6/29/22,Netherlands,52.1326,5.2913,8283818,0,22992,8260826
6/30/22,Netherlands,52.1326,5.2913,8290330,0,23000,8267330
7/1/22,Netherlands,52.1326,5.2913,8296406,0,23003,8273403
7/2/22,Netherlands,52.1326,5.2913,8296406,0,23003,8273403
7/3/22,Netherlands,52.1326,5.2913,8296406,0,23003,8273403
7/4/22,Netherlands,52.1326,5.2913,8310449,0,23007,8287442
7/5/22,Netherlands,52.1326,5.2913,8317175,0,23016,8294159
7/6/22,Netherlands,52.1326,5.2913,8323722,0,23020,8300702
7/7/22,Netherlands,52.1326,5.2913,8331055,0,23025,8308030
7/8/22,Netherlands,52.1326,5.2913,8338213,0,23030,8315183
7/9/22,Netherlands,52.1326,5.2913,8338213,0,23030,8315183
7/10/22,Netherlands,52.1326,5.2913,8338213,0,23030,8315183
7/11/22,Netherlands,52.1326,5.2913,8353626,0,23032,8330594
7/12/22,Netherlands,52.1326,5.2913,8361159,0,23037,8338122
7/13/22,Netherlands,52.1326,5.2913,8367997,0,23041,8344956
7/14/22,Netherlands,52.1326,5.2913,8375065,0,23045,8352020
7/15/22,Netherlands,52.1326,5.2913,8381920,0,23050,8358870
7/16/22,Netherlands,52.1326,5.2913,8381920,0,23050,8358870
7/17/22,Netherlands,52.1326,5.2913,8381920,0,23050,8358870
7/18/22,Netherlands,52.1326,5.2913,8395102,0,23062,8372040
7/19/22,Netherlands,52.1326,5.2913,8400164,0,23069,8377095
7/20/22,Netherlands,52.1326,5.2913,8404838,0,23076,8381762
7/21/22,Netherlands,52.1326,5.2913,8409332,0,23080,8386252
7/22/22,Netherlands,52.1326,5.2913,8413961,0,23086,8390875
7/23/22,Netherlands,52.1326,5.2913,8413961,0,23086,8390875
7/24/22,Netherlands,52.1326,5.2913,8413961,0,23086,8390875
7/25/22,Netherlands,52.1326,5.2913,8424253,0,23095,8401158
7/26/22,Netherlands,52.1326,5.2913,8428731,0,23106,8405625
7/27/22,Netherlands,52.1326,5.2913,8433004,0,23113,8409891
7/28/22,Netherlands,52.1326,5.2913,8436688,0,23119,8413569
7/29/22,Netherlands,52.1326,5.2913,8439920,0,23122,8416798
7/30/22,Netherlands,52.1326,5.2913,8439920,0,23122,8416798
7/31/22,Netherlands,52.1326,5.2913,8439920,0,23122,8416798
8/1/22,Netherlands,52.1326,5.2913,8447247,0,23127,8424120
8/2/22,Netherlands,52.1326,5.2913,8450770,0,23132,8427638
8/3/22,Netherlands,52.1326,5.2913,8453818,0,23138,8430680
8/4/22,Netherlands,52.1326,5.2913,8456256,0,23142,8433114
8/5/22,Netherlands,52.1326,5.2913,8458726,0,23143,8435583
8/6/22,Netherlands,52.1326,5.2913,8458726,0,23143,8435583
8/7/22,Netherlands,52.1326,5.2913,8458726,0,23143,8435583
8/8/22,Netherlands,52.1326,5.2913,8463722,0,23160,8440562
8/9/22,Netherlands,52.1326,5.2913,8465910,0,23164,8442746
8/10/22,Netherlands,52.1326,5.2913,8468285,0,23169,8445116
8/11/22,Netherlands,52.1326,5.2913,8470047,0,23171,8446876
8/12/22,Netherlands,52.1326,5.2913,8471927,0,23175,8448752
8/13/22,Netherlands,52.1326,5.2913,8471927,0,23175,8448752
8/14/22,Netherlands,52.1326,5.2913,8471927,0,23175,8448752
8/15/22,Netherlands,52.1326,5.2913,8476031,0,23180,8452851
8/16/22,Netherlands,52.1326,5.2913,8477956,0,23188,8454768
8/17/22,Netherlands,52.1326,5.2913,8479828,0,23197,8456631
8/18/22,Netherlands,52.1326,5.2913,8480167,0,23201,8456966
8/19/22,Netherlands,52.1326,5.2913,8482627,0,23210,8459417
8/20/22,Netherlands,52.1326,5.2913,8482627,0,23210,8459417
8/21/22,Netherlands,52.1326,5.2913,8482627,0,23210,8459417
8/22/22,Netherlands,52.1326,5.2913,8485749,0,23219,8462530
8/23/22,Netherlands,52.1326,5.2913,8487125,0,23223,8463902
8/24/22,Netherlands,52.1326,5.2913,8488563,0,23228,8465335
8/25/22,Netherlands,52.1326,5.2913,8489763,0,23230,8466533
8/26/22,Netherlands,52.1326,5.2913,8490917,0,23232,8467685
8/27/22,Netherlands,52.1326,5.2913,8490917,0,23232,8467685
8/28/22,Netherlands,52.1326,5.2913,8490917,0,23232,8467685
8/29/22,Netherlands,52.1326,5.2913,8493784,0,23236,8470548
8/30/22,Netherlands,52.1326,5.2913,8495070,0,23237,8471833
8/31/22,Netherlands,52.1326,5.2913,8496405,0,23239,8473166
9/1/22,Netherlands,52.1326,5.2913,8498770,0,23239,8475531
9/2/22,Netherlands,52.1326,5.2913,8498770,0,23244,8475526
9/3/22,Netherlands,52.1326,5.2913,8499911,0,23244,8476667
9/4/22,Netherlands,52.1326,5.2913,8500795,0,23244,8477551
9/5/22,Netherlands,52.1326,5.2913,8501662,0,23244,8478418
9/6/22,Netherlands,52.1326,5.2913,8503126,0,23248,8479878
9/7/22,Netherlands,52.1326,5.2913,8503247,0,23249,8479998
9/8/22,Netherlands,52.1326,5.2913,8503247,0,23249,8479998
9/9/22,Netherlands,52.1326,5.2913,8507272,0,23253,8484019
9/10/22,Netherlands,52.1326,5.2913,8507272,0,23253,8484019
9/11/22,Netherlands,52.1326,5.2913,8507272,0,23253,8484019
9/12/22,Netherlands,52.1326,5.2913,8507272,0,23253,8484019
9/13/22,Netherlands,52.1326,5.2913,8511573,0,23260,8488313
9/14/22,Netherlands,52.1326,5.2913,8511603,0,23260,8488343
9/15/22,Netherlands,52.1326,5.2913,8511627,0,23260,8488367
9/16/22,Netherlands,52.1326,5.2913,8515935,0,23266,8492669
9/17/22,Netherlands,52.1326,5.2913,8515935,0,23266,8492669
9/18/22,Netherlands,52.1326,5.2913,8515935,0,23266,8492669
9/19/22,Netherlands,52.1326,5.2913,8515935,0,23266,8492669
9/20/22,Netherlands,52.1326,5.2913,8520435,0,23270,8497165
9/21/22,Netherlands,52.1326,5.2913,8520464,0,23270,8497194
9/22/22,Netherlands,52.1326,5.2913,8520464,0,23270,8497194
9/23/22,Netherlands,52.1326,5.2913,8525846,0,23277,8502569
9/24/22,Netherlands,52.1326,5.2913,8525846,0,23277,8502569
9/25/22,Netherlands,52.1326,5.2913,8525846,0,23277,8502569
9/26/22,Netherlands,52.1326,5.2913,8525850,0,23277,8502573
9/27/22,Netherlands,52.1326,5.2913,8532727,0,23283,8509444
9/28/22,Netherlands,52.1326,5.2913,8532760,0,23285,8509475
9/29/22,Netherlands,52.1326,5.2913,8532760,0,23285,8509475
9/30/22,Netherlands,52.1326,5.2913,8541285,0,23292,8517993
10/1/22,Netherlands,52.1326,5.2913,8541285,0,23292,8517993
10/2/22,Netherlands,52.1326,5.2913,8541285,0,23292,8517993
10/3/22,Netherlands,52.1326,5.2913,8541287,0,23292,8517995
10/4/22,Netherlands,52.1326,5.2913,8551775,0,23305,8528470
10/5/22,Netherlands,52.1326,5.2913,8552993,0,23305,8529688
10/6/22,Netherlands,52.1326,5.2913,8552993,0,23305,8529688
10/7/22,Netherlands,52.1326,5.2913,8564596,0,23334,8541262
10/8/22,Netherlands,52.1326,5.2913,8564596,0,23334,8541262
10/9/22,Netherlands,52.1326,5.2913,8564596,0,23334,8541262
10/10/22,Netherlands,52.1326,5.2913,8564596,0,23334,8541262
10/11/22,Netherlands,52.1326,5.2913,8576672,0,23344,8553328
10/12/22,Netherlands,52.1326,5.2913,8576717,0,23346,8553371
10/13/22,Netherlands,52.1326,5.2913,8576717,0,23348,8553369
10/14/22,Netherlands,52.1326,5.2913,8587757,0,23367,8564390
10/15/22,Netherlands,52.1326,5.2913,8587757,0,23367,8564390
10/16/22,Netherlands,52.1326,5.2913,8587757,0,23367,8564390
10/17/22,Netherlands,52.1326,5.2913,8587789,0,23367,8564422
10/18/22,Netherlands,52.1326,5.2913,8599430,0,23394,8576036
10/19/22,Netherlands,52.1326,5.2913,8598636,0,23394,8575242
10/20/22,Netherlands,52.1326,5.2913,8598636,0,23394,8575242
10/21/22,Netherlands,52.1326,5.2913,8605638,0,23417,8582221
10/22/22,Netherlands,52.1326,5.2913,8605638,0,23417,8582221
10/23/22,Netherlands,52.1326,5.2913,8605638,0,23417,8582221
10/24/22,Netherlands,52.1326,5.2913,8605652,0,23418,8582234
10/25/22,Netherlands,52.1326,5.2913,8616266,0,23432,8592834
10/26/22,Netherlands,52.1326,5.2913,8616365,0,23433,8592932
10/27/22,Netherlands,52.1326,5.2913,8616365,0,23433,8592932
10/28/22,Netherlands,52.1326,5.2913,8622874,0,23459,8599415
10/29/22,Netherlands,52.1326,5.2913,8622874,0,23459,8599415
10/30/22,Netherlands,52.1326,5.2913,8622874,0,23459,8599415
10/31/22,Netherlands,52.1326,5.2913,8622874,0,23459,8599415
11/1/22,Netherlands,52.1326,5.2913,8628718,0,23474,8605244
11/2/22,Netherlands,52.1326,5.2913,8628802,0,23478,8605324
11/3/22,Netherlands,52.1326,5.2913,8628802,0,23478,8605324
11/4/22,Netherlands,52.1326,5.2913,8632865,0,23499,8609366
11/5/22,Netherlands,52.1326,5.2913,8632865,0,23499,8609366
11/6/22,Netherlands,52.1326,5.2913,8632865,0,23499,8609366
11/7/22,Netherlands,52.1326,5.2913,8632865,0,23499,8609366
11/8/22,Netherlands,52.1326,5.2913,8636513,0,23510,8613003
11/9/22,Netherlands,52.1326,5.2913,8636513,0,23510,8613003
11/10/22,Netherlands,52.1326,5.2913,8636598,0,23511,8613087
11/11/22,Netherlands,52.1326,5.2913,8639735,0,23525,8616210
11/12/22,Netherlands,52.1326,5.2913,8639735,0,23525,8616210
11/13/22,Netherlands,52.1326,5.2913,8639735,0,23525,8616210
11/14/22,Netherlands,52.1326,5.2913,8639735,0,23525,8616210
11/15/22,Netherlands,52.1326,5.2913,8642667,0,23540,8619127
11/16/22,Netherlands,52.1326,5.2913,8642805,0,23542,8619263
11/17/22,Netherlands,52.1326,5.2913,8642805,0,23542,8619263
11/18/22,Netherlands,52.1326,5.2913,8645502,0,23549,8621953
11/19/22,Netherlands,52.1326,5.2913,8645502,0,23549,8621953
11/20/22,Netherlands,52.1326,5.2913,8645502,0,23549,8621953
11/21/22,Netherlands,52.1326,5.2913,8645502,0,23549,8621953
11/22/22,Netherlands,52.1326,5.2913,8648207,0,23557,8624650
11/23/22,Netherlands,52.1326,5.2913,8648338,0,23559,8624779
11/24/22,Netherlands,52.1326,5.2913,8648338,0,23559,8624779
11/25/22,Netherlands,52.1326,5.2913,8650785,0,23566,8627219
11/26/22,Netherlands,52.1326,5.2913,8650785,0,23566,8627219
11/27/22,Netherlands,52.1326,5.2913,8650785,0,23566,8627219
11/28/22,Netherlands,52.1326,5.2913,8650785,0,23566,8627219
11/29/22,Netherlands,52.1326,5.2913,8653485,0,23568,8629917
11/30/22,Netherlands,52.1326,5.2913,8654001,0,23568,8630433
12/1/22,Netherlands,52.1326,5.2913,8654001,0,23568,8630433
12/2/22,Netherlands,52.1326,5.2913,8656774,0,23579,8633195
12/3/22,Netherlands,52.1326,5.2913,8656774,0,23579,8633195
12/4/22,Netherlands,52.1326,5.2913,8656774,0,23579,8633195
12/5/22,Netherlands,52.1326,5.2913,8656774,0,23579,8633195
12/6/22,Netherlands,52.1326,5.2913,8659430,0,23585,8635845
12/7/22,Netherlands,52.1326,5.2913,8659523,0,23631,8635892
12/8/22,Netherlands,52.1326,5.2913,8659523,0,23631,8635892
12/9/22,Netherlands,52.1326,5.2913,8662418,0,23641,8638777
12/10/22,Netherlands,52.1326,5.2913,8662418,0,23641,8638777
12/11/22,Netherlands,52.1326,5.2913,8662418,0,23641,8638777
12/12/22,Netherlands,52.1326,5.2913,8662418,0,23641,8638777
12/13/22,Netherlands,52.1326,5.2913,8665326,0,23644,8641682
12/14/22,Netherlands,52.1326,5.2913,8665391,0,23645,8641746
12/15/22,Netherlands,52.1326,5.2913,8665391,0,23645,8641746
12/16/22,Netherlands,52.1326,5.2913,8668302,0,23648,8644654
12/17/22,Netherlands,52.1326,5.2913,8668302,0,23648,8644654
1/1/22,New Zealand,-27.0639,-51.5863,14257,0,48,14209
1/2/22,New Zealand,-27.0639,-51.5863,14308,0,49,14259
1/3/22,New Zealand,-27.0639,-51.5863,14367,0,49,14318
1/4/22,New Zealand,-27.0639,-51.5863,14407,0,49,14358
1/5/22,New Zealand,-27.0639,-51.5863,14469,0,49,14420
1/6/22,New Zealand,-27.0639,-51.5863,14527,0,49,14478
1/7/22,New Zealand,-27.0639,-51.5863,14527,0,49,14478
1/8/22,New Zealand,-27.0639,-51.5863,14675,0,49,14626
1/9/22,New Zealand,-27.0639,-51.5863,14735,0,51,14684
1/10/22,New Zealand,-27.0639,-51.5863,14758,0,51,14707
1/11/22,New Zealand,-27.0639,-51.5863,14850,0,51,14799
1/12/22,New Zealand,-27.0639,-51.5863,14889,0,51,14838
1/13/22,New Zealand,-27.0639,-51.5863,14949,0,51,14898
1/14/22,New Zealand,-27.0639,-51.5863,15003,0,51,14952
1/15/22,New Zealand,-27.0639,-51.5863,15071,0,51,15020
1/16/22,New Zealand,-27.0639,-51.5863,15129,0,51,15078
1/17/22,New Zealand,-27.0639,-51.5863,15172,0,51,15121
1/18/22,New Zealand,-27.0639,-51.5863,15251,0,51,15200
1/19/22,New Zealand,-27.0639,-51.5863,15336,0,51,15285
1/20/22,New Zealand,-27.0639,-51.5863,15403,0,51,15352
1/21/22,New Zealand,-27.0639,-51.5863,15481,0,51,15430
1/22/22,New Zealand,-27.0639,-51.5863,15552,0,51,15501
1/23/22,New Zealand,-27.0639,-51.5863,15627,0,52,15575
1/24/22,New Zealand,-27.0639,-51.5863,15689,0,52,15637
1/25/22,New Zealand,-27.0639,-51.5863,15747,0,52,15695
1/26/22,New Zealand,-27.0639,-51.5863,15844,0,52,15792
1/27/22,New Zealand,-27.0639,-51.5863,15993,0,52,15941
1/28/22,New Zealand,-27.0639,-51.5863,16148,0,52,16096
1/29/22,New Zealand,-27.0639,-51.5863,16288,0,52,16236
1/30/22,New Zealand,-27.0639,-51.5863,16418,0,52,16366
1/31/22,New Zealand,-27.0639,-51.5863,16622,0,52,16570
2/1/22,New Zealand,-27.0639,-51.5863,16819,0,52,16767
2/2/22,New Zealand,-27.0639,-51.5863,17007,0,52,16955
2/3/22,New Zealand,-27.0639,-51.5863,17279,0,52,17227
2/4/22,New Zealand,-27.0639,-51.5863,17548,0,52,17496
2/5/22,New Zealand,-27.0639,-51.5863,17775,0,52,17723
2/6/22,New Zealand,-27.0639,-51.5863,17990,0,52,17938
2/7/22,New Zealand,-27.0639,-51.5863,18255,0,52,18203
2/8/22,New Zealand,-27.0639,-51.5863,18505,0,52,18453
2/9/22,New Zealand,-27.0639,-51.5863,18839,0,52,18787
2/10/22,New Zealand,-27.0639,-51.5863,19315,0,52,19263
2/11/22,New Zealand,-27.0639,-51.5863,19779,0,52,19727
2/12/22,New Zealand,-27.0639,-51.5863,19779,0,52,19727
2/13/22,New Zealand,-27.0639,-51.5863,21575,0,53,21522
2/14/22,New Zealand,-27.0639,-51.5863,22330,0,53,22277
2/15/22,New Zealand,-27.0639,-51.5863,23511,0,53,23458
2/16/22,New Zealand,-27.0639,-51.5863,25052,0,53,24999
2/17/22,New Zealand,-27.0639,-51.5863,26938,0,53,26885
2/18/22,New Zealand,-27.0639,-51.5863,28754,0,53,28701
2/19/22,New Zealand,-27.0639,-51.5863,31091,0,53,31038
2/20/22,New Zealand,-27.0639,-51.5863,33321,0,64,33257
2/21/22,New Zealand,-27.0639,-51.5863,36166,0,64,36102
2/22/22,New Zealand,-27.0639,-51.5863,39349,0,64,39285
2/23/22,New Zealand,-27.0639,-51.5863,45479,0,64,45415
2/24/22,New Zealand,-27.0639,-51.5863,57503,0,64,57439
2/25/22,New Zealand,-27.0639,-51.5863,71130,0,64,71066
2/26/22,New Zealand,-27.0639,-51.5863,71130,0,64,71066
2/27/22,New Zealand,-27.0639,-51.5863,86146,0,84,86062
2/28/22,New Zealand,-27.0639,-51.5863,118822,0,84,118738
3/1/22,New Zealand,-27.0639,-51.5863,142943,0,84,142859
3/2/22,New Zealand,-27.0639,-51.5863,166151,0,84,166067
3/3/22,New Zealand,-27.0639,-51.5863,188751,0,84,188667
3/4/22,New Zealand,-27.0639,-51.5863,207646,0,84,207562
3/5/22,New Zealand,-27.0639,-51.5863,222851,0,84,222767
3/6/22,New Zealand,-27.0639,-51.5863,240403,0,118,240285
3/7/22,New Zealand,-27.0639,-51.5863,264387,0,118,264269
3/8/22,New Zealand,-27.0639,-51.5863,286891,0,118,286773
3/9/22,New Zealand,-27.0639,-51.5863,286924,0,118,286806
3/10/22,New Zealand,-27.0639,-51.5863,308010,0,118,307892
3/11/22,New Zealand,-27.0639,-51.5863,347824,0,118,347706
3/12/22,New Zealand,-27.0639,-51.5863,362357,0,118,362239
3/13/22,New Zealand,-27.0639,-51.5863,377933,0,180,377753
3/14/22,New Zealand,-27.0639,-51.5863,399681,0,180,399501
3/15/22,New Zealand,-27.0639,-51.5863,399722,0,180,399542
3/16/22,New Zealand,-27.0639,-51.5863,439014,0,180,438834
3/17/22,New Zealand,-27.0639,-51.5863,453275,0,180,453095
3/18/22,New Zealand,-27.0639,-51.5863,471902,0,180,471722
3/19/22,New Zealand,-27.0639,-51.5863,483966,0,180,483786
3/20/22,New Zealand,-27.0639,-51.5863,498475,0,273,498202
3/21/22,New Zealand,-27.0639,-51.5863,519521,0,273,519248
3/22/22,New Zealand,-27.0639,-51.5863,539788,0,273,539515
3/23/22,New Zealand,-27.0639,-51.5863,558279,0,273,558006
3/24/22,New Zealand,-27.0639,-51.5863,574309,0,273,574036
3/25/22,New Zealand,-27.0639,-51.5863,588729,0,273,588456
3/26/22,New Zealand,-27.0639,-51.5863,599007,0,273,598734
3/27/22,New Zealand,-27.0639,-51.5863,612087,0,365,611722
3/28/22,New Zealand,-27.0639,-51.5863,629479,0,365,629114
3/29/22,New Zealand,-27.0639,-51.5863,645625,0,365,645260
3/30/22,New Zealand,-27.0639,-51.5863,661065,0,365,660700
3/31/22,New Zealand,-27.0639,-51.5863,674705,0,365,674340
4/1/22,New Zealand,-27.0639,-51.5863,686499,0,365,686134
4/2/22,New Zealand,-27.0639,-51.5863,695344,0,365,694979
4/3/22,New Zealand,-27.0639,-51.5863,705770,0,434,705336
4/4/22,New Zealand,-27.0639,-51.5863,720183,0,434,719749
4/5/22,New Zealand,-27.0639,-51.5863,733007,0,434,732573
4/6/22,New Zealand,-27.0639,-51.5863,744869,0,434,744435
4/7/22,New Zealand,-27.0639,-51.5863,745029,0,434,744595
4/8/22,New Zealand,-27.0639,-51.5863,763718,0,434,763284
4/9/22,New Zealand,-27.0639,-51.5863,770473,0,434,770039
4/10/22,New Zealand,-27.0639,-51.5863,778106,0,516,777590
4/11/22,New Zealand,-27.0639,-51.5863,789514,0,516,788998
4/12/22,New Zealand,-27.0639,-51.5863,799197,0,516,798681
4/13/22,New Zealand,-27.0639,-51.5863,808935,0,533,808402
4/14/22,New Zealand,-27.0639,-51.5863,816865,0,516,816349
4/15/22,New Zealand,-27.0639,-51.5863,822677,0,516,822161
4/16/22,New Zealand,-27.0639,-51.5863,828815,0,516,828299
4/17/22,New Zealand,-27.0639,-51.5863,835097,0,585,834512
4/18/22,New Zealand,-27.0639,-51.5863,835097,0,585,834512
4/19/22,New Zealand,-27.0639,-51.5863,854955,0,585,854370
4/20/22,New Zealand,-27.0639,-51.5863,865529,0,585,864944
4/21/22,New Zealand,-27.0639,-51.5863,875089,0,585,874504
4/22/22,New Zealand,-27.0639,-51.5863,883192,0,585,882607
4/23/22,New Zealand,-27.0639,-51.5863,888906,0,585,888321
4/24/22,New Zealand,-27.0639,-51.5863,894774,0,636,894138
4/25/22,New Zealand,-27.0639,-51.5863,901230,0,637,900593
4/26/22,New Zealand,-27.0639,-51.5863,911259,0,637,910622
4/27/22,New Zealand,-27.0639,-51.5863,920462,0,637,919825
4/28/22,New Zealand,-27.0639,-51.5863,928845,0,637,928208
4/29/22,New Zealand,-27.0639,-51.5863,936008,0,637,935371
4/30/22,New Zealand,-27.0639,-51.5863,941736,0,637,941099
5/1/22,New Zealand,-27.0639,-51.5863,948506,0,698,947808
5/2/22,New Zealand,-27.0639,-51.5863,957822,0,698,957124
5/3/22,New Zealand,-27.0639,-51.5863,966471,0,698,965773
5/4/22,New Zealand,-27.0639,-51.5863,975197,0,698,974499
5/5/22,New Zealand,-27.0639,-51.5863,982635,0,698,981937
5/6/22,New Zealand,-27.0639,-51.5863,989494,0,698,988796
5/7/22,New Zealand,-27.0639,-51.5863,995222,0,698,994524
5/8/22,New Zealand,-27.0639,-51.5863,1001693,0,751,1000942
5/9/22,New Zealand,-27.0639,-51.5863,1010989,0,751,1010238
5/10/22,New Zealand,-27.0639,-51.5863,1019066,0,751,1018315
5/11/22,New Zealand,-27.0639,-51.5863,1028581,0,751,1027830
5/12/22,New Zealand,-27.0639,-51.5863,1036132,0,751,1035381
5/13/22,New Zealand,-27.0639,-51.5863,1043274,0,751,1042523
5/14/22,New Zealand,-27.0639,-51.5863,1049102,0,751,1048351
5/15/22,New Zealand,-27.0639,-51.5863,1056216,0,798,1055418
5/16/22,New Zealand,-27.0639,-51.5863,1066162,0,798,1065364
5/17/22,New Zealand,-27.0639,-51.5863,1075862,0,798,1075064
5/18/22,New Zealand,-27.0639,-51.5863,1085074,0,798,1084276
5/19/22,New Zealand,-27.0639,-51.5863,1092983,0,798,1092185
5/20/22,New Zealand,-27.0639,-51.5863,1099744,0,798,1098946
5/21/22,New Zealand,-27.0639,-51.5863,1104802,0,798,1104004
5/22/22,New Zealand,-27.0639,-51.5863,1110869,0,806,1110063
5/23/22,New Zealand,-27.0639,-51.5863,1119380,0,846,1118534
5/24/22,New Zealand,-27.0639,-51.5863,1127683,0,846,1126837
5/25/22,New Zealand,-27.0639,-51.5863,1135371,0,846,1134525
5/26/22,New Zealand,-27.0639,-51.5863,1142330,0,846,1141484
5/27/22,New Zealand,-27.0639,-51.5863,1148791,0,846,1147945
5/28/22,New Zealand,-27.0639,-51.5863,1153690,0,846,1152844
5/29/22,New Zealand,-27.0639,-51.5863,1159591,0,891,1158700
5/30/22,New Zealand,-27.0639,-51.5863,1168165,0,891,1167274
5/31/22,New Zealand,-27.0639,-51.5863,1176499,0,891,1175608
6/1/22,New Zealand,-27.0639,-51.5863,1184506,0,891,1183615
6/2/22,New Zealand,-27.0639,-51.5863,1190852,0,891,1189961
6/3/22,New Zealand,-27.0639,-51.5863,1197266,0,891,1196375
6/4/22,New Zealand,-27.0639,-51.5863,1201739,0,891,1200848
6/5/22,New Zealand,-27.0639,-51.5863,1201739,0,944,1200795
6/6/22,New Zealand,-27.0639,-51.5863,1212117,0,944,1211173
6/7/22,New Zealand,-27.0639,-51.5863,1219266,0,944,1218322
6/8/22,New Zealand,-27.0639,-51.5863,1227445,0,944,1226501
6/9/22,New Zealand,-27.0639,-51.5863,1233908,0,944,1232964
6/10/22,New Zealand,-27.0639,-51.5863,1239176,0,944,1238232
6/11/22,New Zealand,-27.0639,-51.5863,1243705,0,944,1242761
6/12/22,New Zealand,-27.0639,-51.5863,1248223,0,994,1247229
6/13/22,New Zealand,-27.0639,-51.5863,1254578,0,994,1253584
6/14/22,New Zealand,-27.0639,-51.5863,1260289,0,994,1259295
6/15/22,New Zealand,-27.0639,-51.5863,1266177,0,994,1265183
6/16/22,New Zealand,-27.0639,-51.5863,1271191,0,994,1270197
6/17/22,New Zealand,-27.0639,-51.5863,1275775,0,994,1274781
6/18/22,New Zealand,-27.0639,-51.5863,1279126,0,994,1278132
6/19/22,New Zealand,-27.0639,-51.5863,1283305,0,1047,1282258
6/20/22,New Zealand,-27.0639,-51.5863,1289212,0,1047,1288165
6/21/22,New Zealand,-27.0639,-51.5863,1294900,0,1047,1293853
6/22/22,New Zealand,-27.0639,-51.5863,1300431,0,1047,1299384
6/23/22,New Zealand,-27.0639,-51.5863,1300435,0,1047,1299388
6/24/22,New Zealand,-27.0639,-51.5863,1309557,0,1047,1308510
6/25/22,New Zealand,-27.0639,-51.5863,1314165,0,1047,1313118
6/26/22,New Zealand,-27.0639,-51.5863,1319923,0,1107,1318816
6/27/22,New Zealand,-27.0639,-51.5863,1328254,0,1107,1327147
6/28/22,New Zealand,-27.0639,-51.5863,1336322,0,1107,1335215
6/29/22,New Zealand,-27.0639,-51.5863,1344290,0,1107,1343183
6/30/22,New Zealand,-27.0639,-51.5863,1351585,0,1107,1350478
7/1/22,New Zealand,-27.0639,-51.5863,1358477,0,1107,1357370
7/2/22,New Zealand,-27.0639,-51.5863,1363651,0,1107,1362544
7/3/22,New Zealand,-27.0639,-51.5863,1370527,0,1181,1369346
7/4/22,New Zealand,-27.0639,-51.5863,1380329,0,1181,1379148
7/5/22,New Zealand,-27.0639,-51.5863,1380345,0,1181,1379164
7/6/22,New Zealand,-27.0639,-51.5863,1408886,0,1181,1407705
7/7/22,New Zealand,-27.0639,-51.5863,1418459,0,1181,1417278
7/8/22,New Zealand,-27.0639,-51.5863,1427995,0,1181,1426814
7/9/22,New Zealand,-27.0639,-51.5863,1435741,0,1181,1434560
7/10/22,New Zealand,-27.0639,-51.5863,1444417,0,1305,1443112
7/11/22,New Zealand,-27.0639,-51.5863,1456269,0,1305,1454964
7/12/22,New Zealand,-27.0639,-51.5863,1468096,0,1305,1466791
7/13/22,New Zealand,-27.0639,-51.5863,1479795,0,1305,1478490
7/14/22,New Zealand,-27.0639,-51.5863,1490599,0,1305,1489294
7/15/22,New Zealand,-27.0639,-51.5863,1500129,0,1305,1498824
7/16/22,New Zealand,-27.0639,-51.5863,1506614,0,1305,1505309
7/17/22,New Zealand,-27.0639,-51.5863,1514588,0,1411,1513177
7/18/22,New Zealand,-27.0639,-51.5863,1525350,0,1411,1523939
7/19/22,New Zealand,-27.0639,-51.5863,1536046,0,1411,1534635
7/20/22,New Zealand,-27.0639,-51.5863,1546382,0,1411,1544971
7/21/22,New Zealand,-27.0639,-51.5863,1555462,0,1411,1554051
7/22/22,New Zealand,-27.0639,-51.5863,1563537,0,1411,1562126
7/23/22,New Zealand,-27.0639,-51.5863,1569386,0,1411,1567975
7/24/22,New Zealand,-27.0639,-51.5863,1576678,0,1456,1575222
7/25/22,New Zealand,-27.0639,-51.5863,1576678,0,1456,1575222
7/26/22,New Zealand,-27.0639,-51.5863,1576723,0,1456,1575267
7/27/22,New Zealand,-27.0639,-51.5863,1576811,0,1456,1575355
7/28/22,New Zealand,-27.0639,-51.5863,1611478,0,1480,1609998
7/29/22,New Zealand,-27.0639,-51.5863,1617974,0,1503,1616471
7/30/22,New Zealand,-27.0639,-51.5863,1622430,0,1503,1620927
7/31/22,New Zealand,-27.0639,-51.5863,1628005,0,1503,1626502
8/1/22,New Zealand,-27.0639,-51.5863,1635426,0,1564,1633862
8/2/22,New Zealand,-27.0639,-51.5863,1642152,0,1590,1640562
8/3/22,New Zealand,-27.0639,-51.5863,1648511,0,1604,1646907
8/4/22,New Zealand,-27.0639,-51.5863,1654004,0,1625,1652379
8/5/22,New Zealand,-27.0639,-51.5863,1658896,0,1639,1657257
8/6/22,New Zealand,-27.0639,-51.5863,1662414,0,1639,1660775
8/7/22,New Zealand,-27.0639,-51.5863,1666589,0,1639,1664950
8/8/22,New Zealand,-27.0639,-51.5863,1672726,0,1689,1671037
8/9/22,New Zealand,-27.0639,-51.5863,1678115,0,1706,1676409
8/10/22,New Zealand,-27.0639,-51.5863,1683131,0,1727,1681404
8/11/22,New Zealand,-27.0639,-51.5863,1687478,0,1734,1685744
8/12/22,New Zealand,-27.0639,-51.5863,1691215,0,1751,1689464
8/13/22,New Zealand,-27.0639,-51.5863,1693974,0,1751,1692223
8/14/22,New Zealand,-27.0639,-51.5863,1697530,0,1751,1695779
8/15/22,New Zealand,-27.0639,-51.5863,1702539,0,1783,1700756
8/16/22,New Zealand,-27.0639,-51.5863,1707225,0,1795,1705430
8/17/22,New Zealand,-27.0639,-51.5863,1711922,0,1808,1710114
8/18/22,New Zealand,-27.0639,-51.5863,1715866,0,1816,1714050
8/19/22,New Zealand,-27.0639,-51.5863,1719282,0,1825,1717457
8/20/22,New Zealand,-27.0639,-51.5863,1721490,0,1825,1719665
8/21/22,New Zealand,-27.0639,-51.5863,1724334,0,1825,1722509
8/22/22,New Zealand,-27.0639,-51.5863,1728161,0,1842,1726319
8/23/22,New Zealand,-27.0639,-51.5863,1731435,0,1846,1729589
8/24/22,New Zealand,-27.0639,-51.5863,1734343,0,1846,1732497
8/25/22,New Zealand,-27.0639,-51.5863,1736819,0,1866,1734953
8/26/22,New Zealand,-27.0639,-51.5863,1739090,0,1870,1737220
8/27/22,New Zealand,-27.0639,-51.5863,1740482,0,1870,1738612
8/28/22,New Zealand,-27.0639,-51.5863,1742227,0,1870,1740357
8/29/22,New Zealand,-27.0639,-51.5863,1744825,0,1885,1742940
8/30/22,New Zealand,-27.0639,-51.5863,1747175,0,1894,1745281
8/31/22,New Zealand,-27.0639,-51.5863,1749378,0,1909,1747469
9/1/22,New Zealand,-27.0639,-51.5863,1751273,0,1911,1749362
9/2/22,New Zealand,-27.0639,-51.5863,1753084,0,1916,1751168
9/3/22,New Zealand,-27.0639,-51.5863,1754185,0,1916,1752269
9/4/22,New Zealand,-27.0639,-51.5863,1755585,0,1916,1753669
9/5/22,New Zealand,-27.0639,-51.5863,1757730,0,1934,1755796
9/6/22,New Zealand,-27.0639,-51.5863,1759635,0,1940,1757695
9/7/22,New Zealand,-27.0639,-51.5863,1761359,0,1942,1759417
9/8/22,New Zealand,-27.0639,-51.5863,1762898,0,1945,1760953
9/9/22,New Zealand,-27.0639,-51.5863,1764375,0,1951,1762424
9/10/22,New Zealand,-27.0639,-51.5863,1765347,0,1951,1763396
9/11/22,New Zealand,-27.0639,-51.5863,1766576,0,1951,1764625
9/12/22,New Zealand,-27.0639,-51.5863,1768588,0,1963,1766625
9/13/22,New Zealand,-27.0639,-51.5863,1768590,0,1963,1766627
9/14/22,New Zealand,-27.0639,-51.5863,1768592,0,1963,1766629
9/15/22,New Zealand,-27.0639,-51.5863,1768592,0,1963,1766629
9/16/22,New Zealand,-27.0639,-51.5863,1768593,0,1963,1766630
9/17/22,New Zealand,-27.0639,-51.5863,1768593,0,1963,1766630
9/18/22,New Zealand,-27.0639,-51.5863,1768593,0,1963,1766630
9/19/22,New Zealand,-27.0639,-51.5863,1776162,0,1973,1774189
9/20/22,New Zealand,-27.0639,-51.5863,1776163,0,1973,1774190
9/21/22,New Zealand,-27.0639,-51.5863,1776163,0,1973,1774190
9/22/22,New Zealand,-27.0639,-51.5863,1776163,0,1973,1774190
9/23/22,New Zealand,-27.0639,-51.5863,1776163,0,1973,1774190
9/24/22,New Zealand,-27.0639,-51.5863,1776163,0,1973,1774190
9/25/22,New Zealand,-27.0639,-51.5863,1776163,0,1973,1774190
9/26/22,New Zealand,-27.0639,-51.5863,1785945,0,2031,1783914
9/27/22,New Zealand,-27.0639,-51.5863,1785945,0,2031,1783914
9/28/22,New Zealand,-27.0639,-51.5863,1785945,0,2031,1783914
9/29/22,New Zealand,-27.0639,-51.5863,1785945,0,2031,1783914
9/30/22,New Zealand,-27.0639,-51.5863,1785945,0,2031,1783914
10/1/22,New Zealand,-27.0639,-51.5863,1785945,0,2031,1783914
10/2/22,New Zealand,-27.0639,-51.5863,1795894,0,2039,1793855
10/3/22,New Zealand,-27.0639,-51.5863,1795894,0,2039,1793855
10/4/22,New Zealand,-27.0639,-51.5863,1795894,0,2039,1793855
10/5/22,New Zealand,-27.0639,-51.5863,1795894,0,2039,1793855
10/6/22,New Zealand,-27.0639,-51.5863,1795895,0,2039,1793856
10/7/22,New Zealand,-27.0639,-51.5863,1795895,0,2039,1793856
10/8/22,New Zealand,-27.0639,-51.5863,1795895,0,2039,1793856
10/9/22,New Zealand,-27.0639,-51.5863,1807072,0,2056,1805016
10/10/22,New Zealand,-27.0639,-51.5863,1807072,0,2056,1805016
10/11/22,New Zealand,-27.0639,-51.5863,1807072,0,2056,1805016
10/12/22,New Zealand,-27.0639,-51.5863,1807074,0,2056,1805018
10/13/22,New Zealand,-27.0639,-51.5863,1807074,0,2056,1805018
10/14/22,New Zealand,-27.0639,-51.5863,1807074,0,2056,1805018
10/15/22,New Zealand,-27.0639,-51.5863,1807074,0,2056,1805018
10/16/22,New Zealand,-27.0639,-51.5863,1821362,0,2066,1819296
10/17/22,New Zealand,-27.0639,-51.5863,1821362,0,2066,1819296
10/18/22,New Zealand,-27.0639,-51.5863,1821362,0,2066,1819296
10/19/22,New Zealand,-27.0639,-51.5863,1821362,0,2066,1819296
10/20/22,New Zealand,-27.0639,-51.5863,1821363,0,2066,1819297
10/21/22,New Zealand,-27.0639,-51.5863,1821363,0,2066,1819297
10/22/22,New Zealand,-27.0639,-51.5863,1821363,0,2066,1819297
10/23/22,New Zealand,-27.0639,-51.5863,1821363,0,2066,1819297
10/24/22,New Zealand,-27.0639,-51.5863,1837707,0,2096,1835611
10/25/22,New Zealand,-27.0639,-51.5863,1837707,0,2096,1835611
10/26/22,New Zealand,-27.0639,-51.5863,1837707,0,2096,1835611
10/27/22,New Zealand,-27.0639,-51.5863,1837707,0,2096,1835611
10/28/22,New Zealand,-27.0639,-51.5863,1837707,0,2096,1835611
10/29/22,New Zealand,-27.0639,-51.5863,1837707,0,2096,1835611
10/30/22,New Zealand,-27.0639,-51.5863,1858163,0,2107,1856056
10/31/22,New Zealand,-27.0639,-51.5863,1858163,0,2107,1856056
11/1/22,New Zealand,-27.0639,-51.5863,1858163,0,2107,1856056
11/2/22,New Zealand,-27.0639,-51.5863,1858163,0,2107,1856056
11/3/22,New Zealand,-27.0639,-51.5863,1858163,0,2107,1856056
11/4/22,New Zealand,-27.0639,-51.5863,1858163,0,2107,1856056
11/5/22,New Zealand,-27.0639,-51.5863,1858163,0,2107,1856056
11/6/22,New Zealand,-27.0639,-51.5863,1878933,0,2120,1876813
11/7/22,New Zealand,-27.0639,-51.5863,1878933,0,2120,1876813
11/8/22,New Zealand,-27.0639,-51.5863,1878933,0,2120,1876813
11/9/22,New Zealand,-27.0639,-51.5863,1878933,0,2120,1876813
11/10/22,New Zealand,-27.0639,-51.5863,1878933,0,2120,1876813
11/11/22,New Zealand,-27.0639,-51.5863,1878933,0,2120,1876813
11/12/22,New Zealand,-27.0639,-51.5863,1878933,0,2120,1876813
11/13/22,New Zealand,-27.0639,-51.5863,1900505,0,2155,1898350
11/14/22,New Zealand,-27.0639,-51.5863,1900505,0,2155,1898350
11/15/22,New Zealand,-27.0639,-51.5863,1900505,0,2155,1898350
11/16/22,New Zealand,-27.0639,-51.5863,1900510,0,2155,1898355
11/17/22,New Zealand,-27.0639,-51.5863,1900511,0,2155,1898356
11/18/22,New Zealand,-27.0639,-51.5863,1900515,0,2155,1898360
11/19/22,New Zealand,-27.0639,-51.5863,1900516,0,2155,1898361
11/20/22,New Zealand,-27.0639,-51.5863,1924559,0,2183,1922376
11/21/22,New Zealand,-27.0639,-51.5863,1924559,0,2183,1922376
11/22/22,New Zealand,-27.0639,-51.5863,1924561,0,2183,1922378
11/23/22,New Zealand,-27.0639,-51.5863,1924563,0,2183,1922380
11/24/22,New Zealand,-27.0639,-51.5863,1924563,0,2183,1922380
11/25/22,New Zealand,-27.0639,-51.5863,1924567,0,2183,1922384
11/26/22,New Zealand,-27.0639,-51.5863,1924567,0,2183,1922384
11/27/22,New Zealand,-27.0639,-51.5863,1951614,0,2213,1949401
11/28/22,New Zealand,-27.0639,-51.5863,1951623,0,2213,1949410
11/29/22,New Zealand,-27.0639,-51.5863,1951630,0,2213,1949417
11/30/22,New Zealand,-27.0639,-51.5863,1951642,0,2213,1949429
12/1/22,New Zealand,-27.0639,-51.5863,1951653,0,2213,1949440
12/2/22,New Zealand,-27.0639,-51.5863,1951662,0,2213,1949449
12/3/22,New Zealand,-27.0639,-51.5863,1951670,0,2213,1949457
12/4/22,New Zealand,-27.0639,-51.5863,1986172,0,2236,1983936
12/5/22,New Zealand,-27.0639,-51.5863,1986175,0,2236,1983939
12/6/22,New Zealand,-27.0639,-51.5863,1986183,0,2236,1983947
12/7/22,New Zealand,-27.0639,-51.5863,1986183,0,2236,1983947
12/8/22,New Zealand,-27.0639,-51.5863,1986190,0,2236,1983954
12/9/22,New Zealand,-27.0639,-51.5863,1986192,0,2236,1983956
12/10/22,New Zealand,-27.0639,-51.5863,1986194,0,2236,1983958
12/11/22,New Zealand,-27.0639,-51.5863,2026265,0,2258,2024007
12/12/22,New Zealand,-27.0639,-51.5863,2026272,0,2258,2024014
12/13/22,New Zealand,-27.0639,-51.5863,2026277,0,2258,2024019
12/14/22,New Zealand,-27.0639,-51.5863,2026283,0,2258,2024025
12/15/22,New Zealand,-27.0639,-51.5863,2026286,0,2258,2024028
12/16/22,New Zealand,-27.0639,-51.5863,2026290,0,2258,2024032
12/17/22,New Zealand,-27.0639,-51.5863,2026300,0,2258,2024042
1/1/22,Nicaragua,12.865416,-85.207229,13563,0,217,13346
1/2/22,Nicaragua,12.865416,-85.207229,13563,0,217,13346
1/3/22,Nicaragua,12.865416,-85.207229,13563,0,217,13346
1/4/22,Nicaragua,12.865416,-85.207229,13563,0,217,13346
1/5/22,Nicaragua,12.865416,-85.207229,13589,0,218,13371
1/6/22,Nicaragua,12.865416,-85.207229,13589,0,218,13371
1/7/22,Nicaragua,12.865416,-85.207229,13589,0,218,13371
1/8/22,Nicaragua,12.865416,-85.207229,13589,0,218,13371
1/9/22,Nicaragua,12.865416,-85.207229,13589,0,218,13371
1/10/22,Nicaragua,12.865416,-85.207229,13589,0,218,13371
1/11/22,Nicaragua,12.865416,-85.207229,13589,0,218,13371
1/12/22,Nicaragua,12.865416,-85.207229,13589,0,218,13371
1/13/22,Nicaragua,12.865416,-85.207229,13589,0,218,13371
1/14/22,Nicaragua,12.865416,-85.207229,13589,0,218,13371
1/15/22,Nicaragua,12.865416,-85.207229,13589,0,218,13371
1/16/22,Nicaragua,12.865416,-85.207229,13589,0,218,13371
1/17/22,Nicaragua,12.865416,-85.207229,13589,0,218,13371
1/18/22,Nicaragua,12.865416,-85.207229,13589,0,218,13371
1/19/22,Nicaragua,12.865416,-85.207229,13646,0,219,13427
1/20/22,Nicaragua,12.865416,-85.207229,13646,0,219,13427
1/21/22,Nicaragua,12.865416,-85.207229,13646,0,219,13427
1/22/22,Nicaragua,12.865416,-85.207229,13646,0,219,13427
1/23/22,Nicaragua,12.865416,-85.207229,13646,0,219,13427
1/24/22,Nicaragua,12.865416,-85.207229,13646,0,219,13427
1/25/22,Nicaragua,12.865416,-85.207229,13646,0,219,13427
1/26/22,Nicaragua,12.865416,-85.207229,13681,0,220,13461
1/27/22,Nicaragua,12.865416,-85.207229,13681,0,220,13461
1/28/22,Nicaragua,12.865416,-85.207229,13681,0,220,13461
1/29/22,Nicaragua,12.865416,-85.207229,13681,0,220,13461
1/30/22,Nicaragua,12.865416,-85.207229,13681,0,220,13461
1/31/22,Nicaragua,12.865416,-85.207229,13681,0,220,13461
2/1/22,Nicaragua,12.865416,-85.207229,13681,0,220,13461
2/2/22,Nicaragua,12.865416,-85.207229,13727,0,221,13506
2/3/22,Nicaragua,12.865416,-85.207229,13727,0,221,13506
2/4/22,Nicaragua,12.865416,-85.207229,13727,0,221,13506
2/5/22,Nicaragua,12.865416,-85.207229,13727,0,221,13506
2/6/22,Nicaragua,12.865416,-85.207229,13727,0,221,13506
2/7/22,Nicaragua,12.865416,-85.207229,13727,0,221,13506
2/8/22,Nicaragua,12.865416,-85.207229,13727,0,221,13506
2/9/22,Nicaragua,12.865416,-85.207229,13792,0,222,13570
2/10/22,Nicaragua,12.865416,-85.207229,13792,0,222,13570
2/11/22,Nicaragua,12.865416,-85.207229,13792,0,222,13570
2/12/22,Nicaragua,12.865416,-85.207229,13792,0,222,13570
2/13/22,Nicaragua,12.865416,-85.207229,13792,0,222,13570
2/14/22,Nicaragua,12.865416,-85.207229,13792,0,222,13570
2/15/22,Nicaragua,12.865416,-85.207229,13792,0,222,13570
2/16/22,Nicaragua,12.865416,-85.207229,13877,0,223,13654
2/17/22,Nicaragua,12.865416,-85.207229,13877,0,223,13654
2/18/22,Nicaragua,12.865416,-85.207229,13877,0,223,13654
2/19/22,Nicaragua,12.865416,-85.207229,13877,0,223,13654
2/20/22,Nicaragua,12.865416,-85.207229,13877,0,223,13654
2/21/22,Nicaragua,12.865416,-85.207229,13877,0,223,13654
2/22/22,Nicaragua,12.865416,-85.207229,13877,0,223,13654
2/23/22,Nicaragua,12.865416,-85.207229,13958,0,224,13734
2/24/22,Nicaragua,12.865416,-85.207229,13958,0,224,13734
2/25/22,Nicaragua,12.865416,-85.207229,13958,0,224,13734
2/26/22,Nicaragua,12.865416,-85.207229,13958,0,224,13734
2/27/22,Nicaragua,12.865416,-85.207229,13958,0,224,13734
2/28/22,Nicaragua,12.865416,-85.207229,13958,0,224,13734
3/1/22,Nicaragua,12.865416,-85.207229,13958,0,224,13734
3/2/22,Nicaragua,12.865416,-85.207229,14035,0,225,13810
3/3/22,Nicaragua,12.865416,-85.207229,14035,0,225,13810
3/4/22,Nicaragua,12.865416,-85.207229,14035,0,225,13810
3/5/22,Nicaragua,12.865416,-85.207229,14035,0,225,13810
3/6/22,Nicaragua,12.865416,-85.207229,14035,0,225,13810
3/7/22,Nicaragua,12.865416,-85.207229,14035,0,225,13810
3/8/22,Nicaragua,12.865416,-85.207229,14035,0,225,13810
3/9/22,Nicaragua,12.865416,-85.207229,14108,0,226,13882
3/10/22,Nicaragua,12.865416,-85.207229,14108,0,226,13882
3/11/22,Nicaragua,12.865416,-85.207229,14108,0,226,13882
3/12/22,Nicaragua,12.865416,-85.207229,14108,0,226,13882
3/13/22,Nicaragua,12.865416,-85.207229,14108,0,226,13882
3/14/22,Nicaragua,12.865416,-85.207229,14108,0,226,13882
3/15/22,Nicaragua,12.865416,-85.207229,14108,0,226,13882
3/16/22,Nicaragua,12.865416,-85.207229,14170,0,228,13942
3/17/22,Nicaragua,12.865416,-85.207229,14170,0,228,13942
3/18/22,Nicaragua,12.865416,-85.207229,14170,0,228,13942
3/19/22,Nicaragua,12.865416,-85.207229,14170,0,228,13942
3/20/22,Nicaragua,12.865416,-85.207229,14170,0,228,13942
3/21/22,Nicaragua,12.865416,-85.207229,14170,0,228,13942
3/22/22,Nicaragua,12.865416,-85.207229,14170,0,228,13942
3/23/22,Nicaragua,12.865416,-85.207229,14222,0,229,13993
3/24/22,Nicaragua,12.865416,-85.207229,14222,0,229,13993
3/25/22,Nicaragua,12.865416,-85.207229,14222,0,229,13993
3/26/22,Nicaragua,12.865416,-85.207229,14222,0,229,13993
3/27/22,Nicaragua,12.865416,-85.207229,14222,0,229,13993
3/28/22,Nicaragua,12.865416,-85.207229,14222,0,229,13993
3/29/22,Nicaragua,12.865416,-85.207229,14222,0,229,13993
3/30/22,Nicaragua,12.865416,-85.207229,14269,0,230,14039
3/31/22,Nicaragua,12.865416,-85.207229,14269,0,230,14039
4/1/22,Nicaragua,12.865416,-85.207229,14269,0,230,14039
4/2/22,Nicaragua,12.865416,-85.207229,14269,0,230,14039
4/3/22,Nicaragua,12.865416,-85.207229,14269,0,230,14039
4/4/22,Nicaragua,12.865416,-85.207229,14269,0,230,14039
4/5/22,Nicaragua,12.865416,-85.207229,14269,0,230,14039
4/6/22,Nicaragua,12.865416,-85.207229,14306,0,231,14075
4/7/22,Nicaragua,12.865416,-85.207229,14306,0,231,14075
4/8/22,Nicaragua,12.865416,-85.207229,14306,0,231,14075
4/9/22,Nicaragua,12.865416,-85.207229,14306,0,231,14075
4/10/22,Nicaragua,12.865416,-85.207229,14306,0,231,14075
4/11/22,Nicaragua,12.865416,-85.207229,14306,0,231,14075
4/12/22,Nicaragua,12.865416,-85.207229,14306,0,231,14075
4/13/22,Nicaragua,12.865416,-85.207229,14339,0,232,14107
4/14/22,Nicaragua,12.865416,-85.207229,14339,0,232,14107
4/15/22,Nicaragua,12.865416,-85.207229,14339,0,232,14107
4/16/22,Nicaragua,12.865416,-85.207229,14339,0,232,14107
4/17/22,Nicaragua,12.865416,-85.207229,14339,0,232,14107
4/18/22,Nicaragua,12.865416,-85.207229,14339,0,232,14107
4/19/22,Nicaragua,12.865416,-85.207229,14339,0,232,14107
4/20/22,Nicaragua,12.865416,-85.207229,14371,0,233,14138
4/21/22,Nicaragua,12.865416,-85.207229,14371,0,233,14138
4/22/22,Nicaragua,12.865416,-85.207229,14371,0,233,14138
4/23/22,Nicaragua,12.865416,-85.207229,14371,0,233,14138
4/24/22,Nicaragua,12.865416,-85.207229,14371,0,233,14138
4/25/22,Nicaragua,12.865416,-85.207229,14371,0,233,14138
4/26/22,Nicaragua,12.865416,-85.207229,14371,0,233,14138
4/27/22,Nicaragua,12.865416,-85.207229,14395,0,234,14161
4/28/22,Nicaragua,12.865416,-85.207229,14395,0,234,14161
4/29/22,Nicaragua,12.865416,-85.207229,14395,0,234,14161
4/30/22,Nicaragua,12.865416,-85.207229,14395,0,234,14161
5/1/22,Nicaragua,12.865416,-85.207229,14395,0,234,14161
5/2/22,Nicaragua,12.865416,-85.207229,14395,0,234,14161
5/3/22,Nicaragua,12.865416,-85.207229,14395,0,234,14161
5/4/22,Nicaragua,12.865416,-85.207229,14422,0,235,14187
5/5/22,Nicaragua,12.865416,-85.207229,14422,0,235,14187
5/6/22,Nicaragua,12.865416,-85.207229,14422,0,235,14187
5/7/22,Nicaragua,12.865416,-85.207229,14422,0,235,14187
5/8/22,Nicaragua,12.865416,-85.207229,14422,0,235,14187
5/9/22,Nicaragua,12.865416,-85.207229,14422,0,235,14187
5/10/22,Nicaragua,12.865416,-85.207229,14422,0,235,14187
5/11/22,Nicaragua,12.865416,-85.207229,14447,0,236,14211
5/12/22,Nicaragua,12.865416,-85.207229,14447,0,236,14211
5/13/22,Nicaragua,12.865416,-85.207229,14447,0,236,14211
5/14/22,Nicaragua,12.865416,-85.207229,14447,0,236,14211
5/15/22,Nicaragua,12.865416,-85.207229,14447,0,236,14211
5/16/22,Nicaragua,12.865416,-85.207229,14447,0,236,14211
5/17/22,Nicaragua,12.865416,-85.207229,14447,0,236,14211
5/18/22,Nicaragua,12.865416,-85.207229,14473,0,237,14236
5/19/22,Nicaragua,12.865416,-85.207229,14473,0,237,14236
5/20/22,Nicaragua,12.865416,-85.207229,14473,0,237,14236
5/21/22,Nicaragua,12.865416,-85.207229,14473,0,237,14236
5/22/22,Nicaragua,12.865416,-85.207229,14473,0,236,14237
5/23/22,Nicaragua,12.865416,-85.207229,14473,0,237,14236
5/24/22,Nicaragua,12.865416,-85.207229,14473,0,237,14236
5/25/22,Nicaragua,12.865416,-85.207229,14508,0,238,14270
5/26/22,Nicaragua,12.865416,-85.207229,14508,0,238,14270
5/27/22,Nicaragua,12.865416,-85.207229,14508,0,238,14270
5/28/22,Nicaragua,12.865416,-85.207229,14508,0,238,14270
5/29/22,Nicaragua,12.865416,-85.207229,14508,0,238,14270
5/30/22,Nicaragua,12.865416,-85.207229,14508,0,238,14270
5/31/22,Nicaragua,12.865416,-85.207229,14508,0,238,14270
6/1/22,Nicaragua,12.865416,-85.207229,14538,0,239,14299
6/2/22,Nicaragua,12.865416,-85.207229,14538,0,239,14299
6/3/22,Nicaragua,12.865416,-85.207229,14538,0,239,14299
6/4/22,Nicaragua,12.865416,-85.207229,14538,0,239,14299
6/5/22,Nicaragua,12.865416,-85.207229,14538,0,239,14299
6/6/22,Nicaragua,12.865416,-85.207229,14538,0,239,14299
6/7/22,Nicaragua,12.865416,-85.207229,14538,0,239,14299
6/8/22,Nicaragua,12.865416,-85.207229,14577,0,240,14337
6/9/22,Nicaragua,12.865416,-85.207229,14577,0,240,14337
6/10/22,Nicaragua,12.865416,-85.207229,14577,0,240,14337
6/11/22,Nicaragua,12.865416,-85.207229,14577,0,240,14337
6/12/22,Nicaragua,12.865416,-85.207229,14577,0,240,14337
6/13/22,Nicaragua,12.865416,-85.207229,14577,0,240,14337
6/14/22,Nicaragua,12.865416,-85.207229,14577,0,240,14337
6/15/22,Nicaragua,12.865416,-85.207229,14619,0,241,14378
6/16/22,Nicaragua,12.865416,-85.207229,14619,0,241,14378
6/17/22,Nicaragua,12.865416,-85.207229,14619,0,241,14378
6/18/22,Nicaragua,12.865416,-85.207229,14619,0,241,14378
6/19/22,Nicaragua,12.865416,-85.207229,14619,0,241,14378
6/20/22,Nicaragua,12.865416,-85.207229,14619,0,241,14378
6/21/22,Nicaragua,12.865416,-85.207229,14619,0,241,14378
6/22/22,Nicaragua,12.865416,-85.207229,14619,0,241,14378
6/23/22,Nicaragua,12.865416,-85.207229,14619,0,241,14378
6/24/22,Nicaragua,12.865416,-85.207229,14619,0,241,14378
6/25/22,Nicaragua,12.865416,-85.207229,14619,0,241,14378
6/26/22,Nicaragua,12.865416,-85.207229,14619,0,241,14378
6/27/22,Nicaragua,12.865416,-85.207229,14619,0,241,14378
6/28/22,Nicaragua,12.865416,-85.207229,14619,0,241,14378
6/29/22,Nicaragua,12.865416,-85.207229,14690,0,242,14448
6/30/22,Nicaragua,12.865416,-85.207229,14690,0,242,14448
7/1/22,Nicaragua,12.865416,-85.207229,14690,0,242,14448
7/2/22,Nicaragua,12.865416,-85.207229,14690,0,242,14448
7/3/22,Nicaragua,12.865416,-85.207229,14690,0,242,14448
7/4/22,Nicaragua,12.865416,-85.207229,14690,0,242,14448
7/5/22,Nicaragua,12.865416,-85.207229,14690,0,242,14448
7/6/22,Nicaragua,12.865416,-85.207229,14721,0,243,14478
7/7/22,Nicaragua,12.865416,-85.207229,14721,0,243,14478
7/8/22,Nicaragua,12.865416,-85.207229,14721,0,243,14478
7/9/22,Nicaragua,12.865416,-85.207229,14721,0,243,14478
7/10/22,Nicaragua,12.865416,-85.207229,14721,0,243,14478
7/11/22,Nicaragua,12.865416,-85.207229,14721,0,243,14478
7/12/22,Nicaragua,12.865416,-85.207229,14721,0,243,14478
7/13/22,Nicaragua,12.865416,-85.207229,14751,0,244,14507
7/14/22,Nicaragua,12.865416,-85.207229,14751,0,244,14507
7/15/22,Nicaragua,12.865416,-85.207229,14751,0,244,14507
7/16/22,Nicaragua,12.865416,-85.207229,14751,0,244,14507
7/17/22,Nicaragua,12.865416,-85.207229,14751,0,244,14507
7/18/22,Nicaragua,12.865416,-85.207229,14751,0,244,14507
7/19/22,Nicaragua,12.865416,-85.207229,14751,0,244,14507
7/20/22,Nicaragua,12.865416,-85.207229,14777,0,244,14533
7/21/22,Nicaragua,12.865416,-85.207229,14777,0,244,14533
7/22/22,Nicaragua,12.865416,-85.207229,14777,0,244,14533
7/23/22,Nicaragua,12.865416,-85.207229,14777,0,244,14533
7/24/22,Nicaragua,12.865416,-85.207229,14777,0,244,14533
7/25/22,Nicaragua,12.865416,-85.207229,14777,0,244,14533
7/26/22,Nicaragua,12.865416,-85.207229,14777,0,244,14533
7/27/22,Nicaragua,12.865416,-85.207229,14807,0,244,14563
7/28/22,Nicaragua,12.865416,-85.207229,14807,0,244,14563
7/29/22,Nicaragua,12.865416,-85.207229,14807,0,244,14563
7/30/22,Nicaragua,12.865416,-85.207229,14807,0,244,14563
7/31/22,Nicaragua,12.865416,-85.207229,14807,0,244,14563
8/1/22,Nicaragua,12.865416,-85.207229,14807,0,244,14563
8/2/22,Nicaragua,12.865416,-85.207229,14807,0,244,14563
8/3/22,Nicaragua,12.865416,-85.207229,14807,0,244,14563
8/4/22,Nicaragua,12.865416,-85.207229,14807,0,244,14563
8/5/22,Nicaragua,12.865416,-85.207229,14807,0,244,14563
8/6/22,Nicaragua,12.865416,-85.207229,14807,0,244,14563
8/7/22,Nicaragua,12.865416,-85.207229,14807,0,244,14563
8/8/22,Nicaragua,12.865416,-85.207229,14807,0,244,14563
8/9/22,Nicaragua,12.865416,-85.207229,14807,0,244,14563
8/10/22,Nicaragua,12.865416,-85.207229,14872,0,244,14628
8/11/22,Nicaragua,12.865416,-85.207229,14872,0,244,14628
8/12/22,Nicaragua,12.865416,-85.207229,14872,0,244,14628
8/13/22,Nicaragua,12.865416,-85.207229,14872,0,244,14628
8/14/22,Nicaragua,12.865416,-85.207229,14872,0,244,14628
8/15/22,Nicaragua,12.865416,-85.207229,14872,0,244,14628
8/16/22,Nicaragua,12.865416,-85.207229,14872,0,244,14628
8/17/22,Nicaragua,12.865416,-85.207229,14899,0,244,14655
8/18/22,Nicaragua,12.865416,-85.207229,14899,0,244,14655
8/19/22,Nicaragua,12.865416,-85.207229,14899,0,244,14655
8/20/22,Nicaragua,12.865416,-85.207229,14899,0,244,14655
8/21/22,Nicaragua,12.865416,-85.207229,14899,0,244,14655
8/22/22,Nicaragua,12.865416,-85.207229,14899,0,244,14655
8/23/22,Nicaragua,12.865416,-85.207229,14899,0,244,14655
8/24/22,Nicaragua,12.865416,-85.207229,14931,0,244,14687
8/25/22,Nicaragua,12.865416,-85.207229,14931,0,244,14687
8/26/22,Nicaragua,12.865416,-85.207229,14931,0,244,14687
8/27/22,Nicaragua,12.865416,-85.207229,14931,0,244,14687
8/28/22,Nicaragua,12.865416,-85.207229,14931,0,244,14687
8/29/22,Nicaragua,12.865416,-85.207229,14931,0,244,14687
8/30/22,Nicaragua,12.865416,-85.207229,14931,0,244,14687
8/31/22,Nicaragua,12.865416,-85.207229,14931,0,244,14687
9/1/22,Nicaragua,12.865416,-85.207229,14931,0,244,14687
9/2/22,Nicaragua,12.865416,-85.207229,14931,0,244,14687
9/3/22,Nicaragua,12.865416,-85.207229,14931,0,244,14687
9/4/22,Nicaragua,12.865416,-85.207229,14931,0,244,14687
9/5/22,Nicaragua,12.865416,-85.207229,14931,0,244,14687
9/6/22,Nicaragua,12.865416,-85.207229,14931,0,244,14687
9/7/22,Nicaragua,12.865416,-85.207229,14931,0,244,14687
9/8/22,Nicaragua,12.865416,-85.207229,14931,0,244,14687
9/9/22,Nicaragua,12.865416,-85.207229,14931,0,244,14687
9/10/22,Nicaragua,12.865416,-85.207229,14931,0,244,14687
9/11/22,Nicaragua,12.865416,-85.207229,14931,0,244,14687
9/12/22,Nicaragua,12.865416,-85.207229,14990,0,244,14746
9/13/22,Nicaragua,12.865416,-85.207229,14990,0,244,14746
9/14/22,Nicaragua,12.865416,-85.207229,14990,0,244,14746
9/15/22,Nicaragua,12.865416,-85.207229,14990,0,244,14746
9/16/22,Nicaragua,12.865416,-85.207229,14990,0,244,14746
9/17/22,Nicaragua,12.865416,-85.207229,14990,0,244,14746
9/18/22,Nicaragua,12.865416,-85.207229,14990,0,244,14746
9/19/22,Nicaragua,12.865416,-85.207229,14990,0,244,14746
9/20/22,Nicaragua,12.865416,-85.207229,15021,0,245,14776
9/21/22,Nicaragua,12.865416,-85.207229,15021,0,245,14776
9/22/22,Nicaragua,12.865416,-85.207229,15045,0,245,14800
9/23/22,Nicaragua,12.865416,-85.207229,15045,0,245,14800
9/24/22,Nicaragua,12.865416,-85.207229,15045,0,245,14800
9/25/22,Nicaragua,12.865416,-85.207229,15045,0,245,14800
9/26/22,Nicaragua,12.865416,-85.207229,15045,0,245,14800
9/27/22,Nicaragua,12.865416,-85.207229,15045,0,245,14800
9/28/22,Nicaragua,12.865416,-85.207229,15070,0,245,14825
9/29/22,Nicaragua,12.865416,-85.207229,15070,0,245,14825
9/30/22,Nicaragua,12.865416,-85.207229,15070,0,245,14825
10/1/22,Nicaragua,12.865416,-85.207229,15070,0,245,14825
10/2/22,Nicaragua,12.865416,-85.207229,15070,0,245,14825
10/3/22,Nicaragua,12.865416,-85.207229,15070,0,245,14825
10/4/22,Nicaragua,12.865416,-85.207229,15070,0,245,14825
10/5/22,Nicaragua,12.865416,-85.207229,15092,0,245,14847
10/6/22,Nicaragua,12.865416,-85.207229,15092,0,245,14847
10/7/22,Nicaragua,12.865416,-85.207229,15092,0,245,14847
10/8/22,Nicaragua,12.865416,-85.207229,15092,0,245,14847
10/9/22,Nicaragua,12.865416,-85.207229,15092,0,245,14847
10/10/22,Nicaragua,12.865416,-85.207229,15092,0,245,14847
10/11/22,Nicaragua,12.865416,-85.207229,15092,0,245,14847
10/12/22,Nicaragua,12.865416,-85.207229,15120,0,245,14875
10/13/22,Nicaragua,12.865416,-85.207229,15120,0,245,14875
10/14/22,Nicaragua,12.865416,-85.207229,15120,0,245,14875
10/15/22,Nicaragua,12.865416,-85.207229,15120,0,245,14875
10/16/22,Nicaragua,12.865416,-85.207229,15120,0,245,14875
10/17/22,Nicaragua,12.865416,-85.207229,15120,0,245,14875
10/18/22,Nicaragua,12.865416,-85.207229,15120,0,245,14875
10/19/22,Nicaragua,12.865416,-85.207229,15145,0,245,14900
10/20/22,Nicaragua,12.865416,-85.207229,15145,0,245,14900
10/21/22,Nicaragua,12.865416,-85.207229,15145,0,245,14900
10/22/22,Nicaragua,12.865416,-85.207229,15145,0,245,14900
10/23/22,Nicaragua,12.865416,-85.207229,15145,0,245,14900
10/24/22,Nicaragua,12.865416,-85.207229,15145,0,245,14900
10/25/22,Nicaragua,12.865416,-85.207229,15145,0,245,14900
10/26/22,Nicaragua,12.865416,-85.207229,15166,0,245,14921
10/27/22,Nicaragua,12.865416,-85.207229,15166,0,245,14921
10/28/22,Nicaragua,12.865416,-85.207229,15166,0,245,14921
10/29/22,Nicaragua,12.865416,-85.207229,15166,0,245,14921
10/30/22,Nicaragua,12.865416,-85.207229,15166,0,245,14921
10/31/22,Nicaragua,12.865416,-85.207229,15166,0,245,14921
11/1/22,Nicaragua,12.865416,-85.207229,15166,0,245,14921
11/2/22,Nicaragua,12.865416,-85.207229,15186,0,245,14941
11/3/22,Nicaragua,12.865416,-85.207229,15186,0,245,14941
11/4/22,Nicaragua,12.865416,-85.207229,15186,0,245,14941
11/5/22,Nicaragua,12.865416,-85.207229,15186,0,245,14941
11/6/22,Nicaragua,12.865416,-85.207229,15186,0,245,14941
11/7/22,Nicaragua,12.865416,-85.207229,15186,0,245,14941
11/8/22,Nicaragua,12.865416,-85.207229,15186,0,245,14941
11/9/22,Nicaragua,12.865416,-85.207229,15203,0,245,14958
11/10/22,Nicaragua,12.865416,-85.207229,15203,0,245,14958
11/11/22,Nicaragua,12.865416,-85.207229,15203,0,245,14958
11/12/22,Nicaragua,12.865416,-85.207229,15203,0,245,14958
11/13/22,Nicaragua,12.865416,-85.207229,15203,0,245,14958
11/14/22,Nicaragua,12.865416,-85.207229,15203,0,245,14958
11/15/22,Nicaragua,12.865416,-85.207229,15203,0,245,14958
11/16/22,Nicaragua,12.865416,-85.207229,15219,0,245,14974
11/17/22,Nicaragua,12.865416,-85.207229,15219,0,245,14974
11/18/22,Nicaragua,12.865416,-85.207229,15219,0,245,14974
11/19/22,Nicaragua,12.865416,-85.207229,15219,0,245,14974
11/20/22,Nicaragua,12.865416,-85.207229,15219,0,245,14974
11/21/22,Nicaragua,12.865416,-85.207229,15219,0,245,14974
11/22/22,Nicaragua,12.865416,-85.207229,15219,0,245,14974
11/23/22,Nicaragua,12.865416,-85.207229,15232,0,245,14987
11/24/22,Nicaragua,12.865416,-85.207229,15232,0,245,14987
11/25/22,Nicaragua,12.865416,-85.207229,15232,0,245,14987
11/26/22,Nicaragua,12.865416,-85.207229,15232,0,245,14987
11/27/22,Nicaragua,12.865416,-85.207229,15232,0,245,14987
11/28/22,Nicaragua,12.865416,-85.207229,15232,0,245,14987
11/29/22,Nicaragua,12.865416,-85.207229,15232,0,245,14987
11/30/22,Nicaragua,12.865416,-85.207229,15250,0,245,15005
12/1/22,Nicaragua,12.865416,-85.207229,15250,0,245,15005
12/2/22,Nicaragua,12.865416,-85.207229,15250,0,245,15005
12/3/22,Nicaragua,12.865416,-85.207229,15250,0,245,15005
12/4/22,Nicaragua,12.865416,-85.207229,15250,0,245,15005
12/5/22,Nicaragua,12.865416,-85.207229,15250,0,245,15005
12/6/22,Nicaragua,12.865416,-85.207229,15250,0,245,15005
12/7/22,Nicaragua,12.865416,-85.207229,15263,0,245,15018
12/8/22,Nicaragua,12.865416,-85.207229,15263,0,245,15018
12/9/22,Nicaragua,12.865416,-85.207229,15263,0,245,15018
12/10/22,Nicaragua,12.865416,-85.207229,15263,0,245,15018
12/11/22,Nicaragua,12.865416,-85.207229,15263,0,245,15018
12/12/22,Nicaragua,12.865416,-85.207229,15263,0,245,15018
12/13/22,Nicaragua,12.865416,-85.207229,15263,0,245,15018
12/14/22,Nicaragua,12.865416,-85.207229,15308,0,245,15063
12/15/22,Nicaragua,12.865416,-85.207229,15308,0,245,15063
12/16/22,Nicaragua,12.865416,-85.207229,15308,0,245,15063
12/17/22,Nicaragua,12.865416,-85.207229,15308,0,245,15063
1/1/22,Niger,17.607789,8.081666,7438,0,276,7162
1/2/22,Niger,17.607789,8.081666,7438,0,276,7162
1/3/22,Niger,17.607789,8.081666,7508,0,277,7231
1/4/22,Niger,17.607789,8.081666,7590,0,277,7313
1/5/22,Niger,17.607789,8.081666,7590,0,277,7313
1/6/22,Niger,17.607789,8.081666,7590,0,277,7313
1/7/22,Niger,17.607789,8.081666,7891,0,280,7611
1/8/22,Niger,17.607789,8.081666,7961,0,280,7681
1/9/22,Niger,17.607789,8.081666,8006,0,280,7726
1/10/22,Niger,17.607789,8.081666,8076,0,281,7795
1/11/22,Niger,17.607789,8.081666,8076,0,281,7795
1/12/22,Niger,17.607789,8.081666,8260,0,286,7974
1/13/22,Niger,17.607789,8.081666,8306,0,286,8020
1/14/22,Niger,17.607789,8.081666,8347,0,287,8060
1/15/22,Niger,17.607789,8.081666,8347,0,287,8060
1/16/22,Niger,17.607789,8.081666,8386,0,292,8094
1/17/22,Niger,17.607789,8.081666,8413,0,293,8120
1/18/22,Niger,17.607789,8.081666,8459,0,293,8166
1/19/22,Niger,17.607789,8.081666,8472,0,294,8178
1/20/22,Niger,17.607789,8.081666,8503,0,295,8208
1/21/22,Niger,17.607789,8.081666,8503,0,295,8208
1/22/22,Niger,17.607789,8.081666,8542,0,295,8247
1/23/22,Niger,17.607789,8.081666,8542,0,295,8247
1/24/22,Niger,17.607789,8.081666,8592,0,296,8296
1/25/22,Niger,17.607789,8.081666,8603,0,297,8306
1/26/22,Niger,17.607789,8.081666,8616,0,297,8319
1/27/22,Niger,17.607789,8.081666,8632,0,297,8335
1/28/22,Niger,17.607789,8.081666,8640,0,298,8342
1/29/22,Niger,17.607789,8.081666,8648,0,298,8350
1/30/22,Niger,17.607789,8.081666,8649,0,298,8351
1/31/22,Niger,17.607789,8.081666,8652,0,298,8354
2/1/22,Niger,17.607789,8.081666,8655,0,301,8354
2/2/22,Niger,17.607789,8.081666,8656,0,301,8355
2/3/22,Niger,17.607789,8.081666,8656,0,301,8355
2/4/22,Niger,17.607789,8.081666,8670,0,301,8369
2/5/22,Niger,17.607789,8.081666,8682,0,302,8380
2/6/22,Niger,17.607789,8.081666,8686,0,302,8384
2/7/22,Niger,17.607789,8.081666,8691,0,303,8388
2/8/22,Niger,17.607789,8.081666,8696,0,303,8393
2/9/22,Niger,17.607789,8.081666,8700,0,303,8397
2/10/22,Niger,17.607789,8.081666,8703,0,303,8400
2/11/22,Niger,17.607789,8.081666,8707,0,303,8404
2/12/22,Niger,17.607789,8.081666,8709,0,303,8406
2/13/22,Niger,17.607789,8.081666,8711,0,303,8408
2/14/22,Niger,17.607789,8.081666,8712,0,303,8409
2/15/22,Niger,17.607789,8.081666,8724,0,303,8421
2/16/22,Niger,17.607789,8.081666,8724,0,303,8421
2/17/22,Niger,17.607789,8.081666,8728,0,303,8425
2/18/22,Niger,17.607789,8.081666,8728,0,303,8425
2/19/22,Niger,17.607789,8.081666,8734,0,303,8431
2/20/22,Niger,17.607789,8.081666,8738,0,303,8435
2/21/22,Niger,17.607789,8.081666,8743,0,306,8437
2/22/22,Niger,17.607789,8.081666,8743,0,306,8437
2/23/22,Niger,17.607789,8.081666,8746,0,306,8440
2/24/22,Niger,17.607789,8.081666,8746,0,306,8440
2/25/22,Niger,17.607789,8.081666,8746,0,306,8440
2/26/22,Niger,17.607789,8.081666,8746,0,306,8440
2/27/22,Niger,17.607789,8.081666,8751,0,307,8444
2/28/22,Niger,17.607789,8.081666,8754,0,307,8447
3/1/22,Niger,17.607789,8.081666,8756,0,307,8449
3/2/22,Niger,17.607789,8.081666,8759,0,307,8452
3/3/22,Niger,17.607789,8.081666,8759,0,307,8452
3/4/22,Niger,17.607789,8.081666,8760,0,307,8453
3/5/22,Niger,17.607789,8.081666,8760,0,307,8453
3/6/22,Niger,17.607789,8.081666,8766,0,307,8459
3/7/22,Niger,17.607789,8.081666,8767,0,307,8460
3/8/22,Niger,17.607789,8.081666,8769,0,307,8462
3/9/22,Niger,17.607789,8.081666,8774,0,307,8467
3/10/22,Niger,17.607789,8.081666,8774,0,307,8467
3/11/22,Niger,17.607789,8.081666,8780,0,308,8472
3/12/22,Niger,17.607789,8.081666,8781,0,308,8473
3/13/22,Niger,17.607789,8.081666,8781,0,308,8473
3/14/22,Niger,17.607789,8.081666,8781,0,308,8473
3/15/22,Niger,17.607789,8.081666,8781,0,308,8473
3/16/22,Niger,17.607789,8.081666,8786,0,308,8478
3/17/22,Niger,17.607789,8.081666,8788,0,308,8480
3/18/22,Niger,17.607789,8.081666,8788,0,308,8480
3/19/22,Niger,17.607789,8.081666,8788,0,308,8480
3/20/22,Niger,17.607789,8.081666,8788,0,308,8480
3/21/22,Niger,17.607789,8.081666,8794,0,308,8486
3/22/22,Niger,17.607789,8.081666,8797,0,308,8489
3/23/22,Niger,17.607789,8.081666,8799,0,308,8491
3/24/22,Niger,17.607789,8.081666,8799,0,308,8491
3/25/22,Niger,17.607789,8.081666,8799,0,308,8491
3/26/22,Niger,17.607789,8.081666,8801,0,308,8493
3/27/22,Niger,17.607789,8.081666,8801,0,308,8493
3/28/22,Niger,17.607789,8.081666,8801,0,308,8493
3/29/22,Niger,17.607789,8.081666,8801,0,308,8493
3/30/22,Niger,17.607789,8.081666,8801,0,308,8493
3/31/22,Niger,17.607789,8.081666,8801,0,308,8493
4/1/22,Niger,17.607789,8.081666,8801,0,308,8493
4/2/22,Niger,17.607789,8.081666,8810,0,308,8502
4/3/22,Niger,17.607789,8.081666,8811,0,308,8503
4/4/22,Niger,17.607789,8.081666,8811,0,308,8503
4/5/22,Niger,17.607789,8.081666,8816,0,308,8508
4/6/22,Niger,17.607789,8.081666,8822,0,308,8514
4/7/22,Niger,17.607789,8.081666,8822,0,308,8514
4/8/22,Niger,17.607789,8.081666,8822,0,308,8514
4/9/22,Niger,17.607789,8.081666,8822,0,308,8514
4/10/22,Niger,17.607789,8.081666,8822,0,308,8514
4/11/22,Niger,17.607789,8.081666,8846,0,308,8538
4/12/22,Niger,17.607789,8.081666,8846,0,308,8538
4/13/22,Niger,17.607789,8.081666,8846,0,308,8538
4/14/22,Niger,17.607789,8.081666,8846,0,308,8538
4/15/22,Niger,17.607789,8.081666,8866,0,308,8558
4/16/22,Niger,17.607789,8.081666,8871,0,308,8563
4/17/22,Niger,17.607789,8.081666,8877,0,308,8569
4/18/22,Niger,17.607789,8.081666,8883,0,308,8575
4/19/22,Niger,17.607789,8.081666,8893,0,308,8585
4/20/22,Niger,17.607789,8.081666,8903,0,308,8595
4/21/22,Niger,17.607789,8.081666,8908,0,309,8599
4/22/22,Niger,17.607789,8.081666,8908,0,309,8599
4/23/22,Niger,17.607789,8.081666,8914,0,309,8605
4/24/22,Niger,17.607789,8.081666,8914,0,309,8605
4/25/22,Niger,17.607789,8.081666,8916,0,309,8607
4/26/22,Niger,17.607789,8.081666,8921,0,309,8612
4/27/22,Niger,17.607789,8.081666,8924,0,309,8615
4/28/22,Niger,17.607789,8.081666,8924,0,309,8615
4/29/22,Niger,17.607789,8.081666,8928,0,309,8619
4/30/22,Niger,17.607789,8.081666,8941,0,309,8632
5/1/22,Niger,17.607789,8.081666,8941,0,309,8632
5/2/22,Niger,17.607789,8.081666,8943,0,309,8634
5/3/22,Niger,17.607789,8.081666,8954,0,309,8645
5/4/22,Niger,17.607789,8.081666,8957,0,309,8648
5/5/22,Niger,17.607789,8.081666,8957,0,309,8648
5/6/22,Niger,17.607789,8.081666,8957,0,309,8648
5/7/22,Niger,17.607789,8.081666,8957,0,309,8648
5/8/22,Niger,17.607789,8.081666,8957,0,309,8648
5/9/22,Niger,17.607789,8.081666,8986,0,309,8677
5/10/22,Niger,17.607789,8.081666,9005,0,309,8696
5/11/22,Niger,17.607789,8.081666,9005,0,309,8696
5/12/22,Niger,17.607789,8.081666,9010,0,310,8700
5/13/22,Niger,17.607789,8.081666,9013,0,310,8703
5/14/22,Niger,17.607789,8.081666,9013,0,310,8703
5/15/22,Niger,17.607789,8.081666,9013,0,310,8703
5/16/22,Niger,17.607789,8.081666,9013,0,310,8703
5/17/22,Niger,17.607789,8.081666,9013,0,310,8703
5/18/22,Niger,17.607789,8.081666,9031,0,310,8721
5/19/22,Niger,17.607789,8.081666,9031,0,310,8721
5/20/22,Niger,17.607789,8.081666,9031,0,310,8721
5/21/22,Niger,17.607789,8.081666,9031,0,310,8721
5/22/22,Niger,17.607789,8.081666,9031,0,310,8721
5/23/22,Niger,17.607789,8.081666,9031,0,310,8721
5/24/22,Niger,17.607789,8.081666,9031,0,310,8721
5/25/22,Niger,17.607789,8.081666,9031,0,310,8721
5/26/22,Niger,17.607789,8.081666,9031,0,310,8721
5/27/22,Niger,17.607789,8.081666,9031,0,310,8721
5/28/22,Niger,17.607789,8.081666,9031,0,310,8721
5/29/22,Niger,17.607789,8.081666,9031,0,310,8721
5/30/22,Niger,17.607789,8.081666,9031,0,310,8721
5/31/22,Niger,17.607789,8.081666,9031,0,310,8721
6/1/22,Niger,17.607789,8.081666,9031,0,310,8721
6/2/22,Niger,17.607789,8.081666,9031,0,310,8721
6/3/22,Niger,17.607789,8.081666,9031,0,310,8721
6/4/22,Niger,17.607789,8.081666,9031,0,310,8721
6/5/22,Niger,17.607789,8.081666,9031,0,310,8721
6/6/22,Niger,17.607789,8.081666,9031,0,310,8721
6/7/22,Niger,17.607789,8.081666,9031,0,310,8721
6/8/22,Niger,17.607789,8.081666,9031,0,310,8721
6/9/22,Niger,17.607789,8.081666,9031,0,310,8721
6/10/22,Niger,17.607789,8.081666,9031,0,310,8721
6/11/22,Niger,17.607789,8.081666,9031,0,310,8721
6/12/22,Niger,17.607789,8.081666,9031,0,310,8721
6/13/22,Niger,17.607789,8.081666,9031,0,310,8721
6/14/22,Niger,17.607789,8.081666,9031,0,310,8721
6/15/22,Niger,17.607789,8.081666,9031,0,310,8721
6/16/22,Niger,17.607789,8.081666,9031,0,310,8721
6/17/22,Niger,17.607789,8.081666,9031,0,310,8721
6/18/22,Niger,17.607789,8.081666,9031,0,310,8721
6/19/22,Niger,17.607789,8.081666,9031,0,310,8721
6/20/22,Niger,17.607789,8.081666,9031,0,310,8721
6/21/22,Niger,17.607789,8.081666,9031,0,310,8721
6/22/22,Niger,17.607789,8.081666,9031,0,310,8721
6/23/22,Niger,17.607789,8.081666,9031,0,310,8721
6/24/22,Niger,17.607789,8.081666,9031,0,310,8721
6/25/22,Niger,17.607789,8.081666,9031,0,310,8721
6/26/22,Niger,17.607789,8.081666,9031,0,310,8721
6/27/22,Niger,17.607789,8.081666,9031,0,310,8721
6/28/22,Niger,17.607789,8.081666,9031,0,310,8721
6/29/22,Niger,17.607789,8.081666,9031,0,310,8721
6/30/22,Niger,17.607789,8.081666,9031,0,310,8721
7/1/22,Niger,17.607789,8.081666,9031,0,310,8721
7/2/22,Niger,17.607789,8.081666,9031,0,310,8721
7/3/22,Niger,17.607789,8.081666,9031,0,310,8721
7/4/22,Niger,17.607789,8.081666,9031,0,310,8721
7/5/22,Niger,17.607789,8.081666,9031,0,310,8721
7/6/22,Niger,17.607789,8.081666,9031,0,310,8721
7/7/22,Niger,17.607789,8.081666,9031,0,310,8721
7/8/22,Niger,17.607789,8.081666,9031,0,310,8721
7/9/22,Niger,17.607789,8.081666,9031,0,310,8721
7/10/22,Niger,17.607789,8.081666,9031,0,310,8721
7/11/22,Niger,17.607789,8.081666,9096,0,311,8785
7/12/22,Niger,17.607789,8.081666,9096,0,311,8785
7/13/22,Niger,17.607789,8.081666,9096,0,311,8785
7/14/22,Niger,17.607789,8.081666,9096,0,311,8785
7/15/22,Niger,17.607789,8.081666,9096,0,311,8785
7/16/22,Niger,17.607789,8.081666,9096,0,311,8785
7/17/22,Niger,17.607789,8.081666,9096,0,311,8785
7/18/22,Niger,17.607789,8.081666,9096,0,311,8785
7/19/22,Niger,17.607789,8.081666,9104,0,311,8793
7/20/22,Niger,17.607789,8.081666,9104,0,311,8793
7/21/22,Niger,17.607789,8.081666,9104,0,311,8793
7/22/22,Niger,17.607789,8.081666,9104,0,311,8793
7/23/22,Niger,17.607789,8.081666,9104,0,311,8793
7/24/22,Niger,17.607789,8.081666,9104,0,311,8793
7/25/22,Niger,17.607789,8.081666,9104,0,311,8793
7/26/22,Niger,17.607789,8.081666,9104,0,311,8793
7/27/22,Niger,17.607789,8.081666,9104,0,311,8793
7/28/22,Niger,17.607789,8.081666,9104,0,311,8793
7/29/22,Niger,17.607789,8.081666,9104,0,311,8793
7/30/22,Niger,17.607789,8.081666,9104,0,311,8793
7/31/22,Niger,17.607789,8.081666,9104,0,311,8793
8/1/22,Niger,17.607789,8.081666,9104,0,311,8793
8/2/22,Niger,17.607789,8.081666,9114,0,311,8803
8/3/22,Niger,17.607789,8.081666,9115,0,311,8804
8/4/22,Niger,17.607789,8.081666,9115,0,311,8804
8/5/22,Niger,17.607789,8.081666,9119,0,311,8808
8/6/22,Niger,17.607789,8.081666,9119,0,311,8808
8/7/22,Niger,17.607789,8.081666,9119,0,311,8808
8/8/22,Niger,17.607789,8.081666,9125,0,311,8814
8/9/22,Niger,17.607789,8.081666,9125,0,311,8814
8/10/22,Niger,17.607789,8.081666,9125,0,311,8814
8/11/22,Niger,17.607789,8.081666,9132,0,311,8821
8/12/22,Niger,17.607789,8.081666,9132,0,311,8821
8/13/22,Niger,17.607789,8.081666,9132,0,311,8821
8/14/22,Niger,17.607789,8.081666,9132,0,311,8821
8/15/22,Niger,17.607789,8.081666,9139,0,311,8828
8/16/22,Niger,17.607789,8.081666,9139,0,311,8828
8/17/22,Niger,17.607789,8.081666,9157,0,312,8845
8/18/22,Niger,17.607789,8.081666,9157,0,312,8845
8/19/22,Niger,17.607789,8.081666,9183,0,312,8871
8/20/22,Niger,17.607789,8.081666,9183,0,312,8871
8/21/22,Niger,17.607789,8.081666,9183,0,312,8871
8/22/22,Niger,17.607789,8.081666,9203,0,312,8891
8/23/22,Niger,17.607789,8.081666,9219,0,312,8907
8/24/22,Niger,17.607789,8.081666,9250,0,312,8938
8/25/22,Niger,17.607789,8.081666,9263,0,312,8951
8/26/22,Niger,17.607789,8.081666,9263,0,312,8951
8/27/22,Niger,17.607789,8.081666,9263,0,312,8951
8/28/22,Niger,17.607789,8.081666,9263,0,312,8951
8/29/22,Niger,17.607789,8.081666,9329,0,312,9017
8/30/22,Niger,17.607789,8.081666,9329,0,312,9017
8/31/22,Niger,17.607789,8.081666,9331,0,312,9019
9/1/22,Niger,17.607789,8.081666,9343,0,312,9031
9/2/22,Niger,17.607789,8.081666,9352,0,312,9040
9/3/22,Niger,17.607789,8.081666,9357,0,312,9045
9/4/22,Niger,17.607789,8.081666,9357,0,312,9045
9/5/22,Niger,17.607789,8.081666,9364,0,312,9052
9/6/22,Niger,17.607789,8.081666,9366,0,312,9054
9/7/22,Niger,17.607789,8.081666,9366,0,312,9054
9/8/22,Niger,17.607789,8.081666,9372,0,312,9060
9/9/22,Niger,17.607789,8.081666,9374,0,312,9062
9/10/22,Niger,17.607789,8.081666,9377,0,312,9065
9/11/22,Niger,17.607789,8.081666,9377,0,312,9065
9/12/22,Niger,17.607789,8.081666,9384,0,312,9072
9/13/22,Niger,17.607789,8.081666,9385,0,312,9073
9/14/22,Niger,17.607789,8.081666,9388,0,312,9076
9/15/22,Niger,17.607789,8.081666,9388,0,312,9076
9/16/22,Niger,17.607789,8.081666,9390,0,312,9078
9/17/22,Niger,17.607789,8.081666,9394,0,312,9082
9/18/22,Niger,17.607789,8.081666,9395,0,312,9083
9/19/22,Niger,17.607789,8.081666,9395,0,313,9082
9/20/22,Niger,17.607789,8.081666,9395,0,313,9082
9/21/22,Niger,17.607789,8.081666,9395,0,313,9082
9/22/22,Niger,17.607789,8.081666,9395,0,313,9082
9/23/22,Niger,17.607789,8.081666,9395,0,313,9082
9/24/22,Niger,17.607789,8.081666,9395,0,313,9082
9/25/22,Niger,17.607789,8.081666,9395,0,313,9082
9/26/22,Niger,17.607789,8.081666,9395,0,313,9082
9/27/22,Niger,17.607789,8.081666,9395,0,313,9082
9/28/22,Niger,17.607789,8.081666,9405,0,313,9092
9/29/22,Niger,17.607789,8.081666,9405,0,313,9092
9/30/22,Niger,17.607789,8.081666,9405,0,313,9092
10/1/22,Niger,17.607789,8.081666,9405,0,313,9092
10/2/22,Niger,17.607789,8.081666,9405,0,313,9092
10/3/22,Niger,17.607789,8.081666,9408,0,313,9095
10/4/22,Niger,17.607789,8.081666,9411,0,313,9098
10/5/22,Niger,17.607789,8.081666,9411,0,314,9097
10/6/22,Niger,17.607789,8.081666,9411,0,314,9097
10/7/22,Niger,17.607789,8.081666,9411,0,314,9097
10/8/22,Niger,17.607789,8.081666,9411,0,314,9097
10/9/22,Niger,17.607789,8.081666,9411,0,314,9097
10/10/22,Niger,17.607789,8.081666,9411,0,314,9097
10/11/22,Niger,17.607789,8.081666,9415,0,314,9101
10/12/22,Niger,17.607789,8.081666,9415,0,314,9101
10/13/22,Niger,17.607789,8.081666,9415,0,314,9101
10/14/22,Niger,17.607789,8.081666,9415,0,314,9101
10/15/22,Niger,17.607789,8.081666,9415,0,314,9101
10/16/22,Niger,17.607789,8.081666,9415,0,314,9101
10/17/22,Niger,17.607789,8.081666,9415,0,314,9101
10/18/22,Niger,17.607789,8.081666,9415,0,314,9101
10/19/22,Niger,17.607789,8.081666,9415,0,314,9101
10/20/22,Niger,17.607789,8.081666,9415,0,314,9101
10/21/22,Niger,17.607789,8.081666,9415,0,314,9101
10/22/22,Niger,17.607789,8.081666,9415,0,314,9101
10/23/22,Niger,17.607789,8.081666,9415,0,314,9101
10/24/22,Niger,17.607789,8.081666,9415,0,314,9101
10/25/22,Niger,17.607789,8.081666,9425,0,314,9111
10/26/22,Niger,17.607789,8.081666,9425,0,314,9111
10/27/22,Niger,17.607789,8.081666,9425,0,314,9111
10/28/22,Niger,17.607789,8.081666,9425,0,314,9111
10/29/22,Niger,17.607789,8.081666,9425,0,314,9111
10/30/22,Niger,17.607789,8.081666,9425,0,314,9111
10/31/22,Niger,17.607789,8.081666,9425,0,314,9111
11/1/22,Niger,17.607789,8.081666,9428,0,314,9114
11/2/22,Niger,17.607789,8.081666,9428,0,314,9114
11/3/22,Niger,17.607789,8.081666,9428,0,314,9114
11/4/22,Niger,17.607789,8.081666,9428,0,314,9114
11/5/22,Niger,17.607789,8.081666,9428,0,314,9114
11/6/22,Niger,17.607789,8.081666,9428,0,314,9114
11/7/22,Niger,17.607789,8.081666,9428,0,314,9114
11/8/22,Niger,17.607789,8.081666,9430,0,314,9116
11/9/22,Niger,17.607789,8.081666,9430,0,314,9116
11/10/22,Niger,17.607789,8.081666,9430,0,314,9116
11/11/22,Niger,17.607789,8.081666,9430,0,314,9116
11/12/22,Niger,17.607789,8.081666,9430,0,314,9116
11/13/22,Niger,17.607789,8.081666,9430,0,314,9116
11/14/22,Niger,17.607789,8.081666,9430,0,314,9116
11/15/22,Niger,17.607789,8.081666,9430,0,314,9116
11/16/22,Niger,17.607789,8.081666,9430,0,314,9116
11/17/22,Niger,17.607789,8.081666,9430,0,314,9116
11/18/22,Niger,17.607789,8.081666,9430,0,314,9116
11/19/22,Niger,17.607789,8.081666,9430,0,314,9116
11/20/22,Niger,17.607789,8.081666,9430,0,314,9116
11/21/22,Niger,17.607789,8.081666,9430,0,314,9116
11/22/22,Niger,17.607789,8.081666,9430,0,314,9116
11/23/22,Niger,17.607789,8.081666,9430,0,314,9116
11/24/22,Niger,17.607789,8.081666,9430,0,314,9116
11/25/22,Niger,17.607789,8.081666,9430,0,314,9116
11/26/22,Niger,17.607789,8.081666,9430,0,314,9116
11/27/22,Niger,17.607789,8.081666,9430,0,314,9116
11/28/22,Niger,17.607789,8.081666,9434,0,314,9120
11/29/22,Niger,17.607789,8.081666,9434,0,314,9120
11/30/22,Niger,17.607789,8.081666,9434,0,314,9120
12/1/22,Niger,17.607789,8.081666,9434,0,314,9120
12/2/22,Niger,17.607789,8.081666,9434,0,314,9120
12/3/22,Niger,17.607789,8.081666,9434,0,314,9120
12/4/22,Niger,17.607789,8.081666,9434,0,314,9120
12/5/22,Niger,17.607789,8.081666,9434,0,314,9120
12/6/22,Niger,17.607789,8.081666,9434,0,314,9120
12/7/22,Niger,17.607789,8.081666,9434,0,314,9120
12/8/22,Niger,17.607789,8.081666,9434,0,314,9120
12/9/22,Niger,17.607789,8.081666,9434,0,314,9120
12/10/22,Niger,17.607789,8.081666,9434,0,314,9120
12/11/22,Niger,17.607789,8.081666,9434,0,314,9120
12/12/22,Niger,17.607789,8.081666,9434,0,314,9120
12/13/22,Niger,17.607789,8.081666,9434,0,314,9120
12/14/22,Niger,17.607789,8.081666,9434,0,314,9120
12/15/22,Niger,17.607789,8.081666,9434,0,314,9120
12/16/22,Niger,17.607789,8.081666,9434,0,314,9120
12/17/22,Niger,17.607789,8.081666,9434,0,314,9120
1/1/22,Nigeria,9.082,8.6753,242877,0,3033,239844
1/2/22,Nigeria,9.082,8.6753,242877,0,3033,239844
1/3/22,Nigeria,9.082,8.6753,244120,0,3045,241075
1/4/22,Nigeria,9.082,8.6753,244548,0,3053,241495
1/5/22,Nigeria,9.082,8.6753,245404,0,3058,242346
1/6/22,Nigeria,9.082,8.6753,246195,0,3066,243129
1/7/22,Nigeria,9.082,8.6753,247009,0,3070,243939
1/8/22,Nigeria,9.082,8.6753,247775,0,3071,244704
1/9/22,Nigeria,9.082,8.6753,248312,0,3077,245235
1/10/22,Nigeria,9.082,8.6753,248732,0,3085,245647
1/11/22,Nigeria,9.082,8.6753,249154,0,3086,246068
1/12/22,Nigeria,9.082,8.6753,249586,0,3092,246494
1/13/22,Nigeria,9.082,8.6753,250009,0,3092,246917
1/14/22,Nigeria,9.082,8.6753,250009,0,3092,246917
1/15/22,Nigeria,9.082,8.6753,250628,0,3095,247533
1/16/22,Nigeria,9.082,8.6753,250929,0,3103,247826
1/17/22,Nigeria,9.082,8.6753,251178,0,3110,248068
1/18/22,Nigeria,9.082,8.6753,251341,0,3116,248225
1/19/22,Nigeria,9.082,8.6753,251571,0,3117,248454
1/20/22,Nigeria,9.082,8.6753,251571,0,3117,248454
1/21/22,Nigeria,9.082,8.6753,251930,0,3124,248806
1/22/22,Nigeria,9.082,8.6753,251959,0,3124,248835
1/23/22,Nigeria,9.082,8.6753,252187,0,3124,249063
1/24/22,Nigeria,9.082,8.6753,252428,0,3126,249302
1/25/22,Nigeria,9.082,8.6753,252678,0,3133,249545
1/26/22,Nigeria,9.082,8.6753,252753,0,3134,249619
1/27/22,Nigeria,9.082,8.6753,252753,0,3134,249619
1/28/22,Nigeria,9.082,8.6753,252912,0,3134,249778
1/29/22,Nigeria,9.082,8.6753,253001,0,3135,249866
1/30/22,Nigeria,9.082,8.6753,253023,0,3135,249888
1/31/22,Nigeria,9.082,8.6753,253181,0,3136,250045
2/1/22,Nigeria,9.082,8.6753,253340,0,3136,250204
2/2/22,Nigeria,9.082,8.6753,253405,0,3136,250269
2/3/22,Nigeria,9.082,8.6753,253405,0,3136,250269
2/4/22,Nigeria,9.082,8.6753,253540,0,3136,250404
2/5/22,Nigeria,9.082,8.6753,253685,0,3139,250546
2/6/22,Nigeria,9.082,8.6753,253727,0,3139,250588
2/7/22,Nigeria,9.082,8.6753,253780,0,3139,250641
2/8/22,Nigeria,9.082,8.6753,253838,0,3139,250699
2/9/22,Nigeria,9.082,8.6753,253875,0,3139,250736
2/10/22,Nigeria,9.082,8.6753,253875,0,3139,250736
2/11/22,Nigeria,9.082,8.6753,253923,0,3139,250784
2/12/22,Nigeria,9.082,8.6753,253978,0,3141,250837
2/13/22,Nigeria,9.082,8.6753,254016,0,3141,250875
2/14/22,Nigeria,9.082,8.6753,254016,0,3141,250875
2/15/22,Nigeria,9.082,8.6753,254124,0,3141,250983
2/16/22,Nigeria,9.082,8.6753,254137,0,3141,250996
2/17/22,Nigeria,9.082,8.6753,254137,0,3141,250996
2/18/22,Nigeria,9.082,8.6753,254221,0,3142,251079
2/19/22,Nigeria,9.082,8.6753,254243,0,3142,251101
2/20/22,Nigeria,9.082,8.6753,254243,0,3142,251101
2/21/22,Nigeria,9.082,8.6753,254293,0,3142,251151
2/22/22,Nigeria,9.082,8.6753,254352,0,3142,251210
2/23/22,Nigeria,9.082,8.6753,254352,0,3142,251210
2/24/22,Nigeria,9.082,8.6753,254428,0,3142,251286
2/25/22,Nigeria,9.082,8.6753,254428,0,3142,251286
2/26/22,Nigeria,9.082,8.6753,254501,0,3142,251359
2/27/22,Nigeria,9.082,8.6753,254525,0,3142,251383
2/28/22,Nigeria,9.082,8.6753,254560,0,3142,251418
3/1/22,Nigeria,9.082,8.6753,254570,0,3142,251428
3/2/22,Nigeria,9.082,8.6753,254598,0,3142,251456
3/3/22,Nigeria,9.082,8.6753,254606,0,3142,251464
3/4/22,Nigeria,9.082,8.6753,254637,0,3142,251495
3/5/22,Nigeria,9.082,8.6753,254637,0,3142,251495
3/6/22,Nigeria,9.082,8.6753,254640,0,3142,251498
3/7/22,Nigeria,9.082,8.6753,254659,0,3142,251517
3/8/22,Nigeria,9.082,8.6753,254777,0,3142,251635
3/9/22,Nigeria,9.082,8.6753,254777,0,3142,251635
3/10/22,Nigeria,9.082,8.6753,254861,0,3142,251719
3/11/22,Nigeria,9.082,8.6753,254894,0,3142,251752
3/12/22,Nigeria,9.082,8.6753,254953,0,3142,251811
3/13/22,Nigeria,9.082,8.6753,254953,0,3142,251811
3/14/22,Nigeria,9.082,8.6753,254989,0,3142,251847
3/15/22,Nigeria,9.082,8.6753,255001,0,3142,251859
3/16/22,Nigeria,9.082,8.6753,255001,0,3142,251859
3/17/22,Nigeria,9.082,8.6753,255092,0,3142,251950
3/18/22,Nigeria,9.082,8.6753,255103,0,3142,251961
3/19/22,Nigeria,9.082,8.6753,255103,0,3142,251961
3/20/22,Nigeria,9.082,8.6753,255103,0,3142,251961
3/21/22,Nigeria,9.082,8.6753,255103,0,3142,251961
3/22/22,Nigeria,9.082,8.6753,255190,0,3142,252048
3/23/22,Nigeria,9.082,8.6753,255244,0,3142,252102
3/24/22,Nigeria,9.082,8.6753,255244,0,3142,252102
3/25/22,Nigeria,9.082,8.6753,255244,0,3142,252102
3/26/22,Nigeria,9.082,8.6753,255296,0,3142,252154
3/27/22,Nigeria,9.082,8.6753,255296,0,3142,252154
3/28/22,Nigeria,9.082,8.6753,255341,0,3142,252199
3/29/22,Nigeria,9.082,8.6753,255341,0,3142,252199
3/30/22,Nigeria,9.082,8.6753,255415,0,3142,252273
3/31/22,Nigeria,9.082,8.6753,255415,0,3142,252273
4/1/22,Nigeria,9.082,8.6753,255468,0,3142,252326
4/2/22,Nigeria,9.082,8.6753,255468,0,3142,252326
4/3/22,Nigeria,9.082,8.6753,255468,0,3142,252326
4/4/22,Nigeria,9.082,8.6753,255468,0,3142,252326
4/5/22,Nigeria,9.082,8.6753,255516,0,3142,252374
4/6/22,Nigeria,9.082,8.6753,255516,0,3142,252374
4/7/22,Nigeria,9.082,8.6753,255575,0,3142,252433
4/8/22,Nigeria,9.082,8.6753,255575,0,3142,252433
4/9/22,Nigeria,9.082,8.6753,255606,0,3142,252464
4/10/22,Nigeria,9.082,8.6753,255606,0,3142,252464
4/11/22,Nigeria,9.082,8.6753,255633,0,3142,252491
4/12/22,Nigeria,9.082,8.6753,255663,0,3142,252521
4/13/22,Nigeria,9.082,8.6753,255633,0,3142,252491
4/14/22,Nigeria,9.082,8.6753,255646,0,3143,252503
4/15/22,Nigeria,9.082,8.6753,255646,0,3143,252503
4/16/22,Nigeria,9.082,8.6753,255648,0,3143,252505
4/17/22,Nigeria,9.082,8.6753,255648,0,3143,252505
4/18/22,Nigeria,9.082,8.6753,255648,0,3143,252505
4/19/22,Nigeria,9.082,8.6753,255670,0,3143,252527
4/20/22,Nigeria,9.082,8.6753,255670,0,3143,252527
4/21/22,Nigeria,9.082,8.6753,255679,0,3143,252536
4/22/22,Nigeria,9.082,8.6753,255685,0,3143,252542
4/23/22,Nigeria,9.082,8.6753,255685,0,3143,252542
4/24/22,Nigeria,9.082,8.6753,255685,0,3143,252542
4/25/22,Nigeria,9.082,8.6753,255685,0,3143,252542
4/26/22,Nigeria,9.082,8.6753,255685,0,3143,252542
4/27/22,Nigeria,9.082,8.6753,255685,0,3143,252542
4/28/22,Nigeria,9.082,8.6753,255716,0,3143,252573
4/29/22,Nigeria,9.082,8.6753,255716,0,3143,252573
4/30/22,Nigeria,9.082,8.6753,255716,0,3143,252573
5/1/22,Nigeria,9.082,8.6753,255753,0,3143,252610
5/2/22,Nigeria,9.082,8.6753,255753,0,3143,252610
5/3/22,Nigeria,9.082,8.6753,255766,0,3143,252623
5/4/22,Nigeria,9.082,8.6753,255766,0,3143,252623
5/5/22,Nigeria,9.082,8.6753,255766,0,3143,252623
5/6/22,Nigeria,9.082,8.6753,255766,0,3143,252623
5/7/22,Nigeria,9.082,8.6753,255766,0,3143,252623
5/8/22,Nigeria,9.082,8.6753,255766,0,3143,252623
5/9/22,Nigeria,9.082,8.6753,255766,0,3143,252623
5/10/22,Nigeria,9.082,8.6753,255802,0,3143,252659
5/11/22,Nigeria,9.082,8.6753,255802,0,3143,252659
5/12/22,Nigeria,9.082,8.6753,255836,0,3143,252693
5/13/22,Nigeria,9.082,8.6753,255836,0,3143,252693
5/14/22,Nigeria,9.082,8.6753,255859,0,3143,252716
5/15/22,Nigeria,9.082,8.6753,255859,0,3143,252716
5/16/22,Nigeria,9.082,8.6753,255859,0,3143,252716
5/17/22,Nigeria,9.082,8.6753,255859,0,3143,252716
5/18/22,Nigeria,9.082,8.6753,255889,0,3143,252746
5/19/22,Nigeria,9.082,8.6753,255924,0,3143,252781
5/20/22,Nigeria,9.082,8.6753,255924,0,3143,252781
5/21/22,Nigeria,9.082,8.6753,255937,0,3143,252794
5/22/22,Nigeria,9.082,8.6753,255937,0,3143,252794
5/23/22,Nigeria,9.082,8.6753,255937,0,3143,252794
5/24/22,Nigeria,9.082,8.6753,255972,0,3143,252829
5/25/22,Nigeria,9.082,8.6753,255972,0,3143,252829
5/26/22,Nigeria,9.082,8.6753,256004,0,3143,252861
5/27/22,Nigeria,9.082,8.6753,256028,0,3143,252885
5/28/22,Nigeria,9.082,8.6753,256028,0,3143,252885
5/29/22,Nigeria,9.082,8.6753,256028,0,3143,252885
5/30/22,Nigeria,9.082,8.6753,256028,0,3143,252885
5/31/22,Nigeria,9.082,8.6753,256028,0,3143,252885
6/1/22,Nigeria,9.082,8.6753,256028,0,3143,252885
6/2/22,Nigeria,9.082,8.6753,256113,0,3143,252970
6/3/22,Nigeria,9.082,8.6753,256113,0,3143,252970
6/4/22,Nigeria,9.082,8.6753,256148,0,3143,253005
6/5/22,Nigeria,9.082,8.6753,256148,0,3143,253005
6/6/22,Nigeria,9.082,8.6753,256148,0,3148,253000
6/7/22,Nigeria,9.082,8.6753,256227,0,3148,253079
6/8/22,Nigeria,9.082,8.6753,256227,0,3148,253079
6/9/22,Nigeria,9.082,8.6753,256264,0,3148,253116
6/10/22,Nigeria,9.082,8.6753,256264,0,3144,253120
6/11/22,Nigeria,9.082,8.6753,256352,0,3144,253208
6/12/22,Nigeria,9.082,8.6753,256352,0,3144,253208
6/13/22,Nigeria,9.082,8.6753,256352,0,3144,253208
6/14/22,Nigeria,9.082,8.6753,256404,0,3144,253260
6/15/22,Nigeria,9.082,8.6753,256404,0,3144,253260
6/16/22,Nigeria,9.082,8.6753,256467,0,3144,253323
6/17/22,Nigeria,9.082,8.6753,256467,0,3144,253323
6/18/22,Nigeria,9.082,8.6753,256573,0,3144,253429
6/19/22,Nigeria,9.082,8.6753,256573,0,3144,253429
6/20/22,Nigeria,9.082,8.6753,256573,0,3144,253429
6/21/22,Nigeria,9.082,8.6753,256711,0,3144,253567
6/22/22,Nigeria,9.082,8.6753,256711,0,3144,253567
6/23/22,Nigeria,9.082,8.6753,256711,0,3144,253567
6/24/22,Nigeria,9.082,8.6753,256711,0,3144,253567
6/25/22,Nigeria,9.082,8.6753,256958,0,3144,253814
6/26/22,Nigeria,9.082,8.6753,256958,0,3144,253814
6/27/22,Nigeria,9.082,8.6753,256958,0,3144,253814
6/28/22,Nigeria,9.082,8.6753,256958,0,3144,253814
6/29/22,Nigeria,9.082,8.6753,256958,0,3144,253814
6/30/22,Nigeria,9.082,8.6753,257290,0,3144,254146
7/1/22,Nigeria,9.082,8.6753,257290,0,3144,254146
7/2/22,Nigeria,9.082,8.6753,257637,0,3144,254493
7/3/22,Nigeria,9.082,8.6753,257637,0,3144,254493
7/4/22,Nigeria,9.082,8.6753,257637,0,3144,254493
7/5/22,Nigeria,9.082,8.6753,257637,0,3144,254493
7/6/22,Nigeria,9.082,8.6753,257637,0,3144,254493
7/7/22,Nigeria,9.082,8.6753,257637,0,3144,254493
7/8/22,Nigeria,9.082,8.6753,257637,0,3144,254493
7/9/22,Nigeria,9.082,8.6753,258517,0,3144,255373
7/10/22,Nigeria,9.082,8.6753,258517,0,3144,255373
7/11/22,Nigeria,9.082,8.6753,258517,0,3144,255373
7/12/22,Nigeria,9.082,8.6753,258874,0,3144,255730
7/13/22,Nigeria,9.082,8.6753,258874,0,3144,255730
7/14/22,Nigeria,9.082,8.6753,258934,0,3144,255790
7/15/22,Nigeria,9.082,8.6753,258934,0,3144,255790
7/16/22,Nigeria,9.082,8.6753,259007,0,3144,255863
7/17/22,Nigeria,9.082,8.6753,259007,0,3144,255863
7/18/22,Nigeria,9.082,8.6753,259007,0,3144,255863
7/19/22,Nigeria,9.082,8.6753,259485,0,3146,256339
7/20/22,Nigeria,9.082,8.6753,259485,0,3146,256339
7/21/22,Nigeria,9.082,8.6753,259720,0,3146,256574
7/22/22,Nigeria,9.082,8.6753,259720,0,3146,256574
7/23/22,Nigeria,9.082,8.6753,260339,0,3147,257192
7/24/22,Nigeria,9.082,8.6753,260339,0,3147,257192
7/25/22,Nigeria,9.082,8.6753,260339,0,3147,257192
7/26/22,Nigeria,9.082,8.6753,260764,0,3147,257617
7/27/22,Nigeria,9.082,8.6753,260764,0,3147,257617
7/28/22,Nigeria,9.082,8.6753,260977,0,3147,257830
7/29/22,Nigeria,9.082,8.6753,260977,0,3147,257830
7/30/22,Nigeria,9.082,8.6753,260977,0,3147,257830
7/31/22,Nigeria,9.082,8.6753,260977,0,3147,257830
8/1/22,Nigeria,9.082,8.6753,260977,0,3147,257830
8/2/22,Nigeria,9.082,8.6753,261473,0,3147,258326
8/3/22,Nigeria,9.082,8.6753,261473,0,3147,258326
8/4/22,Nigeria,9.082,8.6753,261473,0,3147,258326
8/5/22,Nigeria,9.082,8.6753,261473,0,3147,258326
8/6/22,Nigeria,9.082,8.6753,261473,0,3147,258326
8/7/22,Nigeria,9.082,8.6753,261885,0,3147,258738
8/8/22,Nigeria,9.082,8.6753,261885,0,3147,258738
8/9/22,Nigeria,9.082,8.6753,261885,0,3147,258738
8/10/22,Nigeria,9.082,8.6753,261885,0,3147,258738
8/11/22,Nigeria,9.082,8.6753,262402,0,3147,259255
8/12/22,Nigeria,9.082,8.6753,262402,0,3147,259255
8/13/22,Nigeria,9.082,8.6753,262520,0,3147,259373
8/14/22,Nigeria,9.082,8.6753,262520,0,3147,259373
8/15/22,Nigeria,9.082,8.6753,262520,0,3147,259373
8/16/22,Nigeria,9.082,8.6753,262664,0,3147,259517
8/17/22,Nigeria,9.082,8.6753,262664,0,3147,259517
8/18/22,Nigeria,9.082,8.6753,262748,0,3147,259601
8/19/22,Nigeria,9.082,8.6753,262748,0,3147,259601
8/20/22,Nigeria,9.082,8.6753,262912,0,3147,259765
8/21/22,Nigeria,9.082,8.6753,262912,0,3147,259765
8/22/22,Nigeria,9.082,8.6753,262912,0,3147,259765
8/23/22,Nigeria,9.082,8.6753,263090,0,3148,259942
8/24/22,Nigeria,9.082,8.6753,263090,0,3148,259942
8/25/22,Nigeria,9.082,8.6753,263322,0,3148,260174
8/26/22,Nigeria,9.082,8.6753,263322,0,3148,260174
8/27/22,Nigeria,9.082,8.6753,263407,0,3148,260259
8/28/22,Nigeria,9.082,8.6753,263407,0,3148,260259
8/29/22,Nigeria,9.082,8.6753,263407,0,3148,260259
8/30/22,Nigeria,9.082,8.6753,263526,0,3148,260378
8/31/22,Nigeria,9.082,8.6753,263526,0,3148,260378
9/1/22,Nigeria,9.082,8.6753,263694,0,3148,260546
9/2/22,Nigeria,9.082,8.6753,263694,0,3148,260546
9/3/22,Nigeria,9.082,8.6753,263867,0,3148,260719
9/4/22,Nigeria,9.082,8.6753,263867,0,3148,260719
9/5/22,Nigeria,9.082,8.6753,263867,0,3148,260719
9/6/22,Nigeria,9.082,8.6753,264014,0,3148,260866
9/7/22,Nigeria,9.082,8.6753,264014,0,3148,260866
9/8/22,Nigeria,9.082,8.6753,264299,0,3154,261145
9/9/22,Nigeria,9.082,8.6753,264299,0,3154,261145
9/10/22,Nigeria,9.082,8.6753,264299,0,3154,261145
9/11/22,Nigeria,9.082,8.6753,264450,0,3154,261296
9/12/22,Nigeria,9.082,8.6753,264450,0,3154,261296
9/13/22,Nigeria,9.082,8.6753,264617,0,3155,261462
9/14/22,Nigeria,9.082,8.6753,264617,0,3155,261462
9/15/22,Nigeria,9.082,8.6753,264744,0,3155,261589
9/16/22,Nigeria,9.082,8.6753,264744,0,3155,261589
9/17/22,Nigeria,9.082,8.6753,264933,0,3155,261778
9/18/22,Nigeria,9.082,8.6753,264933,0,3155,261778
9/19/22,Nigeria,9.082,8.6753,264933,0,3155,261778
9/20/22,Nigeria,9.082,8.6753,265008,0,3155,261853
9/21/22,Nigeria,9.082,8.6753,265008,0,3155,261853
9/22/22,Nigeria,9.082,8.6753,265090,0,3155,261935
9/23/22,Nigeria,9.082,8.6753,265090,0,3155,261935
9/24/22,Nigeria,9.082,8.6753,265186,0,3155,262031
9/25/22,Nigeria,9.082,8.6753,265186,0,3155,262031
9/26/22,Nigeria,9.082,8.6753,265186,0,3155,262031
9/27/22,Nigeria,9.082,8.6753,265316,0,3155,262161
9/28/22,Nigeria,9.082,8.6753,265316,0,3155,262161
9/29/22,Nigeria,9.082,8.6753,265382,0,3155,262227
9/30/22,Nigeria,9.082,8.6753,265382,0,3155,262227
10/1/22,Nigeria,9.082,8.6753,265431,0,3155,262276
10/2/22,Nigeria,9.082,8.6753,265431,0,3155,262276
10/3/22,Nigeria,9.082,8.6753,265431,0,3155,262276
10/4/22,Nigeria,9.082,8.6753,265505,0,3155,262350
10/5/22,Nigeria,9.082,8.6753,265505,0,3155,262350
10/6/22,Nigeria,9.082,8.6753,265741,0,3155,262586
10/7/22,Nigeria,9.082,8.6753,265741,0,3155,262586
10/8/22,Nigeria,9.082,8.6753,265816,0,3155,262661
10/9/22,Nigeria,9.082,8.6753,265816,0,3155,262661
10/10/22,Nigeria,9.082,8.6753,265816,0,3155,262661
10/11/22,Nigeria,9.082,8.6753,265816,0,3155,262661
10/12/22,Nigeria,9.082,8.6753,265816,0,3155,262661
10/13/22,Nigeria,9.082,8.6753,265816,0,3155,262661
10/14/22,Nigeria,9.082,8.6753,265816,0,3155,262661
10/15/22,Nigeria,9.082,8.6753,265937,0,3155,262782
10/16/22,Nigeria,9.082,8.6753,265937,0,3155,262782
10/17/22,Nigeria,9.082,8.6753,265937,0,3155,262782
10/18/22,Nigeria,9.082,8.6753,265937,0,3155,262782
10/19/22,Nigeria,9.082,8.6753,265937,0,3155,262782
10/20/22,Nigeria,9.082,8.6753,265937,0,3155,262782
10/21/22,Nigeria,9.082,8.6753,265937,0,3155,262782
10/22/22,Nigeria,9.082,8.6753,266043,0,3155,262888
10/23/22,Nigeria,9.082,8.6753,266043,0,3155,262888
10/24/22,Nigeria,9.082,8.6753,266043,0,3155,262888
10/25/22,Nigeria,9.082,8.6753,266043,0,3155,262888
10/26/22,Nigeria,9.082,8.6753,266043,0,3155,262888
10/27/22,Nigeria,9.082,8.6753,266043,0,3155,262888
10/28/22,Nigeria,9.082,8.6753,266043,0,3155,262888
10/29/22,Nigeria,9.082,8.6753,266138,0,3155,262983
10/30/22,Nigeria,9.082,8.6753,266138,0,3155,262983
10/31/22,Nigeria,9.082,8.6753,266138,0,3155,262983
11/1/22,Nigeria,9.082,8.6753,266138,0,3155,262983
11/2/22,Nigeria,9.082,8.6753,266138,0,3155,262983
11/3/22,Nigeria,9.082,8.6753,266138,0,3155,262983
11/4/22,Nigeria,9.082,8.6753,266138,0,3155,262983
11/5/22,Nigeria,9.082,8.6753,266192,0,3155,263037
11/6/22,Nigeria,9.082,8.6753,266192,0,3155,263037
11/7/22,Nigeria,9.082,8.6753,266192,0,3155,263037
11/8/22,Nigeria,9.082,8.6753,266192,0,3155,263037
11/9/22,Nigeria,9.082,8.6753,266192,0,3155,263037
11/10/22,Nigeria,9.082,8.6753,266192,0,3155,263037
11/11/22,Nigeria,9.082,8.6753,266192,0,3155,263037
11/12/22,Nigeria,9.082,8.6753,266242,0,3155,263087
11/13/22,Nigeria,9.082,8.6753,266242,0,3155,263087
11/14/22,Nigeria,9.082,8.6753,266242,0,3155,263087
11/15/22,Nigeria,9.082,8.6753,266242,0,3155,263087
11/16/22,Nigeria,9.082,8.6753,266242,0,3155,263087
11/17/22,Nigeria,9.082,8.6753,266242,0,3155,263087
11/18/22,Nigeria,9.082,8.6753,266242,0,3155,263087
11/19/22,Nigeria,9.082,8.6753,266283,0,3155,263128
11/20/22,Nigeria,9.082,8.6753,266283,0,3155,263128
11/21/22,Nigeria,9.082,8.6753,266283,0,3155,263128
11/22/22,Nigeria,9.082,8.6753,266283,0,3155,263128
11/23/22,Nigeria,9.082,8.6753,266283,0,3155,263128
11/24/22,Nigeria,9.082,8.6753,266283,0,3155,263128
11/25/22,Nigeria,9.082,8.6753,266283,0,3155,263128
11/26/22,Nigeria,9.082,8.6753,266283,0,3155,263128
11/27/22,Nigeria,9.082,8.6753,266283,0,3155,263128
11/28/22,Nigeria,9.082,8.6753,266283,0,3155,263128
11/29/22,Nigeria,9.082,8.6753,266283,0,3155,263128
11/30/22,Nigeria,9.082,8.6753,266283,0,3155,263128
12/1/22,Nigeria,9.082,8.6753,266283,0,3155,263128
12/2/22,Nigeria,9.082,8.6753,266283,0,3155,263128
12/3/22,Nigeria,9.082,8.6753,266283,0,3155,263128
12/4/22,Nigeria,9.082,8.6753,266283,0,3155,263128
12/5/22,Nigeria,9.082,8.6753,266283,0,3155,263128
12/6/22,Nigeria,9.082,8.6753,266283,0,3155,263128
12/7/22,Nigeria,9.082,8.6753,266283,0,3155,263128
12/8/22,Nigeria,9.082,8.6753,266283,0,3155,263128
12/9/22,Nigeria,9.082,8.6753,266283,0,3155,263128
12/10/22,Nigeria,9.082,8.6753,266283,0,3155,263128
12/11/22,Nigeria,9.082,8.6753,266283,0,3155,263128
12/12/22,Nigeria,9.082,8.6753,266381,0,3155,263226
12/13/22,Nigeria,9.082,8.6753,266381,0,3155,263226
12/14/22,Nigeria,9.082,8.6753,266381,0,3155,263226
12/15/22,Nigeria,9.082,8.6753,266381,0,3155,263226
12/16/22,Nigeria,9.082,8.6753,266381,0,3155,263226
12/17/22,Nigeria,9.082,8.6753,266381,0,3155,263226
1/1/22,North Macedonia,41.6086,21.7453,225484,0,7969,217515
1/2/22,North Macedonia,41.6086,21.7453,225730,0,7975,217755
1/3/22,North Macedonia,41.6086,21.7453,225972,0,7981,217991
1/4/22,North Macedonia,41.6086,21.7453,227168,0,7996,219172
1/5/22,North Macedonia,41.6086,21.7453,228540,0,8000,220540
1/6/22,North Macedonia,41.6086,21.7453,230265,0,8002,222263
1/7/22,North Macedonia,41.6086,21.7453,231436,0,8012,223424
1/8/22,North Macedonia,41.6086,21.7453,232068,0,8023,224045
1/9/22,North Macedonia,41.6086,21.7453,233464,0,8032,225432
1/10/22,North Macedonia,41.6086,21.7453,234277,0,8042,226235
1/11/22,North Macedonia,41.6086,21.7453,236241,0,8055,228186
1/12/22,North Macedonia,41.6086,21.7453,238061,0,8062,229999
1/13/22,North Macedonia,41.6086,21.7453,239920,0,8070,231850
1/14/22,North Macedonia,41.6086,21.7453,241651,0,8083,233568
1/15/22,North Macedonia,41.6086,21.7453,243284,0,8092,235192
1/16/22,North Macedonia,41.6086,21.7453,244632,0,8100,236532
1/17/22,North Macedonia,41.6086,21.7453,245398,0,8115,237283
1/18/22,North Macedonia,41.6086,21.7453,247663,0,8139,239524
1/19/22,North Macedonia,41.6086,21.7453,249704,0,8153,241551
1/20/22,North Macedonia,41.6086,21.7453,250876,0,8166,242710
1/21/22,North Macedonia,41.6086,21.7453,252947,0,8177,244770
1/22/22,North Macedonia,41.6086,21.7453,254857,0,8198,246659
1/23/22,North Macedonia,41.6086,21.7453,256281,0,8218,248063
1/24/22,North Macedonia,41.6086,21.7453,256996,0,8240,248756
1/25/22,North Macedonia,41.6086,21.7453,259328,0,8266,251062
1/26/22,North Macedonia,41.6086,21.7453,261347,0,8285,253062
1/27/22,North Macedonia,41.6086,21.7453,263206,0,8312,254894
1/28/22,North Macedonia,41.6086,21.7453,265101,0,8338,256763
1/29/22,North Macedonia,41.6086,21.7453,266937,0,8362,258575
1/30/22,North Macedonia,41.6086,21.7453,268191,0,8383,259808
1/31/22,North Macedonia,41.6086,21.7453,268901,0,8409,260492
2/1/22,North Macedonia,41.6086,21.7453,270897,0,8444,262453
2/2/22,North Macedonia,41.6086,21.7453,272437,0,8470,263967
2/3/22,North Macedonia,41.6086,21.7453,274144,0,8494,265650
2/4/22,North Macedonia,41.6086,21.7453,275637,0,8533,267104
2/5/22,North Macedonia,41.6086,21.7453,277137,0,8549,268588
2/6/22,North Macedonia,41.6086,21.7453,278182,0,8578,269604
2/7/22,North Macedonia,41.6086,21.7453,278872,0,8599,270273
2/8/22,North Macedonia,41.6086,21.7453,280594,0,8624,271970
2/9/22,North Macedonia,41.6086,21.7453,282147,0,8658,273489
2/10/22,North Macedonia,41.6086,21.7453,283547,0,8686,274861
2/11/22,North Macedonia,41.6086,21.7453,284875,0,8705,276170
2/12/22,North Macedonia,41.6086,21.7453,286096,0,8736,277360
2/13/22,North Macedonia,41.6086,21.7453,287016,0,8747,278269
2/14/22,North Macedonia,41.6086,21.7453,287481,0,8768,278713
2/15/22,North Macedonia,41.6086,21.7453,288750,0,8793,279957
2/16/22,North Macedonia,41.6086,21.7453,289797,0,8829,280968
2/17/22,North Macedonia,41.6086,21.7453,290915,0,8851,282064
2/18/22,North Macedonia,41.6086,21.7453,291820,0,8869,282951
2/19/22,North Macedonia,41.6086,21.7453,292660,0,8891,283769
2/20/22,North Macedonia,41.6086,21.7453,293328,0,8898,284430
2/21/22,North Macedonia,41.6086,21.7453,293559,0,8915,284644
2/22/22,North Macedonia,41.6086,21.7453,294407,0,8937,285470
2/23/22,North Macedonia,41.6086,21.7453,295082,0,8958,286124
2/24/22,North Macedonia,41.6086,21.7453,295712,0,8968,286744
2/25/22,North Macedonia,41.6086,21.7453,296229,0,8981,287248
2/26/22,North Macedonia,41.6086,21.7453,296703,0,8994,287709
2/27/22,North Macedonia,41.6086,21.7453,297081,0,9001,288080
2/28/22,North Macedonia,41.6086,21.7453,297262,0,9010,288252
3/1/22,North Macedonia,41.6086,21.7453,297738,0,9027,288711
3/2/22,North Macedonia,41.6086,21.7453,298195,0,9036,289159
3/3/22,North Macedonia,41.6086,21.7453,298661,0,9050,289611
3/4/22,North Macedonia,41.6086,21.7453,299049,0,9065,289984
3/5/22,North Macedonia,41.6086,21.7453,299419,0,9075,290344
3/6/22,North Macedonia,41.6086,21.7453,299642,0,9079,290563
3/7/22,North Macedonia,41.6086,21.7453,299766,0,9086,290680
3/8/22,North Macedonia,41.6086,21.7453,300106,0,9097,291009
3/9/22,North Macedonia,41.6086,21.7453,300398,0,9104,291294
3/10/22,North Macedonia,41.6086,21.7453,300714,0,9117,291597
3/11/22,North Macedonia,41.6086,21.7453,301016,0,9123,291893
3/12/22,North Macedonia,41.6086,21.7453,301293,0,9137,292156
3/13/22,North Macedonia,41.6086,21.7453,301491,0,9146,292345
3/14/22,North Macedonia,41.6086,21.7453,301583,0,9150,292433
3/15/22,North Macedonia,41.6086,21.7453,301895,0,9155,292740
3/16/22,North Macedonia,41.6086,21.7453,302224,0,9159,293065
3/17/22,North Macedonia,41.6086,21.7453,302548,0,9162,293386
3/18/22,North Macedonia,41.6086,21.7453,302867,0,9164,293703
3/19/22,North Macedonia,41.6086,21.7453,303140,0,9172,293968
3/20/22,North Macedonia,41.6086,21.7453,303354,0,9180,294174
3/21/22,North Macedonia,41.6086,21.7453,303418,0,9184,294234
3/22/22,North Macedonia,41.6086,21.7453,303728,0,9187,294541
3/23/22,North Macedonia,41.6086,21.7453,304047,0,9188,294859
3/24/22,North Macedonia,41.6086,21.7453,304326,0,9191,295135
3/25/22,North Macedonia,41.6086,21.7453,304648,0,9197,295451
3/26/22,North Macedonia,41.6086,21.7453,304878,0,9203,295675
3/27/22,North Macedonia,41.6086,21.7453,305066,0,9206,295860
3/28/22,North Macedonia,41.6086,21.7453,305114,0,9208,295906
3/29/22,North Macedonia,41.6086,21.7453,305423,0,9214,296209
3/30/22,North Macedonia,41.6086,21.7453,305717,0,9220,296497
3/31/22,North Macedonia,41.6086,21.7453,305979,0,9221,296758
4/1/22,North Macedonia,41.6086,21.7453,306178,0,9226,296952
4/2/22,North Macedonia,41.6086,21.7453,306474,0,9226,297248
4/3/22,North Macedonia,41.6086,21.7453,306670,0,9228,297442
4/4/22,North Macedonia,41.6086,21.7453,306711,0,9231,297480
4/5/22,North Macedonia,41.6086,21.7453,306947,0,9231,297716
4/6/22,North Macedonia,41.6086,21.7453,307142,0,9234,297908
4/7/22,North Macedonia,41.6086,21.7453,307344,0,9236,298108
4/8/22,North Macedonia,41.6086,21.7453,307507,0,9240,298267
4/9/22,North Macedonia,41.6086,21.7453,307654,0,9244,298410
4/10/22,North Macedonia,41.6086,21.7453,307796,0,9251,298545
4/11/22,North Macedonia,41.6086,21.7453,307817,0,9252,298565
4/12/22,North Macedonia,41.6086,21.7453,307967,0,9256,298711
4/13/22,North Macedonia,41.6086,21.7453,308152,0,9256,298896
4/14/22,North Macedonia,41.6086,21.7453,308294,0,9260,299034
4/15/22,North Macedonia,41.6086,21.7453,308390,0,9261,299129
4/16/22,North Macedonia,41.6086,21.7453,308516,0,9261,299255
4/17/22,North Macedonia,41.6086,21.7453,308605,0,9261,299344
4/18/22,North Macedonia,41.6086,21.7453,308620,0,9262,299358
4/19/22,North Macedonia,41.6086,21.7453,308752,0,9263,299489
4/20/22,North Macedonia,41.6086,21.7453,308878,0,9265,299613
4/21/22,North Macedonia,41.6086,21.7453,308964,0,9266,299698
4/22/22,North Macedonia,41.6086,21.7453,309062,0,9271,299791
4/23/22,North Macedonia,41.6086,21.7453,309062,0,9271,299791
4/24/22,North Macedonia,41.6086,21.7453,309062,0,9271,299791
4/25/22,North Macedonia,41.6086,21.7453,309208,0,9276,299932
4/26/22,North Macedonia,41.6086,21.7453,309229,0,9277,299952
4/27/22,North Macedonia,41.6086,21.7453,309310,0,9278,300032
4/28/22,North Macedonia,41.6086,21.7453,309434,0,9278,300156
4/29/22,North Macedonia,41.6086,21.7453,309571,0,9280,300291
4/30/22,North Macedonia,41.6086,21.7453,309571,0,9280,300291
5/1/22,North Macedonia,41.6086,21.7453,309571,0,9280,300291
5/2/22,North Macedonia,41.6086,21.7453,309769,0,9280,300489
5/3/22,North Macedonia,41.6086,21.7453,309790,0,9282,300508
5/4/22,North Macedonia,41.6086,21.7453,309925,0,9283,300642
5/5/22,North Macedonia,41.6086,21.7453,310063,0,9284,300779
5/6/22,North Macedonia,41.6086,21.7453,310063,0,9284,300779
5/7/22,North Macedonia,41.6086,21.7453,310140,0,9284,300856
5/8/22,North Macedonia,41.6086,21.7453,310140,0,9284,300856
5/9/22,North Macedonia,41.6086,21.7453,310298,0,9287,301011
5/10/22,North Macedonia,41.6086,21.7453,310413,0,9287,301126
5/11/22,North Macedonia,41.6086,21.7453,310506,0,9287,301219
5/12/22,North Macedonia,41.6086,21.7453,310595,0,9287,301308
5/13/22,North Macedonia,41.6086,21.7453,310684,0,9289,301395
5/14/22,North Macedonia,41.6086,21.7453,310684,0,9289,301395
5/15/22,North Macedonia,41.6086,21.7453,310684,0,9289,301395
5/16/22,North Macedonia,41.6086,21.7453,310859,0,9291,301568
5/17/22,North Macedonia,41.6086,21.7453,310942,0,9293,301649
5/18/22,North Macedonia,41.6086,21.7453,311038,0,9293,301745
5/19/22,North Macedonia,41.6086,21.7453,311113,0,9296,301817
5/20/22,North Macedonia,41.6086,21.7453,311113,0,9296,301817
5/21/22,North Macedonia,41.6086,21.7453,311113,0,9296,301817
5/22/22,North Macedonia,41.6086,21.7453,311199,0,9297,301902
5/23/22,North Macedonia,41.6086,21.7453,311350,0,9297,302053
5/24/22,North Macedonia,41.6086,21.7453,311350,0,9297,302053
5/25/22,North Macedonia,41.6086,21.7453,311484,0,9300,302184
5/26/22,North Macedonia,41.6086,21.7453,311592,0,9300,302292
5/27/22,North Macedonia,41.6086,21.7453,311701,0,9300,302401
5/28/22,North Macedonia,41.6086,21.7453,311701,0,9300,302401
5/29/22,North Macedonia,41.6086,21.7453,311701,0,9300,302401
5/30/22,North Macedonia,41.6086,21.7453,311851,0,9303,302548
5/31/22,North Macedonia,41.6086,21.7453,311936,0,9303,302633
6/1/22,North Macedonia,41.6086,21.7453,312022,0,9306,302716
6/2/22,North Macedonia,41.6086,21.7453,312097,0,9307,302790
6/3/22,North Macedonia,41.6086,21.7453,312157,0,9309,302848
6/4/22,North Macedonia,41.6086,21.7453,312157,0,9309,302848
6/5/22,North Macedonia,41.6086,21.7453,312157,0,9309,302848
6/6/22,North Macedonia,41.6086,21.7453,312292,0,9309,302983
6/7/22,North Macedonia,41.6086,21.7453,312345,0,9311,303034
6/8/22,North Macedonia,41.6086,21.7453,312418,0,9313,303105
6/9/22,North Macedonia,41.6086,21.7453,312473,0,9313,303160
6/10/22,North Macedonia,41.6086,21.7453,312538,0,9316,303222
6/11/22,North Macedonia,41.6086,21.7453,312538,0,9316,303222
6/12/22,North Macedonia,41.6086,21.7453,312538,0,9316,303222
6/13/22,North Macedonia,41.6086,21.7453,312607,0,9316,303291
6/14/22,North Macedonia,41.6086,21.7453,312673,0,9316,303357
6/15/22,North Macedonia,41.6086,21.7453,312748,0,9318,303430
6/16/22,North Macedonia,41.6086,21.7453,312807,0,9320,303487
6/17/22,North Macedonia,41.6086,21.7453,312879,0,9322,303557
6/18/22,North Macedonia,41.6086,21.7453,312879,0,9322,303557
6/19/22,North Macedonia,41.6086,21.7453,312879,0,9322,303557
6/20/22,North Macedonia,41.6086,21.7453,312960,0,9322,303638
6/21/22,North Macedonia,41.6086,21.7453,313050,0,9322,303728
6/22/22,North Macedonia,41.6086,21.7453,313160,0,9322,303838
6/23/22,North Macedonia,41.6086,21.7453,313252,0,9322,303930
6/24/22,North Macedonia,41.6086,21.7453,313360,0,9322,304038
6/25/22,North Macedonia,41.6086,21.7453,313360,0,9322,304038
6/26/22,North Macedonia,41.6086,21.7453,313360,0,9322,304038
6/27/22,North Macedonia,41.6086,21.7453,313540,0,9322,304218
6/28/22,North Macedonia,41.6086,21.7453,313708,0,9322,304386
6/29/22,North Macedonia,41.6086,21.7453,313856,0,9323,304533
6/30/22,North Macedonia,41.6086,21.7453,314018,0,9325,304693
7/1/22,North Macedonia,41.6086,21.7453,314211,0,9327,304884
7/2/22,North Macedonia,41.6086,21.7453,314211,0,9327,304884
7/3/22,North Macedonia,41.6086,21.7453,314211,0,9327,304884
7/4/22,North Macedonia,41.6086,21.7453,314501,0,9327,305174
7/5/22,North Macedonia,41.6086,21.7453,314794,0,9327,305467
7/6/22,North Macedonia,41.6086,21.7453,315060,0,9327,305733
7/7/22,North Macedonia,41.6086,21.7453,315402,0,9329,306073
7/8/22,North Macedonia,41.6086,21.7453,315699,0,9331,306368
7/9/22,North Macedonia,41.6086,21.7453,315699,0,9331,306368
7/10/22,North Macedonia,41.6086,21.7453,315699,0,9331,306368
7/11/22,North Macedonia,41.6086,21.7453,316219,0,9335,306884
7/12/22,North Macedonia,41.6086,21.7453,316729,0,9337,307392
7/13/22,North Macedonia,41.6086,21.7453,317140,0,9337,307803
7/14/22,North Macedonia,41.6086,21.7453,317634,0,9337,308297
7/15/22,North Macedonia,41.6086,21.7453,318138,0,9339,308799
7/16/22,North Macedonia,41.6086,21.7453,318138,0,9339,308799
7/17/22,North Macedonia,41.6086,21.7453,318138,0,9339,308799
7/18/22,North Macedonia,41.6086,21.7453,319037,0,9339,309698
7/19/22,North Macedonia,41.6086,21.7453,319806,0,9343,310463
7/20/22,North Macedonia,41.6086,21.7453,320598,0,9345,311253
7/21/22,North Macedonia,41.6086,21.7453,321386,0,9349,312037
7/22/22,North Macedonia,41.6086,21.7453,322165,0,9353,312812
7/23/22,North Macedonia,41.6086,21.7453,322165,0,9353,312812
7/24/22,North Macedonia,41.6086,21.7453,322165,0,9353,312812
7/25/22,North Macedonia,41.6086,21.7453,323425,0,9359,314066
7/26/22,North Macedonia,41.6086,21.7453,324382,0,9361,315021
7/27/22,North Macedonia,41.6086,21.7453,325279,0,9361,315918
7/28/22,North Macedonia,41.6086,21.7453,326154,0,9368,316786
7/29/22,North Macedonia,41.6086,21.7453,327009,0,9370,317639
7/30/22,North Macedonia,41.6086,21.7453,327009,0,9370,317639
7/31/22,North Macedonia,41.6086,21.7453,327009,0,9370,317639
8/1/22,North Macedonia,41.6086,21.7453,328180,0,9373,318807
8/2/22,North Macedonia,41.6086,21.7453,328995,0,9377,319618
8/3/22,North Macedonia,41.6086,21.7453,329172,0,9381,319791
8/4/22,North Macedonia,41.6086,21.7453,330016,0,9387,320629
8/5/22,North Macedonia,41.6086,21.7453,330755,0,9388,321367
8/6/22,North Macedonia,41.6086,21.7453,330755,0,9388,321367
8/7/22,North Macedonia,41.6086,21.7453,330755,0,9388,321367
8/8/22,North Macedonia,41.6086,21.7453,331988,0,9398,322590
8/9/22,North Macedonia,41.6086,21.7453,332667,0,9398,323269
8/10/22,North Macedonia,41.6086,21.7453,333360,0,9400,323960
8/11/22,North Macedonia,41.6086,21.7453,333948,0,9410,324538
8/12/22,North Macedonia,41.6086,21.7453,334562,0,9414,325148
8/13/22,North Macedonia,41.6086,21.7453,334562,0,9414,325148
8/14/22,North Macedonia,41.6086,21.7453,334562,0,9414,325148
8/15/22,North Macedonia,41.6086,21.7453,335451,0,9424,326027
8/16/22,North Macedonia,41.6086,21.7453,336041,0,9426,326615
8/17/22,North Macedonia,41.6086,21.7453,336560,0,9429,327131
8/18/22,North Macedonia,41.6086,21.7453,337040,0,9437,327603
8/19/22,North Macedonia,41.6086,21.7453,337513,0,9440,328073
8/20/22,North Macedonia,41.6086,21.7453,337513,0,9440,328073
8/21/22,North Macedonia,41.6086,21.7453,337513,0,9440,328073
8/22/22,North Macedonia,41.6086,21.7453,338120,0,9450,328670
8/23/22,North Macedonia,41.6086,21.7453,338549,0,9455,329094
8/24/22,North Macedonia,41.6086,21.7453,338929,0,9461,329468
8/25/22,North Macedonia,41.6086,21.7453,339240,0,9468,329772
8/26/22,North Macedonia,41.6086,21.7453,339492,0,9473,330019
8/27/22,North Macedonia,41.6086,21.7453,339492,0,9473,330019
8/28/22,North Macedonia,41.6086,21.7453,339492,0,9473,330019
8/29/22,North Macedonia,41.6086,21.7453,339881,0,9477,330404
8/30/22,North Macedonia,41.6086,21.7453,340119,0,9481,330638
8/31/22,North Macedonia,41.6086,21.7453,340341,0,9489,330852
9/1/22,North Macedonia,41.6086,21.7453,340510,0,9490,331020
9/2/22,North Macedonia,41.6086,21.7453,340695,0,9495,331200
9/3/22,North Macedonia,41.6086,21.7453,340695,0,9495,331200
9/4/22,North Macedonia,41.6086,21.7453,340695,0,9495,331200
9/5/22,North Macedonia,41.6086,21.7453,340948,0,9499,331449
9/6/22,North Macedonia,41.6086,21.7453,341127,0,9499,331628
9/7/22,North Macedonia,41.6086,21.7453,341261,0,9502,331759
9/8/22,North Macedonia,41.6086,21.7453,341370,0,9503,331867
9/9/22,North Macedonia,41.6086,21.7453,341404,0,9506,331898
9/10/22,North Macedonia,41.6086,21.7453,341404,0,9506,331898
9/11/22,North Macedonia,41.6086,21.7453,341404,0,9506,331898
9/12/22,North Macedonia,41.6086,21.7453,341583,0,9512,332071
9/13/22,North Macedonia,41.6086,21.7453,341748,0,9515,332233
9/14/22,North Macedonia,41.6086,21.7453,341889,0,9516,332373
9/15/22,North Macedonia,41.6086,21.7453,341986,0,9520,332466
9/16/22,North Macedonia,41.6086,21.7453,342075,0,9521,332554
9/17/22,North Macedonia,41.6086,21.7453,342075,0,9521,332554
9/18/22,North Macedonia,41.6086,21.7453,342075,0,9521,332554
9/19/22,North Macedonia,41.6086,21.7453,342248,0,9524,332724
9/20/22,North Macedonia,41.6086,21.7453,342323,0,9524,332799
9/21/22,North Macedonia,41.6086,21.7453,342413,0,9524,332889
9/22/22,North Macedonia,41.6086,21.7453,342469,0,9526,332943
9/23/22,North Macedonia,41.6086,21.7453,342519,0,9527,332992
9/24/22,North Macedonia,41.6086,21.7453,342519,0,9527,332992
9/25/22,North Macedonia,41.6086,21.7453,342519,0,9527,332992
9/26/22,North Macedonia,41.6086,21.7453,342615,0,9531,333084
9/27/22,North Macedonia,41.6086,21.7453,342696,0,9531,333165
9/28/22,North Macedonia,41.6086,21.7453,342775,0,9535,333240
9/29/22,North Macedonia,41.6086,21.7453,342880,0,9534,333346
9/30/22,North Macedonia,41.6086,21.7453,342961,0,9534,333427
10/1/22,North Macedonia,41.6086,21.7453,342961,0,9534,333427
10/2/22,North Macedonia,41.6086,21.7453,342961,0,9534,333427
10/3/22,North Macedonia,41.6086,21.7453,343069,0,9537,333532
10/4/22,North Macedonia,41.6086,21.7453,343143,0,9539,333604
10/5/22,North Macedonia,41.6086,21.7453,343208,0,9542,333666
10/6/22,North Macedonia,41.6086,21.7453,343263,0,9542,333721
10/7/22,North Macedonia,41.6086,21.7453,343319,0,9544,333775
10/8/22,North Macedonia,41.6086,21.7453,343319,0,9544,333775
10/9/22,North Macedonia,41.6086,21.7453,343319,0,9544,333775
10/10/22,North Macedonia,41.6086,21.7453,343391,0,9548,333843
10/11/22,North Macedonia,41.6086,21.7453,343391,0,9548,333843
10/12/22,North Macedonia,41.6086,21.7453,343462,0,9551,333911
10/13/22,North Macedonia,41.6086,21.7453,343515,0,9551,333964
10/14/22,North Macedonia,41.6086,21.7453,343585,0,9551,334034
10/15/22,North Macedonia,41.6086,21.7453,343585,0,9551,334034
10/16/22,North Macedonia,41.6086,21.7453,343585,0,9551,334034
10/17/22,North Macedonia,41.6086,21.7453,343665,0,9553,334112
10/18/22,North Macedonia,41.6086,21.7453,343722,0,9554,334168
10/19/22,North Macedonia,41.6086,21.7453,343824,0,9556,334268
10/20/22,North Macedonia,41.6086,21.7453,343800,0,9559,334241
10/21/22,North Macedonia,41.6086,21.7453,343850,0,9559,334291
10/22/22,North Macedonia,41.6086,21.7453,343850,0,9559,334291
10/23/22,North Macedonia,41.6086,21.7453,343850,0,9559,334291
10/24/22,North Macedonia,41.6086,21.7453,343916,0,9559,334357
10/25/22,North Macedonia,41.6086,21.7453,343927,0,9561,334366
10/26/22,North Macedonia,41.6086,21.7453,343964,0,9561,334403
10/27/22,North Macedonia,41.6086,21.7453,344031,0,9564,334467
10/28/22,North Macedonia,41.6086,21.7453,344075,0,9564,334511
10/29/22,North Macedonia,41.6086,21.7453,344075,0,9564,334511
10/30/22,North Macedonia,41.6086,21.7453,344075,0,9564,334511
10/31/22,North Macedonia,41.6086,21.7453,344146,0,9564,334582
11/1/22,North Macedonia,41.6086,21.7453,344146,0,9564,334582
11/2/22,North Macedonia,41.6086,21.7453,344146,0,9564,334582
11/3/22,North Macedonia,41.6086,21.7453,344146,0,9564,334582
11/4/22,North Macedonia,41.6086,21.7453,344146,0,9564,334582
11/5/22,North Macedonia,41.6086,21.7453,344146,0,9564,334582
11/6/22,North Macedonia,41.6086,21.7453,344146,0,9564,334582
11/7/22,North Macedonia,41.6086,21.7453,344146,0,9564,334582
11/8/22,North Macedonia,41.6086,21.7453,344146,0,9564,334582
11/9/22,North Macedonia,41.6086,21.7453,344342,0,9564,334778
11/10/22,North Macedonia,41.6086,21.7453,344342,0,9564,334778
11/11/22,North Macedonia,41.6086,21.7453,344342,0,9564,334778
11/12/22,North Macedonia,41.6086,21.7453,344342,0,9564,334778
11/13/22,North Macedonia,41.6086,21.7453,344342,0,9564,334778
11/14/22,North Macedonia,41.6086,21.7453,344342,0,9564,334778
11/15/22,North Macedonia,41.6086,21.7453,344342,0,9564,334778
11/16/22,North Macedonia,41.6086,21.7453,344342,0,9564,334778
11/17/22,North Macedonia,41.6086,21.7453,344531,0,9567,334964
11/18/22,North Macedonia,41.6086,21.7453,344531,0,9567,334964
11/19/22,North Macedonia,41.6086,21.7453,344531,0,9567,334964
11/20/22,North Macedonia,41.6086,21.7453,344531,0,9567,334964
11/21/22,North Macedonia,41.6086,21.7453,344531,0,9567,334964
11/22/22,North Macedonia,41.6086,21.7453,344531,0,9567,334964
11/23/22,North Macedonia,41.6086,21.7453,344710,0,9568,335142
11/24/22,North Macedonia,41.6086,21.7453,344710,0,9568,335142
11/25/22,North Macedonia,41.6086,21.7453,344710,0,9568,335142
11/26/22,North Macedonia,41.6086,21.7453,344710,0,9568,335142
11/27/22,North Macedonia,41.6086,21.7453,344710,0,9568,335142
11/28/22,North Macedonia,41.6086,21.7453,344710,0,9568,335142
11/29/22,North Macedonia,41.6086,21.7453,344710,0,9568,335142
11/30/22,North Macedonia,41.6086,21.7453,344710,0,9568,335142
12/1/22,North Macedonia,41.6086,21.7453,344872,0,9570,335302
12/2/22,North Macedonia,41.6086,21.7453,344872,0,9570,335302
12/3/22,North Macedonia,41.6086,21.7453,344872,0,9570,335302
12/4/22,North Macedonia,41.6086,21.7453,344872,0,9570,335302
12/5/22,North Macedonia,41.6086,21.7453,344872,0,9591,335281
12/6/22,North Macedonia,41.6086,21.7453,345067,0,9591,335476
12/7/22,North Macedonia,41.6086,21.7453,345067,0,9591,335476
12/8/22,North Macedonia,41.6086,21.7453,345067,0,9591,335476
12/9/22,North Macedonia,41.6086,21.7453,345067,0,9591,335476
12/10/22,North Macedonia,41.6086,21.7453,345067,0,9591,335476
12/11/22,North Macedonia,41.6086,21.7453,345067,0,9591,335476
12/12/22,North Macedonia,41.6086,21.7453,345067,0,9591,335476
12/13/22,North Macedonia,41.6086,21.7453,345197,0,9599,335598
12/14/22,North Macedonia,41.6086,21.7453,345197,0,9599,335598
12/15/22,North Macedonia,41.6086,21.7453,345197,0,9599,335598
12/16/22,North Macedonia,41.6086,21.7453,345197,0,9599,335598
12/17/22,North Macedonia,41.6086,21.7453,345197,0,9599,335598
1/1/22,Norway,60.472,8.4689,396415,0,1305,395110
1/2/22,Norway,60.472,8.4689,399318,0,1305,398013
1/3/22,Norway,60.472,8.4689,404551,0,1305,403246
1/4/22,Norway,60.472,8.4689,412472,0,1307,411165
1/5/22,Norway,60.472,8.4689,420857,0,1349,419508
1/6/22,Norway,60.472,8.4689,428736,0,1349,427387
1/7/22,Norway,60.472,8.4689,434896,0,1350,433546
1/8/22,Norway,60.472,8.4689,440184,0,1350,438834
1/9/22,Norway,60.472,8.4689,444368,0,1350,443018
1/10/22,Norway,60.472,8.4689,450908,0,1350,449558
1/11/22,Norway,60.472,8.4689,460530,0,1350,459180
1/12/22,Norway,60.472,8.4689,472355,0,1372,470983
1/13/22,Norway,60.472,8.4689,483952,0,1381,482571
1/14/22,Norway,60.472,8.4689,496312,0,1381,494931
1/15/22,Norway,60.472,8.4689,504789,0,1381,503408
1/16/22,Norway,60.472,8.4689,512393,0,1381,511012
1/17/22,Norway,60.472,8.4689,523424,0,1382,522042
1/18/22,Norway,60.472,8.4689,538791,0,1383,537408
1/19/22,Norway,60.472,8.4689,554778,0,1412,553366
1/20/22,Norway,60.472,8.4689,571655,0,1413,570242
1/21/22,Norway,60.472,8.4689,596613,0,1414,595199
1/22/22,Norway,60.472,8.4689,609950,0,1414,608536
1/23/22,Norway,60.472,8.4689,622596,0,1414,621182
1/24/22,Norway,60.472,8.4689,641138,0,1414,639724
1/25/22,Norway,60.472,8.4689,665567,0,1416,664151
1/26/22,Norway,60.472,8.4689,690244,0,1439,688805
1/27/22,Norway,60.472,8.4689,714532,0,1439,713093
1/28/22,Norway,60.472,8.4689,736051,0,1439,734612
1/29/22,Norway,60.472,8.4689,751021,0,1439,749582
1/30/22,Norway,60.472,8.4689,765061,0,1439,763622
1/31/22,Norway,60.472,8.4689,781049,0,1440,779609
2/1/22,Norway,60.472,8.4689,804286,0,1440,802846
2/2/22,Norway,60.472,8.4689,827585,0,1467,826118
2/3/22,Norway,60.472,8.4689,849389,0,1467,847922
2/4/22,Norway,60.472,8.4689,870245,0,1467,868778
2/5/22,Norway,60.472,8.4689,883388,0,1467,881921
2/6/22,Norway,60.472,8.4689,893560,0,1467,892093
2/7/22,Norway,60.472,8.4689,911212,0,1467,909745
2/8/22,Norway,60.472,8.4689,937321,0,1467,935854
2/9/22,Norway,60.472,8.4689,962407,0,1512,960895
2/10/22,Norway,60.472,8.4689,986855,0,1513,985342
2/11/22,Norway,60.472,8.4689,1009926,0,1513,1008413
2/12/22,Norway,60.472,8.4689,1024379,0,1513,1022866
2/13/22,Norway,60.472,8.4689,1035753,0,1513,1034240
2/14/22,Norway,60.472,8.4689,1049811,0,1513,1048298
2/15/22,Norway,60.472,8.4689,1068686,0,1513,1067173
2/16/22,Norway,60.472,8.4689,1086614,0,1548,1085066
2/17/22,Norway,60.472,8.4689,1103956,0,1548,1102408
2/18/22,Norway,60.472,8.4689,1119204,0,1548,1117656
2/19/22,Norway,60.472,8.4689,1128763,0,1548,1127215
2/20/22,Norway,60.472,8.4689,1136409,0,1548,1134861
2/21/22,Norway,60.472,8.4689,1151288,0,1549,1149739
2/22/22,Norway,60.472,8.4689,1169037,0,1549,1167488
2/23/22,Norway,60.472,8.4689,1186422,0,1598,1184824
2/24/22,Norway,60.472,8.4689,1202017,0,1598,1200419
2/25/22,Norway,60.472,8.4689,1217306,0,1598,1215708
2/26/22,Norway,60.472,8.4689,1225866,0,1598,1224268
2/27/22,Norway,60.472,8.4689,1231766,0,1598,1230168
2/28/22,Norway,60.472,8.4689,1242160,0,1598,1240562
3/1/22,Norway,60.472,8.4689,1257079,0,1599,1255480
3/2/22,Norway,60.472,8.4689,1279169,0,1664,1277505
3/3/22,Norway,60.472,8.4689,1289884,0,1664,1288220
3/4/22,Norway,60.472,8.4689,1299549,0,1664,1297885
3/5/22,Norway,60.472,8.4689,1305006,0,1664,1303342
3/6/22,Norway,60.472,8.4689,1308342,0,1664,1306678
3/7/22,Norway,60.472,8.4689,1315692,0,1664,1314028
3/8/22,Norway,60.472,8.4689,1325909,0,1664,1324245
3/9/22,Norway,60.472,8.4689,1333793,0,1753,1332040
3/10/22,Norway,60.472,8.4689,1341163,0,1753,1339410
3/11/22,Norway,60.472,8.4689,1346777,0,1753,1345024
3/12/22,Norway,60.472,8.4689,1349971,0,1753,1348218
3/13/22,Norway,60.472,8.4689,1351883,0,1753,1350130
3/14/22,Norway,60.472,8.4689,1357280,0,1753,1355527
3/15/22,Norway,60.472,8.4689,1363406,0,1753,1361653
3/16/22,Norway,60.472,8.4689,1368165,0,1826,1366339
3/17/22,Norway,60.472,8.4689,1372340,0,2169,1370171
3/18/22,Norway,60.472,8.4689,1376239,0,2169,1374070
3/19/22,Norway,60.472,8.4689,1378238,0,2169,1376069
3/20/22,Norway,60.472,8.4689,1379467,0,2169,1377298
3/21/22,Norway,60.472,8.4689,1383227,0,2169,1381058
3/22/22,Norway,60.472,8.4689,1387034,0,2169,1384865
3/23/22,Norway,60.472,8.4689,1390035,0,2339,1387696
3/24/22,Norway,60.472,8.4689,1393061,0,2339,1390722
3/25/22,Norway,60.472,8.4689,1395556,0,2339,1393217
3/26/22,Norway,60.472,8.4689,1396911,0,2339,1394572
3/27/22,Norway,60.472,8.4689,1397638,0,2339,1395299
3/28/22,Norway,60.472,8.4689,1399714,0,2339,1397375
3/29/22,Norway,60.472,8.4689,1402219,0,2339,1399880
3/30/22,Norway,60.472,8.4689,1404207,0,2518,1401689
3/31/22,Norway,60.472,8.4689,1405960,0,2518,1403442
4/1/22,Norway,60.472,8.4689,1407422,0,2518,1404904
4/2/22,Norway,60.472,8.4689,1408257,0,2518,1405739
4/3/22,Norway,60.472,8.4689,1408708,0,2518,1406190
4/4/22,Norway,60.472,8.4689,1410051,0,2518,1407533
4/5/22,Norway,60.472,8.4689,1411550,0,2518,1409032
4/6/22,Norway,60.472,8.4689,1412969,0,2667,1410302
4/7/22,Norway,60.472,8.4689,1413957,0,2667,1411290
4/8/22,Norway,60.472,8.4689,1414993,0,2667,1412326
4/9/22,Norway,60.472,8.4689,1415609,0,2667,1412942
4/10/22,Norway,60.472,8.4689,1415928,0,2667,1413261
4/11/22,Norway,60.472,8.4689,1416712,0,2667,1414045
4/12/22,Norway,60.472,8.4689,1417631,0,2667,1414964
4/13/22,Norway,60.472,8.4689,1418431,0,2783,1415648
4/14/22,Norway,60.472,8.4689,1418814,0,2783,1416031
4/15/22,Norway,60.472,8.4689,1419096,0,2783,1416313
4/16/22,Norway,60.472,8.4689,1419507,0,2783,1416724
4/17/22,Norway,60.472,8.4689,1419729,0,2783,1416946
4/18/22,Norway,60.472,8.4689,1420033,0,2783,1417250
4/19/22,Norway,60.472,8.4689,1420750,0,2783,1417967
4/20/22,Norway,60.472,8.4689,1421691,0,2871,1418820
4/21/22,Norway,60.472,8.4689,1422583,0,2871,1419712
4/22/22,Norway,60.472,8.4689,1423220,0,2871,1420349
4/23/22,Norway,60.472,8.4689,1423509,0,2871,1420638
4/24/22,Norway,60.472,8.4689,1423629,0,2871,1420758
4/25/22,Norway,60.472,8.4689,1424180,0,2871,1421309
4/26/22,Norway,60.472,8.4689,1424672,0,2871,1421801
4/27/22,Norway,60.472,8.4689,1425079,0,2932,1422147
4/28/22,Norway,60.472,8.4689,1425464,0,2932,1422532
4/29/22,Norway,60.472,8.4689,1425809,0,2932,1422877
4/30/22,Norway,60.472,8.4689,1426013,0,2932,1423081
5/1/22,Norway,60.472,8.4689,1426128,0,2932,1423196
5/2/22,Norway,60.472,8.4689,1426491,0,2932,1423559
5/3/22,Norway,60.472,8.4689,1426798,0,2932,1423866
5/4/22,Norway,60.472,8.4689,1427148,0,3006,1424142
5/5/22,Norway,60.472,8.4689,1427485,0,3006,1424479
5/6/22,Norway,60.472,8.4689,1427790,0,3006,1424784
5/7/22,Norway,60.472,8.4689,1427956,0,3006,1424950
5/8/22,Norway,60.472,8.4689,1428010,0,3006,1425004
5/9/22,Norway,60.472,8.4689,1428335,0,3006,1425329
5/10/22,Norway,60.472,8.4689,1428699,0,3006,1425693
5/11/22,Norway,60.472,8.4689,1429064,0,3061,1426003
5/12/22,Norway,60.472,8.4689,1429353,0,3061,1426292
5/13/22,Norway,60.472,8.4689,1429630,0,3061,1426569
5/14/22,Norway,60.472,8.4689,1429717,0,3061,1426656
5/15/22,Norway,60.472,8.4689,1429771,0,3061,1426710
5/16/22,Norway,60.472,8.4689,1430124,0,3061,1427063
5/17/22,Norway,60.472,8.4689,1430173,0,3061,1427112
5/18/22,Norway,60.472,8.4689,1430531,0,3061,1427470
5/19/22,Norway,60.472,8.4689,1430844,0,3061,1427783
5/20/22,Norway,60.472,8.4689,1431126,0,3094,1428032
5/21/22,Norway,60.472,8.4689,1431233,0,3094,1428139
5/22/22,Norway,60.472,8.4689,1431291,0,3094,1428197
5/23/22,Norway,60.472,8.4689,1431697,0,3094,1428603
5/24/22,Norway,60.472,8.4689,1431991,0,3094,1428897
5/25/22,Norway,60.472,8.4689,1432335,0,3141,1429194
5/26/22,Norway,60.472,8.4689,1432443,0,3141,1429302
5/27/22,Norway,60.472,8.4689,1432687,0,3141,1429546
5/28/22,Norway,60.472,8.4689,1432831,0,3141,1429690
5/29/22,Norway,60.472,8.4689,1432888,0,3141,1429747
5/30/22,Norway,60.472,8.4689,1433262,0,3141,1430121
5/31/22,Norway,60.472,8.4689,1433641,0,3141,1430500
6/1/22,Norway,60.472,8.4689,1433986,0,3172,1430814
6/2/22,Norway,60.472,8.4689,1434273,0,3172,1431101
6/3/22,Norway,60.472,8.4689,1434653,0,3172,1431481
6/4/22,Norway,60.472,8.4689,1434750,0,3172,1431578
6/5/22,Norway,60.472,8.4689,1434799,0,3172,1431627
6/6/22,Norway,60.472,8.4689,1434896,0,3172,1431724
6/7/22,Norway,60.472,8.4689,1435285,0,3172,1432113
6/8/22,Norway,60.472,8.4689,1435512,0,3210,1432302
6/9/22,Norway,60.472,8.4689,1436118,0,3210,1432908
6/10/22,Norway,60.472,8.4689,1436598,0,3210,1433388
6/11/22,Norway,60.472,8.4689,1436759,0,3210,1433549
6/12/22,Norway,60.472,8.4689,1436855,0,3210,1433645
6/13/22,Norway,60.472,8.4689,1437343,0,3210,1434133
6/14/22,Norway,60.472,8.4689,1437767,0,3210,1434557
6/15/22,Norway,60.472,8.4689,1438244,0,3250,1434994
6/16/22,Norway,60.472,8.4689,1438813,0,3250,1435563
6/17/22,Norway,60.472,8.4689,1439408,0,3250,1436158
6/18/22,Norway,60.472,8.4689,1439656,0,3250,1436406
6/19/22,Norway,60.472,8.4689,1439751,0,3250,1436501
6/20/22,Norway,60.472,8.4689,1440517,0,3250,1437267
6/21/22,Norway,60.472,8.4689,1441164,0,3250,1437914
6/22/22,Norway,60.472,8.4689,1442071,0,3280,1438791
6/23/22,Norway,60.472,8.4689,1442891,0,3280,1439611
6/24/22,Norway,60.472,8.4689,1443637,0,3280,1440357
6/25/22,Norway,60.472,8.4689,1444043,0,3280,1440763
6/26/22,Norway,60.472,8.4689,1444193,0,3280,1440913
6/27/22,Norway,60.472,8.4689,1445034,0,3280,1441754
6/28/22,Norway,60.472,8.4689,1445824,0,3280,1442544
6/29/22,Norway,60.472,8.4689,1446564,0,3337,1443227
6/30/22,Norway,60.472,8.4689,1447270,0,3337,1443933
7/1/22,Norway,60.472,8.4689,1447885,0,3337,1444548
7/2/22,Norway,60.472,8.4689,1448116,0,3337,1444779
7/3/22,Norway,60.472,8.4689,1448228,0,3337,1444891
7/4/22,Norway,60.472,8.4689,1448679,0,3337,1445342
7/5/22,Norway,60.472,8.4689,1449207,0,3337,1445870
7/6/22,Norway,60.472,8.4689,1449639,0,3415,1446224
7/7/22,Norway,60.472,8.4689,1450111,0,3415,1446696
7/8/22,Norway,60.472,8.4689,1450491,0,3415,1447076
7/9/22,Norway,60.472,8.4689,1450634,0,3415,1447219
7/10/22,Norway,60.472,8.4689,1450730,0,3415,1447315
7/11/22,Norway,60.472,8.4689,1451104,0,3415,1447689
7/12/22,Norway,60.472,8.4689,1451515,0,3415,1448100
7/13/22,Norway,60.472,8.4689,1451854,0,3504,1448350
7/14/22,Norway,60.472,8.4689,1452176,0,3504,1448672
7/15/22,Norway,60.472,8.4689,1452521,0,3504,1449017
7/16/22,Norway,60.472,8.4689,1452668,0,3504,1449164
7/17/22,Norway,60.472,8.4689,1452755,0,3504,1449251
7/18/22,Norway,60.472,8.4689,1453071,0,3504,1449567
7/19/22,Norway,60.472,8.4689,1453430,0,3504,1449926
7/20/22,Norway,60.472,8.4689,1453714,0,3596,1450118
7/21/22,Norway,60.472,8.4689,1453985,0,3596,1450389
7/22/22,Norway,60.472,8.4689,1454266,0,3596,1450670
7/23/22,Norway,60.472,8.4689,1454365,0,3596,1450769
7/24/22,Norway,60.472,8.4689,1454423,0,3596,1450827
7/25/22,Norway,60.472,8.4689,1454675,0,3596,1451079
7/26/22,Norway,60.472,8.4689,1454931,0,3623,1451308
7/27/22,Norway,60.472,8.4689,1455162,0,3623,1451539
7/28/22,Norway,60.472,8.4689,1455414,0,3623,1451791
7/29/22,Norway,60.472,8.4689,1455608,0,3623,1451985
7/30/22,Norway,60.472,8.4689,1455732,0,3623,1452109
7/31/22,Norway,60.472,8.4689,1455796,0,3623,1452173
8/1/22,Norway,60.472,8.4689,1456038,0,3623,1452415
8/2/22,Norway,60.472,8.4689,1456268,0,3623,1452645
8/3/22,Norway,60.472,8.4689,1456493,0,3623,1452870
8/4/22,Norway,60.472,8.4689,1456672,0,3623,1453049
8/5/22,Norway,60.472,8.4689,1456851,0,3623,1453228
8/6/22,Norway,60.472,8.4689,1456922,0,3623,1453299
8/7/22,Norway,60.472,8.4689,1456960,0,3623,1453337
8/8/22,Norway,60.472,8.4689,1457187,0,3623,1453564
8/9/22,Norway,60.472,8.4689,1457385,0,3834,1453551
8/10/22,Norway,60.472,8.4689,1457587,0,3834,1453753
8/11/22,Norway,60.472,8.4689,1457792,0,3834,1453958
8/12/22,Norway,60.472,8.4689,1457988,0,3834,1454154
8/13/22,Norway,60.472,8.4689,1458057,0,3834,1454223
8/14/22,Norway,60.472,8.4689,1458092,0,3834,1454258
8/15/22,Norway,60.472,8.4689,1458291,0,3834,1454457
8/16/22,Norway,60.472,8.4689,1458460,0,3890,1454570
8/17/22,Norway,60.472,8.4689,1458603,0,3890,1454713
8/18/22,Norway,60.472,8.4689,1458751,0,3890,1454861
8/19/22,Norway,60.472,8.4689,1458896,0,3890,1455006
8/20/22,Norway,60.472,8.4689,1458952,0,3890,1455062
8/21/22,Norway,60.472,8.4689,1458987,0,3890,1455097
8/22/22,Norway,60.472,8.4689,1459129,0,3890,1455239
8/23/22,Norway,60.472,8.4689,1459273,0,3908,1455365
8/24/22,Norway,60.472,8.4689,1459426,0,3908,1455518
8/25/22,Norway,60.472,8.4689,1459526,0,3953,1455573
8/26/22,Norway,60.472,8.4689,1459661,0,3953,1455708
8/27/22,Norway,60.472,8.4689,1459704,0,3953,1455751
8/28/22,Norway,60.472,8.4689,1459723,0,3953,1455770
8/29/22,Norway,60.472,8.4689,1459868,0,3953,1455915
8/30/22,Norway,60.472,8.4689,1460011,0,3980,1456031
8/31/22,Norway,60.472,8.4689,1460127,0,3980,1456147
9/1/22,Norway,60.472,8.4689,1460246,0,3980,1456266
9/2/22,Norway,60.472,8.4689,1460366,0,3980,1456386
9/3/22,Norway,60.472,8.4689,1460405,0,3980,1456425
9/4/22,Norway,60.472,8.4689,1460431,0,3980,1456451
9/5/22,Norway,60.472,8.4689,1460554,0,3980,1456574
9/6/22,Norway,60.472,8.4689,1460659,0,4004,1456655
9/7/22,Norway,60.472,8.4689,1460759,0,4004,1456755
9/8/22,Norway,60.472,8.4689,1460826,0,4004,1456822
9/9/22,Norway,60.472,8.4689,1460930,0,4004,1456926
9/10/22,Norway,60.472,8.4689,1460970,0,4004,1456966
9/11/22,Norway,60.472,8.4689,1460995,0,4004,1456991
9/12/22,Norway,60.472,8.4689,1461119,0,4004,1457115
9/13/22,Norway,60.472,8.4689,1461206,0,4004,1457202
9/14/22,Norway,60.472,8.4689,1461296,0,4038,1457258
9/15/22,Norway,60.472,8.4689,1461388,0,4038,1457350
9/16/22,Norway,60.472,8.4689,1461461,0,4038,1457423
9/17/22,Norway,60.472,8.4689,1461488,0,4038,1457450
9/18/22,Norway,60.472,8.4689,1461513,0,4038,1457475
9/19/22,Norway,60.472,8.4689,1461593,0,4038,1457555
9/20/22,Norway,60.472,8.4689,1461667,0,4065,1457602
9/21/22,Norway,60.472,8.4689,1461744,0,4065,1457679
9/22/22,Norway,60.472,8.4689,1461810,0,4065,1457745
9/23/22,Norway,60.472,8.4689,1461884,0,4065,1457819
9/24/22,Norway,60.472,8.4689,1461913,0,4065,1457848
9/25/22,Norway,60.472,8.4689,1461945,0,4065,1457880
9/26/22,Norway,60.472,8.4689,1462050,0,4065,1457985
9/27/22,Norway,60.472,8.4689,1462164,0,4098,1458066
9/28/22,Norway,60.472,8.4689,1462238,0,4098,1458140
9/29/22,Norway,60.472,8.4689,1462318,0,4098,1458220
9/30/22,Norway,60.472,8.4689,1462408,0,4098,1458310
10/1/22,Norway,60.472,8.4689,1462437,0,4098,1458339
10/2/22,Norway,60.472,8.4689,1462456,0,4098,1458358
10/3/22,Norway,60.472,8.4689,1462560,0,4098,1458462
10/4/22,Norway,60.472,8.4689,1462647,0,4121,1458526
10/5/22,Norway,60.472,8.4689,1462738,0,4121,1458617
10/6/22,Norway,60.472,8.4689,1462817,0,4121,1458696
10/7/22,Norway,60.472,8.4689,1462908,0,4121,1458787
10/8/22,Norway,60.472,8.4689,1462945,0,4121,1458824
10/9/22,Norway,60.472,8.4689,1462971,0,4121,1458850
10/10/22,Norway,60.472,8.4689,1463093,0,4121,1458972
10/11/22,Norway,60.472,8.4689,1463170,0,4153,1459017
10/12/22,Norway,60.472,8.4689,1463252,0,4153,1459099
10/13/22,Norway,60.472,8.4689,1463324,0,4153,1459171
10/14/22,Norway,60.472,8.4689,1463397,0,4153,1459244
10/15/22,Norway,60.472,8.4689,1463438,0,4153,1459285
10/16/22,Norway,60.472,8.4689,1463464,0,4153,1459311
10/17/22,Norway,60.472,8.4689,1463571,0,4153,1459418
10/18/22,Norway,60.472,8.4689,1463668,0,4153,1459515
10/19/22,Norway,60.472,8.4689,1463751,0,4154,1459597
10/20/22,Norway,60.472,8.4689,1463839,0,4187,1459652
10/21/22,Norway,60.472,8.4689,1463927,0,4187,1459740
10/22/22,Norway,60.472,8.4689,1463958,0,4187,1459771
10/23/22,Norway,60.472,8.4689,1463998,0,4187,1459811
10/24/22,Norway,60.472,8.4689,1464124,0,4187,1459937
10/25/22,Norway,60.472,8.4689,1464236,0,4208,1460028
10/26/22,Norway,60.472,8.4689,1464381,0,4208,1460173
10/27/22,Norway,60.472,8.4689,1464520,0,4208,1460312
10/28/22,Norway,60.472,8.4689,1464651,0,4208,1460443
10/29/22,Norway,60.472,8.4689,1464715,0,4208,1460507
10/30/22,Norway,60.472,8.4689,1464752,0,4208,1460544
10/31/22,Norway,60.472,8.4689,1464946,0,4208,1460738
11/1/22,Norway,60.472,8.4689,1465102,0,4238,1460864
11/2/22,Norway,60.472,8.4689,1465238,0,4238,1461000
11/3/22,Norway,60.472,8.4689,1465398,0,4238,1461160
11/4/22,Norway,60.472,8.4689,1465523,0,4238,1461285
11/5/22,Norway,60.472,8.4689,1465584,0,4238,1461346
11/6/22,Norway,60.472,8.4689,1465631,0,4238,1461393
11/7/22,Norway,60.472,8.4689,1465824,0,4238,1461586
11/8/22,Norway,60.472,8.4689,1465992,0,4238,1461754
11/9/22,Norway,60.472,8.4689,1466164,0,4286,1461878
11/10/22,Norway,60.472,8.4689,1466313,0,4286,1462027
11/11/22,Norway,60.472,8.4689,1466466,0,4286,1462180
11/12/22,Norway,60.472,8.4689,1466523,0,4286,1462237
11/13/22,Norway,60.472,8.4689,1466568,0,4286,1462282
11/14/22,Norway,60.472,8.4689,1466725,0,4286,1462439
11/15/22,Norway,60.472,8.4689,1466855,0,4286,1462569
11/16/22,Norway,60.472,8.4689,1466962,0,4286,1462676
11/17/22,Norway,60.472,8.4689,1467160,0,4286,1462874
11/18/22,Norway,60.472,8.4689,1467328,0,4325,1463003
11/19/22,Norway,60.472,8.4689,1467402,0,4325,1463077
11/20/22,Norway,60.472,8.4689,1467455,0,4325,1463130
11/21/22,Norway,60.472,8.4689,1467622,0,4332,1463290
11/22/22,Norway,60.472,8.4689,1467775,0,4332,1463443
11/23/22,Norway,60.472,8.4689,1467945,0,4332,1463613
11/24/22,Norway,60.472,8.4689,1468135,0,4332,1463803
11/25/22,Norway,60.472,8.4689,1468341,0,4384,1463957
11/26/22,Norway,60.472,8.4689,1468419,0,4384,1464035
11/27/22,Norway,60.472,8.4689,1468473,0,4384,1464089
11/28/22,Norway,60.472,8.4689,1468663,0,4384,1464279
11/29/22,Norway,60.472,8.4689,1468876,0,4384,1464492
11/30/22,Norway,60.472,8.4689,1469061,0,4384,1464677
12/1/22,Norway,60.472,8.4689,1469233,0,4384,1464849
12/2/22,Norway,60.472,8.4689,1469419,0,4439,1464980
12/3/22,Norway,60.472,8.4689,1469494,0,4439,1465055
12/4/22,Norway,60.472,8.4689,1469560,0,4439,1465121
12/5/22,Norway,60.472,8.4689,1469778,0,4439,1465339
12/6/22,Norway,60.472,8.4689,1469983,0,4439,1465544
12/7/22,Norway,60.472,8.4689,1470201,0,4439,1465762
12/8/22,Norway,60.472,8.4689,1470431,0,4498,1465933
12/9/22,Norway,60.472,8.4689,1470650,0,4498,1466152
12/10/22,Norway,60.472,8.4689,1470753,0,4498,1466255
12/11/22,Norway,60.472,8.4689,1470838,0,4498,1466340
12/12/22,Norway,60.472,8.4689,1471132,0,4498,1466634
12/13/22,Norway,60.472,8.4689,1471342,0,4498,1466844
12/14/22,Norway,60.472,8.4689,1471598,0,4498,1467100
12/15/22,Norway,60.472,8.4689,1471834,0,4498,1467336
12/16/22,Norway,60.472,8.4689,1472090,0,4571,1467519
12/17/22,Norway,60.472,8.4689,1472199,0,4571,1467628
1/1/22,Oman,21.512583,55.923255,305489,0,4116,301373
1/2/22,Oman,21.512583,55.923255,305832,0,4117,301715
1/3/22,Oman,21.512583,55.923255,306008,0,4117,301891
1/4/22,Oman,21.512583,55.923255,306240,0,4117,302123
1/5/22,Oman,21.512583,55.923255,306492,0,4117,302375
1/6/22,Oman,21.512583,55.923255,306755,0,4117,302638
1/7/22,Oman,21.512583,55.923255,306755,0,4117,302638
1/8/22,Oman,21.512583,55.923255,306755,0,4117,302638
1/9/22,Oman,21.512583,55.923255,307722,0,4118,303604
1/10/22,Oman,21.512583,55.923255,308261,0,4119,304142
1/11/22,Oman,21.512583,55.923255,308870,0,4119,304751
1/12/22,Oman,21.512583,55.923255,309588,0,4119,305469
1/13/22,Oman,21.512583,55.923255,310338,0,4119,306219
1/14/22,Oman,21.512583,55.923255,310338,0,4119,306219
1/15/22,Oman,21.512583,55.923255,310338,0,4119,306219
1/16/22,Oman,21.512583,55.923255,312425,0,4122,308303
1/17/22,Oman,21.512583,55.923255,313538,0,4122,309416
1/18/22,Oman,21.512583,55.923255,314853,0,4122,310731
1/19/22,Oman,21.512583,55.923255,316472,0,4124,312348
1/20/22,Oman,21.512583,55.923255,318272,0,4125,314147
1/21/22,Oman,21.512583,55.923255,318272,0,4125,314147
1/22/22,Oman,21.512583,55.923255,318272,0,4125,314147
1/23/22,Oman,21.512583,55.923255,322438,0,4128,318310
1/24/22,Oman,21.512583,55.923255,324085,0,4129,319956
1/25/22,Oman,21.512583,55.923255,326164,0,4130,322034
1/26/22,Oman,21.512583,55.923255,328326,0,4133,324193
1/27/22,Oman,21.512583,55.923255,330767,0,4134,326633
1/28/22,Oman,21.512583,55.923255,330767,0,4134,326633
1/29/22,Oman,21.512583,55.923255,330767,0,4134,326633
1/30/22,Oman,21.512583,55.923255,336460,0,4134,332326
1/31/22,Oman,21.512583,55.923255,338880,0,4146,334734
2/1/22,Oman,21.512583,55.923255,341708,0,4148,337560
2/2/22,Oman,21.512583,55.923255,344043,0,4153,339890
2/3/22,Oman,21.512583,55.923255,346041,0,4158,341883
2/4/22,Oman,21.512583,55.923255,346041,0,4158,341883
2/5/22,Oman,21.512583,55.923255,346041,0,4158,341883
2/6/22,Oman,21.512583,55.923255,352187,0,4172,348015
2/7/22,Oman,21.512583,55.923255,354597,0,4180,350417
2/8/22,Oman,21.512583,55.923255,356900,0,4188,352712
2/9/22,Oman,21.512583,55.923255,359256,0,4190,355066
2/10/22,Oman,21.512583,55.923255,360999,0,4195,356804
2/11/22,Oman,21.512583,55.923255,360999,0,4195,356804
2/12/22,Oman,21.512583,55.923255,360999,0,4195,356804
2/13/22,Oman,21.512583,55.923255,365700,0,4208,361492
2/14/22,Oman,21.512583,55.923255,367679,0,4211,363468
2/15/22,Oman,21.512583,55.923255,369190,0,4216,364974
2/16/22,Oman,21.512583,55.923255,370620,0,4221,366399
2/17/22,Oman,21.512583,55.923255,372060,0,4225,367835
2/18/22,Oman,21.512583,55.923255,372060,0,4225,367835
2/19/22,Oman,21.512583,55.923255,372060,0,4225,367835
2/20/22,Oman,21.512583,55.923255,375688,0,4231,371457
2/21/22,Oman,21.512583,55.923255,376724,0,4234,372490
2/22/22,Oman,21.512583,55.923255,377948,0,4238,373710
2/23/22,Oman,21.512583,55.923255,378922,0,4238,374684
2/24/22,Oman,21.512583,55.923255,379618,0,4238,375380
2/25/22,Oman,21.512583,55.923255,379618,0,4238,375380
2/26/22,Oman,21.512583,55.923255,379618,0,4238,375380
2/27/22,Oman,21.512583,55.923255,381381,0,4242,377139
2/28/22,Oman,21.512583,55.923255,382244,0,4244,378000
3/1/22,Oman,21.512583,55.923255,382244,0,4244,378000
3/2/22,Oman,21.512583,55.923255,383389,0,4246,379143
3/3/22,Oman,21.512583,55.923255,383874,0,4248,379626
3/4/22,Oman,21.512583,55.923255,383874,0,4248,379626
3/5/22,Oman,21.512583,55.923255,383874,0,4248,379626
3/6/22,Oman,21.512583,55.923255,384818,0,4249,380569
3/7/22,Oman,21.512583,55.923255,385153,0,4249,380904
3/8/22,Oman,21.512583,55.923255,385513,0,4249,381264
3/9/22,Oman,21.512583,55.923255,385769,0,4249,381520
3/10/22,Oman,21.512583,55.923255,386003,0,4250,381753
3/11/22,Oman,21.512583,55.923255,386003,0,4250,381753
3/12/22,Oman,21.512583,55.923255,386003,0,4250,381753
3/13/22,Oman,21.512583,55.923255,386460,0,4250,382210
3/14/22,Oman,21.512583,55.923255,386646,0,4250,382396
3/15/22,Oman,21.512583,55.923255,386829,0,4250,382579
3/16/22,Oman,21.512583,55.923255,387009,0,4250,382759
3/17/22,Oman,21.512583,55.923255,387180,0,4250,382930
3/18/22,Oman,21.512583,55.923255,387180,0,4250,382930
3/19/22,Oman,21.512583,55.923255,387180,0,4250,382930
3/20/22,Oman,21.512583,55.923255,387505,0,4250,383255
3/21/22,Oman,21.512583,55.923255,387627,0,4250,383377
3/22/22,Oman,21.512583,55.923255,387730,0,4250,383480
3/23/22,Oman,21.512583,55.923255,387829,0,4250,383579
3/24/22,Oman,21.512583,55.923255,387922,0,4250,383672
3/25/22,Oman,21.512583,55.923255,387922,0,4250,383672
3/26/22,Oman,21.512583,55.923255,387922,0,4250,383672
3/27/22,Oman,21.512583,55.923255,388086,0,4250,383836
3/28/22,Oman,21.512583,55.923255,388160,0,4250,383910
3/29/22,Oman,21.512583,55.923255,388229,0,4250,383979
3/30/22,Oman,21.512583,55.923255,388279,0,4250,384029
3/31/22,Oman,21.512583,55.923255,388343,0,4250,384093
4/1/22,Oman,21.512583,55.923255,388343,0,4250,384093
4/2/22,Oman,21.512583,55.923255,388343,0,4250,384093
4/3/22,Oman,21.512583,55.923255,388468,0,4251,384217
4/4/22,Oman,21.512583,55.923255,388500,0,4252,384248
4/5/22,Oman,21.512583,55.923255,388536,0,4252,384284
4/6/22,Oman,21.512583,55.923255,388571,0,4253,384318
4/7/22,Oman,21.512583,55.923255,388603,0,4253,384350
4/8/22,Oman,21.512583,55.923255,388603,0,4253,384350
4/9/22,Oman,21.512583,55.923255,388603,0,4253,384350
4/10/22,Oman,21.512583,55.923255,388686,0,4254,384432
4/11/22,Oman,21.512583,55.923255,388709,0,4254,384455
4/12/22,Oman,21.512583,55.923255,388741,0,4256,384485
4/13/22,Oman,21.512583,55.923255,388763,0,4257,384506
4/14/22,Oman,21.512583,55.923255,388795,0,4257,384538
4/15/22,Oman,21.512583,55.923255,388795,0,4257,384538
4/16/22,Oman,21.512583,55.923255,388795,0,4257,384538
4/17/22,Oman,21.512583,55.923255,388865,0,4257,384608
4/18/22,Oman,21.512583,55.923255,388891,0,4257,384634
4/19/22,Oman,21.512583,55.923255,388922,0,4257,384665
4/20/22,Oman,21.512583,55.923255,388956,0,4257,384699
4/21/22,Oman,21.512583,55.923255,388995,0,4257,384738
4/22/22,Oman,21.512583,55.923255,388995,0,4257,384738
4/23/22,Oman,21.512583,55.923255,388995,0,4257,384738
4/24/22,Oman,21.512583,55.923255,389053,0,4257,384796
4/25/22,Oman,21.512583,55.923255,389074,0,4258,384816
4/26/22,Oman,21.512583,55.923255,389099,0,4258,384841
4/27/22,Oman,21.512583,55.923255,389113,0,4258,384855
4/28/22,Oman,21.512583,55.923255,389126,0,4258,384868
4/29/22,Oman,21.512583,55.923255,389126,0,4258,384868
4/30/22,Oman,21.512583,55.923255,389126,0,4258,384868
5/1/22,Oman,21.512583,55.923255,389126,0,4258,384868
5/2/22,Oman,21.512583,55.923255,389126,0,4258,384868
5/3/22,Oman,21.512583,55.923255,389126,0,4258,384868
5/4/22,Oman,21.512583,55.923255,389126,0,4258,384868
5/5/22,Oman,21.512583,55.923255,389126,0,4258,384868
5/6/22,Oman,21.512583,55.923255,389126,0,4258,384868
5/7/22,Oman,21.512583,55.923255,389126,0,4258,384868
5/8/22,Oman,21.512583,55.923255,389273,0,4259,385014
5/9/22,Oman,21.512583,55.923255,389306,0,4259,385047
5/10/22,Oman,21.512583,55.923255,389325,0,4259,385066
5/11/22,Oman,21.512583,55.923255,389344,0,4259,385085
5/12/22,Oman,21.512583,55.923255,389370,0,4259,385111
5/13/22,Oman,21.512583,55.923255,389370,0,4259,385111
5/14/22,Oman,21.512583,55.923255,389370,0,4259,385111
5/15/22,Oman,21.512583,55.923255,389408,0,4260,385148
5/16/22,Oman,21.512583,55.923255,389427,0,4260,385167
5/17/22,Oman,21.512583,55.923255,389447,0,4260,385187
5/18/22,Oman,21.512583,55.923255,389460,0,4260,385200
5/19/22,Oman,21.512583,55.923255,389473,0,4260,385213
5/20/22,Oman,21.512583,55.923255,389473,0,4260,385213
5/21/22,Oman,21.512583,55.923255,389473,0,4260,385213
5/22/22,Oman,21.512583,55.923255,389473,0,4260,385213
5/23/22,Oman,21.512583,55.923255,389473,0,4260,385213
5/24/22,Oman,21.512583,55.923255,389473,0,4260,385213
5/25/22,Oman,21.512583,55.923255,389473,0,4260,385213
5/26/22,Oman,21.512583,55.923255,389473,0,4260,385213
5/27/22,Oman,21.512583,55.923255,389473,0,4260,385213
5/28/22,Oman,21.512583,55.923255,389473,0,4260,385213
5/29/22,Oman,21.512583,55.923255,389473,0,4260,385213
5/30/22,Oman,21.512583,55.923255,389473,0,4260,385213
5/31/22,Oman,21.512583,55.923255,389473,0,4260,385213
6/1/22,Oman,21.512583,55.923255,389473,0,4260,385213
6/2/22,Oman,21.512583,55.923255,389473,0,4260,385213
6/3/22,Oman,21.512583,55.923255,389473,0,4260,385213
6/4/22,Oman,21.512583,55.923255,389473,0,4260,385213
6/5/22,Oman,21.512583,55.923255,389473,0,4260,385213
6/6/22,Oman,21.512583,55.923255,389473,0,4260,385213
6/7/22,Oman,21.512583,55.923255,389473,0,4260,385213
6/8/22,Oman,21.512583,55.923255,389758,0,4260,385498
6/9/22,Oman,21.512583,55.923255,389758,0,4260,385498
6/10/22,Oman,21.512583,55.923255,389758,0,4260,385498
6/11/22,Oman,21.512583,55.923255,389758,0,4260,385498
6/12/22,Oman,21.512583,55.923255,389758,0,4260,385498
6/13/22,Oman,21.512583,55.923255,389758,0,4260,385498
6/14/22,Oman,21.512583,55.923255,389758,0,4260,385498
6/15/22,Oman,21.512583,55.923255,389758,0,4260,385498
6/16/22,Oman,21.512583,55.923255,389758,0,4628,385130
6/17/22,Oman,21.512583,55.923255,389758,0,4628,385130
6/18/22,Oman,21.512583,55.923255,389758,0,4628,385130
6/19/22,Oman,21.512583,55.923255,389758,0,4628,385130
6/20/22,Oman,21.512583,55.923255,390244,0,4628,385616
6/21/22,Oman,21.512583,55.923255,390244,0,4628,385616
6/22/22,Oman,21.512583,55.923255,390244,0,4628,385616
6/23/22,Oman,21.512583,55.923255,390244,0,4628,385616
6/24/22,Oman,21.512583,55.923255,390244,0,4628,385616
6/25/22,Oman,21.512583,55.923255,390244,0,4628,385616
6/26/22,Oman,21.512583,55.923255,390244,0,4628,385616
6/27/22,Oman,21.512583,55.923255,390244,0,4628,385616
6/28/22,Oman,21.512583,55.923255,390244,0,4628,385616
6/29/22,Oman,21.512583,55.923255,390244,0,4628,385616
6/30/22,Oman,21.512583,55.923255,390244,0,4628,385616
7/1/22,Oman,21.512583,55.923255,390244,0,4628,385616
7/2/22,Oman,21.512583,55.923255,390244,0,4628,385616
7/3/22,Oman,21.512583,55.923255,390244,0,4628,385616
7/4/22,Oman,21.512583,55.923255,390244,0,4628,385616
7/5/22,Oman,21.512583,55.923255,391641,0,4628,387013
7/6/22,Oman,21.512583,55.923255,391641,0,4628,387013
7/7/22,Oman,21.512583,55.923255,391641,0,4628,387013
7/8/22,Oman,21.512583,55.923255,391641,0,4628,387013
7/9/22,Oman,21.512583,55.923255,391641,0,4628,387013
7/10/22,Oman,21.512583,55.923255,391641,0,4628,387013
7/11/22,Oman,21.512583,55.923255,391641,0,4628,387013
7/12/22,Oman,21.512583,55.923255,391641,0,4628,387013
7/13/22,Oman,21.512583,55.923255,391641,0,4628,387013
7/14/22,Oman,21.512583,55.923255,391641,0,4628,387013
7/15/22,Oman,21.512583,55.923255,391641,0,4628,387013
7/16/22,Oman,21.512583,55.923255,391641,0,4628,387013
7/17/22,Oman,21.512583,55.923255,391641,0,4628,387013
7/18/22,Oman,21.512583,55.923255,393002,0,4628,388374
7/19/22,Oman,21.512583,55.923255,393002,0,4628,388374
7/20/22,Oman,21.512583,55.923255,393002,0,4628,388374
7/21/22,Oman,21.512583,55.923255,393002,0,4628,388374
7/22/22,Oman,21.512583,55.923255,393002,0,4628,388374
7/23/22,Oman,21.512583,55.923255,393002,0,4628,388374
7/24/22,Oman,21.512583,55.923255,393002,0,4628,388374
7/25/22,Oman,21.512583,55.923255,393002,0,4628,388374
7/26/22,Oman,21.512583,55.923255,393002,0,4628,388374
7/27/22,Oman,21.512583,55.923255,395737,0,4628,391109
7/28/22,Oman,21.512583,55.923255,395737,0,4628,391109
7/29/22,Oman,21.512583,55.923255,395737,0,4628,391109
7/30/22,Oman,21.512583,55.923255,395737,0,4628,391109
7/31/22,Oman,21.512583,55.923255,395737,0,4628,391109
8/1/22,Oman,21.512583,55.923255,395737,0,4628,391109
8/2/22,Oman,21.512583,55.923255,395737,0,4628,391109
8/3/22,Oman,21.512583,55.923255,395737,0,4628,391109
8/4/22,Oman,21.512583,55.923255,396722,0,4628,392094
8/5/22,Oman,21.512583,55.923255,396722,0,4628,392094
8/6/22,Oman,21.512583,55.923255,396722,0,4628,392094
8/7/22,Oman,21.512583,55.923255,396722,0,4628,392094
8/8/22,Oman,21.512583,55.923255,396722,0,4628,392094
8/9/22,Oman,21.512583,55.923255,397231,0,4628,392603
8/10/22,Oman,21.512583,55.923255,397231,0,4628,392603
8/11/22,Oman,21.512583,55.923255,397231,0,4628,392603
8/12/22,Oman,21.512583,55.923255,397231,0,4628,392603
8/13/22,Oman,21.512583,55.923255,397231,0,4628,392603
8/14/22,Oman,21.512583,55.923255,397231,0,4628,392603
8/15/22,Oman,21.512583,55.923255,397231,0,4628,392603
8/16/22,Oman,21.512583,55.923255,397231,0,4628,392603
8/17/22,Oman,21.512583,55.923255,397574,0,4628,392946
8/18/22,Oman,21.512583,55.923255,397574,0,4628,392946
8/19/22,Oman,21.512583,55.923255,397574,0,4628,392946
8/20/22,Oman,21.512583,55.923255,397574,0,4628,392946
8/21/22,Oman,21.512583,55.923255,397574,0,4628,392946
8/22/22,Oman,21.512583,55.923255,397574,0,4628,392946
8/23/22,Oman,21.512583,55.923255,397846,0,4628,393218
8/24/22,Oman,21.512583,55.923255,397846,0,4628,393218
8/25/22,Oman,21.512583,55.923255,397846,0,4628,393218
8/26/22,Oman,21.512583,55.923255,397846,0,4628,393218
8/27/22,Oman,21.512583,55.923255,397846,0,4628,393218
8/28/22,Oman,21.512583,55.923255,397846,0,4628,393218
8/29/22,Oman,21.512583,55.923255,397846,0,4628,393218
8/30/22,Oman,21.512583,55.923255,397846,0,4628,393218
8/31/22,Oman,21.512583,55.923255,397846,0,4628,393218
9/1/22,Oman,21.512583,55.923255,397846,0,4628,393218
9/2/22,Oman,21.512583,55.923255,397846,0,4628,393218
9/3/22,Oman,21.512583,55.923255,397846,0,4628,393218
9/4/22,Oman,21.512583,55.923255,397846,0,4628,393218
9/5/22,Oman,21.512583,55.923255,397984,0,4628,393356
9/6/22,Oman,21.512583,55.923255,397993,0,4628,393365
9/7/22,Oman,21.512583,55.923255,397993,0,4628,393365
9/8/22,Oman,21.512583,55.923255,397993,0,4628,393365
9/9/22,Oman,21.512583,55.923255,397993,0,4628,393365
9/10/22,Oman,21.512583,55.923255,397993,0,4628,393365
9/11/22,Oman,21.512583,55.923255,397993,0,4628,393365
9/12/22,Oman,21.512583,55.923255,397993,0,4628,393365
9/13/22,Oman,21.512583,55.923255,397993,0,4628,393365
9/14/22,Oman,21.512583,55.923255,397993,0,4628,393365
9/15/22,Oman,21.512583,55.923255,397993,0,4628,393365
9/16/22,Oman,21.512583,55.923255,397993,0,4628,393365
9/17/22,Oman,21.512583,55.923255,397993,0,4628,393365
9/18/22,Oman,21.512583,55.923255,397993,0,4628,393365
9/19/22,Oman,21.512583,55.923255,397993,0,4628,393365
9/20/22,Oman,21.512583,55.923255,397993,0,4628,393365
9/21/22,Oman,21.512583,55.923255,397993,0,4628,393365
9/22/22,Oman,21.512583,55.923255,397993,0,4628,393365
9/23/22,Oman,21.512583,55.923255,397993,0,4628,393365
9/24/22,Oman,21.512583,55.923255,397993,0,4628,393365
9/25/22,Oman,21.512583,55.923255,397993,0,4628,393365
9/26/22,Oman,21.512583,55.923255,397993,0,4628,393365
9/27/22,Oman,21.512583,55.923255,397993,0,4628,393365
9/28/22,Oman,21.512583,55.923255,398424,0,4628,393796
9/29/22,Oman,21.512583,55.923255,398424,0,4628,393796
9/30/22,Oman,21.512583,55.923255,398424,0,4628,393796
10/1/22,Oman,21.512583,55.923255,398424,0,4628,393796
10/2/22,Oman,21.512583,55.923255,398424,0,4628,393796
10/3/22,Oman,21.512583,55.923255,398424,0,4628,393796
10/4/22,Oman,21.512583,55.923255,398424,0,4628,393796
10/5/22,Oman,21.512583,55.923255,398424,0,4628,393796
10/6/22,Oman,21.512583,55.923255,398424,0,4628,393796
10/7/22,Oman,21.512583,55.923255,398424,0,4628,393796
10/8/22,Oman,21.512583,55.923255,398424,0,4628,393796
10/9/22,Oman,21.512583,55.923255,398424,0,4628,393796
10/10/22,Oman,21.512583,55.923255,398424,0,4628,393796
10/11/22,Oman,21.512583,55.923255,398424,0,4628,393796
10/12/22,Oman,21.512583,55.923255,398424,0,4628,393796
10/13/22,Oman,21.512583,55.923255,398424,0,4628,393796
10/14/22,Oman,21.512583,55.923255,398424,0,4628,393796
10/15/22,Oman,21.512583,55.923255,398424,0,4628,393796
10/16/22,Oman,21.512583,55.923255,398424,0,4628,393796
10/17/22,Oman,21.512583,55.923255,398424,0,4628,393796
10/18/22,Oman,21.512583,55.923255,398424,0,4628,393796
10/19/22,Oman,21.512583,55.923255,398660,0,4628,394032
10/20/22,Oman,21.512583,55.923255,398660,0,4628,394032
10/21/22,Oman,21.512583,55.923255,398660,0,4628,394032
10/22/22,Oman,21.512583,55.923255,398660,0,4628,394032
10/23/22,Oman,21.512583,55.923255,398660,0,4628,394032
10/24/22,Oman,21.512583,55.923255,398660,0,4628,394032
10/25/22,Oman,21.512583,55.923255,398775,0,4628,394147
10/26/22,Oman,21.512583,55.923255,398775,0,4628,394147
10/27/22,Oman,21.512583,55.923255,398775,0,4628,394147
10/28/22,Oman,21.512583,55.923255,398775,0,4628,394147
10/29/22,Oman,21.512583,55.923255,398775,0,4628,394147
10/30/22,Oman,21.512583,55.923255,398775,0,4628,394147
10/31/22,Oman,21.512583,55.923255,398775,0,4628,394147
11/1/22,Oman,21.512583,55.923255,398775,0,4628,394147
11/2/22,Oman,21.512583,55.923255,398775,0,4628,394147
11/3/22,Oman,21.512583,55.923255,398775,0,4628,394147
11/4/22,Oman,21.512583,55.923255,398775,0,4628,394147
11/5/22,Oman,21.512583,55.923255,398775,0,4628,394147
11/6/22,Oman,21.512583,55.923255,398775,0,4628,394147
11/7/22,Oman,21.512583,55.923255,398775,0,4628,394147
11/8/22,Oman,21.512583,55.923255,398775,0,4628,394147
11/9/22,Oman,21.512583,55.923255,398775,0,4628,394147
11/10/22,Oman,21.512583,55.923255,398775,0,4628,394147
11/11/22,Oman,21.512583,55.923255,398775,0,4628,394147
11/12/22,Oman,21.512583,55.923255,398775,0,4628,394147
11/13/22,Oman,21.512583,55.923255,398775,0,4628,394147
11/14/22,Oman,21.512583,55.923255,399027,0,4628,394399
11/15/22,Oman,21.512583,55.923255,399027,0,4628,394399
11/16/22,Oman,21.512583,55.923255,399027,0,4628,394399
11/17/22,Oman,21.512583,55.923255,399027,0,4628,394399
11/18/22,Oman,21.512583,55.923255,399027,0,4628,394399
11/19/22,Oman,21.512583,55.923255,399027,0,4628,394399
11/20/22,Oman,21.512583,55.923255,399027,0,4628,394399
11/21/22,Oman,21.512583,55.923255,399027,0,4628,394399
11/22/22,Oman,21.512583,55.923255,399027,0,4628,394399
11/23/22,Oman,21.512583,55.923255,399027,0,4628,394399
11/24/22,Oman,21.512583,55.923255,399027,0,4628,394399
11/25/22,Oman,21.512583,55.923255,399027,0,4628,394399
11/26/22,Oman,21.512583,55.923255,399027,0,4628,394399
11/27/22,Oman,21.512583,55.923255,399027,0,4628,394399
11/28/22,Oman,21.512583,55.923255,399119,0,4628,394491
11/29/22,Oman,21.512583,55.923255,399119,0,4628,394491
11/30/22,Oman,21.512583,55.923255,399119,0,4628,394491
12/1/22,Oman,21.512583,55.923255,399119,0,4628,394491
12/2/22,Oman,21.512583,55.923255,399119,0,4628,394491
12/3/22,Oman,21.512583,55.923255,399119,0,4628,394491
12/4/22,Oman,21.512583,55.923255,399119,0,4628,394491
12/5/22,Oman,21.512583,55.923255,399119,0,4628,394491
12/6/22,Oman,21.512583,55.923255,399119,0,4628,394491
12/7/22,Oman,21.512583,55.923255,399119,0,4628,394491
12/8/22,Oman,21.512583,55.923255,399119,0,4628,394491
12/9/22,Oman,21.512583,55.923255,399119,0,4628,394491
12/10/22,Oman,21.512583,55.923255,399119,0,4628,394491
12/11/22,Oman,21.512583,55.923255,399119,0,4628,394491
12/12/22,Oman,21.512583,55.923255,399119,0,4628,394491
12/13/22,Oman,21.512583,55.923255,399119,0,4628,394491
12/14/22,Oman,21.512583,55.923255,399119,0,4628,394491
12/15/22,Oman,21.512583,55.923255,399119,0,4628,394491
12/16/22,Oman,21.512583,55.923255,399119,0,4628,394491
12/17/22,Oman,21.512583,55.923255,399119,0,4628,394491
1/1/22,Pakistan,30.3753,69.3451,1296527,0,28941,1267586
1/2/22,Pakistan,30.3753,69.3451,1297235,0,28943,1268292
1/3/22,Pakistan,30.3753,69.3451,1297865,0,28945,1268920
1/4/22,Pakistan,30.3753,69.3451,1298763,0,28950,1269813
1/5/22,Pakistan,30.3753,69.3451,1299848,0,28955,1270893
1/6/22,Pakistan,30.3753,69.3451,1301141,0,28961,1272180
1/7/22,Pakistan,30.3753,69.3451,1302486,0,28962,1273524
1/8/22,Pakistan,30.3753,69.3451,1304058,0,28969,1275089
1/9/22,Pakistan,30.3753,69.3451,1305707,0,28972,1276735
1/10/22,Pakistan,30.3753,69.3451,1307174,0,28974,1278200
1/11/22,Pakistan,30.3753,69.3451,1309248,0,28987,1280261
1/12/22,Pakistan,30.3753,69.3451,1312267,0,28992,1283275
1/13/22,Pakistan,30.3753,69.3451,1315834,0,28999,1286835
1/14/22,Pakistan,30.3753,69.3451,1320120,0,29003,1291117
1/15/22,Pakistan,30.3753,69.3451,1324147,0,29012,1295135
1/16/22,Pakistan,30.3753,69.3451,1328487,0,29019,1299468
1/17/22,Pakistan,30.3753,69.3451,1333521,0,29029,1304492
1/18/22,Pakistan,30.3753,69.3451,1338993,0,29037,1309956
1/19/22,Pakistan,30.3753,69.3451,1345801,0,29042,1316759
1/20/22,Pakistan,30.3753,69.3451,1353479,0,29065,1324414
1/21/22,Pakistan,30.3753,69.3451,1360019,0,29077,1330942
1/22/22,Pakistan,30.3753,69.3451,1367605,0,29097,1338508
1/23/22,Pakistan,30.3753,69.3451,1374800,0,29105,1345695
1/24/22,Pakistan,30.3753,69.3451,1381152,0,29122,1352030
1/25/22,Pakistan,30.3753,69.3451,1386348,0,29137,1357211
1/26/22,Pakistan,30.3753,69.3451,1393887,0,29162,1364725
1/27/22,Pakistan,30.3753,69.3451,1402070,0,29192,1372878
1/28/22,Pakistan,30.3753,69.3451,1410033,0,29219,1380814
1/29/22,Pakistan,30.3753,69.3451,1417991,0,29248,1388743
1/30/22,Pakistan,30.3753,69.3451,1425039,0,29269,1395770
1/31/22,Pakistan,30.3753,69.3451,1430366,0,29301,1401065
2/1/22,Pakistan,30.3753,69.3451,1436413,0,29330,1407083
2/2/22,Pakistan,30.3753,69.3451,1442263,0,29372,1412891
2/3/22,Pakistan,30.3753,69.3451,1448663,0,29420,1419243
2/4/22,Pakistan,30.3753,69.3451,1454800,0,29448,1425352
2/5/22,Pakistan,30.3753,69.3451,1459773,0,29478,1430295
2/6/22,Pakistan,30.3753,69.3451,1463111,0,29516,1433595
2/7/22,Pakistan,30.3753,69.3451,1465910,0,29553,1436357
2/8/22,Pakistan,30.3753,69.3451,1470161,0,29601,1440560
2/9/22,Pakistan,30.3753,69.3451,1474075,0,29648,1444427
2/10/22,Pakistan,30.3753,69.3451,1477573,0,29687,1447886
2/11/22,Pakistan,30.3753,69.3451,1480592,0,29731,1450861
2/12/22,Pakistan,30.3753,69.3451,1483798,0,29772,1454026
2/13/22,Pakistan,30.3753,69.3451,1486361,0,29801,1456560
2/14/22,Pakistan,30.3753,69.3451,1488958,0,29828,1459130
2/15/22,Pakistan,30.3753,69.3451,1491423,0,29877,1461546
2/16/22,Pakistan,30.3753,69.3451,1494293,0,29917,1464376
2/17/22,Pakistan,30.3753,69.3451,1496693,0,29950,1466743
2/18/22,Pakistan,30.3753,69.3451,1498676,0,29976,1468700
2/19/22,Pakistan,30.3753,69.3451,1500320,0,30009,1470311
2/20/22,Pakistan,30.3753,69.3451,1501680,0,30040,1471640
2/21/22,Pakistan,30.3753,69.3451,1502641,0,30053,1472588
2/22/22,Pakistan,30.3753,69.3451,1503873,0,30096,1473777
2/23/22,Pakistan,30.3753,69.3451,1505328,0,30114,1475214
2/24/22,Pakistan,30.3753,69.3451,1506450,0,30139,1476311
2/25/22,Pakistan,30.3753,69.3451,1507657,0,30153,1477504
2/26/22,Pakistan,30.3753,69.3451,1508504,0,30173,1478331
2/27/22,Pakistan,30.3753,69.3451,1509360,0,30178,1479182
2/28/22,Pakistan,30.3753,69.3451,1510221,0,30196,1480025
3/1/22,Pakistan,30.3753,69.3451,1510986,0,30218,1480768
3/2/22,Pakistan,30.3753,69.3451,1511754,0,30237,1481517
3/3/22,Pakistan,30.3753,69.3451,1512707,0,30248,1482459
3/4/22,Pakistan,30.3753,69.3451,1513503,0,30258,1483245
3/5/22,Pakistan,30.3753,69.3451,1514258,0,30265,1483993
3/6/22,Pakistan,30.3753,69.3451,1515014,0,30272,1484742
3/7/22,Pakistan,30.3753,69.3451,1515392,0,30281,1485111
3/8/22,Pakistan,30.3753,69.3451,1516150,0,30287,1485863
3/9/22,Pakistan,30.3753,69.3451,1516789,0,30291,1486498
3/10/22,Pakistan,30.3753,69.3451,1517512,0,30298,1487214
3/11/22,Pakistan,30.3753,69.3451,1518083,0,30304,1487779
3/12/22,Pakistan,30.3753,69.3451,1518692,0,30307,1488385
3/13/22,Pakistan,30.3753,69.3451,1519154,0,30309,1488845
3/14/22,Pakistan,30.3753,69.3451,1519627,0,30313,1489314
3/15/22,Pakistan,30.3753,69.3451,1520120,0,30317,1489803
3/16/22,Pakistan,30.3753,69.3451,1520634,0,30319,1490315
3/17/22,Pakistan,30.3753,69.3451,1520817,0,30326,1490491
3/18/22,Pakistan,30.3753,69.3451,1521513,0,30328,1491185
3/19/22,Pakistan,30.3753,69.3451,1521888,0,30329,1491559
3/20/22,Pakistan,30.3753,69.3451,1522191,0,30331,1491860
3/21/22,Pakistan,30.3753,69.3451,1522419,0,30333,1492086
3/22/22,Pakistan,30.3753,69.3451,1522862,0,30333,1492529
3/23/22,Pakistan,30.3753,69.3451,1523072,0,30333,1492739
3/24/22,Pakistan,30.3753,69.3451,1523401,0,30336,1493065
3/25/22,Pakistan,30.3753,69.3451,1523590,0,30340,1493250
3/26/22,Pakistan,30.3753,69.3451,1523900,0,30345,1493555
3/27/22,Pakistan,30.3753,69.3451,1524086,0,30346,1493740
3/28/22,Pakistan,30.3753,69.3451,1524355,0,30347,1494008
3/29/22,Pakistan,30.3753,69.3451,1524549,0,30349,1494200
3/30/22,Pakistan,30.3753,69.3451,1524793,0,30355,1494438
3/31/22,Pakistan,30.3753,69.3451,1524973,0,30359,1494614
4/1/22,Pakistan,30.3753,69.3451,1525181,0,30360,1494821
4/2/22,Pakistan,30.3753,69.3451,1525466,0,30361,1495105
4/3/22,Pakistan,30.3753,69.3451,1525620,0,30361,1495259
4/4/22,Pakistan,30.3753,69.3451,1525775,0,30361,1495414
4/5/22,Pakistan,30.3753,69.3451,1525923,0,30361,1495562
4/6/22,Pakistan,30.3753,69.3451,1526093,0,30361,1495732
4/7/22,Pakistan,30.3753,69.3451,1526234,0,30361,1495873
4/8/22,Pakistan,30.3753,69.3451,1526472,0,30361,1496111
4/9/22,Pakistan,30.3753,69.3451,1526568,0,30361,1496207
4/10/22,Pakistan,30.3753,69.3451,1526666,0,30361,1496305
4/11/22,Pakistan,30.3753,69.3451,1526728,0,30362,1496366
4/12/22,Pakistan,30.3753,69.3451,1526829,0,30362,1496467
4/13/22,Pakistan,30.3753,69.3451,1526952,0,30362,1496590
4/14/22,Pakistan,30.3753,69.3451,1526952,0,30362,1496590
4/15/22,Pakistan,30.3753,69.3451,1527151,0,30363,1496788
4/16/22,Pakistan,30.3753,69.3451,1527248,0,30363,1496885
4/17/22,Pakistan,30.3753,69.3451,1527326,0,30364,1496962
4/18/22,Pakistan,30.3753,69.3451,1527411,0,30364,1497047
4/19/22,Pakistan,30.3753,69.3451,1527486,0,30368,1497118
4/20/22,Pakistan,30.3753,69.3451,1527589,0,30368,1497221
4/21/22,Pakistan,30.3753,69.3451,1527669,0,30368,1497301
4/22/22,Pakistan,30.3753,69.3451,1527751,0,30369,1497382
4/23/22,Pakistan,30.3753,69.3451,1527751,0,30369,1497382
4/24/22,Pakistan,30.3753,69.3451,1527956,0,30369,1497587
4/25/22,Pakistan,30.3753,69.3451,1527956,0,30369,1497587
4/26/22,Pakistan,30.3753,69.3451,1527956,0,30369,1497587
4/27/22,Pakistan,30.3753,69.3451,1527956,0,30369,1497587
4/28/22,Pakistan,30.3753,69.3451,1527956,0,30369,1497587
4/29/22,Pakistan,30.3753,69.3451,1527956,0,30369,1497587
4/30/22,Pakistan,30.3753,69.3451,1527956,0,30369,1497587
5/1/22,Pakistan,30.3753,69.3451,1527956,0,30369,1497587
5/2/22,Pakistan,30.3753,69.3451,1527956,0,30369,1497587
5/3/22,Pakistan,30.3753,69.3451,1527956,0,30369,1497587
5/4/22,Pakistan,30.3753,69.3451,1527956,0,30369,1497587
5/5/22,Pakistan,30.3753,69.3451,1527956,0,30369,1497587
5/6/22,Pakistan,30.3753,69.3451,1527956,0,30369,1497587
5/7/22,Pakistan,30.3753,69.3451,1527956,0,30369,1497587
5/8/22,Pakistan,30.3753,69.3451,1527956,0,30369,1497587
5/9/22,Pakistan,30.3753,69.3451,1528833,0,30375,1498458
5/10/22,Pakistan,30.3753,69.3451,1528833,0,30375,1498458
5/11/22,Pakistan,30.3753,69.3451,1528833,0,30375,1498458
5/12/22,Pakistan,30.3753,69.3451,1528833,0,30375,1498458
5/13/22,Pakistan,30.3753,69.3451,1529167,0,30376,1498791
5/14/22,Pakistan,30.3753,69.3451,1529167,0,30376,1498791
5/15/22,Pakistan,30.3753,69.3451,1529251,0,30376,1498875
5/16/22,Pakistan,30.3753,69.3451,1529251,0,30376,1498875
5/17/22,Pakistan,30.3753,69.3451,1529471,0,30378,1499093
5/18/22,Pakistan,30.3753,69.3451,1529560,0,30379,1499181
5/19/22,Pakistan,30.3753,69.3451,1529641,0,30379,1499262
5/20/22,Pakistan,30.3753,69.3451,1529711,0,30379,1499332
5/21/22,Pakistan,30.3753,69.3451,1529727,0,30379,1499348
5/22/22,Pakistan,30.3753,69.3451,1529837,0,30379,1499458
5/23/22,Pakistan,30.3753,69.3451,1529837,0,30379,1499458
5/24/22,Pakistan,30.3753,69.3451,1529990,0,30379,1499611
5/25/22,Pakistan,30.3753,69.3451,1530066,0,30379,1499687
5/26/22,Pakistan,30.3753,69.3451,1530145,0,30379,1499766
5/27/22,Pakistan,30.3753,69.3451,1530235,0,30379,1499856
5/28/22,Pakistan,30.3753,69.3451,1530285,0,30379,1499906
5/29/22,Pakistan,30.3753,69.3451,1530333,0,30379,1499954
5/30/22,Pakistan,30.3753,69.3451,1530387,0,30379,1500008
5/31/22,Pakistan,30.3753,69.3451,1530453,0,30379,1500074
6/1/22,Pakistan,30.3753,69.3451,1530520,0,30379,1500141
6/2/22,Pakistan,30.3753,69.3451,1530556,0,30379,1500177
6/3/22,Pakistan,30.3753,69.3451,1530556,0,30379,1500177
6/4/22,Pakistan,30.3753,69.3451,1530556,0,30379,1500177
6/5/22,Pakistan,30.3753,69.3451,1530764,0,30379,1500385
6/6/22,Pakistan,30.3753,69.3451,1530814,0,30379,1500435
6/7/22,Pakistan,30.3753,69.3451,1530878,0,30379,1500499
6/8/22,Pakistan,30.3753,69.3451,1530967,0,30379,1500588
6/9/22,Pakistan,30.3753,69.3451,1530967,0,30379,1500588
6/10/22,Pakistan,30.3753,69.3451,1531112,0,30381,1500731
6/11/22,Pakistan,30.3753,69.3451,1531179,0,30381,1500798
6/12/22,Pakistan,30.3753,69.3451,1531273,0,30381,1500892
6/13/22,Pakistan,30.3753,69.3451,1531274,0,30381,1500893
6/14/22,Pakistan,30.3753,69.3451,1531437,0,30381,1501056
6/15/22,Pakistan,30.3753,69.3451,1531581,0,30382,1501199
6/16/22,Pakistan,30.3753,69.3451,1531679,0,30383,1501296
6/17/22,Pakistan,30.3753,69.3451,1531830,0,30383,1501447
6/18/22,Pakistan,30.3753,69.3451,1531982,0,30383,1501599
6/19/22,Pakistan,30.3753,69.3451,1532153,0,30383,1501770
6/20/22,Pakistan,30.3753,69.3451,1532266,0,30384,1501882
6/21/22,Pakistan,30.3753,69.3451,1532470,0,30384,1502086
6/22/22,Pakistan,30.3753,69.3451,1532738,0,30385,1502353
6/23/22,Pakistan,30.3753,69.3451,1533047,0,30385,1502662
6/24/22,Pakistan,30.3753,69.3451,1533482,0,30386,1503096
6/25/22,Pakistan,30.3753,69.3451,1533482,0,30386,1503096
6/26/22,Pakistan,30.3753,69.3451,1534270,0,30390,1503880
6/27/22,Pakistan,30.3753,69.3451,1534603,0,30392,1504211
6/28/22,Pakistan,30.3753,69.3451,1535144,0,30393,1504751
6/29/22,Pakistan,30.3753,69.3451,1535785,0,30395,1505390
6/30/22,Pakistan,30.3753,69.3451,1536479,0,30395,1506084
7/1/22,Pakistan,30.3753,69.3451,1536479,0,30395,1506084
7/2/22,Pakistan,30.3753,69.3451,1537947,0,30401,1507546
7/3/22,Pakistan,30.3753,69.3451,1538622,0,30403,1508219
7/4/22,Pakistan,30.3753,69.3451,1539275,0,30403,1508872
7/5/22,Pakistan,30.3753,69.3451,1539275,0,30403,1508872
7/6/22,Pakistan,30.3753,69.3451,1540952,0,30413,1510539
7/7/22,Pakistan,30.3753,69.3451,1541645,0,30413,1511232
7/8/22,Pakistan,30.3753,69.3451,1542377,0,30420,1511957
7/9/22,Pakistan,30.3753,69.3451,1542377,0,30420,1511957
7/10/22,Pakistan,30.3753,69.3451,1543250,0,30423,1512827
7/11/22,Pakistan,30.3753,69.3451,1543505,0,30424,1513081
7/12/22,Pakistan,30.3753,69.3451,1543741,0,30424,1513317
7/13/22,Pakistan,30.3753,69.3451,1544131,0,30426,1513705
7/14/22,Pakistan,30.3753,69.3451,1544910,0,30428,1514482
7/15/22,Pakistan,30.3753,69.3451,1545647,0,30438,1515209
7/16/22,Pakistan,30.3753,69.3451,1546252,0,30440,1515812
7/17/22,Pakistan,30.3753,69.3451,1546744,0,30445,1516299
7/18/22,Pakistan,30.3753,69.3451,1547203,0,30445,1516758
7/19/22,Pakistan,30.3753,69.3451,1547795,0,30452,1517343
7/20/22,Pakistan,30.3753,69.3451,1548394,0,30455,1517939
7/21/22,Pakistan,30.3753,69.3451,1549073,0,30462,1518611
7/22/22,Pakistan,30.3753,69.3451,1549766,0,30464,1519302
7/23/22,Pakistan,30.3753,69.3451,1550298,0,30467,1519831
7/24/22,Pakistan,30.3753,69.3451,1550880,0,30469,1520411
7/25/22,Pakistan,30.3753,69.3451,1551251,0,30470,1520781
7/26/22,Pakistan,30.3753,69.3451,1551871,0,30474,1521397
7/27/22,Pakistan,30.3753,69.3451,1551871,0,30474,1521397
7/28/22,Pakistan,30.3753,69.3451,1553325,0,30483,1522842
7/29/22,Pakistan,30.3753,69.3451,1553325,0,30483,1522842
7/30/22,Pakistan,30.3753,69.3451,1553325,0,30483,1522842
7/31/22,Pakistan,30.3753,69.3451,1554591,0,30487,1524104
8/1/22,Pakistan,30.3753,69.3451,1555639,0,30490,1525149
8/2/22,Pakistan,30.3753,69.3451,1556445,0,30499,1525946
8/3/22,Pakistan,30.3753,69.3451,1557134,0,30503,1526631
8/4/22,Pakistan,30.3753,69.3451,1557884,0,30505,1527379
8/5/22,Pakistan,30.3753,69.3451,1558557,0,30505,1528052
8/6/22,Pakistan,30.3753,69.3451,1559201,0,30505,1528696
8/7/22,Pakistan,30.3753,69.3451,1559829,0,30508,1529321
8/8/22,Pakistan,30.3753,69.3451,1560250,0,30508,1529742
8/9/22,Pakistan,30.3753,69.3451,1560602,0,30508,1530094
8/10/22,Pakistan,30.3753,69.3451,1560955,0,30509,1530446
8/11/22,Pakistan,30.3753,69.3451,1561579,0,30520,1531059
8/12/22,Pakistan,30.3753,69.3451,1562307,0,30523,1531784
8/13/22,Pakistan,30.3753,69.3451,1562307,0,30523,1531784
8/14/22,Pakistan,30.3753,69.3451,1563347,0,30529,1532818
8/15/22,Pakistan,30.3753,69.3451,1563705,0,30537,1533168
8/16/22,Pakistan,30.3753,69.3451,1564231,0,30542,1533689
8/17/22,Pakistan,30.3753,69.3451,1564809,0,30544,1534265
8/18/22,Pakistan,30.3753,69.3451,1565319,0,30548,1534771
8/19/22,Pakistan,30.3753,69.3451,1565319,0,30548,1534771
8/20/22,Pakistan,30.3753,69.3451,1566236,0,30552,1535684
8/21/22,Pakistan,30.3753,69.3451,1566652,0,30555,1536097
8/22/22,Pakistan,30.3753,69.3451,1566869,0,30557,1536312
8/23/22,Pakistan,30.3753,69.3451,1567147,0,30559,1536588
8/24/22,Pakistan,30.3753,69.3451,1567147,0,30559,1536588
8/25/22,Pakistan,30.3753,69.3451,1567893,0,30569,1537324
8/26/22,Pakistan,30.3753,69.3451,1568183,0,30571,1537612
8/27/22,Pakistan,30.3753,69.3451,1568453,0,30574,1537879
8/28/22,Pakistan,30.3753,69.3451,1568453,0,30574,1537879
8/29/22,Pakistan,30.3753,69.3451,1568849,0,30575,1538274
8/30/22,Pakistan,30.3753,69.3451,1569076,0,30581,1538495
8/31/22,Pakistan,30.3753,69.3451,1569076,0,30581,1538495
9/1/22,Pakistan,30.3753,69.3451,1569076,0,30581,1538495
9/2/22,Pakistan,30.3753,69.3451,1569076,0,30581,1538495
9/3/22,Pakistan,30.3753,69.3451,1569076,0,30581,1538495
9/4/22,Pakistan,30.3753,69.3451,1569076,0,30581,1538495
9/5/22,Pakistan,30.3753,69.3451,1570304,0,30593,1539711
9/6/22,Pakistan,30.3753,69.3451,1570304,0,30593,1539711
9/7/22,Pakistan,30.3753,69.3451,1570636,0,30594,1540042
9/8/22,Pakistan,30.3753,69.3451,1570636,0,30594,1540042
9/9/22,Pakistan,30.3753,69.3451,1570796,0,30598,1540198
9/10/22,Pakistan,30.3753,69.3451,1571091,0,30599,1540492
9/11/22,Pakistan,30.3753,69.3451,1571196,0,30599,1540597
9/12/22,Pakistan,30.3753,69.3451,1571295,0,30600,1540695
9/13/22,Pakistan,30.3753,69.3451,1571295,0,30600,1540695
9/14/22,Pakistan,30.3753,69.3451,1571530,0,30604,1540926
9/15/22,Pakistan,30.3753,69.3451,1571530,0,30604,1540926
9/16/22,Pakistan,30.3753,69.3451,1571732,0,30605,1541127
9/17/22,Pakistan,30.3753,69.3451,1571732,0,30605,1541127
9/18/22,Pakistan,30.3753,69.3451,1571894,0,30607,1541287
9/19/22,Pakistan,30.3753,69.3451,1571894,0,30607,1541287
9/20/22,Pakistan,30.3753,69.3451,1571894,0,30607,1541287
9/21/22,Pakistan,30.3753,69.3451,1571894,0,30607,1541287
9/22/22,Pakistan,30.3753,69.3451,1571894,0,30607,1541287
9/23/22,Pakistan,30.3753,69.3451,1572269,0,30612,1541657
9/24/22,Pakistan,30.3753,69.3451,1572269,0,30612,1541657
9/25/22,Pakistan,30.3753,69.3451,1572316,0,30612,1541704
9/26/22,Pakistan,30.3753,69.3451,1572316,0,30612,1541704
9/27/22,Pakistan,30.3753,69.3451,1572410,0,30612,1541798
9/28/22,Pakistan,30.3753,69.3451,1572410,0,30612,1541798
9/29/22,Pakistan,30.3753,69.3451,1572410,0,30612,1541798
9/30/22,Pakistan,30.3753,69.3451,1572598,0,30616,1541982
10/1/22,Pakistan,30.3753,69.3451,1572598,0,30616,1541982
10/2/22,Pakistan,30.3753,69.3451,1572598,0,30616,1541982
10/3/22,Pakistan,30.3753,69.3451,1572598,0,30616,1541982
10/4/22,Pakistan,30.3753,69.3451,1572778,0,30619,1542159
10/5/22,Pakistan,30.3753,69.3451,1572778,0,30619,1542159
10/6/22,Pakistan,30.3753,69.3451,1572778,0,30619,1542159
10/7/22,Pakistan,30.3753,69.3451,1572778,0,30619,1542159
10/8/22,Pakistan,30.3753,69.3451,1572778,0,30619,1542159
10/9/22,Pakistan,30.3753,69.3451,1572778,0,30619,1542159
10/10/22,Pakistan,30.3753,69.3451,1572778,0,30619,1542159
10/11/22,Pakistan,30.3753,69.3451,1572778,0,30619,1542159
10/12/22,Pakistan,30.3753,69.3451,1572778,0,30619,1542159
10/13/22,Pakistan,30.3753,69.3451,1572778,0,30619,1542159
10/14/22,Pakistan,30.3753,69.3451,1572778,0,30619,1542159
10/15/22,Pakistan,30.3753,69.3451,1572778,0,30619,1542159
10/16/22,Pakistan,30.3753,69.3451,1572778,0,30619,1542159
10/17/22,Pakistan,30.3753,69.3451,1572778,0,30619,1542159
10/18/22,Pakistan,30.3753,69.3451,1572778,0,30619,1542159
10/19/22,Pakistan,30.3753,69.3451,1572778,0,30619,1542159
10/20/22,Pakistan,30.3753,69.3451,1572778,0,30619,1542159
10/21/22,Pakistan,30.3753,69.3451,1572778,0,30619,1542159
10/22/22,Pakistan,30.3753,69.3451,1572778,0,30619,1542159
10/23/22,Pakistan,30.3753,69.3451,1572778,0,30619,1542159
10/24/22,Pakistan,30.3753,69.3451,1572778,0,30619,1542159
10/25/22,Pakistan,30.3753,69.3451,1572778,0,30619,1542159
10/26/22,Pakistan,30.3753,69.3451,1572778,0,30619,1542159
10/27/22,Pakistan,30.3753,69.3451,1573922,0,30625,1543297
10/28/22,Pakistan,30.3753,69.3451,1573922,0,30625,1543297
10/29/22,Pakistan,30.3753,69.3451,1573922,0,30625,1543297
10/30/22,Pakistan,30.3753,69.3451,1573922,0,30625,1543297
10/31/22,Pakistan,30.3753,69.3451,1574094,0,30626,1543468
11/1/22,Pakistan,30.3753,69.3451,1574094,0,30626,1543468
11/2/22,Pakistan,30.3753,69.3451,1574167,0,30627,1543540
11/3/22,Pakistan,30.3753,69.3451,1574275,0,30627,1543648
11/4/22,Pakistan,30.3753,69.3451,1574321,0,30627,1543694
11/5/22,Pakistan,30.3753,69.3451,1574321,0,30627,1543694
11/6/22,Pakistan,30.3753,69.3451,1574407,0,30627,1543780
11/7/22,Pakistan,30.3753,69.3451,1574407,0,30627,1543780
11/8/22,Pakistan,30.3753,69.3451,1574432,0,30627,1543805
11/9/22,Pakistan,30.3753,69.3451,1574508,0,30629,1543879
11/10/22,Pakistan,30.3753,69.3451,1574549,0,30629,1543920
11/11/22,Pakistan,30.3753,69.3451,1574549,0,30629,1543920
11/12/22,Pakistan,30.3753,69.3451,1574638,0,30629,1544009
11/13/22,Pakistan,30.3753,69.3451,1574679,0,30629,1544050
11/14/22,Pakistan,30.3753,69.3451,1574711,0,30629,1544082
11/15/22,Pakistan,30.3753,69.3451,1574743,0,30629,1544114
11/16/22,Pakistan,30.3753,69.3451,1574800,0,30630,1544170
11/17/22,Pakistan,30.3753,69.3451,1574825,0,30630,1544195
11/18/22,Pakistan,30.3753,69.3451,1574825,0,30630,1544195
11/19/22,Pakistan,30.3753,69.3451,1574825,0,30630,1544195
11/20/22,Pakistan,30.3753,69.3451,1574913,0,30630,1544283
11/21/22,Pakistan,30.3753,69.3451,1574938,0,30630,1544308
11/22/22,Pakistan,30.3753,69.3451,1574938,0,30630,1544308
11/23/22,Pakistan,30.3753,69.3451,1574965,0,30630,1544335
11/24/22,Pakistan,30.3753,69.3451,1574965,0,30630,1544335
11/25/22,Pakistan,30.3753,69.3451,1574965,0,30630,1544335
11/26/22,Pakistan,30.3753,69.3451,1574965,0,30630,1544335
11/27/22,Pakistan,30.3753,69.3451,1575124,0,30630,1544494
11/28/22,Pakistan,30.3753,69.3451,1575146,0,30631,1544515
11/29/22,Pakistan,30.3753,69.3451,1575185,0,30631,1544554
11/30/22,Pakistan,30.3753,69.3451,1575225,0,30632,1544593
12/1/22,Pakistan,30.3753,69.3451,1575225,0,30632,1544593
12/2/22,Pakistan,30.3753,69.3451,1575225,0,30632,1544593
12/3/22,Pakistan,30.3753,69.3451,1575225,0,30632,1544593
12/4/22,Pakistan,30.3753,69.3451,1575290,0,30632,1544658
12/5/22,Pakistan,30.3753,69.3451,1575354,0,30632,1544722
12/6/22,Pakistan,30.3753,69.3451,1575382,0,30634,1544748
12/7/22,Pakistan,30.3753,69.3451,1575406,0,30634,1544772
12/8/22,Pakistan,30.3753,69.3451,1575424,0,30635,1544789
12/9/22,Pakistan,30.3753,69.3451,1575424,0,30635,1544789
12/10/22,Pakistan,30.3753,69.3451,1575424,0,30635,1544789
12/11/22,Pakistan,30.3753,69.3451,1575479,0,30635,1544844
12/12/22,Pakistan,30.3753,69.3451,1575486,0,30635,1544851
12/13/22,Pakistan,30.3753,69.3451,1575486,0,30635,1544851
12/14/22,Pakistan,30.3753,69.3451,1575486,0,30635,1544851
12/15/22,Pakistan,30.3753,69.3451,1575486,0,30635,1544851
12/16/22,Pakistan,30.3753,69.3451,1575486,0,30635,1544851
12/17/22,Pakistan,30.3753,69.3451,1575486,0,30635,1544851
1/1/22,Palau,7.515,134.5825,12,0,0,12
1/2/22,Palau,7.515,134.5825,13,0,0,13
1/3/22,Palau,7.515,134.5825,13,0,0,13
1/4/22,Palau,7.515,134.5825,13,0,0,13
1/5/22,Palau,7.515,134.5825,15,0,0,15
1/6/22,Palau,7.515,134.5825,16,0,0,16
1/7/22,Palau,7.515,134.5825,18,0,0,18
1/8/22,Palau,7.515,134.5825,18,0,0,18
1/9/22,Palau,7.515,134.5825,18,0,0,18
1/10/22,Palau,7.515,134.5825,20,0,0,20
1/11/22,Palau,7.515,134.5825,28,0,0,28
1/12/22,Palau,7.515,134.5825,32,0,0,32
1/13/22,Palau,7.515,134.5825,39,0,0,39
1/14/22,Palau,7.515,134.5825,40,0,0,40
1/15/22,Palau,7.515,134.5825,40,0,0,40
1/16/22,Palau,7.515,134.5825,64,0,0,64
1/17/22,Palau,7.515,134.5825,119,0,0,119
1/18/22,Palau,7.515,134.5825,167,0,0,167
1/19/22,Palau,7.515,134.5825,167,0,0,167
1/20/22,Palau,7.515,134.5825,208,0,0,208
1/21/22,Palau,7.515,134.5825,208,0,0,208
1/22/22,Palau,7.515,134.5825,383,0,0,383
1/23/22,Palau,7.515,134.5825,502,0,0,502
1/24/22,Palau,7.515,134.5825,651,0,0,651
1/25/22,Palau,7.515,134.5825,651,0,0,651
1/26/22,Palau,7.515,134.5825,898,0,0,898
1/27/22,Palau,7.515,134.5825,1022,0,0,1022
1/28/22,Palau,7.515,134.5825,1393,0,0,1393
1/29/22,Palau,7.515,134.5825,1404,0,0,1404
1/30/22,Palau,7.515,134.5825,1478,0,0,1478
1/31/22,Palau,7.515,134.5825,1633,0,0,1633
2/1/22,Palau,7.515,134.5825,1810,0,0,1810
2/2/22,Palau,7.515,134.5825,1940,0,0,1940
2/3/22,Palau,7.515,134.5825,2115,0,0,2115
2/4/22,Palau,7.515,134.5825,2352,0,0,2352
2/5/22,Palau,7.515,134.5825,2495,0,0,2495
2/6/22,Palau,7.515,134.5825,2556,0,0,2556
2/7/22,Palau,7.515,134.5825,2716,0,0,2716
2/8/22,Palau,7.515,134.5825,2843,0,0,2843
2/9/22,Palau,7.515,134.5825,2956,0,0,2956
2/10/22,Palau,7.515,134.5825,3045,0,0,3045
2/11/22,Palau,7.515,134.5825,3119,0,1,3118
2/12/22,Palau,7.515,134.5825,3133,0,1,3132
2/13/22,Palau,7.515,134.5825,3133,0,1,3132
2/14/22,Palau,7.515,134.5825,3256,0,4,3252
2/15/22,Palau,7.515,134.5825,3303,0,4,3299
2/16/22,Palau,7.515,134.5825,3303,0,4,3299
2/17/22,Palau,7.515,134.5825,3425,0,5,3420
2/18/22,Palau,7.515,134.5825,3463,0,5,3458
2/19/22,Palau,7.515,134.5825,3463,0,5,3458
2/20/22,Palau,7.515,134.5825,3463,0,5,3458
2/21/22,Palau,7.515,134.5825,3563,0,6,3557
2/22/22,Palau,7.515,134.5825,3627,0,6,3621
2/23/22,Palau,7.515,134.5825,3667,0,6,3661
2/24/22,Palau,7.515,134.5825,3696,0,6,3690
2/25/22,Palau,7.515,134.5825,3726,0,6,3720
2/26/22,Palau,7.515,134.5825,3726,0,6,3720
2/27/22,Palau,7.515,134.5825,3726,0,6,3720
2/28/22,Palau,7.515,134.5825,3781,0,6,3775
3/1/22,Palau,7.515,134.5825,3781,0,6,3775
3/2/22,Palau,7.515,134.5825,3823,0,6,3817
3/3/22,Palau,7.515,134.5825,3823,0,6,3817
3/4/22,Palau,7.515,134.5825,3844,0,6,3838
3/5/22,Palau,7.515,134.5825,3844,0,6,3838
3/6/22,Palau,7.515,134.5825,3844,0,6,3838
3/7/22,Palau,7.515,134.5825,3864,0,6,3858
3/8/22,Palau,7.515,134.5825,3864,0,6,3858
3/9/22,Palau,7.515,134.5825,3888,0,6,3882
3/10/22,Palau,7.515,134.5825,3888,0,6,3882
3/11/22,Palau,7.515,134.5825,3899,0,6,3893
3/12/22,Palau,7.515,134.5825,3899,0,6,3893
3/13/22,Palau,7.515,134.5825,3899,0,6,3893
3/14/22,Palau,7.515,134.5825,3922,0,6,3916
3/15/22,Palau,7.515,134.5825,3922,0,6,3916
3/16/22,Palau,7.515,134.5825,3935,0,6,3929
3/17/22,Palau,7.515,134.5825,3935,0,6,3929
3/18/22,Palau,7.515,134.5825,3945,0,6,3939
3/19/22,Palau,7.515,134.5825,3945,0,6,3939
3/20/22,Palau,7.515,134.5825,3945,0,6,3939
3/21/22,Palau,7.515,134.5825,3966,0,6,3960
3/22/22,Palau,7.515,134.5825,3966,0,6,3960
3/23/22,Palau,7.515,134.5825,3976,0,6,3970
3/24/22,Palau,7.515,134.5825,3976,0,6,3970
3/25/22,Palau,7.515,134.5825,3987,0,6,3981
3/26/22,Palau,7.515,134.5825,3987,0,6,3981
3/27/22,Palau,7.515,134.5825,3987,0,6,3981
3/28/22,Palau,7.515,134.5825,4014,0,6,4008
3/29/22,Palau,7.515,134.5825,4014,0,6,4008
3/30/22,Palau,7.515,134.5825,4024,0,6,4018
3/31/22,Palau,7.515,134.5825,4024,0,6,4018
4/1/22,Palau,7.515,134.5825,4042,0,6,4036
4/2/22,Palau,7.515,134.5825,4042,0,6,4036
4/3/22,Palau,7.515,134.5825,4042,0,6,4036
4/4/22,Palau,7.515,134.5825,4042,0,6,4036
4/5/22,Palau,7.515,134.5825,4070,0,6,4064
4/6/22,Palau,7.515,134.5825,4070,0,6,4064
4/7/22,Palau,7.515,134.5825,4070,0,6,4064
4/8/22,Palau,7.515,134.5825,4098,0,6,4092
4/9/22,Palau,7.515,134.5825,4098,0,6,4092
4/10/22,Palau,7.515,134.5825,4098,0,6,4092
4/11/22,Palau,7.515,134.5825,4098,0,6,4092
4/12/22,Palau,7.515,134.5825,4122,0,6,4116
4/13/22,Palau,7.515,134.5825,4122,0,6,4116
4/14/22,Palau,7.515,134.5825,4122,0,6,4116
4/15/22,Palau,7.515,134.5825,4190,0,6,4184
4/16/22,Palau,7.515,134.5825,4190,0,6,4184
4/17/22,Palau,7.515,134.5825,4190,0,6,4184
4/18/22,Palau,7.515,134.5825,4190,0,6,4184
4/19/22,Palau,7.515,134.5825,4190,0,6,4184
4/20/22,Palau,7.515,134.5825,4279,0,6,4273
4/21/22,Palau,7.515,134.5825,4279,0,6,4273
4/22/22,Palau,7.515,134.5825,4396,0,6,4390
4/23/22,Palau,7.515,134.5825,4396,0,6,4390
4/24/22,Palau,7.515,134.5825,4396,0,6,4390
4/25/22,Palau,7.515,134.5825,4396,0,6,4390
4/26/22,Palau,7.515,134.5825,4486,0,6,4480
4/27/22,Palau,7.515,134.5825,4486,0,6,4480
4/28/22,Palau,7.515,134.5825,4486,0,6,4480
4/29/22,Palau,7.515,134.5825,4610,0,6,4604
4/30/22,Palau,7.515,134.5825,4610,0,6,4604
5/1/22,Palau,7.515,134.5825,4610,0,6,4604
5/2/22,Palau,7.515,134.5825,4610,0,6,4604
5/3/22,Palau,7.515,134.5825,4690,0,6,4684
5/4/22,Palau,7.515,134.5825,4690,0,6,4684
5/5/22,Palau,7.515,134.5825,4690,0,6,4684
5/6/22,Palau,7.515,134.5825,4732,0,6,4726
5/7/22,Palau,7.515,134.5825,4732,0,6,4726
5/8/22,Palau,7.515,134.5825,4732,0,6,4726
5/9/22,Palau,7.515,134.5825,4732,0,6,4726
5/10/22,Palau,7.515,134.5825,4782,0,6,4776
5/11/22,Palau,7.515,134.5825,4782,0,6,4776
5/12/22,Palau,7.515,134.5825,4782,0,6,4776
5/13/22,Palau,7.515,134.5825,4879,0,6,4873
5/14/22,Palau,7.515,134.5825,4879,0,6,4873
5/15/22,Palau,7.515,134.5825,4879,0,6,4873
5/16/22,Palau,7.515,134.5825,4879,0,6,4873
5/17/22,Palau,7.515,134.5825,4936,0,6,4930
5/18/22,Palau,7.515,134.5825,4936,0,6,4930
5/19/22,Palau,7.515,134.5825,4936,0,6,4930
5/20/22,Palau,7.515,134.5825,4967,0,6,4961
5/21/22,Palau,7.515,134.5825,4967,0,6,4961
5/22/22,Palau,7.515,134.5825,4967,0,6,4961
5/23/22,Palau,7.515,134.5825,4967,0,6,4961
5/24/22,Palau,7.515,134.5825,5020,0,6,5014
5/25/22,Palau,7.515,134.5825,5020,0,6,5014
5/26/22,Palau,7.515,134.5825,5020,0,6,5014
5/27/22,Palau,7.515,134.5825,5043,0,6,5037
5/28/22,Palau,7.515,134.5825,5043,0,6,5037
5/29/22,Palau,7.515,134.5825,5043,0,6,5037
5/30/22,Palau,7.515,134.5825,5043,0,6,5037
5/31/22,Palau,7.515,134.5825,5065,0,6,5059
6/1/22,Palau,7.515,134.5825,5065,0,6,5059
6/2/22,Palau,7.515,134.5825,5065,0,6,5059
6/3/22,Palau,7.515,134.5825,5083,0,6,5077
6/4/22,Palau,7.515,134.5825,5083,0,6,5077
6/5/22,Palau,7.515,134.5825,5083,0,6,5077
6/6/22,Palau,7.515,134.5825,5083,0,6,5077
6/7/22,Palau,7.515,134.5825,5126,0,6,5120
6/8/22,Palau,7.515,134.5825,5126,0,6,5120
6/9/22,Palau,7.515,134.5825,5126,0,6,5120
6/10/22,Palau,7.515,134.5825,5145,0,6,5139
6/11/22,Palau,7.515,134.5825,5145,0,6,5139
6/12/22,Palau,7.515,134.5825,5145,0,6,5139
6/13/22,Palau,7.515,134.5825,5145,0,6,5139
6/14/22,Palau,7.515,134.5825,5165,0,6,5159
6/15/22,Palau,7.515,134.5825,5165,0,6,5159
6/16/22,Palau,7.515,134.5825,5165,0,6,5159
6/17/22,Palau,7.515,134.5825,5181,0,6,5175
6/18/22,Palau,7.515,134.5825,5181,0,6,5175
6/19/22,Palau,7.515,134.5825,5181,0,6,5175
6/20/22,Palau,7.515,134.5825,5181,0,6,5175
6/21/22,Palau,7.515,134.5825,5193,0,6,5187
6/22/22,Palau,7.515,134.5825,5193,0,6,5187
6/23/22,Palau,7.515,134.5825,5193,0,6,5187
6/24/22,Palau,7.515,134.5825,5201,0,6,5195
6/25/22,Palau,7.515,134.5825,5201,0,6,5195
6/26/22,Palau,7.515,134.5825,5201,0,6,5195
6/27/22,Palau,7.515,134.5825,5201,0,6,5195
6/28/22,Palau,7.515,134.5825,5220,0,6,5214
6/29/22,Palau,7.515,134.5825,5220,0,6,5214
6/30/22,Palau,7.515,134.5825,5220,0,6,5214
7/1/22,Palau,7.515,134.5825,5237,0,6,5231
7/2/22,Palau,7.515,134.5825,5237,0,6,5231
7/3/22,Palau,7.515,134.5825,5237,0,6,5231
7/4/22,Palau,7.515,134.5825,5237,0,6,5231
7/5/22,Palau,7.515,134.5825,5269,0,6,5263
7/6/22,Palau,7.515,134.5825,5269,0,6,5263
7/7/22,Palau,7.515,134.5825,5269,0,6,5263
7/8/22,Palau,7.515,134.5825,5269,0,6,5263
7/9/22,Palau,7.515,134.5825,5269,0,6,5263
7/10/22,Palau,7.515,134.5825,5269,0,6,5263
7/11/22,Palau,7.515,134.5825,5269,0,6,5263
7/12/22,Palau,7.515,134.5825,5308,0,6,5302
7/13/22,Palau,7.515,134.5825,5308,0,6,5302
7/14/22,Palau,7.515,134.5825,5308,0,6,5302
7/15/22,Palau,7.515,134.5825,5308,0,6,5302
7/16/22,Palau,7.515,134.5825,5308,0,6,5302
7/17/22,Palau,7.515,134.5825,5308,0,6,5302
7/18/22,Palau,7.515,134.5825,5308,0,6,5302
7/19/22,Palau,7.515,134.5825,5308,0,6,5302
7/20/22,Palau,7.515,134.5825,5308,0,6,5302
7/21/22,Palau,7.515,134.5825,5308,0,6,5302
7/22/22,Palau,7.515,134.5825,5308,0,6,5302
7/23/22,Palau,7.515,134.5825,5308,0,6,5302
7/24/22,Palau,7.515,134.5825,5308,0,6,5302
7/25/22,Palau,7.515,134.5825,5308,0,6,5302
7/26/22,Palau,7.515,134.5825,5308,0,6,5302
7/27/22,Palau,7.515,134.5825,5308,0,6,5302
7/28/22,Palau,7.515,134.5825,5308,0,6,5302
7/29/22,Palau,7.515,134.5825,5308,0,6,5302
7/30/22,Palau,7.515,134.5825,5308,0,6,5302
7/31/22,Palau,7.515,134.5825,5308,0,6,5302
8/1/22,Palau,7.515,134.5825,5308,0,6,5302
8/2/22,Palau,7.515,134.5825,5308,0,6,5302
8/3/22,Palau,7.515,134.5825,5308,0,6,5302
8/4/22,Palau,7.515,134.5825,5308,0,6,5302
8/5/22,Palau,7.515,134.5825,5308,0,6,5302
8/6/22,Palau,7.515,134.5825,5308,0,6,5302
8/7/22,Palau,7.515,134.5825,5308,0,6,5302
8/8/22,Palau,7.515,134.5825,5308,0,6,5302
8/9/22,Palau,7.515,134.5825,5308,0,6,5302
8/10/22,Palau,7.515,134.5825,5308,0,6,5302
8/11/22,Palau,7.515,134.5825,5308,0,6,5302
8/12/22,Palau,7.515,134.5825,5308,0,6,5302
8/13/22,Palau,7.515,134.5825,5308,0,6,5302
8/14/22,Palau,7.515,134.5825,5308,0,6,5302
8/15/22,Palau,7.515,134.5825,5308,0,6,5302
8/16/22,Palau,7.515,134.5825,5308,0,6,5302
8/17/22,Palau,7.515,134.5825,5308,0,6,5302
8/18/22,Palau,7.515,134.5825,5308,0,6,5302
8/19/22,Palau,7.515,134.5825,5308,0,6,5302
8/20/22,Palau,7.515,134.5825,5308,0,6,5302
8/21/22,Palau,7.515,134.5825,5308,0,6,5302
8/22/22,Palau,7.515,134.5825,5308,0,6,5302
8/23/22,Palau,7.515,134.5825,5308,0,6,5302
8/24/22,Palau,7.515,134.5825,5308,0,6,5302
8/25/22,Palau,7.515,134.5825,5308,0,6,5302
8/26/22,Palau,7.515,134.5825,5348,0,6,5342
8/27/22,Palau,7.515,134.5825,5348,0,6,5342
8/28/22,Palau,7.515,134.5825,5348,0,6,5342
8/29/22,Palau,7.515,134.5825,5348,0,6,5342
8/30/22,Palau,7.515,134.5825,5348,0,6,5342
8/31/22,Palau,7.515,134.5825,5348,0,6,5342
9/1/22,Palau,7.515,134.5825,5348,0,6,5342
9/2/22,Palau,7.515,134.5825,5403,0,6,5397
9/3/22,Palau,7.515,134.5825,5403,0,6,5397
9/4/22,Palau,7.515,134.5825,5403,0,6,5397
9/5/22,Palau,7.515,134.5825,5403,0,6,5397
9/6/22,Palau,7.515,134.5825,5403,0,6,5397
9/7/22,Palau,7.515,134.5825,5403,0,6,5397
9/8/22,Palau,7.515,134.5825,5403,0,6,5397
9/9/22,Palau,7.515,134.5825,5430,0,6,5424
9/10/22,Palau,7.515,134.5825,5430,0,6,5424
9/11/22,Palau,7.515,134.5825,5430,0,6,5424
9/12/22,Palau,7.515,134.5825,5430,0,6,5424
9/13/22,Palau,7.515,134.5825,5430,0,6,5424
9/14/22,Palau,7.515,134.5825,5430,0,6,5424
9/15/22,Palau,7.515,134.5825,5430,0,6,5424
9/16/22,Palau,7.515,134.5825,5430,0,6,5424
9/17/22,Palau,7.515,134.5825,5445,0,6,5439
9/18/22,Palau,7.515,134.5825,5445,0,6,5439
9/19/22,Palau,7.515,134.5825,5445,0,6,5439
9/20/22,Palau,7.515,134.5825,5445,0,6,5439
9/21/22,Palau,7.515,134.5825,5445,0,6,5439
9/22/22,Palau,7.515,134.5825,5445,0,6,5439
9/23/22,Palau,7.515,134.5825,5445,0,6,5439
9/24/22,Palau,7.515,134.5825,5460,0,6,5454
9/25/22,Palau,7.515,134.5825,5460,0,6,5454
9/26/22,Palau,7.515,134.5825,5460,0,6,5454
9/27/22,Palau,7.515,134.5825,5460,0,6,5454
9/28/22,Palau,7.515,134.5825,5460,0,6,5454
9/29/22,Palau,7.515,134.5825,5460,0,6,5454
9/30/22,Palau,7.515,134.5825,5460,0,6,5454
10/1/22,Palau,7.515,134.5825,5460,0,6,5454
10/2/22,Palau,7.515,134.5825,5460,0,6,5454
10/3/22,Palau,7.515,134.5825,5460,0,6,5454
10/4/22,Palau,7.515,134.5825,5460,0,6,5454
10/5/22,Palau,7.515,134.5825,5460,0,6,5454
10/6/22,Palau,7.515,134.5825,5460,0,6,5454
10/7/22,Palau,7.515,134.5825,5460,0,6,5454
10/8/22,Palau,7.515,134.5825,5481,0,6,5475
10/9/22,Palau,7.515,134.5825,5481,0,6,5475
10/10/22,Palau,7.515,134.5825,5481,0,6,5475
10/11/22,Palau,7.515,134.5825,5481,0,6,5475
10/12/22,Palau,7.515,134.5825,5481,0,6,5475
10/13/22,Palau,7.515,134.5825,5481,0,6,5475
10/14/22,Palau,7.515,134.5825,5490,0,7,5483
10/15/22,Palau,7.515,134.5825,5490,0,7,5483
10/16/22,Palau,7.515,134.5825,5490,0,7,5483
10/17/22,Palau,7.515,134.5825,5490,0,7,5483
10/18/22,Palau,7.515,134.5825,5490,0,7,5483
10/19/22,Palau,7.515,134.5825,5490,0,7,5483
10/20/22,Palau,7.515,134.5825,5490,0,7,5483
10/21/22,Palau,7.515,134.5825,5490,0,7,5483
10/22/22,Palau,7.515,134.5825,5490,0,7,5483
10/23/22,Palau,7.515,134.5825,5490,0,7,5483
10/24/22,Palau,7.515,134.5825,5490,0,7,5483
10/25/22,Palau,7.515,134.5825,5509,0,7,5502
10/26/22,Palau,7.515,134.5825,5509,0,7,5502
10/27/22,Palau,7.515,134.5825,5509,0,7,5502
10/28/22,Palau,7.515,134.5825,5509,0,7,5502
10/29/22,Palau,7.515,134.5825,5513,0,7,5506
10/30/22,Palau,7.515,134.5825,5513,0,7,5506
10/31/22,Palau,7.515,134.5825,5513,0,7,5506
11/1/22,Palau,7.515,134.5825,5513,0,7,5506
11/2/22,Palau,7.515,134.5825,5513,0,7,5506
11/3/22,Palau,7.515,134.5825,5513,0,7,5506
11/4/22,Palau,7.515,134.5825,5513,0,7,5506
11/5/22,Palau,7.515,134.5825,5513,0,7,5506
11/6/22,Palau,7.515,134.5825,5513,0,7,5506
11/7/22,Palau,7.515,134.5825,5530,0,7,5523
11/8/22,Palau,7.515,134.5825,5530,0,7,5523
11/9/22,Palau,7.515,134.5825,5530,0,7,5523
11/10/22,Palau,7.515,134.5825,5530,0,7,5523
11/11/22,Palau,7.515,134.5825,5530,0,7,5523
11/12/22,Palau,7.515,134.5825,5530,0,7,5523
11/13/22,Palau,7.515,134.5825,5572,0,7,5565
11/14/22,Palau,7.515,134.5825,5572,0,7,5565
11/15/22,Palau,7.515,134.5825,5572,0,7,5565
11/16/22,Palau,7.515,134.5825,5572,0,7,5565
11/17/22,Palau,7.515,134.5825,5572,0,7,5565
11/18/22,Palau,7.515,134.5825,5684,0,7,5677
11/19/22,Palau,7.515,134.5825,5684,0,7,5677
11/20/22,Palau,7.515,134.5825,5684,0,7,5677
11/21/22,Palau,7.515,134.5825,5684,0,7,5677
11/22/22,Palau,7.515,134.5825,5684,0,7,5677
11/23/22,Palau,7.515,134.5825,5684,0,7,5677
11/24/22,Palau,7.515,134.5825,5684,0,7,5677
11/25/22,Palau,7.515,134.5825,5684,0,7,5677
11/26/22,Palau,7.515,134.5825,5684,0,7,5677
11/27/22,Palau,7.515,134.5825,5684,0,7,5677
11/28/22,Palau,7.515,134.5825,5785,0,7,5778
11/29/22,Palau,7.515,134.5825,5785,0,7,5778
11/30/22,Palau,7.515,134.5825,5785,0,7,5778
12/1/22,Palau,7.515,134.5825,5785,0,7,5778
12/2/22,Palau,7.515,134.5825,5785,0,7,5778
12/3/22,Palau,7.515,134.5825,5785,0,7,5778
12/4/22,Palau,7.515,134.5825,5785,0,7,5778
12/5/22,Palau,7.515,134.5825,5896,0,7,5889
12/6/22,Palau,7.515,134.5825,5896,0,7,5889
12/7/22,Palau,7.515,134.5825,5896,0,7,5889
12/8/22,Palau,7.515,134.5825,5896,0,7,5889
12/9/22,Palau,7.515,134.5825,5896,0,7,5889
12/10/22,Palau,7.515,134.5825,5896,0,7,5889
12/11/22,Palau,7.515,134.5825,5896,0,7,5889
12/12/22,Palau,7.515,134.5825,5896,0,7,5889
12/13/22,Palau,7.515,134.5825,5933,0,9,5924
12/14/22,Palau,7.515,134.5825,5933,0,9,5924
12/15/22,Palau,7.515,134.5825,5933,0,9,5924
12/16/22,Palau,7.515,134.5825,5933,0,9,5924
12/17/22,Palau,7.515,134.5825,5933,0,9,5924
1/1/22,Panama,8.538,-80.7821,497808,0,7430,490378
1/2/22,Panama,8.538,-80.7821,498785,0,7433,491352
1/3/22,Panama,8.538,-80.7821,500148,0,7440,492708
1/4/22,Panama,8.538,-80.7821,500148,0,7440,492708
1/5/22,Panama,8.538,-80.7821,503407,0,7445,495962
1/6/22,Panama,8.538,-80.7821,512402,0,7449,504953
1/7/22,Panama,8.538,-80.7821,517445,0,7453,509992
1/8/22,Panama,8.538,-80.7821,522249,0,7458,514791
1/9/22,Panama,8.538,-80.7821,526315,0,7465,518850
1/10/22,Panama,8.538,-80.7821,529454,0,7469,521985
1/11/22,Panama,8.538,-80.7821,533559,0,7479,526080
1/12/22,Panama,8.538,-80.7821,540072,0,7486,532586
1/13/22,Panama,8.538,-80.7821,540072,0,7486,532586
1/14/22,Panama,8.538,-80.7821,558676,0,7500,551176
1/15/22,Panama,8.538,-80.7821,567578,0,7511,560067
1/16/22,Panama,8.538,-80.7821,574856,0,7520,567336
1/17/22,Panama,8.538,-80.7821,580324,0,7528,572796
1/18/22,Panama,8.538,-80.7821,591843,0,7545,584298
1/19/22,Panama,8.538,-80.7821,602606,0,7554,595052
1/20/22,Panama,8.538,-80.7821,614957,0,7565,607392
1/21/22,Panama,8.538,-80.7821,626890,0,7574,619316
1/22/22,Panama,8.538,-80.7821,626890,0,7574,619316
1/23/22,Panama,8.538,-80.7821,644683,0,7598,637085
1/24/22,Panama,8.538,-80.7821,644683,0,7598,637085
1/25/22,Panama,8.538,-80.7821,650138,0,7609,642529
1/26/22,Panama,8.538,-80.7821,669860,0,7645,662215
1/27/22,Panama,8.538,-80.7821,678128,0,7656,670472
1/28/22,Panama,8.538,-80.7821,685630,0,7680,677950
1/29/22,Panama,8.538,-80.7821,692634,0,7698,684936
1/30/22,Panama,8.538,-80.7821,697124,0,7716,689408
1/31/22,Panama,8.538,-80.7821,697124,0,7716,689408
2/1/22,Panama,8.538,-80.7821,705880,0,7752,698128
2/2/22,Panama,8.538,-80.7821,705880,0,7752,698128
2/3/22,Panama,8.538,-80.7821,717171,0,7788,709383
2/4/22,Panama,8.538,-80.7821,721479,0,7813,713666
2/5/22,Panama,8.538,-80.7821,721479,0,7813,713666
2/6/22,Panama,8.538,-80.7821,727413,0,7844,719569
2/7/22,Panama,8.538,-80.7821,727413,0,7844,719569
2/8/22,Panama,8.538,-80.7821,732207,0,7886,724321
2/9/22,Panama,8.538,-80.7821,735235,0,7898,727337
2/10/22,Panama,8.538,-80.7821,737659,0,7909,729750
2/11/22,Panama,8.538,-80.7821,739770,0,7926,731844
2/12/22,Panama,8.538,-80.7821,741651,0,7938,733713
2/13/22,Panama,8.538,-80.7821,742854,0,7950,734904
2/14/22,Panama,8.538,-80.7821,742854,0,7950,734904
2/15/22,Panama,8.538,-80.7821,745367,0,7970,737397
2/16/22,Panama,8.538,-80.7821,746695,0,7987,738708
2/17/22,Panama,8.538,-80.7821,747916,0,7993,739923
2/18/22,Panama,8.538,-80.7821,749135,0,8000,741135
2/19/22,Panama,8.538,-80.7821,749135,0,8000,741135
2/20/22,Panama,8.538,-80.7821,750760,0,8019,742741
2/21/22,Panama,8.538,-80.7821,750760,0,8019,742741
2/22/22,Panama,8.538,-80.7821,752173,0,8036,744137
2/23/22,Panama,8.538,-80.7821,752907,0,8047,744860
2/24/22,Panama,8.538,-80.7821,753694,0,8058,745636
2/25/22,Panama,8.538,-80.7821,754362,0,8063,746299
2/26/22,Panama,8.538,-80.7821,754905,0,8073,746832
2/27/22,Panama,8.538,-80.7821,755262,0,8079,747183
2/28/22,Panama,8.538,-80.7821,755498,0,8083,747415
3/1/22,Panama,8.538,-80.7821,755853,0,8093,747760
3/2/22,Panama,8.538,-80.7821,756085,0,8098,747987
3/3/22,Panama,8.538,-80.7821,756539,0,8101,748438
3/4/22,Panama,8.538,-80.7821,757061,0,8106,748955
3/5/22,Panama,8.538,-80.7821,757487,0,8111,749376
3/6/22,Panama,8.538,-80.7821,757487,0,8111,749376
3/7/22,Panama,8.538,-80.7821,757930,0,8118,749812
3/8/22,Panama,8.538,-80.7821,758312,0,8122,750190
3/9/22,Panama,8.538,-80.7821,758613,0,8125,750488
3/10/22,Panama,8.538,-80.7821,758923,0,8128,750795
3/11/22,Panama,8.538,-80.7821,759224,0,8131,751093
3/12/22,Panama,8.538,-80.7821,759224,0,8131,751093
3/13/22,Panama,8.538,-80.7821,759636,0,8137,751499
3/14/22,Panama,8.538,-80.7821,759782,0,8140,751642
3/15/22,Panama,8.538,-80.7821,760105,0,8143,751962
3/16/22,Panama,8.538,-80.7821,760405,0,8146,752259
3/17/22,Panama,8.538,-80.7821,760735,0,8150,752585
3/18/22,Panama,8.538,-80.7821,761004,0,8153,752851
3/19/22,Panama,8.538,-80.7821,761004,0,8153,752851
3/20/22,Panama,8.538,-80.7821,761508,0,8156,753352
3/21/22,Panama,8.538,-80.7821,761508,0,8156,753352
3/22/22,Panama,8.538,-80.7821,762008,0,8159,753849
3/23/22,Panama,8.538,-80.7821,762394,0,8159,754235
3/24/22,Panama,8.538,-80.7821,762735,0,8160,754575
3/25/22,Panama,8.538,-80.7821,763025,0,8162,754863
3/26/22,Panama,8.538,-80.7821,763280,0,8163,755117
3/27/22,Panama,8.538,-80.7821,763483,0,8164,755319
3/28/22,Panama,8.538,-80.7821,763608,0,8167,755441
3/29/22,Panama,8.538,-80.7821,763933,0,8168,755765
3/30/22,Panama,8.538,-80.7821,764243,0,8168,756075
3/31/22,Panama,8.538,-80.7821,764536,0,8170,756366
4/1/22,Panama,8.538,-80.7821,764831,0,8170,756661
4/2/22,Panama,8.538,-80.7821,764831,0,8170,756661
4/3/22,Panama,8.538,-80.7821,765213,0,8170,757043
4/4/22,Panama,8.538,-80.7821,765337,0,8172,757165
4/5/22,Panama,8.538,-80.7821,765677,0,8172,757505
4/6/22,Panama,8.538,-80.7821,765930,0,8172,757758
4/7/22,Panama,8.538,-80.7821,766177,0,8174,758003
4/8/22,Panama,8.538,-80.7821,766504,0,8174,758330
4/9/22,Panama,8.538,-80.7821,766504,0,8174,758330
4/10/22,Panama,8.538,-80.7821,766931,0,8176,758755
4/11/22,Panama,8.538,-80.7821,766931,0,8176,758755
4/12/22,Panama,8.538,-80.7821,767067,0,8177,758890
4/13/22,Panama,8.538,-80.7821,767835,0,8178,759657
4/14/22,Panama,8.538,-80.7821,768199,0,8178,760021
4/15/22,Panama,8.538,-80.7821,768470,0,8178,760292
4/16/22,Panama,8.538,-80.7821,768470,0,8178,760292
4/17/22,Panama,8.538,-80.7821,768794,0,8179,760615
4/18/22,Panama,8.538,-80.7821,768978,0,8179,760799
4/19/22,Panama,8.538,-80.7821,769457,0,8179,761278
4/20/22,Panama,8.538,-80.7821,769976,0,8180,761796
4/21/22,Panama,8.538,-80.7821,770463,0,8180,762283
4/22/22,Panama,8.538,-80.7821,771005,0,8182,762823
4/23/22,Panama,8.538,-80.7821,771486,0,8182,763304
4/24/22,Panama,8.538,-80.7821,771819,0,8182,763637
4/25/22,Panama,8.538,-80.7821,772086,0,8182,763904
4/26/22,Panama,8.538,-80.7821,772830,0,8183,764647
4/27/22,Panama,8.538,-80.7821,773675,0,8183,765492
4/28/22,Panama,8.538,-80.7821,774549,0,8184,766365
4/29/22,Panama,8.538,-80.7821,775488,0,8184,767304
4/30/22,Panama,8.538,-80.7821,776420,0,8184,768236
5/1/22,Panama,8.538,-80.7821,777120,0,8184,768936
5/2/22,Panama,8.538,-80.7821,777658,0,8185,769473
5/3/22,Panama,8.538,-80.7821,778310,0,8188,770122
5/4/22,Panama,8.538,-80.7821,780148,0,8189,771959
5/5/22,Panama,8.538,-80.7821,782265,0,8189,774076
5/6/22,Panama,8.538,-80.7821,784184,0,8191,775993
5/7/22,Panama,8.538,-80.7821,786856,0,8192,778664
5/8/22,Panama,8.538,-80.7821,788471,0,8193,780278
5/9/22,Panama,8.538,-80.7821,789830,0,8194,781636
5/10/22,Panama,8.538,-80.7821,793137,0,8194,784943
5/11/22,Panama,8.538,-80.7821,796461,0,8199,788262
5/12/22,Panama,8.538,-80.7821,799975,0,8199,791776
5/13/22,Panama,8.538,-80.7821,803223,0,8202,795021
5/14/22,Panama,8.538,-80.7821,806277,0,8203,798074
5/15/22,Panama,8.538,-80.7821,808443,0,8205,800238
5/16/22,Panama,8.538,-80.7821,810242,0,8206,802036
5/17/22,Panama,8.538,-80.7821,810242,0,8206,802036
5/18/22,Panama,8.538,-80.7821,817658,0,8211,809447
5/19/22,Panama,8.538,-80.7821,821500,0,8211,813289
5/20/22,Panama,8.538,-80.7821,824917,0,8216,816701
5/21/22,Panama,8.538,-80.7821,828120,0,8221,819899
5/22/22,Panama,8.538,-80.7821,830287,0,8227,822060
5/23/22,Panama,8.538,-80.7821,832045,0,8229,823816
5/24/22,Panama,8.538,-80.7821,835921,0,8232,827689
5/25/22,Panama,8.538,-80.7821,839746,0,8236,831510
5/26/22,Panama,8.538,-80.7821,843697,0,8239,835458
5/27/22,Panama,8.538,-80.7821,847375,0,8244,839131
5/28/22,Panama,8.538,-80.7821,850484,0,8247,842237
5/29/22,Panama,8.538,-80.7821,852607,0,8249,844358
5/30/22,Panama,8.538,-80.7821,854449,0,8254,846195
5/31/22,Panama,8.538,-80.7821,858268,0,8255,850013
6/1/22,Panama,8.538,-80.7821,861711,0,8258,853453
6/2/22,Panama,8.538,-80.7821,865500,0,8262,857238
6/3/22,Panama,8.538,-80.7821,868796,0,8267,860529
6/4/22,Panama,8.538,-80.7821,871852,0,8269,863583
6/5/22,Panama,8.538,-80.7821,873794,0,8275,865519
6/6/22,Panama,8.538,-80.7821,875486,0,8276,867210
6/7/22,Panama,8.538,-80.7821,879009,0,8279,870730
6/8/22,Panama,8.538,-80.7821,882253,0,8284,873969
6/9/22,Panama,8.538,-80.7821,885046,0,8288,876758
6/10/22,Panama,8.538,-80.7821,887637,0,8295,879342
6/11/22,Panama,8.538,-80.7821,889960,0,8298,881662
6/12/22,Panama,8.538,-80.7821,891349,0,8299,883050
6/13/22,Panama,8.538,-80.7821,892455,0,8307,884148
6/14/22,Panama,8.538,-80.7821,894844,0,8312,886532
6/15/22,Panama,8.538,-80.7821,896924,0,8314,888610
6/16/22,Panama,8.538,-80.7821,898882,0,8316,890566
6/17/22,Panama,8.538,-80.7821,900333,0,8318,892015
6/18/22,Panama,8.538,-80.7821,902386,0,8319,894067
6/19/22,Panama,8.538,-80.7821,903529,0,8323,895206
6/20/22,Panama,8.538,-80.7821,904355,0,8325,896030
6/21/22,Panama,8.538,-80.7821,906435,0,8329,898106
6/22/22,Panama,8.538,-80.7821,908392,0,8332,900060
6/23/22,Panama,8.538,-80.7821,910522,0,8335,902187
6/24/22,Panama,8.538,-80.7821,912348,0,8340,904008
6/25/22,Panama,8.538,-80.7821,913932,0,8346,905586
6/26/22,Panama,8.538,-80.7821,915057,0,8347,906710
6/27/22,Panama,8.538,-80.7821,915923,0,8348,907575
6/28/22,Panama,8.538,-80.7821,917912,0,8352,909560
6/29/22,Panama,8.538,-80.7821,919740,0,8359,911381
6/30/22,Panama,8.538,-80.7821,921364,0,8364,913000
7/1/22,Panama,8.538,-80.7821,922990,0,8368,914622
7/2/22,Panama,8.538,-80.7821,922990,0,8368,914622
7/3/22,Panama,8.538,-80.7821,925254,0,8373,916881
7/4/22,Panama,8.538,-80.7821,925254,0,8373,916881
7/5/22,Panama,8.538,-80.7821,925254,0,8373,916881
7/6/22,Panama,8.538,-80.7821,925254,0,8373,916881
7/7/22,Panama,8.538,-80.7821,925254,0,8373,916881
7/8/22,Panama,8.538,-80.7821,932710,0,8384,924326
7/9/22,Panama,8.538,-80.7821,932710,0,8384,924326
7/10/22,Panama,8.538,-80.7821,932710,0,8384,924326
7/11/22,Panama,8.538,-80.7821,932710,0,8384,924326
7/12/22,Panama,8.538,-80.7821,938791,0,8384,930407
7/13/22,Panama,8.538,-80.7821,938791,0,8384,930407
7/14/22,Panama,8.538,-80.7821,938791,0,8386,930405
7/15/22,Panama,8.538,-80.7821,938791,0,8386,930405
7/16/22,Panama,8.538,-80.7821,938791,0,8386,930405
7/17/22,Panama,8.538,-80.7821,938791,0,8386,930405
7/18/22,Panama,8.538,-80.7821,942083,0,8395,933688
7/19/22,Panama,8.538,-80.7821,942083,0,8395,933688
7/20/22,Panama,8.538,-80.7821,942083,0,8395,933688
7/21/22,Panama,8.538,-80.7821,942083,0,8395,933688
7/22/22,Panama,8.538,-80.7821,942083,0,8395,933688
7/23/22,Panama,8.538,-80.7821,942083,0,8395,933688
7/24/22,Panama,8.538,-80.7821,942083,0,8395,933688
7/25/22,Panama,8.538,-80.7821,942083,0,8395,933688
7/26/22,Panama,8.538,-80.7821,948473,0,8412,940061
7/27/22,Panama,8.538,-80.7821,948473,0,8412,940061
7/28/22,Panama,8.538,-80.7821,948473,0,8412,940061
7/29/22,Panama,8.538,-80.7821,948473,0,8412,940061
7/30/22,Panama,8.538,-80.7821,948473,0,8412,940061
7/31/22,Panama,8.538,-80.7821,948473,0,8412,940061
8/1/22,Panama,8.538,-80.7821,954369,0,8425,945944
8/2/22,Panama,8.538,-80.7821,954369,0,8425,945944
8/3/22,Panama,8.538,-80.7821,954369,0,8425,945944
8/4/22,Panama,8.538,-80.7821,954369,0,8425,945944
8/5/22,Panama,8.538,-80.7821,954369,0,8425,945944
8/6/22,Panama,8.538,-80.7821,954369,0,8425,945944
8/7/22,Panama,8.538,-80.7821,954369,0,8425,945944
8/8/22,Panama,8.538,-80.7821,960300,0,8434,951866
8/9/22,Panama,8.538,-80.7821,960300,0,8434,951866
8/10/22,Panama,8.538,-80.7821,960300,0,8434,951866
8/11/22,Panama,8.538,-80.7821,960300,0,8434,951866
8/12/22,Panama,8.538,-80.7821,960300,0,8434,951866
8/13/22,Panama,8.538,-80.7821,960300,0,8434,951866
8/14/22,Panama,8.538,-80.7821,960300,0,8434,951866
8/15/22,Panama,8.538,-80.7821,960300,0,8434,951866
8/16/22,Panama,8.538,-80.7821,966779,0,8444,958335
8/17/22,Panama,8.538,-80.7821,966779,0,8444,958335
8/18/22,Panama,8.538,-80.7821,966779,0,8444,958335
8/19/22,Panama,8.538,-80.7821,966779,0,8444,958335
8/20/22,Panama,8.538,-80.7821,966779,0,8444,958335
8/21/22,Panama,8.538,-80.7821,966779,0,8444,958335
8/22/22,Panama,8.538,-80.7821,972800,0,8456,964344
8/23/22,Panama,8.538,-80.7821,972800,0,8456,964344
8/24/22,Panama,8.538,-80.7821,972800,0,8456,964344
8/25/22,Panama,8.538,-80.7821,972800,0,8456,964344
8/26/22,Panama,8.538,-80.7821,972800,0,8456,964344
8/27/22,Panama,8.538,-80.7821,972800,0,8456,964344
8/28/22,Panama,8.538,-80.7821,972800,0,8456,964344
8/29/22,Panama,8.538,-80.7821,978181,0,8470,969711
8/30/22,Panama,8.538,-80.7821,978181,0,8470,969711
8/31/22,Panama,8.538,-80.7821,978181,0,8470,969711
9/1/22,Panama,8.538,-80.7821,978181,0,8470,969711
9/2/22,Panama,8.538,-80.7821,978181,0,8470,969711
9/3/22,Panama,8.538,-80.7821,978181,0,8470,969711
9/4/22,Panama,8.538,-80.7821,978181,0,8470,969711
9/5/22,Panama,8.538,-80.7821,981822,0,8480,973342
9/6/22,Panama,8.538,-80.7821,981822,0,8480,973342
9/7/22,Panama,8.538,-80.7821,981822,0,8480,973342
9/8/22,Panama,8.538,-80.7821,981822,0,8480,973342
9/9/22,Panama,8.538,-80.7821,981822,0,8480,973342
9/10/22,Panama,8.538,-80.7821,981822,0,8480,973342
9/11/22,Panama,8.538,-80.7821,981822,0,8480,973342
9/12/22,Panama,8.538,-80.7821,984234,0,8487,975747
9/13/22,Panama,8.538,-80.7821,984234,0,8487,975747
9/14/22,Panama,8.538,-80.7821,984234,0,8487,975747
9/15/22,Panama,8.538,-80.7821,984234,0,8487,975747
9/16/22,Panama,8.538,-80.7821,984234,0,8487,975747
9/17/22,Panama,8.538,-80.7821,984234,0,8487,975747
9/18/22,Panama,8.538,-80.7821,984234,0,8487,975747
9/19/22,Panama,8.538,-80.7821,985814,0,8490,977324
9/20/22,Panama,8.538,-80.7821,985814,0,8490,977324
9/21/22,Panama,8.538,-80.7821,985814,0,8490,977324
9/22/22,Panama,8.538,-80.7821,985814,0,8490,977324
9/23/22,Panama,8.538,-80.7821,985814,0,8490,977324
9/24/22,Panama,8.538,-80.7821,985814,0,8490,977324
9/25/22,Panama,8.538,-80.7821,985814,0,8490,977324
9/26/22,Panama,8.538,-80.7821,986866,0,8497,978369
9/27/22,Panama,8.538,-80.7821,986866,0,8497,978369
9/28/22,Panama,8.538,-80.7821,986866,0,8497,978369
9/29/22,Panama,8.538,-80.7821,986866,0,8497,978369
9/30/22,Panama,8.538,-80.7821,986866,0,8497,978369
10/1/22,Panama,8.538,-80.7821,986866,0,8497,978369
10/2/22,Panama,8.538,-80.7821,986866,0,8497,978369
10/3/22,Panama,8.538,-80.7821,987613,0,8502,979111
10/4/22,Panama,8.538,-80.7821,987613,0,8502,979111
10/5/22,Panama,8.538,-80.7821,987613,0,8502,979111
10/6/22,Panama,8.538,-80.7821,987613,0,8502,979111
10/7/22,Panama,8.538,-80.7821,987613,0,8502,979111
10/8/22,Panama,8.538,-80.7821,987613,0,8502,979111
10/9/22,Panama,8.538,-80.7821,987613,0,8502,979111
10/10/22,Panama,8.538,-80.7821,988280,0,8505,979775
10/11/22,Panama,8.538,-80.7821,988280,0,8505,979775
10/12/22,Panama,8.538,-80.7821,988280,0,8505,979775
10/13/22,Panama,8.538,-80.7821,988280,0,8505,979775
10/14/22,Panama,8.538,-80.7821,988280,0,8505,979775
10/15/22,Panama,8.538,-80.7821,988280,0,8505,979775
10/16/22,Panama,8.538,-80.7821,988280,0,8505,979775
10/17/22,Panama,8.538,-80.7821,988280,0,8505,979775
10/18/22,Panama,8.538,-80.7821,989005,0,8506,980499
10/19/22,Panama,8.538,-80.7821,989005,0,8506,980499
10/20/22,Panama,8.538,-80.7821,989005,0,8506,980499
10/21/22,Panama,8.538,-80.7821,989005,0,8506,980499
10/22/22,Panama,8.538,-80.7821,989005,0,8506,980499
10/23/22,Panama,8.538,-80.7821,989005,0,8506,980499
10/24/22,Panama,8.538,-80.7821,989005,0,8506,980499
10/25/22,Panama,8.538,-80.7821,989608,0,8506,981102
10/26/22,Panama,8.538,-80.7821,989608,0,8506,981102
10/27/22,Panama,8.538,-80.7821,989608,0,8506,981102
10/28/22,Panama,8.538,-80.7821,989608,0,8506,981102
10/29/22,Panama,8.538,-80.7821,989608,0,8506,981102
10/30/22,Panama,8.538,-80.7821,989608,0,8506,981102
10/31/22,Panama,8.538,-80.7821,990413,0,8509,981904
11/1/22,Panama,8.538,-80.7821,990413,0,8509,981904
11/2/22,Panama,8.538,-80.7821,990413,0,8509,981904
11/3/22,Panama,8.538,-80.7821,990413,0,8509,981904
11/4/22,Panama,8.538,-80.7821,990413,0,8509,981904
11/5/22,Panama,8.538,-80.7821,990413,0,8509,981904
11/6/22,Panama,8.538,-80.7821,990413,0,8509,981904
11/7/22,Panama,8.538,-80.7821,991251,0,8509,982742
11/8/22,Panama,8.538,-80.7821,991251,0,8509,982742
11/9/22,Panama,8.538,-80.7821,991251,0,8509,982742
11/10/22,Panama,8.538,-80.7821,991251,0,8509,982742
11/11/22,Panama,8.538,-80.7821,991251,0,8509,982742
11/12/22,Panama,8.538,-80.7821,991251,0,8509,982742
11/13/22,Panama,8.538,-80.7821,991251,0,8509,982742
11/14/22,Panama,8.538,-80.7821,992623,0,8515,984108
11/15/22,Panama,8.538,-80.7821,992623,0,8515,984108
11/16/22,Panama,8.538,-80.7821,992623,0,8515,984108
11/17/22,Panama,8.538,-80.7821,992623,0,8515,984108
11/18/22,Panama,8.538,-80.7821,992623,0,8515,984108
11/19/22,Panama,8.538,-80.7821,992623,0,8515,984108
11/20/22,Panama,8.538,-80.7821,992623,0,8515,984108
11/21/22,Panama,8.538,-80.7821,995726,0,8519,987207
11/22/22,Panama,8.538,-80.7821,995726,0,8519,987207
11/23/22,Panama,8.538,-80.7821,995726,0,8519,987207
11/24/22,Panama,8.538,-80.7821,995726,0,8519,987207
11/25/22,Panama,8.538,-80.7821,995726,0,8519,987207
11/26/22,Panama,8.538,-80.7821,995726,0,8519,987207
11/27/22,Panama,8.538,-80.7821,995726,0,8519,987207
11/28/22,Panama,8.538,-80.7821,995726,0,8519,987207
11/29/22,Panama,8.538,-80.7821,1002161,0,8526,993635
11/30/22,Panama,8.538,-80.7821,1002161,0,8526,993635
12/1/22,Panama,8.538,-80.7821,1002161,0,8526,993635
12/2/22,Panama,8.538,-80.7821,1002161,0,8526,993635
12/3/22,Panama,8.538,-80.7821,1002161,0,8526,993635
12/4/22,Panama,8.538,-80.7821,1002161,0,8526,993635
12/5/22,Panama,8.538,-80.7821,1009252,0,8533,1000719
12/6/22,Panama,8.538,-80.7821,1009252,0,8533,1000719
12/7/22,Panama,8.538,-80.7821,1009252,0,8533,1000719
12/8/22,Panama,8.538,-80.7821,1009252,0,8533,1000719
12/9/22,Panama,8.538,-80.7821,1009252,0,8533,1000719
12/10/22,Panama,8.538,-80.7821,1009252,0,8533,1000719
12/11/22,Panama,8.538,-80.7821,1009252,0,8533,1000719
12/12/22,Panama,8.538,-80.7821,1009252,0,8533,1000719
12/13/22,Panama,8.538,-80.7821,1015970,0,8543,1007427
12/14/22,Panama,8.538,-80.7821,1015970,0,8543,1007427
12/15/22,Panama,8.538,-80.7821,1015970,0,8543,1007427
12/16/22,Panama,8.538,-80.7821,1015970,0,8543,1007427
12/17/22,Panama,8.538,-80.7821,1015970,0,8543,1007427
1/1/22,Papua New Guinea,-6.314993,143.95555,36158,0,590,35568
1/2/22,Papua New Guinea,-6.314993,143.95555,36190,0,590,35600
1/3/22,Papua New Guinea,-6.314993,143.95555,36192,0,590,35602
1/4/22,Papua New Guinea,-6.314993,143.95555,36193,0,590,35603
1/5/22,Papua New Guinea,-6.314993,143.95555,36196,0,590,35606
1/6/22,Papua New Guinea,-6.314993,143.95555,36285,0,591,35694
1/7/22,Papua New Guinea,-6.314993,143.95555,36326,0,591,35735
1/8/22,Papua New Guinea,-6.314993,143.95555,36326,0,591,35735
1/9/22,Papua New Guinea,-6.314993,143.95555,36357,0,591,35766
1/10/22,Papua New Guinea,-6.314993,143.95555,36403,0,591,35812
1/11/22,Papua New Guinea,-6.314993,143.95555,36415,0,595,35820
1/12/22,Papua New Guinea,-6.314993,143.95555,36429,0,595,35834
1/13/22,Papua New Guinea,-6.314993,143.95555,36432,0,595,35837
1/14/22,Papua New Guinea,-6.314993,143.95555,36435,0,596,35839
1/15/22,Papua New Guinea,-6.314993,143.95555,36435,0,596,35839
1/16/22,Papua New Guinea,-6.314993,143.95555,36435,0,596,35839
1/17/22,Papua New Guinea,-6.314993,143.95555,36446,0,596,35850
1/18/22,Papua New Guinea,-6.314993,143.95555,36446,0,596,35850
1/19/22,Papua New Guinea,-6.314993,143.95555,36446,0,596,35850
1/20/22,Papua New Guinea,-6.314993,143.95555,36446,0,596,35850
1/21/22,Papua New Guinea,-6.314993,143.95555,36446,0,596,35850
1/22/22,Papua New Guinea,-6.314993,143.95555,36446,0,596,35850
1/23/22,Papua New Guinea,-6.314993,143.95555,36446,0,596,35850
1/24/22,Papua New Guinea,-6.314993,143.95555,36480,0,597,35883
1/25/22,Papua New Guinea,-6.314993,143.95555,36548,0,597,35951
1/26/22,Papua New Guinea,-6.314993,143.95555,36596,0,597,35999
1/27/22,Papua New Guinea,-6.314993,143.95555,36596,0,597,35999
1/28/22,Papua New Guinea,-6.314993,143.95555,36866,0,597,36269
1/29/22,Papua New Guinea,-6.314993,143.95555,36866,0,597,36269
1/30/22,Papua New Guinea,-6.314993,143.95555,36866,0,597,36269
1/31/22,Papua New Guinea,-6.314993,143.95555,36866,0,597,36269
2/1/22,Papua New Guinea,-6.314993,143.95555,37270,0,597,36673
2/2/22,Papua New Guinea,-6.314993,143.95555,37390,0,597,36793
2/3/22,Papua New Guinea,-6.314993,143.95555,37390,0,597,36793
2/4/22,Papua New Guinea,-6.314993,143.95555,37390,0,597,36793
2/5/22,Papua New Guinea,-6.314993,143.95555,37390,0,597,36793
2/6/22,Papua New Guinea,-6.314993,143.95555,37390,0,597,36793
2/7/22,Papua New Guinea,-6.314993,143.95555,37788,0,597,37191
2/8/22,Papua New Guinea,-6.314993,143.95555,37788,0,597,37191
2/9/22,Papua New Guinea,-6.314993,143.95555,37983,0,597,37386
2/10/22,Papua New Guinea,-6.314993,143.95555,38222,0,610,37612
2/11/22,Papua New Guinea,-6.314993,143.95555,38222,0,610,37612
2/12/22,Papua New Guinea,-6.314993,143.95555,38481,0,610,37871
2/13/22,Papua New Guinea,-6.314993,143.95555,38481,0,610,37871
2/14/22,Papua New Guinea,-6.314993,143.95555,38671,0,610,38061
2/15/22,Papua New Guinea,-6.314993,143.95555,38671,0,610,38061
2/16/22,Papua New Guinea,-6.314993,143.95555,39035,0,628,38407
2/17/22,Papua New Guinea,-6.314993,143.95555,39580,0,628,38952
2/18/22,Papua New Guinea,-6.314993,143.95555,39580,0,628,38952
2/19/22,Papua New Guinea,-6.314993,143.95555,39580,0,628,38952
2/20/22,Papua New Guinea,-6.314993,143.95555,39909,0,636,39273
2/21/22,Papua New Guinea,-6.314993,143.95555,40296,0,636,39660
2/22/22,Papua New Guinea,-6.314993,143.95555,40296,0,636,39660
2/23/22,Papua New Guinea,-6.314993,143.95555,40621,0,636,39985
2/24/22,Papua New Guinea,-6.314993,143.95555,40748,0,638,40110
2/25/22,Papua New Guinea,-6.314993,143.95555,41038,0,638,40400
2/26/22,Papua New Guinea,-6.314993,143.95555,41038,0,638,40400
2/27/22,Papua New Guinea,-6.314993,143.95555,41038,0,638,40400
2/28/22,Papua New Guinea,-6.314993,143.95555,41290,0,638,40652
3/1/22,Papua New Guinea,-6.314993,143.95555,41290,0,638,40652
3/2/22,Papua New Guinea,-6.314993,143.95555,41335,0,638,40697
3/3/22,Papua New Guinea,-6.314993,143.95555,41421,0,638,40783
3/4/22,Papua New Guinea,-6.314993,143.95555,41421,0,638,40783
3/5/22,Papua New Guinea,-6.314993,143.95555,41421,0,638,40783
3/6/22,Papua New Guinea,-6.314993,143.95555,41421,0,638,40783
3/7/22,Papua New Guinea,-6.314993,143.95555,41533,0,639,40894
3/8/22,Papua New Guinea,-6.314993,143.95555,41533,0,639,40894
3/9/22,Papua New Guinea,-6.314993,143.95555,41533,0,639,40894
3/10/22,Papua New Guinea,-6.314993,143.95555,41533,0,639,40894
3/11/22,Papua New Guinea,-6.314993,143.95555,41533,0,639,40894
3/12/22,Papua New Guinea,-6.314993,143.95555,41533,0,639,40894
3/13/22,Papua New Guinea,-6.314993,143.95555,41533,0,639,40894
3/14/22,Papua New Guinea,-6.314993,143.95555,41533,0,639,40894
3/15/22,Papua New Guinea,-6.314993,143.95555,41533,0,639,40894
3/16/22,Papua New Guinea,-6.314993,143.95555,41533,0,639,40894
3/17/22,Papua New Guinea,-6.314993,143.95555,41533,0,639,40894
3/18/22,Papua New Guinea,-6.314993,143.95555,41533,0,639,40894
3/19/22,Papua New Guinea,-6.314993,143.95555,41533,0,639,40894
3/20/22,Papua New Guinea,-6.314993,143.95555,41533,0,639,40894
3/21/22,Papua New Guinea,-6.314993,143.95555,41533,0,639,40894
3/22/22,Papua New Guinea,-6.314993,143.95555,41533,0,639,40894
3/23/22,Papua New Guinea,-6.314993,143.95555,41533,0,639,40894
3/24/22,Papua New Guinea,-6.314993,143.95555,41533,0,639,40894
3/25/22,Papua New Guinea,-6.314993,143.95555,43076,0,640,42436
3/26/22,Papua New Guinea,-6.314993,143.95555,43076,0,640,42436
3/27/22,Papua New Guinea,-6.314993,143.95555,43076,0,640,42436
3/28/22,Papua New Guinea,-6.314993,143.95555,43203,0,640,42563
3/29/22,Papua New Guinea,-6.314993,143.95555,43203,0,640,42563
3/30/22,Papua New Guinea,-6.314993,143.95555,43203,0,640,42563
3/31/22,Papua New Guinea,-6.314993,143.95555,43203,0,640,42563
4/1/22,Papua New Guinea,-6.314993,143.95555,43203,0,640,42563
4/2/22,Papua New Guinea,-6.314993,143.95555,43203,0,640,42563
4/3/22,Papua New Guinea,-6.314993,143.95555,43203,0,640,42563
4/4/22,Papua New Guinea,-6.314993,143.95555,43374,0,643,42731
4/5/22,Papua New Guinea,-6.314993,143.95555,43374,0,643,42731
4/6/22,Papua New Guinea,-6.314993,143.95555,43424,0,643,42781
4/7/22,Papua New Guinea,-6.314993,143.95555,43424,0,643,42781
4/8/22,Papua New Guinea,-6.314993,143.95555,43424,0,643,42781
4/9/22,Papua New Guinea,-6.314993,143.95555,43424,0,643,42781
4/10/22,Papua New Guinea,-6.314993,143.95555,43424,0,643,42781
4/11/22,Papua New Guinea,-6.314993,143.95555,43526,0,643,42883
4/12/22,Papua New Guinea,-6.314993,143.95555,43615,0,649,42966
4/13/22,Papua New Guinea,-6.314993,143.95555,43615,0,649,42966
4/14/22,Papua New Guinea,-6.314993,143.95555,43636,0,649,42987
4/15/22,Papua New Guinea,-6.314993,143.95555,43660,0,649,43011
4/16/22,Papua New Guinea,-6.314993,143.95555,43660,0,649,43011
4/17/22,Papua New Guinea,-6.314993,143.95555,43660,0,649,43011
4/18/22,Papua New Guinea,-6.314993,143.95555,43663,0,649,43014
4/19/22,Papua New Guinea,-6.314993,143.95555,43663,0,649,43014
4/20/22,Papua New Guinea,-6.314993,143.95555,43669,0,649,43020
4/21/22,Papua New Guinea,-6.314993,143.95555,43732,0,649,43083
4/22/22,Papua New Guinea,-6.314993,143.95555,43732,0,649,43083
4/23/22,Papua New Guinea,-6.314993,143.95555,43732,0,649,43083
4/24/22,Papua New Guinea,-6.314993,143.95555,43732,0,649,43083
4/25/22,Papua New Guinea,-6.314993,143.95555,43800,0,649,43151
4/26/22,Papua New Guinea,-6.314993,143.95555,43800,0,649,43151
4/27/22,Papua New Guinea,-6.314993,143.95555,43803,0,649,43154
4/28/22,Papua New Guinea,-6.314993,143.95555,43814,0,649,43165
4/29/22,Papua New Guinea,-6.314993,143.95555,43817,0,650,43167
4/30/22,Papua New Guinea,-6.314993,143.95555,43817,0,650,43167
5/1/22,Papua New Guinea,-6.314993,143.95555,43817,0,650,43167
5/2/22,Papua New Guinea,-6.314993,143.95555,43821,0,650,43171
5/3/22,Papua New Guinea,-6.314993,143.95555,43821,0,650,43171
5/4/22,Papua New Guinea,-6.314993,143.95555,43823,0,650,43173
5/5/22,Papua New Guinea,-6.314993,143.95555,43826,0,651,43175
5/6/22,Papua New Guinea,-6.314993,143.95555,43827,0,651,43176
5/7/22,Papua New Guinea,-6.314993,143.95555,43827,0,651,43176
5/8/22,Papua New Guinea,-6.314993,143.95555,43827,0,651,43176
5/9/22,Papua New Guinea,-6.314993,143.95555,43827,0,651,43176
5/10/22,Papua New Guinea,-6.314993,143.95555,43839,0,651,43188
5/11/22,Papua New Guinea,-6.314993,143.95555,43843,0,651,43192
5/12/22,Papua New Guinea,-6.314993,143.95555,43876,0,651,43225
5/13/22,Papua New Guinea,-6.314993,143.95555,43876,0,651,43225
5/14/22,Papua New Guinea,-6.314993,143.95555,43876,0,651,43225
5/15/22,Papua New Guinea,-6.314993,143.95555,43876,0,651,43225
5/16/22,Papua New Guinea,-6.314993,143.95555,44276,0,651,43625
5/17/22,Papua New Guinea,-6.314993,143.95555,44394,0,651,43743
5/18/22,Papua New Guinea,-6.314993,143.95555,44394,0,651,43743
5/19/22,Papua New Guinea,-6.314993,143.95555,44394,0,651,43743
5/20/22,Papua New Guinea,-6.314993,143.95555,44394,0,651,43743
5/21/22,Papua New Guinea,-6.314993,143.95555,44394,0,651,43743
5/22/22,Papua New Guinea,-6.314993,143.95555,44394,0,651,43743
5/23/22,Papua New Guinea,-6.314993,143.95555,44403,0,651,43752
5/24/22,Papua New Guinea,-6.314993,143.95555,44403,0,651,43752
5/25/22,Papua New Guinea,-6.314993,143.95555,44425,0,651,43774
5/26/22,Papua New Guinea,-6.314993,143.95555,44425,0,651,43774
5/27/22,Papua New Guinea,-6.314993,143.95555,44425,0,651,43774
5/28/22,Papua New Guinea,-6.314993,143.95555,44425,0,651,43774
5/29/22,Papua New Guinea,-6.314993,143.95555,44425,0,651,43774
5/30/22,Papua New Guinea,-6.314993,143.95555,44432,0,651,43781
5/31/22,Papua New Guinea,-6.314993,143.95555,44481,0,651,43830
6/1/22,Papua New Guinea,-6.314993,143.95555,44551,0,651,43900
6/2/22,Papua New Guinea,-6.314993,143.95555,44622,0,651,43971
6/3/22,Papua New Guinea,-6.314993,143.95555,44634,0,651,43983
6/4/22,Papua New Guinea,-6.314993,143.95555,44634,0,651,43983
6/5/22,Papua New Guinea,-6.314993,143.95555,44634,0,651,43983
6/6/22,Papua New Guinea,-6.314993,143.95555,44638,0,651,43987
6/7/22,Papua New Guinea,-6.314993,143.95555,44639,0,651,43988
6/8/22,Papua New Guinea,-6.314993,143.95555,44643,0,657,43986
6/9/22,Papua New Guinea,-6.314993,143.95555,44644,0,658,43986
6/10/22,Papua New Guinea,-6.314993,143.95555,44655,0,658,43997
6/11/22,Papua New Guinea,-6.314993,143.95555,44655,0,658,43997
6/12/22,Papua New Guinea,-6.314993,143.95555,44655,0,658,43997
6/13/22,Papua New Guinea,-6.314993,143.95555,44662,0,658,44004
6/14/22,Papua New Guinea,-6.314993,143.95555,44675,0,658,44017
6/15/22,Papua New Guinea,-6.314993,143.95555,44675,0,658,44017
6/16/22,Papua New Guinea,-6.314993,143.95555,44681,0,658,44023
6/17/22,Papua New Guinea,-6.314993,143.95555,44681,0,658,44023
6/18/22,Papua New Guinea,-6.314993,143.95555,44681,0,658,44023
6/19/22,Papua New Guinea,-6.314993,143.95555,44681,0,658,44023
6/20/22,Papua New Guinea,-6.314993,143.95555,44691,0,658,44033
6/21/22,Papua New Guinea,-6.314993,143.95555,44691,0,658,44033
6/22/22,Papua New Guinea,-6.314993,143.95555,44691,0,662,44029
6/23/22,Papua New Guinea,-6.314993,143.95555,44692,0,662,44030
6/24/22,Papua New Guinea,-6.314993,143.95555,44702,0,662,44040
6/25/22,Papua New Guinea,-6.314993,143.95555,44702,0,662,44040
6/26/22,Papua New Guinea,-6.314993,143.95555,44702,0,662,44040
6/27/22,Papua New Guinea,-6.314993,143.95555,44711,0,662,44049
6/28/22,Papua New Guinea,-6.314993,143.95555,44711,0,662,44049
6/29/22,Papua New Guinea,-6.314993,143.95555,44717,0,662,44055
6/30/22,Papua New Guinea,-6.314993,143.95555,44717,0,662,44055
7/1/22,Papua New Guinea,-6.314993,143.95555,44725,0,662,44063
7/2/22,Papua New Guinea,-6.314993,143.95555,44725,0,662,44063
7/3/22,Papua New Guinea,-6.314993,143.95555,44725,0,662,44063
7/4/22,Papua New Guinea,-6.314993,143.95555,44728,0,662,44066
7/5/22,Papua New Guinea,-6.314993,143.95555,44732,0,662,44070
7/6/22,Papua New Guinea,-6.314993,143.95555,44739,0,662,44077
7/7/22,Papua New Guinea,-6.314993,143.95555,44739,0,662,44077
7/8/22,Papua New Guinea,-6.314993,143.95555,44745,0,662,44083
7/9/22,Papua New Guinea,-6.314993,143.95555,44745,0,662,44083
7/10/22,Papua New Guinea,-6.314993,143.95555,44745,0,662,44083
7/11/22,Papua New Guinea,-6.314993,143.95555,44751,0,662,44089
7/12/22,Papua New Guinea,-6.314993,143.95555,44752,0,662,44090
7/13/22,Papua New Guinea,-6.314993,143.95555,44752,0,662,44090
7/14/22,Papua New Guinea,-6.314993,143.95555,44758,0,662,44096
7/15/22,Papua New Guinea,-6.314993,143.95555,44761,0,662,44099
7/16/22,Papua New Guinea,-6.314993,143.95555,44761,0,662,44099
7/17/22,Papua New Guinea,-6.314993,143.95555,44761,0,662,44099
7/18/22,Papua New Guinea,-6.314993,143.95555,44761,0,662,44099
7/19/22,Papua New Guinea,-6.314993,143.95555,44761,0,662,44099
7/20/22,Papua New Guinea,-6.314993,143.95555,44765,0,662,44103
7/21/22,Papua New Guinea,-6.314993,143.95555,44768,0,662,44106
7/22/22,Papua New Guinea,-6.314993,143.95555,44772,0,662,44110
7/23/22,Papua New Guinea,-6.314993,143.95555,44772,0,662,44110
7/24/22,Papua New Guinea,-6.314993,143.95555,44772,0,662,44110
7/25/22,Papua New Guinea,-6.314993,143.95555,44772,0,662,44110
7/26/22,Papua New Guinea,-6.314993,143.95555,44772,0,662,44110
7/27/22,Papua New Guinea,-6.314993,143.95555,44776,0,662,44114
7/28/22,Papua New Guinea,-6.314993,143.95555,44776,0,663,44113
7/29/22,Papua New Guinea,-6.314993,143.95555,44784,0,663,44121
7/30/22,Papua New Guinea,-6.314993,143.95555,44784,0,663,44121
7/31/22,Papua New Guinea,-6.314993,143.95555,44784,0,663,44121
8/1/22,Papua New Guinea,-6.314993,143.95555,44784,0,663,44121
8/2/22,Papua New Guinea,-6.314993,143.95555,44797,0,663,44134
8/3/22,Papua New Guinea,-6.314993,143.95555,44798,0,663,44135
8/4/22,Papua New Guinea,-6.314993,143.95555,44798,0,663,44135
8/5/22,Papua New Guinea,-6.314993,143.95555,44800,0,663,44137
8/6/22,Papua New Guinea,-6.314993,143.95555,44800,0,663,44137
8/7/22,Papua New Guinea,-6.314993,143.95555,44800,0,663,44137
8/8/22,Papua New Guinea,-6.314993,143.95555,44800,0,663,44137
8/9/22,Papua New Guinea,-6.314993,143.95555,44800,0,663,44137
8/10/22,Papua New Guinea,-6.314993,143.95555,44811,0,663,44148
8/11/22,Papua New Guinea,-6.314993,143.95555,44812,0,663,44149
8/12/22,Papua New Guinea,-6.314993,143.95555,44820,0,663,44157
8/13/22,Papua New Guinea,-6.314993,143.95555,44820,0,663,44157
8/14/22,Papua New Guinea,-6.314993,143.95555,44820,0,663,44157
8/15/22,Papua New Guinea,-6.314993,143.95555,44820,0,663,44157
8/16/22,Papua New Guinea,-6.314993,143.95555,44824,0,663,44161
8/17/22,Papua New Guinea,-6.314993,143.95555,44843,0,663,44180
8/18/22,Papua New Guinea,-6.314993,143.95555,44846,0,664,44182
8/19/22,Papua New Guinea,-6.314993,143.95555,44846,0,664,44182
8/20/22,Papua New Guinea,-6.314993,143.95555,44846,0,664,44182
8/21/22,Papua New Guinea,-6.314993,143.95555,44846,0,664,44182
8/22/22,Papua New Guinea,-6.314993,143.95555,44848,0,664,44184
8/23/22,Papua New Guinea,-6.314993,143.95555,44862,0,664,44198
8/24/22,Papua New Guinea,-6.314993,143.95555,44866,0,664,44202
8/25/22,Papua New Guinea,-6.314993,143.95555,44876,0,664,44212
8/26/22,Papua New Guinea,-6.314993,143.95555,44876,0,664,44212
8/27/22,Papua New Guinea,-6.314993,143.95555,44876,0,664,44212
8/28/22,Papua New Guinea,-6.314993,143.95555,44876,0,664,44212
8/29/22,Papua New Guinea,-6.314993,143.95555,44876,0,664,44212
8/30/22,Papua New Guinea,-6.314993,143.95555,44880,0,664,44216
8/31/22,Papua New Guinea,-6.314993,143.95555,44880,0,664,44216
9/1/22,Papua New Guinea,-6.314993,143.95555,44887,0,664,44223
9/2/22,Papua New Guinea,-6.314993,143.95555,44887,0,664,44223
9/3/22,Papua New Guinea,-6.314993,143.95555,44887,0,664,44223
9/4/22,Papua New Guinea,-6.314993,143.95555,44887,0,664,44223
9/5/22,Papua New Guinea,-6.314993,143.95555,44894,0,664,44230
9/6/22,Papua New Guinea,-6.314993,143.95555,44896,0,664,44232
9/7/22,Papua New Guinea,-6.314993,143.95555,44900,0,664,44236
9/8/22,Papua New Guinea,-6.314993,143.95555,44900,0,664,44236
9/9/22,Papua New Guinea,-6.314993,143.95555,44900,0,664,44236
9/10/22,Papua New Guinea,-6.314993,143.95555,44900,0,664,44236
9/11/22,Papua New Guinea,-6.314993,143.95555,44900,0,664,44236
9/12/22,Papua New Guinea,-6.314993,143.95555,44915,0,664,44251
9/13/22,Papua New Guinea,-6.314993,143.95555,44915,0,664,44251
9/14/22,Papua New Guinea,-6.314993,143.95555,44922,0,664,44258
9/15/22,Papua New Guinea,-6.314993,143.95555,44931,0,664,44267
9/16/22,Papua New Guinea,-6.314993,143.95555,44931,0,664,44267
9/17/22,Papua New Guinea,-6.314993,143.95555,44931,0,664,44267
9/18/22,Papua New Guinea,-6.314993,143.95555,44931,0,664,44267
9/19/22,Papua New Guinea,-6.314993,143.95555,44937,0,664,44273
9/20/22,Papua New Guinea,-6.314993,143.95555,44942,0,664,44278
9/21/22,Papua New Guinea,-6.314993,143.95555,44954,0,664,44290
9/22/22,Papua New Guinea,-6.314993,143.95555,44954,0,664,44290
9/23/22,Papua New Guinea,-6.314993,143.95555,44959,0,664,44295
9/24/22,Papua New Guinea,-6.314993,143.95555,44959,0,664,44295
9/25/22,Papua New Guinea,-6.314993,143.95555,44959,0,664,44295
9/26/22,Papua New Guinea,-6.314993,143.95555,44981,0,664,44317
9/27/22,Papua New Guinea,-6.314993,143.95555,44981,0,664,44317
9/28/22,Papua New Guinea,-6.314993,143.95555,44988,0,664,44324
9/29/22,Papua New Guinea,-6.314993,143.95555,44997,0,668,44329
9/30/22,Papua New Guinea,-6.314993,143.95555,44997,0,668,44329
10/1/22,Papua New Guinea,-6.314993,143.95555,44997,0,668,44329
10/2/22,Papua New Guinea,-6.314993,143.95555,44997,0,668,44329
10/3/22,Papua New Guinea,-6.314993,143.95555,45010,0,668,44342
10/4/22,Papua New Guinea,-6.314993,143.95555,45010,0,668,44342
10/5/22,Papua New Guinea,-6.314993,143.95555,45010,0,668,44342
10/6/22,Papua New Guinea,-6.314993,143.95555,45067,0,668,44399
10/7/22,Papua New Guinea,-6.314993,143.95555,45091,0,668,44423
10/8/22,Papua New Guinea,-6.314993,143.95555,45091,0,668,44423
10/9/22,Papua New Guinea,-6.314993,143.95555,45091,0,668,44423
10/10/22,Papua New Guinea,-6.314993,143.95555,45133,0,668,44465
10/11/22,Papua New Guinea,-6.314993,143.95555,45146,0,668,44478
10/12/22,Papua New Guinea,-6.314993,143.95555,45146,0,668,44478
10/13/22,Papua New Guinea,-6.314993,143.95555,45170,0,668,44502
10/14/22,Papua New Guinea,-6.314993,143.95555,45199,0,668,44531
10/15/22,Papua New Guinea,-6.314993,143.95555,45199,0,668,44531
10/16/22,Papua New Guinea,-6.314993,143.95555,45199,0,668,44531
10/17/22,Papua New Guinea,-6.314993,143.95555,45264,0,668,44596
10/18/22,Papua New Guinea,-6.314993,143.95555,45264,0,668,44596
10/19/22,Papua New Guinea,-6.314993,143.95555,45264,0,668,44596
10/20/22,Papua New Guinea,-6.314993,143.95555,45313,0,668,44645
10/21/22,Papua New Guinea,-6.314993,143.95555,45328,0,668,44660
10/22/22,Papua New Guinea,-6.314993,143.95555,45328,0,668,44660
10/23/22,Papua New Guinea,-6.314993,143.95555,45328,0,668,44660
10/24/22,Papua New Guinea,-6.314993,143.95555,45328,0,668,44660
10/25/22,Papua New Guinea,-6.314993,143.95555,45365,0,668,44697
10/26/22,Papua New Guinea,-6.314993,143.95555,45393,0,668,44725
10/27/22,Papua New Guinea,-6.314993,143.95555,45393,0,668,44725
10/28/22,Papua New Guinea,-6.314993,143.95555,45393,0,668,44725
10/29/22,Papua New Guinea,-6.314993,143.95555,45393,0,668,44725
10/30/22,Papua New Guinea,-6.314993,143.95555,45393,0,668,44725
10/31/22,Papua New Guinea,-6.314993,143.95555,45465,0,668,44797
11/1/22,Papua New Guinea,-6.314993,143.95555,45465,0,668,44797
11/2/22,Papua New Guinea,-6.314993,143.95555,45518,0,668,44850
11/3/22,Papua New Guinea,-6.314993,143.95555,45550,0,668,44882
11/4/22,Papua New Guinea,-6.314993,143.95555,45550,0,668,44882
11/5/22,Papua New Guinea,-6.314993,143.95555,45550,0,668,44882
11/6/22,Papua New Guinea,-6.314993,143.95555,45550,0,668,44882
11/7/22,Papua New Guinea,-6.314993,143.95555,45629,0,668,44961
11/8/22,Papua New Guinea,-6.314993,143.95555,45638,0,668,44970
11/9/22,Papua New Guinea,-6.314993,143.95555,45691,0,668,45023
11/10/22,Papua New Guinea,-6.314993,143.95555,45691,0,668,45023
11/11/22,Papua New Guinea,-6.314993,143.95555,45721,0,668,45053
11/12/22,Papua New Guinea,-6.314993,143.95555,45721,0,668,45053
11/13/22,Papua New Guinea,-6.314993,143.95555,45721,0,668,45053
11/14/22,Papua New Guinea,-6.314993,143.95555,45773,0,668,45105
11/15/22,Papua New Guinea,-6.314993,143.95555,45773,0,668,45105
11/16/22,Papua New Guinea,-6.314993,143.95555,45773,0,668,45105
11/17/22,Papua New Guinea,-6.314993,143.95555,45819,0,668,45151
11/18/22,Papua New Guinea,-6.314993,143.95555,45819,0,668,45151
11/19/22,Papua New Guinea,-6.314993,143.95555,45819,0,668,45151
11/20/22,Papua New Guinea,-6.314993,143.95555,45819,0,668,45151
11/21/22,Papua New Guinea,-6.314993,143.95555,45819,0,668,45151
11/22/22,Papua New Guinea,-6.314993,143.95555,45819,0,668,45151
11/23/22,Papua New Guinea,-6.314993,143.95555,45819,0,668,45151
11/24/22,Papua New Guinea,-6.314993,143.95555,45819,0,668,45151
11/25/22,Papua New Guinea,-6.314993,143.95555,45819,0,668,45151
11/26/22,Papua New Guinea,-6.314993,143.95555,45819,0,668,45151
11/27/22,Papua New Guinea,-6.314993,143.95555,45819,0,668,45151
11/28/22,Papua New Guinea,-6.314993,143.95555,45819,0,668,45151
11/29/22,Papua New Guinea,-6.314993,143.95555,45917,0,668,45249
11/30/22,Papua New Guinea,-6.314993,143.95555,46146,0,668,45478
12/1/22,Papua New Guinea,-6.314993,143.95555,46182,0,668,45514
12/2/22,Papua New Guinea,-6.314993,143.95555,46247,0,668,45579
12/3/22,Papua New Guinea,-6.314993,143.95555,46247,0,668,45579
12/4/22,Papua New Guinea,-6.314993,143.95555,46247,0,668,45579
12/5/22,Papua New Guinea,-6.314993,143.95555,46247,0,668,45579
12/6/22,Papua New Guinea,-6.314993,143.95555,46247,0,668,45579
12/7/22,Papua New Guinea,-6.314993,143.95555,46338,0,668,45670
12/8/22,Papua New Guinea,-6.314993,143.95555,46374,0,668,45706
12/9/22,Papua New Guinea,-6.314993,143.95555,46427,0,668,45759
12/10/22,Papua New Guinea,-6.314993,143.95555,46427,0,668,45759
12/11/22,Papua New Guinea,-6.314993,143.95555,46427,0,668,45759
12/12/22,Papua New Guinea,-6.314993,143.95555,46457,0,669,45788
12/13/22,Papua New Guinea,-6.314993,143.95555,46457,0,669,45788
12/14/22,Papua New Guinea,-6.314993,143.95555,46457,0,669,45788
12/15/22,Papua New Guinea,-6.314993,143.95555,46542,0,669,45873
12/16/22,Papua New Guinea,-6.314993,143.95555,46557,0,669,45888
12/17/22,Papua New Guinea,-6.314993,143.95555,46557,0,669,45888
1/1/22,Paraguay,-23.4425,-58.4438,466101,0,16624,449477
1/2/22,Paraguay,-23.4425,-58.4438,466101,0,16624,449477
1/3/22,Paraguay,-23.4425,-58.4438,469523,0,16642,452881
1/4/22,Paraguay,-23.4425,-58.4438,470460,0,16645,453815
1/5/22,Paraguay,-23.4425,-58.4438,471434,0,16653,454781
1/6/22,Paraguay,-23.4425,-58.4438,472673,0,16658,456015
1/7/22,Paraguay,-23.4425,-58.4438,472673,0,16658,456015
1/8/22,Paraguay,-23.4425,-58.4438,472673,0,16658,456015
1/9/22,Paraguay,-23.4425,-58.4438,472673,0,16658,456015
1/10/22,Paraguay,-23.4425,-58.4438,475686,0,16670,459016
1/11/22,Paraguay,-23.4425,-58.4438,475686,0,16670,459016
1/12/22,Paraguay,-23.4425,-58.4438,475686,0,16670,459016
1/13/22,Paraguay,-23.4425,-58.4438,475686,0,16670,459016
1/14/22,Paraguay,-23.4425,-58.4438,475686,0,16670,459016
1/15/22,Paraguay,-23.4425,-58.4438,475686,0,16670,459016
1/16/22,Paraguay,-23.4425,-58.4438,475686,0,16670,459016
1/17/22,Paraguay,-23.4425,-58.4438,501189,0,16821,484368
1/18/22,Paraguay,-23.4425,-58.4438,504380,0,16844,487536
1/19/22,Paraguay,-23.4425,-58.4438,509795,0,16866,492929
1/20/22,Paraguay,-23.4425,-58.4438,516555,0,16887,499668
1/21/22,Paraguay,-23.4425,-58.4438,516555,0,16887,499668
1/22/22,Paraguay,-23.4425,-58.4438,516555,0,16887,499668
1/23/22,Paraguay,-23.4425,-58.4438,516555,0,16887,499668
1/24/22,Paraguay,-23.4425,-58.4438,542388,0,17009,525379
1/25/22,Paraguay,-23.4425,-58.4438,548252,0,17054,531198
1/26/22,Paraguay,-23.4425,-58.4438,554182,0,17112,537070
1/27/22,Paraguay,-23.4425,-58.4438,559906,0,17176,542730
1/28/22,Paraguay,-23.4425,-58.4438,565368,0,17212,548156
1/29/22,Paraguay,-23.4425,-58.4438,570469,0,17231,553238
1/30/22,Paraguay,-23.4425,-58.4438,570469,0,17231,553238
1/31/22,Paraguay,-23.4425,-58.4438,583662,0,17321,566341
2/1/22,Paraguay,-23.4425,-58.4438,589318,0,17386,571932
2/2/22,Paraguay,-23.4425,-58.4438,594430,0,17426,577004
2/3/22,Paraguay,-23.4425,-58.4438,598170,0,17476,580694
2/4/22,Paraguay,-23.4425,-58.4438,598170,0,17476,580694
2/5/22,Paraguay,-23.4425,-58.4438,605005,0,17558,587447
2/6/22,Paraguay,-23.4425,-58.4438,607947,0,17605,590342
2/7/22,Paraguay,-23.4425,-58.4438,610207,0,17653,592554
2/8/22,Paraguay,-23.4425,-58.4438,612893,0,17704,595189
2/9/22,Paraguay,-23.4425,-58.4438,615911,0,17751,598160
2/10/22,Paraguay,-23.4425,-58.4438,618815,0,17801,601014
2/11/22,Paraguay,-23.4425,-58.4438,620708,0,17844,602864
2/12/22,Paraguay,-23.4425,-58.4438,620708,0,17844,602864
2/13/22,Paraguay,-23.4425,-58.4438,624475,0,17905,606570
2/14/22,Paraguay,-23.4425,-58.4438,626355,0,17964,608391
2/15/22,Paraguay,-23.4425,-58.4438,628574,0,18027,610547
2/16/22,Paraguay,-23.4425,-58.4438,630718,0,18079,612639
2/17/22,Paraguay,-23.4425,-58.4438,632444,0,18116,614328
2/18/22,Paraguay,-23.4425,-58.4438,633733,0,18147,615586
2/19/22,Paraguay,-23.4425,-58.4438,634780,0,18191,616589
2/20/22,Paraguay,-23.4425,-58.4438,634780,0,18191,616589
2/21/22,Paraguay,-23.4425,-58.4438,636520,0,18237,618283
2/22/22,Paraguay,-23.4425,-58.4438,637225,0,18259,618966
2/23/22,Paraguay,-23.4425,-58.4438,638153,0,18281,619872
2/24/22,Paraguay,-23.4425,-58.4438,639078,0,18315,620763
2/25/22,Paraguay,-23.4425,-58.4438,639078,0,18315,620763
2/26/22,Paraguay,-23.4425,-58.4438,639078,0,18315,620763
2/27/22,Paraguay,-23.4425,-58.4438,641321,0,18359,622962
2/28/22,Paraguay,-23.4425,-58.4438,641321,0,18359,622962
3/1/22,Paraguay,-23.4425,-58.4438,642184,0,18392,623792
3/2/22,Paraguay,-23.4425,-58.4438,642573,0,18422,624151
3/3/22,Paraguay,-23.4425,-58.4438,642982,0,18440,624542
3/4/22,Paraguay,-23.4425,-58.4438,643342,0,18454,624888
3/5/22,Paraguay,-23.4425,-58.4438,643619,0,18460,625159
3/6/22,Paraguay,-23.4425,-58.4438,643879,0,18471,625408
3/7/22,Paraguay,-23.4425,-58.4438,644199,0,18482,625717
3/8/22,Paraguay,-23.4425,-58.4438,644609,0,18494,626115
3/9/22,Paraguay,-23.4425,-58.4438,645020,0,18510,626510
3/10/22,Paraguay,-23.4425,-58.4438,645383,0,18517,626866
3/11/22,Paraguay,-23.4425,-58.4438,645655,0,18522,627133
3/12/22,Paraguay,-23.4425,-58.4438,645768,0,18529,627239
3/13/22,Paraguay,-23.4425,-58.4438,645883,0,18538,627345
3/14/22,Paraguay,-23.4425,-58.4438,646054,0,18548,627506
3/15/22,Paraguay,-23.4425,-58.4438,646283,0,18552,627731
3/16/22,Paraguay,-23.4425,-58.4438,646495,0,18555,627940
3/17/22,Paraguay,-23.4425,-58.4438,646630,0,18559,628071
3/18/22,Paraguay,-23.4425,-58.4438,646843,0,18571,628272
3/19/22,Paraguay,-23.4425,-58.4438,646968,0,18577,628391
3/20/22,Paraguay,-23.4425,-58.4438,647099,0,18586,628513
3/21/22,Paraguay,-23.4425,-58.4438,647268,0,18599,628669
3/22/22,Paraguay,-23.4425,-58.4438,647428,0,18603,628825
3/23/22,Paraguay,-23.4425,-58.4438,647538,0,18606,628932
3/24/22,Paraguay,-23.4425,-58.4438,647672,0,18608,629064
3/25/22,Paraguay,-23.4425,-58.4438,647762,0,18662,629100
3/26/22,Paraguay,-23.4425,-58.4438,647836,0,18663,629173
3/27/22,Paraguay,-23.4425,-58.4438,647906,0,18664,629242
3/28/22,Paraguay,-23.4425,-58.4438,647950,0,18664,629286
3/29/22,Paraguay,-23.4425,-58.4438,647950,0,18664,629286
3/30/22,Paraguay,-23.4425,-58.4438,647950,0,18664,629286
3/31/22,Paraguay,-23.4425,-58.4438,647950,0,18664,629286
4/1/22,Paraguay,-23.4425,-58.4438,648353,0,18731,629622
4/2/22,Paraguay,-23.4425,-58.4438,648353,0,18731,629622
4/3/22,Paraguay,-23.4425,-58.4438,648353,0,18731,629622
4/4/22,Paraguay,-23.4425,-58.4438,648353,0,18731,629622
4/5/22,Paraguay,-23.4425,-58.4438,648353,0,18731,629622
4/6/22,Paraguay,-23.4425,-58.4438,648353,0,18731,629622
4/7/22,Paraguay,-23.4425,-58.4438,648353,0,18731,629622
4/8/22,Paraguay,-23.4425,-58.4438,648446,0,18734,629712
4/9/22,Paraguay,-23.4425,-58.4438,648446,0,18734,629712
4/10/22,Paraguay,-23.4425,-58.4438,648446,0,18734,629712
4/11/22,Paraguay,-23.4425,-58.4438,648446,0,18734,629712
4/12/22,Paraguay,-23.4425,-58.4438,648446,0,18734,629712
4/13/22,Paraguay,-23.4425,-58.4438,648446,0,18734,629712
4/14/22,Paraguay,-23.4425,-58.4438,648446,0,18734,629712
4/15/22,Paraguay,-23.4425,-58.4438,648446,0,18734,629712
4/16/22,Paraguay,-23.4425,-58.4438,648446,0,18734,629712
4/17/22,Paraguay,-23.4425,-58.4438,648446,0,18734,629712
4/18/22,Paraguay,-23.4425,-58.4438,648446,0,18734,629712
4/19/22,Paraguay,-23.4425,-58.4438,648682,0,18786,629896
4/20/22,Paraguay,-23.4425,-58.4438,648682,0,18786,629896
4/21/22,Paraguay,-23.4425,-58.4438,648682,0,18786,629896
4/22/22,Paraguay,-23.4425,-58.4438,649034,0,18795,630239
4/23/22,Paraguay,-23.4425,-58.4438,649034,0,18795,630239
4/24/22,Paraguay,-23.4425,-58.4438,649034,0,18795,630239
4/25/22,Paraguay,-23.4425,-58.4438,649034,0,18795,630239
4/26/22,Paraguay,-23.4425,-58.4438,649034,0,18795,630239
4/27/22,Paraguay,-23.4425,-58.4438,649034,0,18795,630239
4/28/22,Paraguay,-23.4425,-58.4438,649034,0,18795,630239
4/29/22,Paraguay,-23.4425,-58.4438,649455,0,18795,630660
4/30/22,Paraguay,-23.4425,-58.4438,649455,0,18870,630585
5/1/22,Paraguay,-23.4425,-58.4438,649455,0,18870,630585
5/2/22,Paraguay,-23.4425,-58.4438,649455,0,18870,630585
5/3/22,Paraguay,-23.4425,-58.4438,649455,0,18870,630585
5/4/22,Paraguay,-23.4425,-58.4438,649455,0,18870,630585
5/5/22,Paraguay,-23.4425,-58.4438,649455,0,18870,630585
5/6/22,Paraguay,-23.4425,-58.4438,649718,0,18872,630846
5/7/22,Paraguay,-23.4425,-58.4438,649718,0,18872,630846
5/8/22,Paraguay,-23.4425,-58.4438,649718,0,18872,630846
5/9/22,Paraguay,-23.4425,-58.4438,649718,0,18872,630846
5/10/22,Paraguay,-23.4425,-58.4438,649718,0,18872,630846
5/11/22,Paraguay,-23.4425,-58.4438,649718,0,18872,630846
5/12/22,Paraguay,-23.4425,-58.4438,649718,0,18872,630846
5/13/22,Paraguay,-23.4425,-58.4438,649718,0,18872,630846
5/14/22,Paraguay,-23.4425,-58.4438,649718,0,18872,630846
5/15/22,Paraguay,-23.4425,-58.4438,649718,0,18872,630846
5/16/22,Paraguay,-23.4425,-58.4438,649929,0,18881,631048
5/17/22,Paraguay,-23.4425,-58.4438,649929,0,18881,631048
5/18/22,Paraguay,-23.4425,-58.4438,649929,0,18881,631048
5/19/22,Paraguay,-23.4425,-58.4438,649929,0,18881,631048
5/20/22,Paraguay,-23.4425,-58.4438,650283,0,18885,631398
5/21/22,Paraguay,-23.4425,-58.4438,650283,0,18885,631398
5/22/22,Paraguay,-23.4425,-58.4438,650283,0,18885,631398
5/23/22,Paraguay,-23.4425,-58.4438,650283,0,18885,631398
5/24/22,Paraguay,-23.4425,-58.4438,650283,0,18885,631398
5/25/22,Paraguay,-23.4425,-58.4438,650283,0,18885,631398
5/26/22,Paraguay,-23.4425,-58.4438,650283,0,18885,631398
5/27/22,Paraguay,-23.4425,-58.4438,650661,0,18894,631767
5/28/22,Paraguay,-23.4425,-58.4438,650661,0,18894,631767
5/29/22,Paraguay,-23.4425,-58.4438,650661,0,18894,631767
5/30/22,Paraguay,-23.4425,-58.4438,650661,0,18894,631767
5/31/22,Paraguay,-23.4425,-58.4438,650661,0,18894,631767
6/1/22,Paraguay,-23.4425,-58.4438,650661,0,18894,631767
6/2/22,Paraguay,-23.4425,-58.4438,650661,0,18894,631767
6/3/22,Paraguay,-23.4425,-58.4438,650661,0,18894,631767
6/4/22,Paraguay,-23.4425,-58.4438,651268,0,18911,632357
6/5/22,Paraguay,-23.4425,-58.4438,651268,0,18911,632357
6/6/22,Paraguay,-23.4425,-58.4438,651268,0,18911,632357
6/7/22,Paraguay,-23.4425,-58.4438,651268,0,18911,632357
6/8/22,Paraguay,-23.4425,-58.4438,651268,0,18911,632357
6/9/22,Paraguay,-23.4425,-58.4438,651268,0,18911,632357
6/10/22,Paraguay,-23.4425,-58.4438,652044,0,18932,633112
6/11/22,Paraguay,-23.4425,-58.4438,652044,0,18932,633112
6/12/22,Paraguay,-23.4425,-58.4438,652044,0,18932,633112
6/13/22,Paraguay,-23.4425,-58.4438,652044,0,18932,633112
6/14/22,Paraguay,-23.4425,-58.4438,652044,0,18932,633112
6/15/22,Paraguay,-23.4425,-58.4438,652044,0,18932,633112
6/16/22,Paraguay,-23.4425,-58.4438,652044,0,18932,633112
6/17/22,Paraguay,-23.4425,-58.4438,653428,0,18947,634481
6/18/22,Paraguay,-23.4425,-58.4438,653428,0,18947,634481
6/19/22,Paraguay,-23.4425,-58.4438,653428,0,18947,634481
6/20/22,Paraguay,-23.4425,-58.4438,653428,0,18947,634481
6/21/22,Paraguay,-23.4425,-58.4438,653428,0,18947,634481
6/22/22,Paraguay,-23.4425,-58.4438,653428,0,18947,634481
6/23/22,Paraguay,-23.4425,-58.4438,653428,0,18947,634481
6/24/22,Paraguay,-23.4425,-58.4438,655532,0,18963,636569
6/25/22,Paraguay,-23.4425,-58.4438,655532,0,18963,636569
6/26/22,Paraguay,-23.4425,-58.4438,655532,0,18963,636569
6/27/22,Paraguay,-23.4425,-58.4438,655532,0,18963,636569
6/28/22,Paraguay,-23.4425,-58.4438,655532,0,18963,636569
6/29/22,Paraguay,-23.4425,-58.4438,655532,0,18963,636569
6/30/22,Paraguay,-23.4425,-58.4438,655532,0,18963,636569
7/1/22,Paraguay,-23.4425,-58.4438,655532,0,18963,636569
7/2/22,Paraguay,-23.4425,-58.4438,655532,0,18963,636569
7/3/22,Paraguay,-23.4425,-58.4438,660841,0,18994,641847
7/4/22,Paraguay,-23.4425,-58.4438,660841,0,18994,641847
7/5/22,Paraguay,-23.4425,-58.4438,660841,0,18994,641847
7/6/22,Paraguay,-23.4425,-58.4438,660841,0,18994,641847
7/7/22,Paraguay,-23.4425,-58.4438,660841,0,18994,641847
7/8/22,Paraguay,-23.4425,-58.4438,660841,0,18994,641847
7/9/22,Paraguay,-23.4425,-58.4438,660841,0,18994,641847
7/10/22,Paraguay,-23.4425,-58.4438,673829,0,19036,654793
7/11/22,Paraguay,-23.4425,-58.4438,673829,0,19036,654793
7/12/22,Paraguay,-23.4425,-58.4438,673829,0,19036,654793
7/13/22,Paraguay,-23.4425,-58.4438,673829,0,19036,654793
7/14/22,Paraguay,-23.4425,-58.4438,673829,0,19036,654793
7/15/22,Paraguay,-23.4425,-58.4438,688820,0,19083,669737
7/16/22,Paraguay,-23.4425,-58.4438,688820,0,19083,669737
7/17/22,Paraguay,-23.4425,-58.4438,688820,0,19083,669737
7/18/22,Paraguay,-23.4425,-58.4438,688820,0,19083,669737
7/19/22,Paraguay,-23.4425,-58.4438,688820,0,19083,669737
7/20/22,Paraguay,-23.4425,-58.4438,688820,0,19083,669737
7/21/22,Paraguay,-23.4425,-58.4438,688820,0,19083,669737
7/22/22,Paraguay,-23.4425,-58.4438,688820,0,19083,669737
7/23/22,Paraguay,-23.4425,-58.4438,701060,0,19147,681913
7/24/22,Paraguay,-23.4425,-58.4438,701060,0,19147,681913
7/25/22,Paraguay,-23.4425,-58.4438,701060,0,19147,681913
7/26/22,Paraguay,-23.4425,-58.4438,701060,0,19147,681913
7/27/22,Paraguay,-23.4425,-58.4438,701060,0,19147,681913
7/28/22,Paraguay,-23.4425,-58.4438,701060,0,19147,681913
7/29/22,Paraguay,-23.4425,-58.4438,707109,0,19220,687889
7/30/22,Paraguay,-23.4425,-58.4438,707109,0,19220,687889
7/31/22,Paraguay,-23.4425,-58.4438,707109,0,19220,687889
8/1/22,Paraguay,-23.4425,-58.4438,707109,0,19220,687889
8/2/22,Paraguay,-23.4425,-58.4438,707109,0,19220,687889
8/3/22,Paraguay,-23.4425,-58.4438,707109,0,19220,687889
8/4/22,Paraguay,-23.4425,-58.4438,707109,0,19220,687889
8/5/22,Paraguay,-23.4425,-58.4438,710890,0,19289,691601
8/6/22,Paraguay,-23.4425,-58.4438,710890,0,19289,691601
8/7/22,Paraguay,-23.4425,-58.4438,710890,0,19289,691601
8/8/22,Paraguay,-23.4425,-58.4438,710890,0,19289,691601
8/9/22,Paraguay,-23.4425,-58.4438,710890,0,19289,691601
8/10/22,Paraguay,-23.4425,-58.4438,710890,0,19289,691601
8/11/22,Paraguay,-23.4425,-58.4438,710890,0,19289,691601
8/12/22,Paraguay,-23.4425,-58.4438,712907,0,19357,693550
8/13/22,Paraguay,-23.4425,-58.4438,712907,0,19357,693550
8/14/22,Paraguay,-23.4425,-58.4438,712907,0,19357,693550
8/15/22,Paraguay,-23.4425,-58.4438,712907,0,19357,693550
8/16/22,Paraguay,-23.4425,-58.4438,712907,0,19357,693550
8/17/22,Paraguay,-23.4425,-58.4438,712907,0,19357,693550
8/18/22,Paraguay,-23.4425,-58.4438,712907,0,19357,693550
8/19/22,Paraguay,-23.4425,-58.4438,714340,0,19448,694892
8/20/22,Paraguay,-23.4425,-58.4438,714340,0,19448,694892
8/21/22,Paraguay,-23.4425,-58.4438,714340,0,19448,694892
8/22/22,Paraguay,-23.4425,-58.4438,714340,0,19448,694892
8/23/22,Paraguay,-23.4425,-58.4438,714340,0,19448,694892
8/24/22,Paraguay,-23.4425,-58.4438,714340,0,19448,694892
8/25/22,Paraguay,-23.4425,-58.4438,714340,0,19448,694892
8/26/22,Paraguay,-23.4425,-58.4438,715162,0,19478,695684
8/27/22,Paraguay,-23.4425,-58.4438,715162,0,19478,695684
8/28/22,Paraguay,-23.4425,-58.4438,715162,0,19478,695684
8/29/22,Paraguay,-23.4425,-58.4438,715162,0,19478,695684
8/30/22,Paraguay,-23.4425,-58.4438,715162,0,19478,695684
8/31/22,Paraguay,-23.4425,-58.4438,715162,0,19478,695684
9/1/22,Paraguay,-23.4425,-58.4438,715162,0,19478,695684
9/2/22,Paraguay,-23.4425,-58.4438,715569,0,19494,696075
9/3/22,Paraguay,-23.4425,-58.4438,715569,0,19494,696075
9/4/22,Paraguay,-23.4425,-58.4438,715569,0,19494,696075
9/5/22,Paraguay,-23.4425,-58.4438,715569,0,19494,696075
9/6/22,Paraguay,-23.4425,-58.4438,715569,0,19494,696075
9/7/22,Paraguay,-23.4425,-58.4438,715569,0,19494,696075
9/8/22,Paraguay,-23.4425,-58.4438,715569,0,19494,696075
9/9/22,Paraguay,-23.4425,-58.4438,715806,0,19530,696276
9/10/22,Paraguay,-23.4425,-58.4438,715806,0,19530,696276
9/11/22,Paraguay,-23.4425,-58.4438,715806,0,19530,696276
9/12/22,Paraguay,-23.4425,-58.4438,715806,0,19530,696276
9/13/22,Paraguay,-23.4425,-58.4438,715806,0,19530,696276
9/14/22,Paraguay,-23.4425,-58.4438,715806,0,19530,696276
9/15/22,Paraguay,-23.4425,-58.4438,715806,0,19530,696276
9/16/22,Paraguay,-23.4425,-58.4438,716009,0,19564,696445
9/17/22,Paraguay,-23.4425,-58.4438,716009,0,19564,696445
9/18/22,Paraguay,-23.4425,-58.4438,716009,0,19564,696445
9/19/22,Paraguay,-23.4425,-58.4438,716009,0,19564,696445
9/20/22,Paraguay,-23.4425,-58.4438,716009,0,19564,696445
9/21/22,Paraguay,-23.4425,-58.4438,716009,0,19564,696445
9/22/22,Paraguay,-23.4425,-58.4438,716009,0,19564,696445
9/23/22,Paraguay,-23.4425,-58.4438,716059,0,19583,696476
9/24/22,Paraguay,-23.4425,-58.4438,716059,0,19583,696476
9/25/22,Paraguay,-23.4425,-58.4438,716059,0,19583,696476
9/26/22,Paraguay,-23.4425,-58.4438,716059,0,19583,696476
9/27/22,Paraguay,-23.4425,-58.4438,716059,0,19583,696476
9/28/22,Paraguay,-23.4425,-58.4438,716059,0,19583,696476
9/29/22,Paraguay,-23.4425,-58.4438,716059,0,19583,696476
9/30/22,Paraguay,-23.4425,-58.4438,716543,0,19591,696952
10/1/22,Paraguay,-23.4425,-58.4438,716543,0,19591,696952
10/2/22,Paraguay,-23.4425,-58.4438,716543,0,19591,696952
10/3/22,Paraguay,-23.4425,-58.4438,716543,0,19591,696952
10/4/22,Paraguay,-23.4425,-58.4438,716543,0,19591,696952
10/5/22,Paraguay,-23.4425,-58.4438,716543,0,19591,696952
10/6/22,Paraguay,-23.4425,-58.4438,716543,0,19591,696952
10/7/22,Paraguay,-23.4425,-58.4438,717039,0,19595,697444
10/8/22,Paraguay,-23.4425,-58.4438,717039,0,19595,697444
10/9/22,Paraguay,-23.4425,-58.4438,717039,0,19595,697444
10/10/22,Paraguay,-23.4425,-58.4438,717039,0,19595,697444
10/11/22,Paraguay,-23.4425,-58.4438,717039,0,19595,697444
10/12/22,Paraguay,-23.4425,-58.4438,717039,0,19595,697444
10/13/22,Paraguay,-23.4425,-58.4438,717039,0,19595,697444
10/14/22,Paraguay,-23.4425,-58.4438,717260,0,19596,697664
10/15/22,Paraguay,-23.4425,-58.4438,717260,0,19596,697664
10/16/22,Paraguay,-23.4425,-58.4438,717260,0,19596,697664
10/17/22,Paraguay,-23.4425,-58.4438,717260,0,19596,697664
10/18/22,Paraguay,-23.4425,-58.4438,717260,0,19596,697664
10/19/22,Paraguay,-23.4425,-58.4438,717260,0,19596,697664
10/20/22,Paraguay,-23.4425,-58.4438,717260,0,19596,697664
10/21/22,Paraguay,-23.4425,-58.4438,717628,0,19598,698030
10/22/22,Paraguay,-23.4425,-58.4438,717628,0,19598,698030
10/23/22,Paraguay,-23.4425,-58.4438,717628,0,19598,698030
10/24/22,Paraguay,-23.4425,-58.4438,717628,0,19598,698030
10/25/22,Paraguay,-23.4425,-58.4438,717628,0,19598,698030
10/26/22,Paraguay,-23.4425,-58.4438,717628,0,19598,698030
10/27/22,Paraguay,-23.4425,-58.4438,717628,0,19598,698030
10/28/22,Paraguay,-23.4425,-58.4438,717955,0,19601,698354
10/29/22,Paraguay,-23.4425,-58.4438,717955,0,19601,698354
10/30/22,Paraguay,-23.4425,-58.4438,717955,0,19601,698354
10/31/22,Paraguay,-23.4425,-58.4438,717955,0,19601,698354
11/1/22,Paraguay,-23.4425,-58.4438,717955,0,19601,698354
11/2/22,Paraguay,-23.4425,-58.4438,717955,0,19601,698354
11/3/22,Paraguay,-23.4425,-58.4438,717955,0,19601,698354
11/4/22,Paraguay,-23.4425,-58.4438,717980,0,19606,698374
11/5/22,Paraguay,-23.4425,-58.4438,717980,0,19606,698374
11/6/22,Paraguay,-23.4425,-58.4438,717980,0,19606,698374
11/7/22,Paraguay,-23.4425,-58.4438,717980,0,19606,698374
11/8/22,Paraguay,-23.4425,-58.4438,717980,0,19606,698374
11/9/22,Paraguay,-23.4425,-58.4438,717980,0,19606,698374
11/10/22,Paraguay,-23.4425,-58.4438,717980,0,19606,698374
11/11/22,Paraguay,-23.4425,-58.4438,718049,0,19608,698441
11/12/22,Paraguay,-23.4425,-58.4438,718049,0,19608,698441
11/13/22,Paraguay,-23.4425,-58.4438,718049,0,19608,698441
11/14/22,Paraguay,-23.4425,-58.4438,718049,0,19608,698441
11/15/22,Paraguay,-23.4425,-58.4438,718049,0,19608,698441
11/16/22,Paraguay,-23.4425,-58.4438,718049,0,19608,698441
11/17/22,Paraguay,-23.4425,-58.4438,718049,0,19608,698441
11/18/22,Paraguay,-23.4425,-58.4438,718071,0,19611,698460
11/19/22,Paraguay,-23.4425,-58.4438,718071,0,19611,698460
11/20/22,Paraguay,-23.4425,-58.4438,718071,0,19611,698460
11/21/22,Paraguay,-23.4425,-58.4438,718071,0,19611,698460
11/22/22,Paraguay,-23.4425,-58.4438,718071,0,19611,698460
11/23/22,Paraguay,-23.4425,-58.4438,718071,0,19611,698460
11/24/22,Paraguay,-23.4425,-58.4438,718071,0,19611,698460
11/25/22,Paraguay,-23.4425,-58.4438,718164,0,19621,698543
11/26/22,Paraguay,-23.4425,-58.4438,718164,0,19621,698543
11/27/22,Paraguay,-23.4425,-58.4438,718164,0,19621,698543
11/28/22,Paraguay,-23.4425,-58.4438,718164,0,19621,698543
11/29/22,Paraguay,-23.4425,-58.4438,718164,0,19621,698543
11/30/22,Paraguay,-23.4425,-58.4438,718164,0,19621,698543
12/1/22,Paraguay,-23.4425,-58.4438,718164,0,19621,698543
12/2/22,Paraguay,-23.4425,-58.4438,718164,0,19621,698543
12/3/22,Paraguay,-23.4425,-58.4438,777525,0,19630,757895
12/4/22,Paraguay,-23.4425,-58.4438,777525,0,19630,757895
12/5/22,Paraguay,-23.4425,-58.4438,777525,0,19630,757895
12/6/22,Paraguay,-23.4425,-58.4438,777525,0,19630,757895
12/7/22,Paraguay,-23.4425,-58.4438,778895,0,19646,759249
12/8/22,Paraguay,-23.4425,-58.4438,778895,0,19646,759249
12/9/22,Paraguay,-23.4425,-58.4438,778895,0,19646,759249
12/10/22,Paraguay,-23.4425,-58.4438,778895,0,19646,759249
12/11/22,Paraguay,-23.4425,-58.4438,778895,0,19646,759249
12/12/22,Paraguay,-23.4425,-58.4438,778895,0,19646,759249
12/13/22,Paraguay,-23.4425,-58.4438,778895,0,19646,759249
12/14/22,Paraguay,-23.4425,-58.4438,778895,0,19646,759249
12/15/22,Paraguay,-23.4425,-58.4438,778895,0,19646,759249
12/16/22,Paraguay,-23.4425,-58.4438,781111,0,19655,761456
12/17/22,Paraguay,-23.4425,-58.4438,781111,0,19655,761456
1/1/22,Peru,-9.19,-75.0152,2301177,0,202741,2098436
1/2/22,Peru,-9.19,-75.0152,2302678,0,202782,2099896
1/3/22,Peru,-9.19,-75.0152,2304674,0,202818,2101856
1/4/22,Peru,-9.19,-75.0152,2309856,0,202867,2106989
1/5/22,Peru,-9.19,-75.0152,2318543,0,202904,2115639
1/6/22,Peru,-9.19,-75.0152,2329717,0,202934,2126783
1/7/22,Peru,-9.19,-75.0152,2342550,0,202981,2139569
1/8/22,Peru,-9.19,-75.0152,2358685,0,203019,2155666
1/9/22,Peru,-9.19,-75.0152,2375813,0,203067,2172746
1/10/22,Peru,-9.19,-75.0152,2388289,0,203097,2185192
1/11/22,Peru,-9.19,-75.0152,2412577,0,203157,2209420
1/12/22,Peru,-9.19,-75.0152,2440349,0,203193,2237156
1/13/22,Peru,-9.19,-75.0152,2473709,0,203255,2270454
1/14/22,Peru,-9.19,-75.0152,2512789,0,203302,2309487
1/15/22,Peru,-9.19,-75.0152,2562534,0,203376,2359158
1/16/22,Peru,-9.19,-75.0152,2606126,0,203464,2402662
1/17/22,Peru,-9.19,-75.0152,2631826,0,203550,2428276
1/18/22,Peru,-9.19,-75.0152,2668224,0,203645,2464579
1/19/22,Peru,-9.19,-75.0152,2723166,0,203750,2519416
1/20/22,Peru,-9.19,-75.0152,2780049,0,203868,2576181
1/21/22,Peru,-9.19,-75.0152,2839519,0,203994,2635525
1/22/22,Peru,-9.19,-75.0152,2894215,0,204141,2690074
1/23/22,Peru,-9.19,-75.0152,2946151,0,204323,2741828
1/24/22,Peru,-9.19,-75.0152,2976260,0,204404,2771856
1/25/22,Peru,-9.19,-75.0152,3020756,0,204587,2816169
1/26/22,Peru,-9.19,-75.0152,3070357,0,204769,2865588
1/27/22,Peru,-9.19,-75.0152,3120401,0,204940,2915461
1/28/22,Peru,-9.19,-75.0152,3160732,0,205112,2955620
1/29/22,Peru,-9.19,-75.0152,3196488,0,205347,2991141
1/30/22,Peru,-9.19,-75.0152,3224406,0,205505,3018901
1/31/22,Peru,-9.19,-75.0152,3239538,0,205834,3033704
2/1/22,Peru,-9.19,-75.0152,3239538,0,205834,3033704
2/2/22,Peru,-9.19,-75.0152,3286151,0,206220,3079931
2/3/22,Peru,-9.19,-75.0152,3308693,0,206406,3102287
2/4/22,Peru,-9.19,-75.0152,3331290,0,206646,3124644
2/5/22,Peru,-9.19,-75.0152,3349298,0,206891,3142407
2/6/22,Peru,-9.19,-75.0152,3363489,0,206984,3156505
2/7/22,Peru,-9.19,-75.0152,3372895,0,207114,3165781
2/8/22,Peru,-9.19,-75.0152,3384546,0,207312,3177234
2/9/22,Peru,-9.19,-75.0152,3397637,0,207536,3190101
2/10/22,Peru,-9.19,-75.0152,3411201,0,207737,3203464
2/11/22,Peru,-9.19,-75.0152,3424894,0,207965,3216929
2/12/22,Peru,-9.19,-75.0152,3435753,0,208120,3227633
2/13/22,Peru,-9.19,-75.0152,3445680,0,208381,3237299
2/14/22,Peru,-9.19,-75.0152,3449712,0,208466,3241246
2/15/22,Peru,-9.19,-75.0152,3456789,0,208622,3248167
2/16/22,Peru,-9.19,-75.0152,3466309,0,208789,3257520
2/17/22,Peru,-9.19,-75.0152,3474965,0,208964,3266001
2/18/22,Peru,-9.19,-75.0152,3481752,0,209110,3272642
2/19/22,Peru,-9.19,-75.0152,3490988,0,209298,3281690
2/20/22,Peru,-9.19,-75.0152,3496009,0,209468,3286541
2/21/22,Peru,-9.19,-75.0152,3497896,0,209641,3288255
2/22/22,Peru,-9.19,-75.0152,3500880,0,209808,3291072
2/23/22,Peru,-9.19,-75.0152,3503892,0,209927,3293965
2/24/22,Peru,-9.19,-75.0152,3506075,0,210116,3295959
2/25/22,Peru,-9.19,-75.0152,3508642,0,210229,3298413
2/26/22,Peru,-9.19,-75.0152,3512404,0,210407,3301997
2/27/22,Peru,-9.19,-75.0152,3516264,0,210538,3305726
2/28/22,Peru,-9.19,-75.0152,3517260,0,210672,3306588
3/1/22,Peru,-9.19,-75.0152,3518721,0,210744,3307977
3/2/22,Peru,-9.19,-75.0152,3520604,0,210851,3309753
3/3/22,Peru,-9.19,-75.0152,3522484,0,210907,3311577
3/4/22,Peru,-9.19,-75.0152,3524504,0,210995,3313509
3/5/22,Peru,-9.19,-75.0152,3525940,0,211032,3314908
3/6/22,Peru,-9.19,-75.0152,3527549,0,211108,3316441
3/7/22,Peru,-9.19,-75.0152,3528038,0,211155,3316883
3/8/22,Peru,-9.19,-75.0152,3528939,0,211252,3317687
3/9/22,Peru,-9.19,-75.0152,3530004,0,211301,3318703
3/10/22,Peru,-9.19,-75.0152,3531075,0,211364,3319711
3/11/22,Peru,-9.19,-75.0152,3534687,0,211423,3323264
3/12/22,Peru,-9.19,-75.0152,3535726,0,211482,3324244
3/13/22,Peru,-9.19,-75.0152,3536496,0,211546,3324950
3/14/22,Peru,-9.19,-75.0152,3536842,0,211579,3325263
3/15/22,Peru,-9.19,-75.0152,3537488,0,211619,3325869
3/16/22,Peru,-9.19,-75.0152,3538453,0,211661,3326792
3/17/22,Peru,-9.19,-75.0152,3539400,0,211691,3327709
3/18/22,Peru,-9.19,-75.0152,3540108,0,211751,3328357
3/19/22,Peru,-9.19,-75.0152,3540793,0,211814,3328979
3/20/22,Peru,-9.19,-75.0152,3541397,0,211865,3329532
3/21/22,Peru,-9.19,-75.0152,3541994,0,211924,3330070
3/22/22,Peru,-9.19,-75.0152,3542602,0,211944,3330658
3/23/22,Peru,-9.19,-75.0152,3543179,0,211981,3331198
3/24/22,Peru,-9.19,-75.0152,3543790,0,212022,3331768
3/25/22,Peru,-9.19,-75.0152,3544338,0,212050,3332288
3/26/22,Peru,-9.19,-75.0152,3544862,0,212102,3332760
3/27/22,Peru,-9.19,-75.0152,3545403,0,212128,3333275
3/28/22,Peru,-9.19,-75.0152,3545628,0,212157,3333471
3/29/22,Peru,-9.19,-75.0152,3546083,0,212179,3333904
3/30/22,Peru,-9.19,-75.0152,3546696,0,212207,3334489
3/31/22,Peru,-9.19,-75.0152,3547125,0,212222,3334903
4/1/22,Peru,-9.19,-75.0152,3547606,0,212256,3335350
4/2/22,Peru,-9.19,-75.0152,3548088,0,212299,3335789
4/3/22,Peru,-9.19,-75.0152,3548559,0,212328,3336231
4/4/22,Peru,-9.19,-75.0152,3548717,0,212354,3336363
4/5/22,Peru,-9.19,-75.0152,3549028,0,212372,3336656
4/6/22,Peru,-9.19,-75.0152,3549511,0,212396,3337115
4/7/22,Peru,-9.19,-75.0152,3550240,0,212420,3337820
4/8/22,Peru,-9.19,-75.0152,3550791,0,212438,3338353
4/9/22,Peru,-9.19,-75.0152,3551245,0,212471,3338774
4/10/22,Peru,-9.19,-75.0152,3551540,0,212486,3339054
4/11/22,Peru,-9.19,-75.0152,3551800,0,212507,3339293
4/12/22,Peru,-9.19,-75.0152,3552467,0,212528,3339939
4/13/22,Peru,-9.19,-75.0152,3553210,0,212547,3340663
4/14/22,Peru,-9.19,-75.0152,3554006,0,212565,3341441
4/15/22,Peru,-9.19,-75.0152,3554669,0,212596,3342073
4/16/22,Peru,-9.19,-75.0152,3555139,0,212619,3342520
4/17/22,Peru,-9.19,-75.0152,3555739,0,212630,3343109
4/18/22,Peru,-9.19,-75.0152,3556384,0,212654,3343730
4/19/22,Peru,-9.19,-75.0152,3557139,0,212676,3344463
4/20/22,Peru,-9.19,-75.0152,3557869,0,212704,3345165
4/21/22,Peru,-9.19,-75.0152,3558613,0,212715,3345898
4/22/22,Peru,-9.19,-75.0152,3559343,0,212724,3346619
4/23/22,Peru,-9.19,-75.0152,3560095,0,212736,3347359
4/24/22,Peru,-9.19,-75.0152,3560876,0,212742,3348134
4/25/22,Peru,-9.19,-75.0152,3561677,0,212761,3348916
4/26/22,Peru,-9.19,-75.0152,3562300,0,212769,3349531
4/27/22,Peru,-9.19,-75.0152,3563151,0,212778,3350373
4/28/22,Peru,-9.19,-75.0152,3563929,0,212798,3351131
4/29/22,Peru,-9.19,-75.0152,3564558,0,212810,3351748
4/30/22,Peru,-9.19,-75.0152,3565253,0,212824,3352429
5/1/22,Peru,-9.19,-75.0152,3565839,0,212841,3352998
5/2/22,Peru,-9.19,-75.0152,3566523,0,212865,3353658
5/3/22,Peru,-9.19,-75.0152,3567171,0,212877,3354294
5/4/22,Peru,-9.19,-75.0152,3567863,0,212891,3354972
5/5/22,Peru,-9.19,-75.0152,3568692,0,212906,3355786
5/6/22,Peru,-9.19,-75.0152,3569026,0,212913,3356113
5/7/22,Peru,-9.19,-75.0152,3569326,0,212933,3356393
5/8/22,Peru,-9.19,-75.0152,3569782,0,212946,3356836
5/9/22,Peru,-9.19,-75.0152,3570075,0,212957,3357118
5/10/22,Peru,-9.19,-75.0152,3570339,0,212968,3357371
5/11/22,Peru,-9.19,-75.0152,3570801,0,212979,3357822
5/12/22,Peru,-9.19,-75.0152,3571161,0,213000,3358161
5/13/22,Peru,-9.19,-75.0152,3571516,0,213013,3358503
5/14/22,Peru,-9.19,-75.0152,3571919,0,213023,3358896
5/15/22,Peru,-9.19,-75.0152,3572423,0,213040,3359383
5/16/22,Peru,-9.19,-75.0152,3571516,0,213013,3358503
5/17/22,Peru,-9.19,-75.0152,3572832,0,213044,3359788
5/18/22,Peru,-9.19,-75.0152,3575738,0,213069,3362669
5/19/22,Peru,-9.19,-75.0152,3574182,0,213077,3361105
5/20/22,Peru,-9.19,-75.0152,3574876,0,213086,3361790
5/21/22,Peru,-9.19,-75.0152,3575291,0,213098,3362193
5/22/22,Peru,-9.19,-75.0152,3576042,0,213106,3362936
5/23/22,Peru,-9.19,-75.0152,3576309,0,213116,3363193
5/24/22,Peru,-9.19,-75.0152,3576640,0,213122,3363518
5/25/22,Peru,-9.19,-75.0152,3577241,0,213134,3364107
5/26/22,Peru,-9.19,-75.0152,3577907,0,213145,3364762
5/27/22,Peru,-9.19,-75.0152,3578364,0,213155,3365209
5/28/22,Peru,-9.19,-75.0152,3579534,0,213162,3366372
5/29/22,Peru,-9.19,-75.0152,3580051,0,213173,3366878
5/30/22,Peru,-9.19,-75.0152,3580347,0,213186,3367161
5/31/22,Peru,-9.19,-75.0152,3580960,0,213195,3367765
6/1/22,Peru,-9.19,-75.0152,3581524,0,213205,3368319
6/2/22,Peru,-9.19,-75.0152,3582604,0,213227,3369377
6/3/22,Peru,-9.19,-75.0152,3583403,0,213228,3370175
6/4/22,Peru,-9.19,-75.0152,3584256,0,213248,3371008
6/5/22,Peru,-9.19,-75.0152,3585381,0,213259,3372122
6/6/22,Peru,-9.19,-75.0152,3585767,0,213269,3372498
6/7/22,Peru,-9.19,-75.0152,3586242,0,213281,3372961
6/8/22,Peru,-9.19,-75.0152,3587142,0,213289,3373853
6/9/22,Peru,-9.19,-75.0152,3587906,0,213296,3374610
6/10/22,Peru,-9.19,-75.0152,3588697,0,213308,3375389
6/11/22,Peru,-9.19,-75.0152,3589782,0,213316,3376466
6/12/22,Peru,-9.19,-75.0152,3590882,0,213324,3377558
6/13/22,Peru,-9.19,-75.0152,3591816,0,213338,3378478
6/14/22,Peru,-9.19,-75.0152,3592765,0,213343,3379422
6/15/22,Peru,-9.19,-75.0152,3593625,0,213350,3380275
6/16/22,Peru,-9.19,-75.0152,3594977,0,213361,3381616
6/17/22,Peru,-9.19,-75.0152,3596377,0,213374,3383003
6/18/22,Peru,-9.19,-75.0152,3597866,0,213382,3384484
6/19/22,Peru,-9.19,-75.0152,3599501,0,213389,3386112
6/20/22,Peru,-9.19,-75.0152,3600993,0,213395,3387598
6/21/22,Peru,-9.19,-75.0152,3603127,0,213405,3389722
6/22/22,Peru,-9.19,-75.0152,3605614,0,213425,3392189
6/23/22,Peru,-9.19,-75.0152,3608565,0,213432,3395133
6/24/22,Peru,-9.19,-75.0152,3611123,0,213443,3397680
6/25/22,Peru,-9.19,-75.0152,3613464,0,213447,3400017
6/26/22,Peru,-9.19,-75.0152,3616929,0,213462,3403467
6/27/22,Peru,-9.19,-75.0152,3617629,0,213475,3404154
6/28/22,Peru,-9.19,-75.0152,3620801,0,213483,3407318
6/29/22,Peru,-9.19,-75.0152,3625091,0,213497,3411594
6/30/22,Peru,-9.19,-75.0152,3626802,0,213509,3413293
7/1/22,Peru,-9.19,-75.0152,3629796,0,213526,3416270
7/2/22,Peru,-9.19,-75.0152,3634918,0,213545,3421373
7/3/22,Peru,-9.19,-75.0152,3637529,0,213551,3423978
7/4/22,Peru,-9.19,-75.0152,3640061,0,213579,3426482
7/5/22,Peru,-9.19,-75.0152,3644199,0,213593,3430606
7/6/22,Peru,-9.19,-75.0152,3650203,0,213612,3436591
7/7/22,Peru,-9.19,-75.0152,3656309,0,213623,3442686
7/8/22,Peru,-9.19,-75.0152,3662685,0,213652,3449033
7/9/22,Peru,-9.19,-75.0152,3669043,0,213665,3455378
7/10/22,Peru,-9.19,-75.0152,3675152,0,213685,3461467
7/11/22,Peru,-9.19,-75.0152,3683213,0,213695,3469518
7/12/22,Peru,-9.19,-75.0152,3691213,0,213714,3477499
7/13/22,Peru,-9.19,-75.0152,3703751,0,213731,3490020
7/14/22,Peru,-9.19,-75.0152,3703751,0,213731,3490020
7/15/22,Peru,-9.19,-75.0152,3729879,0,213769,3516110
7/16/22,Peru,-9.19,-75.0152,3740861,0,213801,3527060
7/17/22,Peru,-9.19,-75.0152,3740861,0,213801,3527060
7/18/22,Peru,-9.19,-75.0152,3761445,0,213840,3547605
7/19/22,Peru,-9.19,-75.0152,3773733,0,213870,3559863
7/20/22,Peru,-9.19,-75.0152,3787887,0,213894,3573993
7/21/22,Peru,-9.19,-75.0152,3801893,0,213918,3587975
7/22/22,Peru,-9.19,-75.0152,3816804,0,213953,3602851
7/23/22,Peru,-9.19,-75.0152,3829775,0,213998,3615777
7/24/22,Peru,-9.19,-75.0152,3839099,0,214028,3625071
7/25/22,Peru,-9.19,-75.0152,3845093,0,214071,3631022
7/26/22,Peru,-9.19,-75.0152,3859279,0,214112,3645167
7/27/22,Peru,-9.19,-75.0152,3873702,0,214120,3659582
7/28/22,Peru,-9.19,-75.0152,3889029,0,214154,3674875
7/29/22,Peru,-9.19,-75.0152,3889029,0,214154,3674875
7/30/22,Peru,-9.19,-75.0152,3895496,0,214195,3681301
7/31/22,Peru,-9.19,-75.0152,3909870,0,214303,3695567
8/1/22,Peru,-9.19,-75.0152,3914506,0,214364,3700142
8/2/22,Peru,-9.19,-75.0152,3923744,0,214407,3709337
8/3/22,Peru,-9.19,-75.0152,3932838,0,214431,3718407
8/4/22,Peru,-9.19,-75.0152,3940482,0,214480,3726002
8/5/22,Peru,-9.19,-75.0152,3951495,0,214546,3736949
8/6/22,Peru,-9.19,-75.0152,3961513,0,214588,3746925
8/7/22,Peru,-9.19,-75.0152,3966898,0,214637,3752261
8/8/22,Peru,-9.19,-75.0152,3970336,0,214694,3755642
8/9/22,Peru,-9.19,-75.0152,3980850,0,214739,3766111
8/10/22,Peru,-9.19,-75.0152,3992728,0,214788,3777940
8/11/22,Peru,-9.19,-75.0152,4002949,0,214818,3788131
8/12/22,Peru,-9.19,-75.0152,4013831,0,214890,3798941
8/13/22,Peru,-9.19,-75.0152,4022016,0,214934,3807082
8/14/22,Peru,-9.19,-75.0152,4027614,0,214956,3812658
8/15/22,Peru,-9.19,-75.0152,4031007,0,215028,3815979
8/16/22,Peru,-9.19,-75.0152,4037977,0,215088,3822889
8/17/22,Peru,-9.19,-75.0152,4037977,0,215088,3822889
8/18/22,Peru,-9.19,-75.0152,4055454,0,215209,3840245
8/19/22,Peru,-9.19,-75.0152,4055454,0,215209,3840245
8/20/22,Peru,-9.19,-75.0152,4070583,0,215317,3855266
8/21/22,Peru,-9.19,-75.0152,4074004,0,215342,3858662
8/22/22,Peru,-9.19,-75.0152,4075910,0,215379,3860531
8/23/22,Peru,-9.19,-75.0152,4081141,0,215454,3865687
8/24/22,Peru,-9.19,-75.0152,4086627,0,215486,3871141
8/25/22,Peru,-9.19,-75.0152,4091366,0,215514,3875852
8/26/22,Peru,-9.19,-75.0152,4094652,0,215556,3879096
8/27/22,Peru,-9.19,-75.0152,4097530,0,215602,3881928
8/28/22,Peru,-9.19,-75.0152,4099785,0,215639,3884146
8/29/22,Peru,-9.19,-75.0152,4100923,0,215685,3885238
8/30/22,Peru,-9.19,-75.0152,4102641,0,215745,3886896
8/31/22,Peru,-9.19,-75.0152,4103874,0,215762,3888112
9/1/22,Peru,-9.19,-75.0152,4103874,0,215762,3888112
9/2/22,Peru,-9.19,-75.0152,4111045,0,215790,3895255
9/3/22,Peru,-9.19,-75.0152,4113567,0,215859,3897708
9/4/22,Peru,-9.19,-75.0152,4115117,0,215877,3899240
9/5/22,Peru,-9.19,-75.0152,4115878,0,215928,3899950
9/6/22,Peru,-9.19,-75.0152,4117246,0,215960,3901286
9/7/22,Peru,-9.19,-75.0152,4118792,0,215982,3902810
9/8/22,Peru,-9.19,-75.0152,4121036,0,216003,3905033
9/9/22,Peru,-9.19,-75.0152,4123435,0,216045,3907390
9/10/22,Peru,-9.19,-75.0152,4125208,0,216086,3909122
9/11/22,Peru,-9.19,-75.0152,4126021,0,216125,3909896
9/12/22,Peru,-9.19,-75.0152,4126462,0,216151,3910311
9/13/22,Peru,-9.19,-75.0152,4127612,0,216173,3911439
9/14/22,Peru,-9.19,-75.0152,4128680,0,216202,3912478
9/15/22,Peru,-9.19,-75.0152,4130040,0,216235,3913805
9/16/22,Peru,-9.19,-75.0152,4131137,0,216264,3914873
9/17/22,Peru,-9.19,-75.0152,4131996,0,216287,3915709
9/18/22,Peru,-9.19,-75.0152,4132687,0,216309,3916378
9/19/22,Peru,-9.19,-75.0152,4132687,0,216309,3916378
9/20/22,Peru,-9.19,-75.0152,4132687,0,216309,3916378
9/21/22,Peru,-9.19,-75.0152,4137314,0,216406,3920908
9/22/22,Peru,-9.19,-75.0152,4138979,0,216429,3922550
9/23/22,Peru,-9.19,-75.0152,4140129,0,216446,3923683
9/24/22,Peru,-9.19,-75.0152,4140874,0,216473,3924401
9/25/22,Peru,-9.19,-75.0152,4141241,0,216493,3924748
9/26/22,Peru,-9.19,-75.0152,4141410,0,216514,3924896
9/27/22,Peru,-9.19,-75.0152,4142104,0,216526,3925578
9/28/22,Peru,-9.19,-75.0152,4142104,0,216526,3925578
9/29/22,Peru,-9.19,-75.0152,4143085,0,216539,3926546
9/30/22,Peru,-9.19,-75.0152,4144416,0,216575,3927841
10/1/22,Peru,-9.19,-75.0152,4145048,0,216578,3928470
10/2/22,Peru,-9.19,-75.0152,4145301,0,216596,3928705
10/3/22,Peru,-9.19,-75.0152,4145449,0,216607,3928842
10/4/22,Peru,-9.19,-75.0152,4146000,0,216626,3929374
10/5/22,Peru,-9.19,-75.0152,4146000,0,216626,3929374
10/6/22,Peru,-9.19,-75.0152,4147822,0,216665,3931157
10/7/22,Peru,-9.19,-75.0152,4148161,0,216700,3931461
10/8/22,Peru,-9.19,-75.0152,4148457,0,216727,3931730
10/9/22,Peru,-9.19,-75.0152,4148587,0,216755,3931832
10/10/22,Peru,-9.19,-75.0152,4148691,0,216788,3931903
10/11/22,Peru,-9.19,-75.0152,4149079,0,216819,3932260
10/12/22,Peru,-9.19,-75.0152,4149440,0,216830,3932610
10/13/22,Peru,-9.19,-75.0152,4149823,0,216844,3932979
10/14/22,Peru,-9.19,-75.0152,4150121,0,216855,3933266
10/15/22,Peru,-9.19,-75.0152,4150544,0,216860,3933684
10/16/22,Peru,-9.19,-75.0152,4150737,0,216877,3933860
10/17/22,Peru,-9.19,-75.0152,4150832,0,216877,3933955
10/18/22,Peru,-9.19,-75.0152,4151044,0,216877,3934167
10/19/22,Peru,-9.19,-75.0152,4151414,0,216877,3934537
10/20/22,Peru,-9.19,-75.0152,4151705,0,216877,3934828
10/21/22,Peru,-9.19,-75.0152,4152019,0,216877,3935142
10/22/22,Peru,-9.19,-75.0152,4152284,0,216877,3935407
10/23/22,Peru,-9.19,-75.0152,4152499,0,216877,3935622
10/24/22,Peru,-9.19,-75.0152,4152580,0,216877,3935703
10/25/22,Peru,-9.19,-75.0152,4152804,0,216877,3935927
10/26/22,Peru,-9.19,-75.0152,4153605,0,216884,3936721
10/27/22,Peru,-9.19,-75.0152,4153919,0,216909,3937010
10/28/22,Peru,-9.19,-75.0152,4154336,0,216942,3937394
10/29/22,Peru,-9.19,-75.0152,4155286,0,216972,3938314
10/30/22,Peru,-9.19,-75.0152,4156078,0,217005,3939073
10/31/22,Peru,-9.19,-75.0152,4156924,0,217012,3939912
11/1/22,Peru,-9.19,-75.0152,4157569,0,217013,3940556
11/2/22,Peru,-9.19,-75.0152,4158534,0,217025,3941509
11/3/22,Peru,-9.19,-75.0152,4159132,0,217030,3942102
11/4/22,Peru,-9.19,-75.0152,4159132,0,217030,3942102
11/5/22,Peru,-9.19,-75.0152,4161218,0,217069,3944149
11/6/22,Peru,-9.19,-75.0152,4161617,0,217080,3944537
11/7/22,Peru,-9.19,-75.0152,4161769,0,217098,3944671
11/8/22,Peru,-9.19,-75.0152,4163326,0,217103,3946223
11/9/22,Peru,-9.19,-75.0152,4165187,0,217129,3948058
11/10/22,Peru,-9.19,-75.0152,4167290,0,217146,3950144
11/11/22,Peru,-9.19,-75.0152,4169751,0,217172,3952579
11/12/22,Peru,-9.19,-75.0152,4171838,0,217185,3954653
11/13/22,Peru,-9.19,-75.0152,4172486,0,217192,3955294
11/14/22,Peru,-9.19,-75.0152,4171185,0,217294,3953891
11/15/22,Peru,-9.19,-75.0152,4175383,0,217203,3958180
11/16/22,Peru,-9.19,-75.0152,4177786,0,217212,3960574
11/17/22,Peru,-9.19,-75.0152,4180834,0,217218,3963616
11/18/22,Peru,-9.19,-75.0152,4184191,0,217229,3966962
11/19/22,Peru,-9.19,-75.0152,4184191,0,217229,3966962
11/20/22,Peru,-9.19,-75.0152,4190948,0,217264,3973684
11/21/22,Peru,-9.19,-75.0152,4190948,0,217279,3973669
11/22/22,Peru,-9.19,-75.0152,4197026,0,217287,3979739
11/23/22,Peru,-9.19,-75.0152,4197026,0,217287,3979739
11/24/22,Peru,-9.19,-75.0152,4209905,0,217314,3992591
11/25/22,Peru,-9.19,-75.0152,4217068,0,217339,3999729
11/26/22,Peru,-9.19,-75.0152,4217068,0,217353,3999715
11/27/22,Peru,-9.19,-75.0152,4227446,0,217370,4010076
11/28/22,Peru,-9.19,-75.0152,4229179,0,217386,4011793
11/29/22,Peru,-9.19,-75.0152,4238042,0,217394,4020648
11/30/22,Peru,-9.19,-75.0152,4252383,0,217414,4034969
12/1/22,Peru,-9.19,-75.0152,4266251,0,217428,4048823
12/2/22,Peru,-9.19,-75.0152,4278997,0,217441,4061556
12/3/22,Peru,-9.19,-75.0152,4291373,0,217470,4073903
12/4/22,Peru,-9.19,-75.0152,4300576,0,217496,4083080
12/5/22,Peru,-9.19,-75.0152,4300576,0,217496,4083080
12/6/22,Peru,-9.19,-75.0152,4300306,0,217542,4082764
12/7/22,Peru,-9.19,-75.0152,4330521,0,217566,4112955
12/8/22,Peru,-9.19,-75.0152,4344977,0,217604,4127373
12/9/22,Peru,-9.19,-75.0152,4350513,0,217624,4132889
12/10/22,Peru,-9.19,-75.0152,4354251,0,217636,4136615
12/11/22,Peru,-9.19,-75.0152,4359209,0,217657,4141552
12/12/22,Peru,-9.19,-75.0152,4362281,0,217679,4144602
12/13/22,Peru,-9.19,-75.0152,4376905,0,217704,4159201
12/14/22,Peru,-9.19,-75.0152,4390355,0,217738,4172617
12/15/22,Peru,-9.19,-75.0152,4399073,0,217782,4181291
12/16/22,Peru,-9.19,-75.0152,4405843,0,217821,4188022
12/17/22,Peru,-9.19,-75.0152,4405843,0,217821,4188022
1/1/22,Philippines,12.879721,121.774017,2847486,0,51545,2795941
1/2/22,Philippines,12.879721,121.774017,2851931,0,51570,2800361
1/3/22,Philippines,12.879721,121.774017,2855819,0,51586,2804233
1/4/22,Philippines,12.879721,121.774017,2861119,0,51604,2809515
1/5/22,Philippines,12.879721,121.774017,2871745,0,51662,2820083
1/6/22,Philippines,12.879721,121.774017,2888917,0,51743,2837174
1/7/22,Philippines,12.879721,121.774017,2910664,0,51871,2858793
1/8/22,Philippines,12.879721,121.774017,2936875,0,52135,2884740
1/9/22,Philippines,12.879721,121.774017,2965447,0,52150,2913297
1/10/22,Philippines,12.879721,121.774017,2998530,0,52293,2946237
1/11/22,Philippines,12.879721,121.774017,3026473,0,52511,2973962
1/12/22,Philippines,12.879721,121.774017,3058634,0,52654,3005980
1/13/22,Philippines,12.879721,121.774017,3092409,0,52736,3039673
1/14/22,Philippines,12.879721,121.774017,3129512,0,52815,3076697
1/15/22,Philippines,12.879721,121.774017,3168379,0,52858,3115521
1/16/22,Philippines,12.879721,121.774017,3205396,0,52907,3152489
1/17/22,Philippines,12.879721,121.774017,3242374,0,52929,3189445
1/18/22,Philippines,12.879721,121.774017,3270758,0,52962,3217796
1/19/22,Philippines,12.879721,121.774017,3293625,0,53044,3240581
1/20/22,Philippines,12.879721,121.774017,3324478,0,53153,3271325
1/21/22,Philippines,12.879721,121.774017,3357083,0,53309,3303774
1/22/22,Philippines,12.879721,121.774017,3387524,0,53406,3334118
1/23/22,Philippines,12.879721,121.774017,3417216,0,53472,3363744
1/24/22,Philippines,12.879721,121.774017,3442056,0,53519,3388537
1/25/22,Philippines,12.879721,121.774017,3459646,0,53598,3406048
1/26/22,Philippines,12.879721,121.774017,3475293,0,53664,3421629
1/27/22,Philippines,12.879721,121.774017,3493447,0,53736,3439711
1/28/22,Philippines,12.879721,121.774017,3511491,0,53801,3457690
1/29/22,Philippines,12.879721,121.774017,3528796,0,53871,3474925
1/30/22,Philippines,12.879721,121.774017,3545680,0,53891,3491789
1/31/22,Philippines,12.879721,121.774017,3560202,0,54003,3506199
2/1/22,Philippines,12.879721,121.774017,3569665,0,54054,3515611
2/2/22,Philippines,12.879721,121.774017,3577298,0,54097,3523201
2/3/22,Philippines,12.879721,121.774017,3585461,0,54168,3531293
2/4/22,Philippines,12.879721,121.774017,3594002,0,54214,3539788
2/5/22,Philippines,12.879721,121.774017,3601471,0,54214,3547257
2/6/22,Philippines,12.879721,121.774017,3609568,0,54526,3555042
2/7/22,Philippines,12.879721,121.774017,3616387,0,54538,3561849
2/8/22,Philippines,12.879721,121.774017,3619633,0,54621,3565012
2/9/22,Philippines,12.879721,121.774017,3623176,0,54690,3568486
2/10/22,Philippines,12.879721,121.774017,3627575,0,54783,3572792
2/11/22,Philippines,12.879721,121.774017,3630637,0,54854,3575783
2/12/22,Philippines,12.879721,121.774017,3634368,0,54930,3579438
2/13/22,Philippines,12.879721,121.774017,3637280,0,54930,3582350
2/14/22,Philippines,12.879721,121.774017,3639942,0,55094,3584848
2/15/22,Philippines,12.879721,121.774017,3641940,0,55146,3586794
2/16/22,Philippines,12.879721,121.774017,3644597,0,55223,3589374
2/17/22,Philippines,12.879721,121.774017,3646793,0,55330,3591463
2/18/22,Philippines,12.879721,121.774017,3648925,0,55409,3593516
2/19/22,Philippines,12.879721,121.774017,3650748,0,55607,3595141
2/20/22,Philippines,12.879721,121.774017,3652203,0,55684,3596519
2/21/22,Philippines,12.879721,121.774017,3653526,0,55763,3597763
2/22/22,Philippines,12.879721,121.774017,3654284,0,55776,3598508
2/23/22,Philippines,12.879721,121.774017,3655709,0,55977,3599732
2/24/22,Philippines,12.879721,121.774017,3657342,0,56165,3601177
2/25/22,Philippines,12.879721,121.774017,3658892,0,56224,3602668
2/26/22,Philippines,12.879721,121.774017,3660020,0,56351,3603669
2/27/22,Philippines,12.879721,121.774017,3661049,0,56401,3604648
2/28/22,Philippines,12.879721,121.774017,3661997,0,56451,3605546
3/1/22,Philippines,12.879721,121.774017,3663059,0,56451,3606608
3/2/22,Philippines,12.879721,121.774017,3663920,0,56504,3607416
3/3/22,Philippines,12.879721,121.774017,3664905,0,56538,3608367
3/4/22,Philippines,12.879721,121.774017,3665747,0,56770,3608977
3/5/22,Philippines,12.879721,121.774017,3666678,0,56879,3609799
3/6/22,Philippines,12.879721,121.774017,3667542,0,57023,3610519
3/7/22,Philippines,12.879721,121.774017,3668268,0,57066,3611202
3/8/22,Philippines,12.879721,121.774017,3668710,0,57072,3611638
3/9/22,Philippines,12.879721,121.774017,3669283,0,57182,3612101
3/10/22,Philippines,12.879721,121.774017,3668940,0,57258,3611682
3/11/22,Philippines,12.879721,121.774017,3669523,0,57317,3612206
3/12/22,Philippines,12.879721,121.774017,3670177,0,57441,3612736
3/13/22,Philippines,12.879721,121.774017,3670739,0,57610,3613129
3/14/22,Philippines,12.879721,121.774017,3671293,0,57625,3613668
3/15/22,Philippines,12.879721,121.774017,3671293,0,57625,3613668
3/16/22,Philippines,12.879721,121.774017,3672069,0,57735,3614334
3/17/22,Philippines,12.879721,121.774017,3672661,0,57880,3614781
3/18/22,Philippines,12.879721,121.774017,3673201,0,57999,3615202
3/19/22,Philippines,12.879721,121.774017,3673717,0,58023,3615694
3/20/22,Philippines,12.879721,121.774017,3674286,0,58263,3616023
3/21/22,Philippines,12.879721,121.774017,3674694,0,58276,3616418
3/22/22,Philippines,12.879721,121.774017,3674983,0,58281,3616702
3/23/22,Philippines,12.879721,121.774017,3675384,0,58563,3616821
3/24/22,Philippines,12.879721,121.774017,3675821,0,58771,3617050
3/25/22,Philippines,12.879721,121.774017,3676230,0,58831,3617399
3/26/22,Philippines,12.879721,121.774017,3676665,0,58884,3617781
3/27/22,Philippines,12.879721,121.774017,3676991,0,59015,3617976
3/28/22,Philippines,12.879721,121.774017,3677376,0,59030,3618346
3/29/22,Philippines,12.879721,121.774017,3677616,0,59038,3618578
3/30/22,Philippines,12.879721,121.774017,3677924,0,59125,3618799
3/31/22,Philippines,12.879721,121.774017,3678245,0,59249,3618996
4/1/22,Philippines,12.879721,121.774017,3678598,0,59298,3619300
4/2/22,Philippines,12.879721,121.774017,3678968,0,59324,3619644
4/3/22,Philippines,12.879721,121.774017,3679629,0,59343,3620286
4/4/22,Philippines,12.879721,121.774017,3679761,0,59365,3620396
4/5/22,Philippines,12.879721,121.774017,3679983,0,59370,3620613
4/6/22,Philippines,12.879721,121.774017,3680244,0,59422,3620822
4/7/22,Philippines,12.879721,121.774017,3680514,0,59591,3620923
4/8/22,Philippines,12.879721,121.774017,3680802,0,59660,3621142
4/9/22,Philippines,12.879721,121.774017,3681101,0,59730,3621371
4/10/22,Philippines,12.879721,121.774017,3681374,0,59769,3621605
4/11/22,Philippines,12.879721,121.774017,3681646,0,59777,3621869
4/12/22,Philippines,12.879721,121.774017,3681851,0,59778,3622073
4/13/22,Philippines,12.879721,121.774017,3682083,0,59891,3622192
4/14/22,Philippines,12.879721,121.774017,3682356,0,59932,3622424
4/15/22,Philippines,12.879721,121.774017,3682623,0,59956,3622667
4/16/22,Philippines,12.879721,121.774017,3682847,0,59964,3622883
4/17/22,Philippines,12.879721,121.774017,3683042,0,59969,3623073
4/18/22,Philippines,12.879721,121.774017,3683211,0,59976,3623235
4/19/22,Philippines,12.879721,121.774017,3683367,0,59982,3623385
4/20/22,Philippines,12.879721,121.774017,3683732,0,59990,3623742
4/21/22,Philippines,12.879721,121.774017,3683865,0,60056,3623809
4/22/22,Philippines,12.879721,121.774017,3684094,0,60118,3623976
4/23/22,Philippines,12.879721,121.774017,3684300,0,60179,3624121
4/24/22,Philippines,12.879721,121.774017,3684500,0,60182,3624318
4/25/22,Philippines,12.879721,121.774017,3684712,0,60194,3624518
4/26/22,Philippines,12.879721,121.774017,3684835,0,60195,3624640
4/27/22,Philippines,12.879721,121.774017,3685029,0,60215,3624814
4/28/22,Philippines,12.879721,121.774017,3685222,0,60267,3624955
4/29/22,Philippines,12.879721,121.774017,3685403,0,60305,3625098
4/30/22,Philippines,12.879721,121.774017,3685643,0,60341,3625302
5/1/22,Philippines,12.879721,121.774017,3685895,0,60397,3625498
5/2/22,Philippines,12.879721,121.774017,3686082,0,60410,3625672
5/3/22,Philippines,12.879721,121.774017,3686216,0,60412,3625804
5/4/22,Philippines,12.879721,121.774017,3686375,0,60439,3625936
5/5/22,Philippines,12.879721,121.774017,3686543,0,60439,3626104
5/6/22,Philippines,12.879721,121.774017,3686693,0,60439,3626254
5/7/22,Philippines,12.879721,121.774017,3686868,0,60439,3626429
5/8/22,Philippines,12.879721,121.774017,3687018,0,60439,3626579
5/9/22,Philippines,12.879721,121.774017,3687197,0,60439,3626758
5/10/22,Philippines,12.879721,121.774017,3687320,0,60439,3626881
5/11/22,Philippines,12.879721,121.774017,3687428,0,60439,3626989
5/12/22,Philippines,12.879721,121.774017,3687567,0,60452,3627115
5/13/22,Philippines,12.879721,121.774017,3687748,0,60455,3627293
5/14/22,Philippines,12.879721,121.774017,3687922,0,60455,3627467
5/15/22,Philippines,12.879721,121.774017,3688132,0,60455,3627677
5/16/22,Philippines,12.879721,121.774017,3688292,0,60458,3627834
5/17/22,Philippines,12.879721,121.774017,3688001,0,60452,3627549
5/18/22,Philippines,12.879721,121.774017,3688100,0,60452,3627648
5/19/22,Philippines,12.879721,121.774017,3688295,0,60452,3627843
5/20/22,Philippines,12.879721,121.774017,3688508,0,60455,3628053
5/21/22,Philippines,12.879721,121.774017,3688751,0,60455,3628296
5/22/22,Philippines,12.879721,121.774017,3688941,0,60455,3628486
5/23/22,Philippines,12.879721,121.774017,3689132,0,60455,3628677
5/24/22,Philippines,12.879721,121.774017,3689281,0,60455,3628826
5/25/22,Philippines,12.879721,121.774017,3689457,0,60455,3629002
5/26/22,Philippines,12.879721,121.774017,3689656,0,60455,3629201
5/27/22,Philippines,12.879721,121.774017,3689865,0,60455,3629410
5/28/22,Philippines,12.879721,121.774017,3690055,0,60455,3629600
5/29/22,Philippines,12.879721,121.774017,3690254,0,60455,3629799
5/30/22,Philippines,12.879721,121.774017,3690451,0,60455,3629996
5/31/22,Philippines,12.879721,121.774017,3690581,0,60455,3630126
6/1/22,Philippines,12.879721,121.774017,3690707,0,60455,3630252
6/2/22,Philippines,12.879721,121.774017,3690889,0,60455,3630434
6/3/22,Philippines,12.879721,121.774017,3691114,0,60456,3630658
6/4/22,Philippines,12.879721,121.774017,3691327,0,60456,3630871
6/5/22,Philippines,12.879721,121.774017,3691546,0,60456,3631090
6/6/22,Philippines,12.879721,121.774017,3691724,0,60456,3631268
6/7/22,Philippines,12.879721,121.774017,3691892,0,60456,3631436
6/8/22,Philippines,12.879721,121.774017,3692084,0,60456,3631628
6/9/22,Philippines,12.879721,121.774017,3692336,0,60456,3631880
6/10/22,Philippines,12.879721,121.774017,3692617,0,60461,3632156
6/11/22,Philippines,12.879721,121.774017,3692914,0,60461,3632453
6/12/22,Philippines,12.879721,121.774017,3693222,0,60461,3632761
6/13/22,Philippines,12.879721,121.774017,3693608,0,60461,3633147
6/14/22,Philippines,12.879721,121.774017,3693865,0,60461,3633404
6/15/22,Philippines,12.879721,121.774017,3694121,0,60461,3633660
6/16/22,Philippines,12.879721,121.774017,3694529,0,60461,3634068
6/17/22,Philippines,12.879721,121.774017,3695068,0,60467,3634601
6/18/22,Philippines,12.879721,121.774017,3695652,0,60467,3635185
6/19/22,Philippines,12.879721,121.774017,3696264,0,60467,3635797
6/20/22,Philippines,12.879721,121.774017,3696793,0,60467,3636326
6/21/22,Philippines,12.879721,121.774017,3697200,0,60476,3636724
6/22/22,Philippines,12.879721,121.774017,3697793,0,60484,3637309
6/23/22,Philippines,12.879721,121.774017,3698509,0,60495,3638014
6/24/22,Philippines,12.879721,121.774017,3699251,0,60507,3638744
6/25/22,Philippines,12.879721,121.774017,3700028,0,60507,3639521
6/26/22,Philippines,12.879721,121.774017,3700876,0,60518,3640358
6/27/22,Philippines,12.879721,121.774017,3701743,0,60518,3641225
6/28/22,Philippines,12.879721,121.774017,3702319,0,60531,3641788
6/29/22,Philippines,12.879721,121.774017,3703100,0,60542,3642558
6/30/22,Philippines,12.879721,121.774017,3704407,0,60555,3643852
7/1/22,Philippines,12.879721,121.774017,3705649,0,60565,3645084
7/2/22,Philippines,12.879721,121.774017,3706951,0,60578,3646373
7/3/22,Philippines,12.879721,121.774017,3708271,0,60592,3647679
7/4/22,Philippines,12.879721,121.774017,3709386,0,60602,3648784
7/5/22,Philippines,12.879721,121.774017,3710145,0,60610,3649535
7/6/22,Philippines,12.879721,121.774017,3711268,0,60622,3650646
7/7/22,Philippines,12.879721,121.774017,3713131,0,60625,3652506
7/8/22,Philippines,12.879721,121.774017,3714770,0,60639,3654131
7/9/22,Philippines,12.879721,121.774017,3716522,0,60639,3655883
7/10/22,Philippines,12.879721,121.774017,3718467,0,60640,3657827
7/11/22,Philippines,12.879721,121.774017,3720054,0,60640,3659414
7/12/22,Philippines,12.879721,121.774017,3721413,0,60640,3660773
7/13/22,Philippines,12.879721,121.774017,3723014,0,60640,3662374
7/14/22,Philippines,12.879721,121.774017,3725382,0,60641,3664741
7/15/22,Philippines,12.879721,121.774017,3727970,0,60641,3667329
7/16/22,Philippines,12.879721,121.774017,3730545,0,60641,3669904
7/17/22,Philippines,12.879721,121.774017,3733101,0,60641,3672460
7/18/22,Philippines,12.879721,121.774017,3735383,0,60641,3674742
7/19/22,Philippines,12.879721,121.774017,3737222,0,60641,3676581
7/20/22,Philippines,12.879721,121.774017,3739160,0,60641,3678519
7/21/22,Philippines,12.879721,121.774017,3741987,0,60641,3681346
7/22/22,Philippines,12.879721,121.774017,3745375,0,60656,3684719
7/23/22,Philippines,12.879721,121.774017,3748979,0,60670,3688309
7/24/22,Philippines,12.879721,121.774017,3752534,0,60683,3691851
7/25/22,Philippines,12.879721,121.774017,3755403,0,60694,3694709
7/26/22,Philippines,12.879721,121.774017,3757762,0,60694,3697068
7/27/22,Philippines,12.879721,121.774017,3760488,0,60694,3699794
7/28/22,Philippines,12.879721,121.774017,3764346,0,60704,3703642
7/29/22,Philippines,12.879721,121.774017,3768474,0,60718,3707756
7/30/22,Philippines,12.879721,121.774017,3772468,0,60719,3711749
7/31/22,Philippines,12.879721,121.774017,3776627,0,60727,3715900
8/1/22,Philippines,12.879721,121.774017,3780178,0,60737,3719441
8/2/22,Philippines,12.879721,121.774017,3782822,0,60749,3722073
8/3/22,Philippines,12.879721,121.774017,3785869,0,60762,3725107
8/4/22,Philippines,12.879721,121.774017,3790309,0,60773,3729536
8/5/22,Philippines,12.879721,121.774017,3795008,0,60774,3734234
8/6/22,Philippines,12.879721,121.774017,3799334,0,60789,3738545
8/7/22,Philippines,12.879721,121.774017,3803955,0,60807,3743148
8/8/22,Philippines,12.879721,121.774017,3808156,0,60837,3747319
8/9/22,Philippines,12.879721,121.774017,3810772,0,60864,3749908
8/10/22,Philippines,12.879721,121.774017,3813952,0,60889,3753063
8/11/22,Philippines,12.879721,121.774017,3818480,0,60916,3757564
8/12/22,Philippines,12.879721,121.774017,3823084,0,60944,3762140
8/13/22,Philippines,12.879721,121.774017,3827758,0,60992,3766766
8/14/22,Philippines,12.879721,121.774017,3831941,0,61036,3770905
8/15/22,Philippines,12.879721,121.774017,3835422,0,61078,3774344
8/16/22,Philippines,12.879721,121.774017,3838062,0,61127,3776935
8/17/22,Philippines,12.879721,121.774017,3840943,0,61173,3779770
8/18/22,Philippines,12.879721,121.774017,3844708,0,61221,3783487
8/19/22,Philippines,12.879721,121.774017,3848449,0,61261,3787188
8/20/22,Philippines,12.879721,121.774017,3852170,0,61308,3790862
8/21/22,Philippines,12.879721,121.774017,3855804,0,61357,3794447
8/22/22,Philippines,12.879721,121.774017,3858838,0,61386,3797452
8/23/22,Philippines,12.879721,121.774017,3860537,0,61426,3799111
8/24/22,Philippines,12.879721,121.774017,3864034,0,61476,3802558
8/25/22,Philippines,12.879721,121.774017,3867071,0,61519,3805552
8/26/22,Philippines,12.879721,121.774017,3869976,0,61559,3808417
8/27/22,Philippines,12.879721,121.774017,3872405,0,61613,3810792
8/28/22,Philippines,12.879721,121.774017,3874641,0,61667,3812974
8/29/22,Philippines,12.879721,121.774017,3877110,0,61720,3815390
8/30/22,Philippines,12.879721,121.774017,3878734,0,61773,3816961
8/31/22,Philippines,12.879721,121.774017,3880229,0,61814,3818415
9/1/22,Philippines,12.879721,121.774017,3883957,0,61864,3822093
9/2/22,Philippines,12.879721,121.774017,3886395,0,61910,3824485
9/3/22,Philippines,12.879721,121.774017,3889160,0,61962,3827198
9/4/22,Philippines,12.879721,121.774017,3891418,0,62011,3829407
9/5/22,Philippines,12.879721,121.774017,3893573,0,62062,3831511
9/6/22,Philippines,12.879721,121.774017,3894840,0,62118,3832722
9/7/22,Philippines,12.879721,121.774017,3896541,0,62167,3834374
9/8/22,Philippines,12.879721,121.774017,3898882,0,62206,3836676
9/9/22,Philippines,12.879721,121.774017,3901033,0,62249,3838784
9/10/22,Philippines,12.879721,121.774017,3904133,0,62288,3841845
9/11/22,Philippines,12.879721,121.774017,3906269,0,62304,3843965
9/12/22,Philippines,12.879721,121.774017,3908295,0,62342,3845953
9/13/22,Philippines,12.879721,121.774017,3909772,0,62382,3847390
9/14/22,Philippines,12.879721,121.774017,3911487,0,62416,3849071
9/15/22,Philippines,12.879721,121.774017,3913536,0,62447,3851089
9/16/22,Philippines,12.879721,121.774017,3916162,0,62479,3853683
9/17/22,Philippines,12.879721,121.774017,3918329,0,62514,3855815
9/18/22,Philippines,12.879721,121.774017,3920693,0,62549,3858144
9/19/22,Philippines,12.879721,121.774017,3923727,0,62587,3861140
9/20/22,Philippines,12.879721,121.774017,3925326,0,62620,3862706
9/21/22,Philippines,12.879721,121.774017,3927120,0,62657,3864463
9/22/22,Philippines,12.879721,121.774017,3929819,0,62695,3867124
9/23/22,Philippines,12.879721,121.774017,3932155,0,62730,3869425
9/24/22,Philippines,12.879721,121.774017,3934778,0,62759,3872019
9/25/22,Philippines,12.879721,121.774017,3938203,0,62790,3875413
9/26/22,Philippines,12.879721,121.774017,3940201,0,62819,3877382
9/27/22,Philippines,12.879721,121.774017,3941656,0,62849,3878807
9/28/22,Philippines,12.879721,121.774017,3943153,0,62882,3880271
9/29/22,Philippines,12.879721,121.774017,3945566,0,62916,3882650
9/30/22,Philippines,12.879721,121.774017,3948040,0,62947,3885093
10/1/22,Philippines,12.879721,121.774017,3951766,0,62981,3888785
10/2/22,Philippines,12.879721,121.774017,3953886,0,63013,3890873
10/3/22,Philippines,12.879721,121.774017,3955758,0,63042,3892716
10/4/22,Philippines,12.879721,121.774017,3957112,0,63078,3894034
10/5/22,Philippines,12.879721,121.774017,3958786,0,63111,3895675
10/6/22,Philippines,12.879721,121.774017,3961349,0,63149,3898200
10/7/22,Philippines,12.879721,121.774017,3963666,0,63191,3900475
10/8/22,Philippines,12.879721,121.774017,3965865,0,63230,3902635
10/9/22,Philippines,12.879721,121.774017,3967861,0,63264,3904597
10/10/22,Philippines,12.879721,121.774017,3969987,0,63297,3906690
10/11/22,Philippines,12.879721,121.774017,3971455,0,63329,3908126
10/12/22,Philippines,12.879721,121.774017,3973091,0,63363,3909728
10/13/22,Philippines,12.879721,121.774017,3975884,0,63403,3912481
10/14/22,Philippines,12.879721,121.774017,3978354,0,63439,3914915
10/15/22,Philippines,12.879721,121.774017,3980629,0,63477,3917152
10/16/22,Philippines,12.879721,121.774017,3982965,0,63510,3919455
10/17/22,Philippines,12.879721,121.774017,3984815,0,63547,3921268
10/18/22,Philippines,12.879721,121.774017,3986028,0,63581,3922447
10/19/22,Philippines,12.879721,121.774017,3987316,0,63625,3923691
10/20/22,Philippines,12.879721,121.774017,3989556,0,63669,3925887
10/21/22,Philippines,12.879721,121.774017,3991441,0,63706,3927735
10/22/22,Philippines,12.879721,121.774017,3993148,0,63742,3929406
10/23/22,Philippines,12.879721,121.774017,3994634,0,63779,3930855
10/24/22,Philippines,12.879721,121.774017,3995967,0,63814,3932153
10/25/22,Philippines,12.879721,121.774017,3996818,0,63846,3932972
10/26/22,Philippines,12.879721,121.774017,3997941,0,63883,3934058
10/27/22,Philippines,12.879721,121.774017,3999226,0,63921,3935305
10/28/22,Philippines,12.879721,121.774017,4000783,0,63959,3936824
10/29/22,Philippines,12.879721,121.774017,4002080,0,63995,3938085
10/30/22,Philippines,12.879721,121.774017,4003459,0,64033,3939426
10/31/22,Philippines,12.879721,121.774017,4004465,0,64074,3940391
11/1/22,Philippines,12.879721,121.774017,4005157,0,64109,3941048
11/2/22,Philippines,12.879721,121.774017,4005840,0,64145,3941695
11/3/22,Philippines,12.879721,121.774017,4006635,0,64179,3942456
11/4/22,Philippines,12.879721,121.774017,4007318,0,64211,3943107
11/5/22,Philippines,12.879721,121.774017,4008550,0,64240,3944310
11/6/22,Philippines,12.879721,121.774017,4009466,0,64274,3945192
11/7/22,Philippines,12.879721,121.774017,4011026,0,64291,3946735
11/8/22,Philippines,12.879721,121.774017,4011625,0,64298,3947327
11/9/22,Philippines,12.879721,121.774017,4012868,0,64322,3948546
11/10/22,Philippines,12.879721,121.774017,4014039,0,64329,3949710
11/11/22,Philippines,12.879721,121.774017,4015266,0,64355,3950911
11/12/22,Philippines,12.879721,121.774017,4016401,0,64382,3952019
11/13/22,Philippines,12.879721,121.774017,4018253,0,64387,3953866
11/14/22,Philippines,12.879721,121.774017,4019163,0,64405,3954758
11/15/22,Philippines,12.879721,121.774017,4020240,0,64420,3955820
11/16/22,Philippines,12.879721,121.774017,4020965,0,64432,3956533
11/17/22,Philippines,12.879721,121.774017,4022127,0,64441,3957686
11/18/22,Philippines,12.879721,121.774017,4023798,0,64458,3959340
11/19/22,Philippines,12.879721,121.774017,4024956,0,64468,3960488
11/20/22,Philippines,12.879721,121.774017,4025917,0,64476,3961441
11/21/22,Philippines,12.879721,121.774017,4026895,0,64485,3962410
11/22/22,Philippines,12.879721,121.774017,4027469,0,64500,3962969
11/23/22,Philippines,12.879721,121.774017,4028187,0,64504,3963683
11/24/22,Philippines,12.879721,121.774017,4029201,0,64524,3964677
11/25/22,Philippines,12.879721,121.774017,4030572,0,64548,3966024
11/26/22,Philippines,12.879721,121.774017,4032326,0,64571,3967755
11/27/22,Philippines,12.879721,121.774017,4033682,0,64594,3969088
11/28/22,Philippines,12.879721,121.774017,4034658,0,64608,3970050
11/29/22,Philippines,12.879721,121.774017,4035487,0,64620,3970867
11/30/22,Philippines,12.879721,121.774017,4036277,0,64641,3971636
12/1/22,Philippines,12.879721,121.774017,4037547,0,64658,3972889
12/2/22,Philippines,12.879721,121.774017,4038716,0,64682,3974034
12/3/22,Philippines,12.879721,121.774017,4039978,0,64701,3975277
12/4/22,Philippines,12.879721,121.774017,4041023,0,64725,3976298
12/5/22,Philippines,12.879721,121.774017,4042182,0,64750,3977432
12/6/22,Philippines,12.879721,121.774017,4042936,0,64770,3978166
12/7/22,Philippines,12.879721,121.774017,4044000,0,64794,3979206
12/8/22,Philippines,12.879721,121.774017,4045358,0,64820,3980538
12/9/22,Philippines,12.879721,121.774017,4046849,0,64845,3982004
12/10/22,Philippines,12.879721,121.774017,4047878,0,64856,3983022
12/11/22,Philippines,12.879721,121.774017,4049042,0,64880,3984162
12/12/22,Philippines,12.879721,121.774017,4050045,0,64902,3985143
12/13/22,Philippines,12.879721,121.774017,4050866,0,64921,3985945
12/14/22,Philippines,12.879721,121.774017,4051754,0,64944,3986810
12/15/22,Philippines,12.879721,121.774017,4052967,0,64968,3987999
12/16/22,Philippines,12.879721,121.774017,4054159,0,64995,3989164
12/17/22,Philippines,12.879721,121.774017,4055396,0,65034,3990362
1/1/22,Poland,51.9194,19.1451,4120248,0,97559,4022689
1/2/22,Poland,51.9194,19.1451,4127428,0,97592,4029836
1/3/22,Poland,51.9194,19.1451,4133851,0,97601,4036250
1/4/22,Poland,51.9194,19.1451,4145518,0,98034,4047484
1/5/22,Poland,51.9194,19.1451,4162715,0,98666,4064049
1/6/22,Poland,51.9194,19.1451,4179292,0,99311,4079981
1/7/22,Poland,51.9194,19.1451,4191193,0,99428,4091765
1/8/22,Poland,51.9194,19.1451,4202090,0,99720,4102370
1/9/22,Poland,51.9194,19.1451,4213197,0,99742,4113455
1/10/22,Poland,51.9194,19.1451,4220984,0,99761,4121223
1/11/22,Poland,51.9194,19.1451,4232386,0,100254,4132132
1/12/22,Poland,51.9194,19.1451,4248559,0,100938,4147621
1/13/22,Poland,51.9194,19.1451,4265433,0,101419,4164014
1/14/22,Poland,51.9194,19.1451,4281482,0,101841,4179641
1/15/22,Poland,51.9194,19.1451,4298375,0,102270,4196105
1/16/22,Poland,51.9194,19.1451,4313036,0,102305,4210731
1/17/22,Poland,51.9194,19.1451,4323482,0,102309,4221173
1/18/22,Poland,51.9194,19.1451,4343130,0,102686,4240444
1/19/22,Poland,51.9194,19.1451,4373718,0,103062,4270656
1/20/22,Poland,51.9194,19.1451,4406553,0,103378,4303175
1/21/22,Poland,51.9194,19.1451,4443217,0,103626,4339591
1/22/22,Poland,51.9194,19.1451,4484095,0,103819,4380276
1/23/22,Poland,51.9194,19.1451,4518218,0,103844,4414374
1/24/22,Poland,51.9194,19.1451,4547315,0,103846,4443469
1/25/22,Poland,51.9194,19.1451,4584360,0,104097,4480263
1/26/22,Poland,51.9194,19.1451,4637776,0,104373,4533403
1/27/22,Poland,51.9194,19.1451,4695435,0,104636,4590799
1/28/22,Poland,51.9194,19.1451,4752700,0,104907,4647793
1/29/22,Poland,51.9194,19.1451,4804390,0,105138,4699252
1/30/22,Poland,51.9194,19.1451,4852677,0,105161,4747516
1/31/22,Poland,51.9194,19.1451,4886154,0,105194,4780960
2/1/22,Poland,51.9194,19.1451,4925270,0,105434,4819836
2/2/22,Poland,51.9194,19.1451,4981321,0,105753,4875568
2/3/22,Poland,51.9194,19.1451,5035796,0,106060,4929736
2/4/22,Poland,51.9194,19.1451,5083332,0,106306,4977026
2/5/22,Poland,51.9194,19.1451,5129080,0,106578,5022502
2/6/22,Poland,51.9194,19.1451,5163780,0,106597,5057183
2/7/22,Poland,51.9194,19.1451,5188184,0,106607,5081577
2/8/22,Poland,51.9194,19.1451,5223507,0,106894,5116613
2/9/22,Poland,51.9194,19.1451,5270363,0,107204,5163159
2/10/22,Poland,51.9194,19.1451,5312450,0,107466,5204984
2/11/22,Poland,51.9194,19.1451,5348224,0,107757,5240467
2/12/22,Poland,51.9194,19.1451,5379551,0,108089,5271462
2/13/22,Poland,51.9194,19.1451,5401615,0,108120,5293495
2/14/22,Poland,51.9194,19.1451,5415088,0,108137,5306951
2/15/22,Poland,51.9194,19.1451,5437343,0,108515,5328828
2/16/22,Poland,51.9194,19.1451,5466198,0,108887,5357311
2/17/22,Poland,51.9194,19.1451,5495432,0,109205,5386227
2/18/22,Poland,51.9194,19.1451,5519411,0,109509,5409902
2/19/22,Poland,51.9194,19.1451,5540302,0,109792,5430510
2/20/22,Poland,51.9194,19.1451,5553989,0,109817,5444172
2/21/22,Poland,51.9194,19.1451,5563446,0,109833,5453613
2/22/22,Poland,51.9194,19.1451,5582217,0,110157,5472060
2/23/22,Poland,51.9194,19.1451,5602680,0,110517,5492163
2/24/22,Poland,51.9194,19.1451,5620946,0,110858,5510088
2/25/22,Poland,51.9194,19.1451,5637646,0,111056,5526590
2/26/22,Poland,51.9194,19.1451,5651596,0,111277,5540319
2/27/22,Poland,51.9194,19.1451,5660493,0,111316,5549177
2/28/22,Poland,51.9194,19.1451,5667054,0,111317,5555737
3/1/22,Poland,51.9194,19.1451,5680034,0,111586,5568448
3/2/22,Poland,51.9194,19.1451,5694767,0,111864,5582903
3/3/22,Poland,51.9194,19.1451,5708827,0,112130,5596697
3/4/22,Poland,51.9194,19.1451,5721316,0,112336,5608980
3/5/22,Poland,51.9194,19.1451,5734041,0,112535,5621506
3/6/22,Poland,51.9194,19.1451,5741739,0,112545,5629194
3/7/22,Poland,51.9194,19.1451,5747322,0,112551,5634771
3/8/22,Poland,51.9194,19.1451,5760498,0,112768,5647730
3/9/22,Poland,51.9194,19.1451,5774938,0,113002,5661936
3/10/22,Poland,51.9194,19.1451,5788363,0,113186,5675177
3/11/22,Poland,51.9194,19.1451,5799996,0,113307,5686689
3/12/22,Poland,51.9194,19.1451,5811109,0,113434,5697675
3/13/22,Poland,51.9194,19.1451,5818687,0,113443,5705244
3/14/22,Poland,51.9194,19.1451,5823982,0,113444,5710538
3/15/22,Poland,51.9194,19.1451,5836672,0,113622,5723050
3/16/22,Poland,51.9194,19.1451,5851147,0,113773,5737374
3/17/22,Poland,51.9194,19.1451,5863414,0,113980,5749434
3/18/22,Poland,51.9194,19.1451,5875072,0,114087,5760985
3/19/22,Poland,51.9194,19.1451,5885446,0,114206,5771240
3/20/22,Poland,51.9194,19.1451,5891140,0,114218,5776922
3/21/22,Poland,51.9194,19.1451,5895304,0,114221,5781083
3/22/22,Poland,51.9194,19.1451,5905463,0,114355,5791108
3/23/22,Poland,51.9194,19.1451,5915888,0,114480,5801408
3/24/22,Poland,51.9194,19.1451,5924876,0,114626,5810250
3/25/22,Poland,51.9194,19.1451,5933107,0,114736,5818371
3/26/22,Poland,51.9194,19.1451,5939735,0,114821,5824914
3/27/22,Poland,51.9194,19.1451,5943227,0,114828,5828399
3/28/22,Poland,51.9194,19.1451,5945594,0,114829,5830765
3/29/22,Poland,51.9194,19.1451,5952200,0,114939,5837261
3/30/22,Poland,51.9194,19.1451,5957940,0,115040,5842900
3/31/22,Poland,51.9194,19.1451,5962931,0,115173,5847758
4/1/22,Poland,51.9194,19.1451,5966970,0,115247,5851723
4/2/22,Poland,51.9194,19.1451,5969071,0,115343,5853728
4/3/22,Poland,51.9194,19.1451,5969621,0,115345,5854276
4/4/22,Poland,51.9194,19.1451,5970114,0,115345,5854769
4/5/22,Poland,51.9194,19.1451,5971998,0,115395,5856603
4/6/22,Poland,51.9194,19.1451,5973557,0,115472,5858085
4/7/22,Poland,51.9194,19.1451,5975040,0,115536,5859504
4/8/22,Poland,51.9194,19.1451,5976364,0,115594,5860770
4/9/22,Poland,51.9194,19.1451,5977773,0,115635,5862138
4/10/22,Poland,51.9194,19.1451,5978215,0,115635,5862580
4/11/22,Poland,51.9194,19.1451,5978596,0,115635,5862961
4/12/22,Poland,51.9194,19.1451,5980220,0,115696,5864524
4/13/22,Poland,51.9194,19.1451,5981486,0,115736,5865750
4/14/22,Poland,51.9194,19.1451,5982664,0,115775,5866889
4/15/22,Poland,51.9194,19.1451,5983864,0,115809,5868055
4/16/22,Poland,51.9194,19.1451,5984940,0,115838,5869102
4/17/22,Poland,51.9194,19.1451,5985251,0,115838,5869413
4/18/22,Poland,51.9194,19.1451,5985517,0,115838,5869679
4/19/22,Poland,51.9194,19.1451,5985818,0,115838,5869980
4/20/22,Poland,51.9194,19.1451,5987341,0,115869,5871472
4/21/22,Poland,51.9194,19.1451,5988518,0,115899,5872619
4/22/22,Poland,51.9194,19.1451,5989614,0,115926,5873688
4/23/22,Poland,51.9194,19.1451,5990853,0,115948,5874905
4/24/22,Poland,51.9194,19.1451,5991197,0,115948,5875249
4/25/22,Poland,51.9194,19.1451,5991464,0,115948,5875516
4/26/22,Poland,51.9194,19.1451,5992820,0,115977,5876843
4/27/22,Poland,51.9194,19.1451,5993861,0,115998,5877863
4/28/22,Poland,51.9194,19.1451,5994818,0,116022,5878796
4/29/22,Poland,51.9194,19.1451,5995674,0,116042,5879632
4/30/22,Poland,51.9194,19.1451,5996514,0,116059,5880455
5/1/22,Poland,51.9194,19.1451,5996748,0,116059,5880689
5/2/22,Poland,51.9194,19.1451,5996935,0,116059,5880876
5/3/22,Poland,51.9194,19.1451,5997825,0,116069,5881756
5/4/22,Poland,51.9194,19.1451,5997998,0,116070,5881928
5/5/22,Poland,51.9194,19.1451,5998909,0,116099,5882810
5/6/22,Poland,51.9194,19.1451,5999517,0,116124,5883393
5/7/22,Poland,51.9194,19.1451,6000217,0,116138,5884079
5/8/22,Poland,51.9194,19.1451,6000416,0,116138,5884278
5/9/22,Poland,51.9194,19.1451,6000600,0,116138,5884462
5/10/22,Poland,51.9194,19.1451,6001327,0,116150,5885177
5/11/22,Poland,51.9194,19.1451,6001893,0,116164,5885729
5/12/22,Poland,51.9194,19.1451,6002394,0,116175,5886219
5/13/22,Poland,51.9194,19.1451,6002863,0,116186,5886677
5/14/22,Poland,51.9194,19.1451,6003297,0,116207,5887090
5/15/22,Poland,51.9194,19.1451,6003436,0,116207,5887229
5/16/22,Poland,51.9194,19.1451,6003531,0,116207,5887324
5/17/22,Poland,51.9194,19.1451,6004041,0,116217,5887824
5/18/22,Poland,51.9194,19.1451,6004427,0,116230,5888197
5/19/22,Poland,51.9194,19.1451,6004786,0,116242,5888544
5/20/22,Poland,51.9194,19.1451,6005101,0,116255,5888846
5/21/22,Poland,51.9194,19.1451,6005436,0,116268,5889168
5/22/22,Poland,51.9194,19.1451,6005531,0,116268,5889263
5/23/22,Poland,51.9194,19.1451,6005596,0,116268,5889328
5/24/22,Poland,51.9194,19.1451,6006015,0,116284,5889731
5/25/22,Poland,51.9194,19.1451,6006298,0,116290,5890008
5/26/22,Poland,51.9194,19.1451,6006547,0,116299,5890248
5/27/22,Poland,51.9194,19.1451,6006809,0,116305,5890504
5/28/22,Poland,51.9194,19.1451,6007073,0,116311,5890762
5/29/22,Poland,51.9194,19.1451,6007156,0,116311,5890845
5/30/22,Poland,51.9194,19.1451,6007238,0,116311,5890927
5/31/22,Poland,51.9194,19.1451,6007584,0,116318,5891266
6/1/22,Poland,51.9194,19.1451,6007840,0,116326,5891514
6/2/22,Poland,51.9194,19.1451,6008059,0,116333,5891726
6/3/22,Poland,51.9194,19.1451,6008295,0,116338,5891957
6/4/22,Poland,51.9194,19.1451,6008550,0,116349,5892201
6/5/22,Poland,51.9194,19.1451,6008612,0,116349,5892263
6/6/22,Poland,51.9194,19.1451,6008665,0,116349,5892316
6/7/22,Poland,51.9194,19.1451,6009003,0,116355,5892648
6/8/22,Poland,51.9194,19.1451,6009205,0,116362,5892843
6/9/22,Poland,51.9194,19.1451,6009479,0,116368,5893111
6/10/22,Poland,51.9194,19.1451,6009726,0,116369,5893357
6/11/22,Poland,51.9194,19.1451,6009989,0,116371,5893618
6/12/22,Poland,51.9194,19.1451,6010045,0,116371,5893674
6/13/22,Poland,51.9194,19.1451,6010090,0,116371,5893719
6/14/22,Poland,51.9194,19.1451,6010411,0,116380,5894031
6/15/22,Poland,51.9194,19.1451,6010643,0,116387,5894256
6/16/22,Poland,51.9194,19.1451,6010871,0,116390,5894481
6/17/22,Poland,51.9194,19.1451,6010919,0,116390,5894529
6/18/22,Poland,51.9194,19.1451,6011174,0,116393,5894781
6/19/22,Poland,51.9194,19.1451,6011239,0,116393,5894846
6/20/22,Poland,51.9194,19.1451,6011286,0,116393,5894893
6/21/22,Poland,51.9194,19.1451,6011660,0,116400,5895260
6/22/22,Poland,51.9194,19.1451,6011984,0,116404,5895580
6/23/22,Poland,51.9194,19.1451,6012289,0,116405,5895884
6/24/22,Poland,51.9194,19.1451,6012635,0,116412,5896223
6/25/22,Poland,51.9194,19.1451,6012979,0,116417,5896562
6/26/22,Poland,51.9194,19.1451,6013076,0,116417,5896659
6/27/22,Poland,51.9194,19.1451,6013164,0,116417,5896747
6/28/22,Poland,51.9194,19.1451,6013859,0,116420,5897439
6/29/22,Poland,51.9194,19.1451,6014404,0,116424,5897980
6/30/22,Poland,51.9194,19.1451,6014992,0,116424,5898568
7/1/22,Poland,51.9194,19.1451,6015634,0,116429,5899205
7/2/22,Poland,51.9194,19.1451,6016249,0,116435,5899814
7/3/22,Poland,51.9194,19.1451,6016407,0,116435,5899972
7/4/22,Poland,51.9194,19.1451,6016526,0,116435,5900091
7/5/22,Poland,51.9194,19.1451,6017601,0,116437,5901164
7/6/22,Poland,51.9194,19.1451,6018565,0,116440,5902125
7/7/22,Poland,51.9194,19.1451,6019633,0,116449,5903184
7/8/22,Poland,51.9194,19.1451,6020679,0,116449,5904230
7/9/22,Poland,51.9194,19.1451,6021943,0,116453,5905490
7/10/22,Poland,51.9194,19.1451,6022227,0,116453,5905774
7/11/22,Poland,51.9194,19.1451,6022454,0,116453,5906001
7/12/22,Poland,51.9194,19.1451,6024488,0,116458,5908030
7/13/22,Poland,51.9194,19.1451,6026134,0,116464,5909670
7/14/22,Poland,51.9194,19.1451,6027974,0,116468,5911506
7/15/22,Poland,51.9194,19.1451,6029947,0,116470,5913477
7/16/22,Poland,51.9194,19.1451,6032078,0,116470,5915608
7/17/22,Poland,51.9194,19.1451,6032475,0,116470,5916005
7/18/22,Poland,51.9194,19.1451,6032794,0,116470,5916324
7/19/22,Poland,51.9194,19.1451,6036042,0,116475,5919567
7/20/22,Poland,51.9194,19.1451,6038893,0,116486,5922407
7/21/22,Poland,51.9194,19.1451,6041891,0,116492,5925399
7/22/22,Poland,51.9194,19.1451,6044923,0,116498,5928425
7/23/22,Poland,51.9194,19.1451,6048411,0,116510,5931901
7/24/22,Poland,51.9194,19.1451,6049052,0,116510,5932542
7/25/22,Poland,51.9194,19.1451,6049640,0,116510,5933130
7/26/22,Poland,51.9194,19.1451,6054743,0,116524,5938219
7/27/22,Poland,51.9194,19.1451,6058462,0,116535,5941927
7/28/22,Poland,51.9194,19.1451,6061946,0,116547,5945399
7/29/22,Poland,51.9194,19.1451,6065332,0,116556,5948776
7/30/22,Poland,51.9194,19.1451,6069016,0,116570,5952446
7/31/22,Poland,51.9194,19.1451,6069665,0,116570,5953095
8/1/22,Poland,51.9194,19.1451,6070282,0,116570,5953712
8/2/22,Poland,51.9194,19.1451,6075927,0,116592,5959335
8/3/22,Poland,51.9194,19.1451,6080398,0,116608,5963790
8/4/22,Poland,51.9194,19.1451,6084876,0,116628,5968248
8/5/22,Poland,51.9194,19.1451,6089166,0,116645,5972521
8/6/22,Poland,51.9194,19.1451,6093571,0,116660,5976911
8/7/22,Poland,51.9194,19.1451,6094269,0,116660,5977609
8/8/22,Poland,51.9194,19.1451,6094868,0,116660,5978208
8/9/22,Poland,51.9194,19.1451,6100827,0,116686,5984141
8/10/22,Poland,51.9194,19.1451,6105306,0,116717,5988589
8/11/22,Poland,51.9194,19.1451,6109621,0,116737,5992884
8/12/22,Poland,51.9194,19.1451,6113843,0,116751,5997092
8/13/22,Poland,51.9194,19.1451,6118482,0,116773,6001709
8/14/22,Poland,51.9194,19.1451,6119257,0,116773,6002484
8/15/22,Poland,51.9194,19.1451,6120028,0,116773,6003255
8/16/22,Poland,51.9194,19.1451,6120834,0,116773,6004061
8/17/22,Poland,51.9194,19.1451,6128006,0,116798,6011208
8/18/22,Poland,51.9194,19.1451,6133274,0,116826,6016448
8/19/22,Poland,51.9194,19.1451,6138093,0,116860,6021233
8/20/22,Poland,51.9194,19.1451,6142917,0,116881,6026036
8/21/22,Poland,51.9194,19.1451,6143682,0,116881,6026801
8/22/22,Poland,51.9194,19.1451,6144404,0,116881,6027523
8/23/22,Poland,51.9194,19.1451,6150576,0,116909,6033667
8/24/22,Poland,51.9194,19.1451,6154969,0,116936,6038033
8/25/22,Poland,51.9194,19.1451,6158817,0,116967,6041850
8/26/22,Poland,51.9194,19.1451,6162667,0,117007,6045660
8/27/22,Poland,51.9194,19.1451,6166596,0,117030,6049566
8/28/22,Poland,51.9194,19.1451,6167203,0,117030,6050173
8/29/22,Poland,51.9194,19.1451,6167759,0,117030,6050729
8/30/22,Poland,51.9194,19.1451,6173059,0,117059,6056000
8/31/22,Poland,51.9194,19.1451,6176885,0,117093,6059792
9/1/22,Poland,51.9194,19.1451,6180224,0,117119,6063105
9/2/22,Poland,51.9194,19.1451,6183676,0,117130,6066546
9/3/22,Poland,51.9194,19.1451,6186948,0,117153,6069795
9/4/22,Poland,51.9194,19.1451,6187450,0,117153,6070297
9/5/22,Poland,51.9194,19.1451,6187928,0,117153,6070775
9/6/22,Poland,51.9194,19.1451,6193765,0,117174,6076591
9/7/22,Poland,51.9194,19.1451,6198213,0,117194,6081019
9/8/22,Poland,51.9194,19.1451,6202436,0,117219,6085217
9/9/22,Poland,51.9194,19.1451,6206985,0,117233,6089752
9/10/22,Poland,51.9194,19.1451,6211955,0,117252,6094703
9/11/22,Poland,51.9194,19.1451,6212603,0,117252,6095351
9/12/22,Poland,51.9194,19.1451,6213262,0,117252,6096010
9/13/22,Poland,51.9194,19.1451,6221132,0,117280,6103852
9/14/22,Poland,51.9194,19.1451,6227259,0,117299,6109960
9/15/22,Poland,51.9194,19.1451,6233117,0,117316,6115801
9/16/22,Poland,51.9194,19.1451,6238544,0,117341,6121203
9/17/22,Poland,51.9194,19.1451,6243975,0,117351,6126624
9/18/22,Poland,51.9194,19.1451,6244650,0,117351,6127299
9/19/22,Poland,51.9194,19.1451,6245370,0,117351,6128019
9/20/22,Poland,51.9194,19.1451,6253044,0,117367,6135677
9/21/22,Poland,51.9194,19.1451,6258678,0,117391,6141287
9/22/22,Poland,51.9194,19.1451,6263616,0,117412,6146204
9/23/22,Poland,51.9194,19.1451,6268049,0,117431,6150618
9/24/22,Poland,51.9194,19.1451,6272576,0,117456,6155120
9/25/22,Poland,51.9194,19.1451,6273317,0,117456,6155861
9/26/22,Poland,51.9194,19.1451,6274048,0,117456,6156592
9/27/22,Poland,51.9194,19.1451,6280530,0,117481,6163049
9/28/22,Poland,51.9194,19.1451,6285403,0,117509,6167894
9/29/22,Poland,51.9194,19.1451,6289672,0,117539,6172133
9/30/22,Poland,51.9194,19.1451,6293558,0,117569,6175989
10/1/22,Poland,51.9194,19.1451,6297123,0,117598,6179525
10/2/22,Poland,51.9194,19.1451,6297431,0,117598,6179833
10/3/22,Poland,51.9194,19.1451,6297656,0,117598,6180058
10/4/22,Poland,51.9194,19.1451,6302275,0,117631,6184644
10/5/22,Poland,51.9194,19.1451,6305467,0,117660,6187807
10/6/22,Poland,51.9194,19.1451,6308347,0,117702,6190645
10/7/22,Poland,51.9194,19.1451,6310973,0,117743,6193230
10/8/22,Poland,51.9194,19.1451,6314705,0,117756,6196949
10/9/22,Poland,51.9194,19.1451,6315166,0,117756,6197410
10/10/22,Poland,51.9194,19.1451,6315552,0,117756,6197796
10/11/22,Poland,51.9194,19.1451,6318840,0,117801,6201039
10/12/22,Poland,51.9194,19.1451,6321200,0,117823,6203377
10/13/22,Poland,51.9194,19.1451,6323108,0,117847,6205261
10/14/22,Poland,51.9194,19.1451,6324853,0,117869,6206984
10/15/22,Poland,51.9194,19.1451,6326446,0,117900,6208546
10/16/22,Poland,51.9194,19.1451,6326748,0,117900,6208848
10/17/22,Poland,51.9194,19.1451,6327033,0,117900,6209133
10/18/22,Poland,51.9194,19.1451,6329293,0,117931,6211362
10/19/22,Poland,51.9194,19.1451,6330904,0,117973,6212931
10/20/22,Poland,51.9194,19.1451,6332422,0,117991,6214431
10/21/22,Poland,51.9194,19.1451,6333591,0,118015,6215576
10/22/22,Poland,51.9194,19.1451,6334706,0,118029,6216677
10/23/22,Poland,51.9194,19.1451,6334887,0,118029,6216858
10/24/22,Poland,51.9194,19.1451,6335060,0,118029,6217031
10/25/22,Poland,51.9194,19.1451,6336534,0,118050,6218484
10/26/22,Poland,51.9194,19.1451,6337557,0,118073,6219484
10/27/22,Poland,51.9194,19.1451,6338531,0,118095,6220436
10/28/22,Poland,51.9194,19.1451,6339321,0,118107,6221214
10/29/22,Poland,51.9194,19.1451,6340127,0,118124,6222003
10/30/22,Poland,51.9194,19.1451,6340285,0,118124,6222161
10/31/22,Poland,51.9194,19.1451,6340435,0,118124,6222311
11/1/22,Poland,51.9194,19.1451,6341296,0,118131,6223165
11/2/22,Poland,51.9194,19.1451,6341449,0,118131,6223318
11/3/22,Poland,51.9194,19.1451,6342404,0,118143,6224261
11/4/22,Poland,51.9194,19.1451,6343097,0,118157,6224940
11/5/22,Poland,51.9194,19.1451,6343675,0,118170,6225505
11/6/22,Poland,51.9194,19.1451,6343775,0,118170,6225605
11/7/22,Poland,51.9194,19.1451,6343905,0,118170,6225735
11/8/22,Poland,51.9194,19.1451,6344651,0,118178,6226473
11/9/22,Poland,51.9194,19.1451,6345188,0,118195,6226993
11/10/22,Poland,51.9194,19.1451,6345679,0,118205,6227474
11/11/22,Poland,51.9194,19.1451,6346155,0,118210,6227945
11/12/22,Poland,51.9194,19.1451,6346228,0,118210,6228018
11/13/22,Poland,51.9194,19.1451,6346312,0,118210,6228102
11/14/22,Poland,51.9194,19.1451,6346397,0,118210,6228187
11/15/22,Poland,51.9194,19.1451,6347085,0,118227,6228858
11/16/22,Poland,51.9194,19.1451,6347590,0,118242,6229348
11/17/22,Poland,51.9194,19.1451,6348022,0,118252,6229770
11/18/22,Poland,51.9194,19.1451,6348380,0,118267,6230113
11/19/22,Poland,51.9194,19.1451,6348771,0,118274,6230497
11/20/22,Poland,51.9194,19.1451,6348842,0,118274,6230568
11/21/22,Poland,51.9194,19.1451,6348928,0,118274,6230654
11/22/22,Poland,51.9194,19.1451,6349525,0,118282,6231243
11/23/22,Poland,51.9194,19.1451,6349973,0,118292,6231681
11/24/22,Poland,51.9194,19.1451,6350427,0,118296,6232131
11/25/22,Poland,51.9194,19.1451,6350817,0,118298,6232519
11/26/22,Poland,51.9194,19.1451,6351237,0,118306,6232931
11/27/22,Poland,51.9194,19.1451,6351315,0,118306,6233009
11/28/22,Poland,51.9194,19.1451,6351408,0,118306,6233102
11/29/22,Poland,51.9194,19.1451,6352170,0,118313,6233857
11/30/22,Poland,51.9194,19.1451,6352755,0,118319,6234436
12/1/22,Poland,51.9194,19.1451,6353310,0,118328,6234982
12/2/22,Poland,51.9194,19.1451,6353850,0,118332,6235518
12/3/22,Poland,51.9194,19.1451,6354298,0,118340,6235958
12/4/22,Poland,51.9194,19.1451,6354402,0,118340,6236062
12/5/22,Poland,51.9194,19.1451,6354511,0,118340,6236171
12/6/22,Poland,51.9194,19.1451,6355424,0,118347,6237077
12/7/22,Poland,51.9194,19.1451,6356082,0,118350,6237732
12/8/22,Poland,51.9194,19.1451,6356729,0,118365,6238364
12/9/22,Poland,51.9194,19.1451,6356979,0,118371,6238608
12/10/22,Poland,51.9194,19.1451,6357366,0,118382,6238984
12/11/22,Poland,51.9194,19.1451,6357489,0,118382,6239107
12/12/22,Poland,51.9194,19.1451,6357700,0,118382,6239318
12/13/22,Poland,51.9194,19.1451,6358786,0,118389,6240397
12/14/22,Poland,51.9194,19.1451,6359556,0,118395,6241161
12/15/22,Poland,51.9194,19.1451,6360240,0,118412,6241828
12/16/22,Poland,51.9194,19.1451,6360843,0,118419,6242424
12/17/22,Poland,51.9194,19.1451,6361464,0,118429,6243035
1/1/22,Portugal,39.3999,-8.2245,1412936,0,18976,1393960
1/2/22,Portugal,39.3999,-8.2245,1424016,0,18990,1405026
1/3/22,Portugal,39.3999,-8.2245,1434570,0,19000,1415570
1/4/22,Portugal,39.3999,-8.2245,1460406,0,19015,1441391
1/5/22,Portugal,39.3999,-8.2245,1499976,0,19029,1480947
1/6/22,Portugal,39.3999,-8.2245,1539050,0,19054,1519996
1/7/22,Portugal,39.3999,-8.2245,1577784,0,19071,1558713
1/8/22,Portugal,39.3999,-8.2245,1613427,0,19091,1594336
1/9/22,Portugal,39.3999,-8.2245,1639846,0,19113,1620733
1/10/22,Portugal,39.3999,-8.2245,1660058,0,19133,1640925
1/11/22,Portugal,39.3999,-8.2245,1693398,0,19161,1674237
1/12/22,Portugal,39.3999,-8.2245,1734343,0,19181,1715162
1/13/22,Portugal,39.3999,-8.2245,1774477,0,19203,1755274
1/14/22,Portugal,39.3999,-8.2245,1814567,0,19237,1795330
1/15/22,Portugal,39.3999,-8.2245,1852703,0,19270,1833433
1/16/22,Portugal,39.3999,-8.2245,1884974,0,19303,1865671
1/17/22,Portugal,39.3999,-8.2245,1906891,0,19334,1887557
1/18/22,Portugal,39.3999,-8.2245,1950620,0,19380,1931240
1/19/22,Portugal,39.3999,-8.2245,2003169,0,19413,1983756
1/20/22,Portugal,39.3999,-8.2245,2059595,0,19447,2040148
1/21/22,Portugal,39.3999,-8.2245,2118125,0,19496,2098629
1/22/22,Portugal,39.3999,-8.2245,2176256,0,19539,2156717
1/23/22,Portugal,39.3999,-8.2245,2221825,0,19569,2202256
1/24/22,Portugal,39.3999,-8.2245,2254583,0,19613,2234970
1/25/22,Portugal,39.3999,-8.2245,2312240,0,19661,2292579
1/26/22,Portugal,39.3999,-8.2245,2377818,0,19703,2358115
1/27/22,Portugal,39.3999,-8.2245,2443524,0,19744,2423780
1/28/22,Portugal,39.3999,-8.2245,2507357,0,19788,2487569
1/29/22,Portugal,39.3999,-8.2245,2566551,0,19827,2546724
1/30/22,Portugal,39.3999,-8.2245,2611886,0,19856,2592030
1/31/22,Portugal,39.3999,-8.2245,2689167,0,19905,2669262
2/1/22,Portugal,39.3999,-8.2245,2718138,0,19968,2698170
2/2/22,Portugal,39.3999,-8.2245,2771842,0,20024,2751818
2/3/22,Portugal,39.3999,-8.2245,2829347,0,20077,2809270
2/4/22,Portugal,39.3999,-8.2245,2882659,0,20127,2862532
2/5/22,Portugal,39.3999,-8.2245,2932680,0,20171,2912509
2/6/22,Portugal,39.3999,-8.2245,2976771,0,20222,2956549
2/7/22,Portugal,39.3999,-8.2245,3009717,0,20258,2989459
2/8/22,Portugal,39.3999,-8.2245,3027626,0,20302,3007324
2/9/22,Portugal,39.3999,-8.2245,3060477,0,20354,3040123
2/10/22,Portugal,39.3999,-8.2245,3096708,0,20401,3076307
2/11/22,Portugal,39.3999,-8.2245,3126295,0,20442,3105853
2/12/22,Portugal,39.3999,-8.2245,3152099,0,20492,3131607
2/13/22,Portugal,39.3999,-8.2245,3172961,0,20530,3152431
2/14/22,Portugal,39.3999,-8.2245,3189891,0,20565,3169326
2/15/22,Portugal,39.3999,-8.2245,3198779,0,20620,3178159
2/16/22,Portugal,39.3999,-8.2245,3218215,0,20666,3197549
2/17/22,Portugal,39.3999,-8.2245,3239570,0,20708,3218862
2/18/22,Portugal,39.3999,-8.2245,3257373,0,20759,3236614
2/19/22,Portugal,39.3999,-8.2245,3274118,0,20796,3253322
2/20/22,Portugal,39.3999,-8.2245,3289278,0,20831,3268447
2/21/22,Portugal,39.3999,-8.2245,3299337,0,20866,3278471
2/22/22,Portugal,39.3999,-8.2245,3305484,0,20894,3284590
2/23/22,Portugal,39.3999,-8.2245,3319787,0,20922,3298865
2/24/22,Portugal,39.3999,-8.2245,3339225,0,20941,3318284
2/25/22,Portugal,39.3999,-8.2245,3351880,0,20973,3330907
2/26/22,Portugal,39.3999,-8.2245,3363373,0,21001,3342372
2/27/22,Portugal,39.3999,-8.2245,3373936,0,21039,3352897
2/28/22,Portugal,39.3999,-8.2245,3381602,0,21063,3360539
3/1/22,Portugal,39.3999,-8.2245,3385947,0,21086,3364861
3/2/22,Portugal,39.3999,-8.2245,3397759,0,21111,3376648
3/3/22,Portugal,39.3999,-8.2245,3408227,0,21141,3387086
3/4/22,Portugal,39.3999,-8.2245,3421312,0,21162,3400150
3/5/22,Portugal,39.3999,-8.2245,3437003,0,21182,3415821
3/6/22,Portugal,39.3999,-8.2245,3452144,0,21199,3430945
3/7/22,Portugal,39.3999,-8.2245,3462783,0,21216,3441567
3/8/22,Portugal,39.3999,-8.2245,3468709,0,21248,3447461
3/9/22,Portugal,39.3999,-8.2245,3484914,0,21267,3463647
3/10/22,Portugal,39.3999,-8.2245,3500549,0,21285,3479264
3/11/22,Portugal,39.3999,-8.2245,3514241,0,21285,3492956
3/12/22,Portugal,39.3999,-8.2245,3527608,0,21285,3506323
3/13/22,Portugal,39.3999,-8.2245,3540541,0,21285,3519256
3/14/22,Portugal,39.3999,-8.2245,3549564,0,21342,3528222
3/15/22,Portugal,39.3999,-8.2245,3554472,0,21342,3533130
3/16/22,Portugal,39.3999,-8.2245,3569220,0,21342,3547878
3/17/22,Portugal,39.3999,-8.2245,3584504,0,21342,3563162
3/18/22,Portugal,39.3999,-8.2245,3598152,0,21408,3576744
3/19/22,Portugal,39.3999,-8.2245,3610906,0,21408,3589498
3/20/22,Portugal,39.3999,-8.2245,3622880,0,21408,3601472
3/21/22,Portugal,39.3999,-8.2245,3631435,0,21408,3610027
3/22/22,Portugal,39.3999,-8.2245,3635880,0,21408,3614472
3/23/22,Portugal,39.3999,-8.2245,3650572,0,21408,3629164
3/24/22,Portugal,39.3999,-8.2245,3665551,0,21408,3644143
3/25/22,Portugal,39.3999,-8.2245,3678412,0,21545,3656867
3/26/22,Portugal,39.3999,-8.2245,3689786,0,21545,3668241
3/27/22,Portugal,39.3999,-8.2245,3701665,0,21545,3680120
3/28/22,Portugal,39.3999,-8.2245,3709342,0,21545,3687797
3/29/22,Portugal,39.3999,-8.2245,3713333,0,21545,3691788
3/30/22,Portugal,39.3999,-8.2245,3726043,0,21545,3704498
3/31/22,Portugal,39.3999,-8.2245,3738919,0,21695,3717224
4/1/22,Portugal,39.3999,-8.2245,3750596,0,21716,3728880
4/2/22,Portugal,39.3999,-8.2245,3761667,0,21716,3739951
4/3/22,Portugal,39.3999,-8.2245,3771485,0,21716,3749769
4/4/22,Portugal,39.3999,-8.2245,3778225,0,21733,3756492
4/5/22,Portugal,39.3999,-8.2245,3781692,0,21789,3759903
4/6/22,Portugal,39.3999,-8.2245,3792576,0,21813,3770763
4/7/22,Portugal,39.3999,-8.2245,3803856,0,21827,3782029
4/8/22,Portugal,39.3999,-8.2245,3813931,0,21874,3792057
4/9/22,Portugal,39.3999,-8.2245,3824253,0,21874,3802379
4/10/22,Portugal,39.3999,-8.2245,3834105,0,21874,3812231
4/11/22,Portugal,39.3999,-8.2245,3841334,0,21935,3819399
4/12/22,Portugal,39.3999,-8.2245,3845066,0,21958,3823108
4/13/22,Portugal,39.3999,-8.2245,3857251,0,21970,3835281
4/14/22,Portugal,39.3999,-8.2245,3869796,0,21993,3847803
4/15/22,Portugal,39.3999,-8.2245,3881346,0,21993,3859353
4/16/22,Portugal,39.3999,-8.2245,3893109,0,21993,3871116
4/17/22,Portugal,39.3999,-8.2245,3898232,0,21993,3876239
4/18/22,Portugal,39.3999,-8.2245,3905880,0,21993,3883887
4/19/22,Portugal,39.3999,-8.2245,3909157,0,22088,3887069
4/20/22,Portugal,39.3999,-8.2245,3922227,0,22106,3900121
4/21/22,Portugal,39.3999,-8.2245,3936432,0,22127,3914305
4/22/22,Portugal,39.3999,-8.2245,3948030,0,22148,3925882
4/23/22,Portugal,39.3999,-8.2245,3959702,0,22162,3937540
4/24/22,Portugal,39.3999,-8.2245,3969315,0,22162,3947153
4/25/22,Portugal,39.3999,-8.2245,3976259,0,22162,3954097
4/26/22,Portugal,39.3999,-8.2245,3979984,0,22162,3957822
4/27/22,Portugal,39.3999,-8.2245,3984766,0,22226,3962540
4/28/22,Portugal,39.3999,-8.2245,3999112,0,22248,3976864
4/29/22,Portugal,39.3999,-8.2245,4013640,0,22280,3991360
4/30/22,Portugal,39.3999,-8.2245,4027684,0,22280,4005404
5/1/22,Portugal,39.3999,-8.2245,4041278,0,22280,4018998
5/2/22,Portugal,39.3999,-8.2245,4050283,0,22280,4028003
5/3/22,Portugal,39.3999,-8.2245,4055001,0,22337,4032664
5/4/22,Portugal,39.3999,-8.2245,4068606,0,22355,4046251
5/5/22,Portugal,39.3999,-8.2245,4085189,0,22381,4062808
5/6/22,Portugal,39.3999,-8.2245,4100844,0,22397,4078447
5/7/22,Portugal,39.3999,-8.2245,4118439,0,22420,4096019
5/8/22,Portugal,39.3999,-8.2245,4135703,0,22420,4113283
5/9/22,Portugal,39.3999,-8.2245,4149241,0,22420,4126821
5/10/22,Portugal,39.3999,-8.2245,4156577,0,22472,4134105
5/11/22,Portugal,39.3999,-8.2245,4179518,0,22500,4157018
5/12/22,Portugal,39.3999,-8.2245,4207177,0,22528,4184649
5/13/22,Portugal,39.3999,-8.2245,4235153,0,22528,4212625
5/14/22,Portugal,39.3999,-8.2245,4264908,0,22583,4242325
5/15/22,Portugal,39.3999,-8.2245,4289314,0,22583,4266731
5/16/22,Portugal,39.3999,-8.2245,4308574,0,22583,4285991
5/17/22,Portugal,39.3999,-8.2245,4317675,0,22665,4295010
5/18/22,Portugal,39.3999,-8.2245,4356248,0,22665,4333583
5/19/22,Portugal,39.3999,-8.2245,4390672,0,22722,4367950
5/20/22,Portugal,39.3999,-8.2245,4422533,0,22754,4399779
5/21/22,Portugal,39.3999,-8.2245,4422533,0,22754,4399779
5/22/22,Portugal,39.3999,-8.2245,4422533,0,22754,4399779
5/23/22,Portugal,39.3999,-8.2245,4453294,0,22784,4430510
5/24/22,Portugal,39.3999,-8.2245,4508817,0,22885,4485932
5/25/22,Portugal,39.3999,-8.2245,4544317,0,22926,4521391
5/26/22,Portugal,39.3999,-8.2245,4544317,0,22926,4521391
5/27/22,Portugal,39.3999,-8.2245,4606051,0,22981,4583070
5/28/22,Portugal,39.3999,-8.2245,4606051,0,22981,4583070
5/29/22,Portugal,39.3999,-8.2245,4606051,0,22981,4583070
5/30/22,Portugal,39.3999,-8.2245,4632100,0,23014,4609086
5/31/22,Portugal,39.3999,-8.2245,4683018,0,23115,4659903
6/1/22,Portugal,39.3999,-8.2245,4717243,0,23150,4694093
6/2/22,Portugal,39.3999,-8.2245,4749137,0,23190,4725947
6/3/22,Portugal,39.3999,-8.2245,4775529,0,23243,4752286
6/4/22,Portugal,39.3999,-8.2245,4775529,0,23243,4752286
6/5/22,Portugal,39.3999,-8.2245,4775529,0,23243,4752286
6/6/22,Portugal,39.3999,-8.2245,4775529,0,23243,4752286
6/7/22,Portugal,39.3999,-8.2245,4846230,0,23411,4822819
6/8/22,Portugal,39.3999,-8.2245,4894982,0,23488,4871494
6/9/22,Portugal,39.3999,-8.2245,4894982,0,23489,4871493
6/10/22,Portugal,39.3999,-8.2245,4917127,0,23531,4893596
6/11/22,Portugal,39.3999,-8.2245,4917127,0,23531,4893596
6/12/22,Portugal,39.3999,-8.2245,4917127,0,23531,4893596
6/13/22,Portugal,39.3999,-8.2245,4917127,0,23531,4893596
6/14/22,Portugal,39.3999,-8.2245,4985742,0,23707,4962035
6/15/22,Portugal,39.3999,-8.2245,5005783,0,23746,4982037
6/16/22,Portugal,39.3999,-8.2245,5005783,0,23746,4982037
6/17/22,Portugal,39.3999,-8.2245,5005783,0,23746,4982037
6/18/22,Portugal,39.3999,-8.2245,5005783,0,23746,4982037
6/19/22,Portugal,39.3999,-8.2245,5005783,0,23746,4982037
6/20/22,Portugal,39.3999,-8.2245,5062552,0,23924,5038628
6/21/22,Portugal,39.3999,-8.2245,5080587,0,23946,5056641
6/22/22,Portugal,39.3999,-8.2245,5095959,0,23967,5071992
6/23/22,Portugal,39.3999,-8.2245,5109412,0,23995,5085417
6/24/22,Portugal,39.3999,-8.2245,5120970,0,24013,5096957
6/25/22,Portugal,39.3999,-8.2245,5120970,0,24013,5096957
6/26/22,Portugal,39.3999,-8.2245,5120970,0,24013,5096957
6/27/22,Portugal,39.3999,-8.2245,5138659,0,24061,5114598
6/28/22,Portugal,39.3999,-8.2245,5154296,0,24082,5130214
6/29/22,Portugal,39.3999,-8.2245,5160861,0,24121,5136740
6/30/22,Portugal,39.3999,-8.2245,5171236,0,24149,5147087
7/1/22,Portugal,39.3999,-8.2245,5171236,0,24149,5147087
7/2/22,Portugal,39.3999,-8.2245,5171236,0,24149,5147087
7/3/22,Portugal,39.3999,-8.2245,5171236,0,24149,5147087
7/4/22,Portugal,39.3999,-8.2245,5171236,0,24149,5147087
7/5/22,Portugal,39.3999,-8.2245,5214701,0,24236,5190465
7/6/22,Portugal,39.3999,-8.2245,5225205,0,24253,5200952
7/7/22,Portugal,39.3999,-8.2245,5234600,0,24273,5210327
7/8/22,Portugal,39.3999,-8.2245,5242121,0,24291,5217830
7/9/22,Portugal,39.3999,-8.2245,5242121,0,24291,5217830
7/10/22,Portugal,39.3999,-8.2245,5242121,0,24291,5217830
7/11/22,Portugal,39.3999,-8.2245,5257536,0,24346,5233190
7/12/22,Portugal,39.3999,-8.2245,5266454,0,24359,5242095
7/13/22,Portugal,39.3999,-8.2245,5273845,0,24369,5249476
7/14/22,Portugal,39.3999,-8.2245,5273845,0,24381,5249464
7/15/22,Portugal,39.3999,-8.2245,5273845,0,24381,5249464
7/16/22,Portugal,39.3999,-8.2245,5273845,0,24381,5249464
7/17/22,Portugal,39.3999,-8.2245,5273845,0,24381,5249464
7/18/22,Portugal,39.3999,-8.2245,5294315,0,24474,5269841
7/19/22,Portugal,39.3999,-8.2245,5301289,0,24487,5276802
7/20/22,Portugal,39.3999,-8.2245,5307141,0,24503,5282638
7/21/22,Portugal,39.3999,-8.2245,5312553,0,24513,5288040
7/22/22,Portugal,39.3999,-8.2245,5317004,0,24528,5292476
7/23/22,Portugal,39.3999,-8.2245,5317004,0,24528,5292476
7/24/22,Portugal,39.3999,-8.2245,5317004,0,24528,5292476
7/25/22,Portugal,39.3999,-8.2245,5323725,0,24555,5299170
7/26/22,Portugal,39.3999,-8.2245,5329332,0,24564,5304768
7/27/22,Portugal,39.3999,-8.2245,5333656,0,24576,5309080
7/28/22,Portugal,39.3999,-8.2245,5337121,0,24587,5312534
7/29/22,Portugal,39.3999,-8.2245,5340612,0,24592,5316020
7/30/22,Portugal,39.3999,-8.2245,5340612,0,24592,5316020
7/31/22,Portugal,39.3999,-8.2245,5340612,0,24592,5316020
8/1/22,Portugal,39.3999,-8.2245,5345143,0,24623,5320520
8/2/22,Portugal,39.3999,-8.2245,5349218,0,24635,5324583
8/3/22,Portugal,39.3999,-8.2245,5353103,0,24645,5328458
8/4/22,Portugal,39.3999,-8.2245,5356285,0,24656,5331629
8/5/22,Portugal,39.3999,-8.2245,5359624,0,24664,5334960
8/6/22,Portugal,39.3999,-8.2245,5359624,0,24664,5334960
8/7/22,Portugal,39.3999,-8.2245,5359624,0,24664,5334960
8/8/22,Portugal,39.3999,-8.2245,5359624,0,24670,5334954
8/9/22,Portugal,39.3999,-8.2245,5367395,0,24707,5342688
8/10/22,Portugal,39.3999,-8.2245,5370600,0,24714,5345886
8/11/22,Portugal,39.3999,-8.2245,5373479,0,24721,5348758
8/12/22,Portugal,39.3999,-8.2245,5376433,0,24722,5351711
8/13/22,Portugal,39.3999,-8.2245,5376433,0,24722,5351711
8/14/22,Portugal,39.3999,-8.2245,5376433,0,24722,5351711
8/15/22,Portugal,39.3999,-8.2245,5376433,0,24726,5351707
8/16/22,Portugal,39.3999,-8.2245,5381599,0,24754,5356845
8/17/22,Portugal,39.3999,-8.2245,5385702,0,24762,5360940
8/18/22,Portugal,39.3999,-8.2245,5388758,0,24764,5363994
8/19/22,Portugal,39.3999,-8.2245,5391747,0,24772,5366975
8/20/22,Portugal,39.3999,-8.2245,5391747,0,24772,5366975
8/21/22,Portugal,39.3999,-8.2245,5391747,0,24772,5366975
8/22/22,Portugal,39.3999,-8.2245,5391747,0,24775,5366972
8/23/22,Portugal,39.3999,-8.2245,5399857,0,24797,5375060
8/24/22,Portugal,39.3999,-8.2245,5399857,0,24797,5375060
8/25/22,Portugal,39.3999,-8.2245,5406095,0,24810,5381285
8/26/22,Portugal,39.3999,-8.2245,5409185,0,24813,5384372
8/27/22,Portugal,39.3999,-8.2245,5409185,0,24813,5384372
8/28/22,Portugal,39.3999,-8.2245,5409185,0,24813,5384372
8/29/22,Portugal,39.3999,-8.2245,5413173,0,24839,5388334
8/30/22,Portugal,39.3999,-8.2245,5417101,0,24845,5392256
8/31/22,Portugal,39.3999,-8.2245,5420140,0,24855,5395285
9/1/22,Portugal,39.3999,-8.2245,5420140,0,24857,5395283
9/2/22,Portugal,39.3999,-8.2245,5425891,0,24865,5401026
9/3/22,Portugal,39.3999,-8.2245,5425891,0,24865,5401026
9/4/22,Portugal,39.3999,-8.2245,5425891,0,24865,5401026
9/5/22,Portugal,39.3999,-8.2245,5429340,0,24886,5404454
9/6/22,Portugal,39.3999,-8.2245,5433073,0,24893,5408180
9/7/22,Portugal,39.3999,-8.2245,5435782,0,24899,5410883
9/8/22,Portugal,39.3999,-8.2245,5438351,0,24905,5413446
9/9/22,Portugal,39.3999,-8.2245,5440953,0,24909,5416044
9/10/22,Portugal,39.3999,-8.2245,5440953,0,24909,5416044
9/11/22,Portugal,39.3999,-8.2245,5440953,0,24909,5416044
9/12/22,Portugal,39.3999,-8.2245,5444993,0,24924,5420069
9/13/22,Portugal,39.3999,-8.2245,5448713,0,24931,5423782
9/14/22,Portugal,39.3999,-8.2245,5451798,0,24942,5426856
9/15/22,Portugal,39.3999,-8.2245,5454001,0,24947,5429054
9/16/22,Portugal,39.3999,-8.2245,5456778,0,24951,5431827
9/17/22,Portugal,39.3999,-8.2245,5456778,0,24951,5431827
9/18/22,Portugal,39.3999,-8.2245,5456778,0,24951,5431827
9/19/22,Portugal,39.3999,-8.2245,5461888,0,24966,5436922
9/20/22,Portugal,39.3999,-8.2245,5466249,0,24970,5441279
9/21/22,Portugal,39.3999,-8.2245,5469808,0,24972,5444836
9/22/22,Portugal,39.3999,-8.2245,5472957,0,24984,5447973
9/23/22,Portugal,39.3999,-8.2245,5476059,0,24991,5451068
9/24/22,Portugal,39.3999,-8.2245,5476059,0,24991,5451068
9/25/22,Portugal,39.3999,-8.2245,5476059,0,24991,5451068
9/26/22,Portugal,39.3999,-8.2245,5480864,0,25008,5455856
9/27/22,Portugal,39.3999,-8.2245,5481669,0,25012,5456657
9/28/22,Portugal,39.3999,-8.2245,5484946,0,25017,5459929
9/29/22,Portugal,39.3999,-8.2245,5490639,0,25024,5465615
9/30/22,Portugal,39.3999,-8.2245,5493540,0,25031,5468509
10/1/22,Portugal,39.3999,-8.2245,5493540,0,25031,5468509
10/2/22,Portugal,39.3999,-8.2245,5493540,0,25031,5468509
10/3/22,Portugal,39.3999,-8.2245,5498126,0,25058,5473068
10/4/22,Portugal,39.3999,-8.2245,5499469,0,25063,5474406
10/5/22,Portugal,39.3999,-8.2245,5500613,0,25070,5475543
10/6/22,Portugal,39.3999,-8.2245,5501103,0,25075,5476028
10/7/22,Portugal,39.3999,-8.2245,5501103,0,25075,5476028
10/8/22,Portugal,39.3999,-8.2245,5501103,0,25075,5476028
10/9/22,Portugal,39.3999,-8.2245,5501103,0,25075,5476028
10/10/22,Portugal,39.3999,-8.2245,5502208,0,25087,5477121
10/11/22,Portugal,39.3999,-8.2245,5505654,0,25106,5480548
10/12/22,Portugal,39.3999,-8.2245,5506988,0,25114,5481874
10/13/22,Portugal,39.3999,-8.2245,5508231,0,25119,5483112
10/14/22,Portugal,39.3999,-8.2245,5509424,0,25125,5484299
10/15/22,Portugal,39.3999,-8.2245,5509424,0,25125,5484299
10/16/22,Portugal,39.3999,-8.2245,5509424,0,25125,5484299
10/17/22,Portugal,39.3999,-8.2245,5509424,0,25125,5484299
10/18/22,Portugal,39.3999,-8.2245,5509424,0,25128,5484296
10/19/22,Portugal,39.3999,-8.2245,5509424,0,25128,5484296
10/20/22,Portugal,39.3999,-8.2245,5509424,0,25128,5484296
10/21/22,Portugal,39.3999,-8.2245,5509424,0,25128,5484296
10/22/22,Portugal,39.3999,-8.2245,5509424,0,25128,5484296
10/23/22,Portugal,39.3999,-8.2245,5509424,0,25128,5484296
10/24/22,Portugal,39.3999,-8.2245,5509424,0,25128,5484296
10/25/22,Portugal,39.3999,-8.2245,5517061,0,25203,5491858
10/26/22,Portugal,39.3999,-8.2245,5518155,0,25209,5492946
10/27/22,Portugal,39.3999,-8.2245,5518155,0,25209,5492946
10/28/22,Portugal,39.3999,-8.2245,5518155,0,25209,5492946
10/29/22,Portugal,39.3999,-8.2245,5518155,0,25209,5492946
10/30/22,Portugal,39.3999,-8.2245,5520731,0,25228,5495503
10/31/22,Portugal,39.3999,-8.2245,5520731,0,25228,5495503
11/1/22,Portugal,39.3999,-8.2245,5520731,0,25228,5495503
11/2/22,Portugal,39.3999,-8.2245,5520731,0,25228,5495503
11/3/22,Portugal,39.3999,-8.2245,5520731,0,25228,5495503
11/4/22,Portugal,39.3999,-8.2245,5520731,0,25228,5495503
11/5/22,Portugal,39.3999,-8.2245,5520731,0,25228,5495503
11/6/22,Portugal,39.3999,-8.2245,5525459,0,25290,5500169
11/7/22,Portugal,39.3999,-8.2245,5527261,0,25312,5501949
11/8/22,Portugal,39.3999,-8.2245,5527261,0,25312,5501949
11/9/22,Portugal,39.3999,-8.2245,5528365,0,25319,5503046
11/10/22,Portugal,39.3999,-8.2245,5528365,0,25319,5503046
11/11/22,Portugal,39.3999,-8.2245,5528365,0,25319,5503046
11/12/22,Portugal,39.3999,-8.2245,5531172,0,25339,5505833
11/13/22,Portugal,39.3999,-8.2245,5531172,0,25339,5505833
11/14/22,Portugal,39.3999,-8.2245,5532964,0,25365,5507599
11/15/22,Portugal,39.3999,-8.2245,5532964,0,25365,5507599
11/16/22,Portugal,39.3999,-8.2245,5532964,0,25365,5507599
11/17/22,Portugal,39.3999,-8.2245,5532964,0,25365,5507599
11/18/22,Portugal,39.3999,-8.2245,5537108,0,25395,5511713
11/19/22,Portugal,39.3999,-8.2245,5537108,0,25395,5511713
11/20/22,Portugal,39.3999,-8.2245,5537108,0,25395,5511713
11/21/22,Portugal,39.3999,-8.2245,5537108,0,25395,5511713
11/22/22,Portugal,39.3999,-8.2245,5537108,0,25395,5511713
11/23/22,Portugal,39.3999,-8.2245,5537108,0,25395,5511713
11/24/22,Portugal,39.3999,-8.2245,5537108,0,25395,5511713
11/25/22,Portugal,39.3999,-8.2245,5542265,0,25450,5516815
11/26/22,Portugal,39.3999,-8.2245,5542265,0,25450,5516815
11/27/22,Portugal,39.3999,-8.2245,5542265,0,25450,5516815
11/28/22,Portugal,39.3999,-8.2245,5542265,0,25450,5516815
11/29/22,Portugal,39.3999,-8.2245,5542265,0,25450,5516815
11/30/22,Portugal,39.3999,-8.2245,5542265,0,25450,5516815
12/1/22,Portugal,39.3999,-8.2245,5542265,0,25450,5516815
12/2/22,Portugal,39.3999,-8.2245,5546290,0,25517,5520773
12/3/22,Portugal,39.3999,-8.2245,5546290,0,25517,5520773
12/4/22,Portugal,39.3999,-8.2245,5546290,0,25517,5520773
12/5/22,Portugal,39.3999,-8.2245,5546290,0,25517,5520773
12/6/22,Portugal,39.3999,-8.2245,5546290,0,25517,5520773
12/7/22,Portugal,39.3999,-8.2245,5546290,0,25517,5520773
12/8/22,Portugal,39.3999,-8.2245,5549479,0,25584,5523895
12/9/22,Portugal,39.3999,-8.2245,5549479,0,25584,5523895
12/10/22,Portugal,39.3999,-8.2245,5549479,0,25584,5523895
12/11/22,Portugal,39.3999,-8.2245,5549479,0,25584,5523895
12/12/22,Portugal,39.3999,-8.2245,5549479,0,25584,5523895
12/13/22,Portugal,39.3999,-8.2245,5549479,0,25584,5523895
12/14/22,Portugal,39.3999,-8.2245,5551364,0,25643,5525721
12/15/22,Portugal,39.3999,-8.2245,5551364,0,25643,5525721
12/16/22,Portugal,39.3999,-8.2245,5551364,0,25643,5525721
12/17/22,Portugal,39.3999,-8.2245,5551364,0,25643,5525721
1/1/22,Qatar,25.3548,51.1839,251361,0,618,250743
1/2/22,Qatar,25.3548,51.1839,252359,0,618,251741
1/3/22,Qatar,25.3548,51.1839,253536,0,618,252918
1/4/22,Qatar,25.3548,51.1839,255231,0,618,254613
1/5/22,Qatar,25.3548,51.1839,257504,0,618,256886
1/6/22,Qatar,25.3548,51.1839,260283,0,618,259665
1/7/22,Qatar,25.3548,51.1839,263475,0,618,262857
1/8/22,Qatar,25.3548,51.1839,266962,0,618,266344
1/9/22,Qatar,25.3548,51.1839,270651,0,618,270033
1/10/22,Qatar,25.3548,51.1839,274529,0,619,273910
1/11/22,Qatar,25.3548,51.1839,278698,0,621,278077
1/12/22,Qatar,25.3548,51.1839,282904,0,621,282283
1/13/22,Qatar,25.3548,51.1839,287091,0,623,286468
1/14/22,Qatar,25.3548,51.1839,291214,0,623,290591
1/15/22,Qatar,25.3548,51.1839,295221,0,624,294597
1/16/22,Qatar,25.3548,51.1839,299242,0,626,298616
1/17/22,Qatar,25.3548,51.1839,303240,0,627,302613
1/18/22,Qatar,25.3548,51.1839,307056,0,630,306426
1/19/22,Qatar,25.3548,51.1839,310779,0,631,310148
1/20/22,Qatar,25.3548,51.1839,314073,0,632,313441
1/21/22,Qatar,25.3548,51.1839,317277,0,632,316645
1/22/22,Qatar,25.3548,51.1839,320364,0,633,319731
1/23/22,Qatar,25.3548,51.1839,323345,0,634,322711
1/24/22,Qatar,25.3548,51.1839,326093,0,636,325457
1/25/22,Qatar,25.3548,51.1839,328644,0,637,328007
1/26/22,Qatar,25.3548,51.1839,330848,0,638,330210
1/27/22,Qatar,25.3548,51.1839,332800,0,640,332160
1/28/22,Qatar,25.3548,51.1839,334543,0,641,333902
1/29/22,Qatar,25.3548,51.1839,336081,0,645,335436
1/30/22,Qatar,25.3548,51.1839,337638,0,645,336993
1/31/22,Qatar,25.3548,51.1839,339147,0,645,338502
2/1/22,Qatar,25.3548,51.1839,340383,0,647,339736
2/2/22,Qatar,25.3548,51.1839,341628,0,649,340979
2/3/22,Qatar,25.3548,51.1839,342811,0,651,342160
2/4/22,Qatar,25.3548,51.1839,343808,0,652,343156
2/5/22,Qatar,25.3548,51.1839,344711,0,652,344059
2/6/22,Qatar,25.3548,51.1839,345623,0,652,344971
2/7/22,Qatar,25.3548,51.1839,346546,0,652,345894
2/8/22,Qatar,25.3548,51.1839,347365,0,653,346712
2/9/22,Qatar,25.3548,51.1839,348141,0,653,347488
2/10/22,Qatar,25.3548,51.1839,348924,0,655,348269
2/11/22,Qatar,25.3548,51.1839,349581,0,656,348925
2/12/22,Qatar,25.3548,51.1839,350188,0,656,349532
2/13/22,Qatar,25.3548,51.1839,350801,0,656,350145
2/14/22,Qatar,25.3548,51.1839,351402,0,658,350744
2/15/22,Qatar,25.3548,51.1839,351949,0,658,351291
2/16/22,Qatar,25.3548,51.1839,352447,0,658,351789
2/17/22,Qatar,25.3548,51.1839,352894,0,660,352234
2/18/22,Qatar,25.3548,51.1839,353346,0,661,352685
2/19/22,Qatar,25.3548,51.1839,353780,0,662,353118
2/20/22,Qatar,25.3548,51.1839,354222,0,662,353560
2/21/22,Qatar,25.3548,51.1839,354638,0,662,353976
2/22/22,Qatar,25.3548,51.1839,355032,0,662,354370
2/23/22,Qatar,25.3548,51.1839,355397,0,664,354733
2/24/22,Qatar,25.3548,51.1839,355740,0,664,355076
2/25/22,Qatar,25.3548,51.1839,356066,0,664,355402
2/26/22,Qatar,25.3548,51.1839,356363,0,667,355696
2/27/22,Qatar,25.3548,51.1839,356671,0,668,356003
2/28/22,Qatar,25.3548,51.1839,356982,0,670,356312
3/1/22,Qatar,25.3548,51.1839,357292,0,670,356622
3/2/22,Qatar,25.3548,51.1839,357583,0,670,356913
3/3/22,Qatar,25.3548,51.1839,357764,0,670,357094
3/4/22,Qatar,25.3548,51.1839,357920,0,670,357250
3/5/22,Qatar,25.3548,51.1839,358083,0,670,357413
3/6/22,Qatar,25.3548,51.1839,358253,0,670,357583
3/7/22,Qatar,25.3548,51.1839,358418,0,670,357748
3/8/22,Qatar,25.3548,51.1839,358564,0,671,357893
3/9/22,Qatar,25.3548,51.1839,358694,0,672,358022
3/10/22,Qatar,25.3548,51.1839,358821,0,672,358149
3/11/22,Qatar,25.3548,51.1839,358946,0,674,358272
3/12/22,Qatar,25.3548,51.1839,359028,0,675,358353
3/13/22,Qatar,25.3548,51.1839,359149,0,676,358473
3/14/22,Qatar,25.3548,51.1839,359259,0,677,358582
3/15/22,Qatar,25.3548,51.1839,359361,0,677,358684
3/16/22,Qatar,25.3548,51.1839,359449,0,677,358772
3/17/22,Qatar,25.3548,51.1839,359517,0,677,358840
3/18/22,Qatar,25.3548,51.1839,359670,0,677,358993
3/19/22,Qatar,25.3548,51.1839,359806,0,677,359129
3/20/22,Qatar,25.3548,51.1839,359956,0,677,359279
3/21/22,Qatar,25.3548,51.1839,360109,0,677,359432
3/22/22,Qatar,25.3548,51.1839,360251,0,677,359574
3/23/22,Qatar,25.3548,51.1839,360382,0,677,359705
3/24/22,Qatar,25.3548,51.1839,360497,0,677,359820
3/25/22,Qatar,25.3548,51.1839,360619,0,677,359942
3/26/22,Qatar,25.3548,51.1839,360704,0,677,360027
3/27/22,Qatar,25.3548,51.1839,360868,0,677,360191
3/28/22,Qatar,25.3548,51.1839,361020,0,677,360343
3/29/22,Qatar,25.3548,51.1839,361160,0,677,360483
3/30/22,Qatar,25.3548,51.1839,361283,0,677,360606
3/31/22,Qatar,25.3548,51.1839,361415,0,677,360738
4/1/22,Qatar,25.3548,51.1839,361545,0,677,360868
4/2/22,Qatar,25.3548,51.1839,361667,0,677,360990
4/3/22,Qatar,25.3548,51.1839,361819,0,677,361142
4/4/22,Qatar,25.3548,51.1839,362007,0,677,361330
4/5/22,Qatar,25.3548,51.1839,362150,0,677,361473
4/6/22,Qatar,25.3548,51.1839,362273,0,677,361596
4/7/22,Qatar,25.3548,51.1839,362404,0,677,361727
4/8/22,Qatar,25.3548,51.1839,362404,0,677,361727
4/9/22,Qatar,25.3548,51.1839,362623,0,677,361946
4/10/22,Qatar,25.3548,51.1839,362783,0,677,362106
4/11/22,Qatar,25.3548,51.1839,362937,0,677,362260
4/12/22,Qatar,25.3548,51.1839,363031,0,677,362354
4/13/22,Qatar,25.3548,51.1839,363139,0,677,362462
4/14/22,Qatar,25.3548,51.1839,363258,0,677,362581
4/15/22,Qatar,25.3548,51.1839,363345,0,677,362668
4/16/22,Qatar,25.3548,51.1839,363443,0,677,362766
4/17/22,Qatar,25.3548,51.1839,363543,0,677,362866
4/18/22,Qatar,25.3548,51.1839,363654,0,677,362977
4/19/22,Qatar,25.3548,51.1839,363754,0,677,363077
4/20/22,Qatar,25.3548,51.1839,363828,0,677,363151
4/21/22,Qatar,25.3548,51.1839,363905,0,677,363228
4/22/22,Qatar,25.3548,51.1839,364012,0,677,363335
4/23/22,Qatar,25.3548,51.1839,364089,0,677,363412
4/24/22,Qatar,25.3548,51.1839,364187,0,677,363510
4/25/22,Qatar,25.3548,51.1839,364300,0,677,363623
4/26/22,Qatar,25.3548,51.1839,364371,0,677,363694
4/27/22,Qatar,25.3548,51.1839,364421,0,677,363744
4/28/22,Qatar,25.3548,51.1839,364498,0,677,363821
4/29/22,Qatar,25.3548,51.1839,364560,0,677,363883
4/30/22,Qatar,25.3548,51.1839,364602,0,677,363925
5/1/22,Qatar,25.3548,51.1839,364655,0,677,363978
5/2/22,Qatar,25.3548,51.1839,364728,0,677,364051
5/3/22,Qatar,25.3548,51.1839,364778,0,677,364101
5/4/22,Qatar,25.3548,51.1839,364826,0,677,364149
5/5/22,Qatar,25.3548,51.1839,364895,0,677,364218
5/6/22,Qatar,25.3548,51.1839,364981,0,677,364304
5/7/22,Qatar,25.3548,51.1839,365058,0,677,364381
5/8/22,Qatar,25.3548,51.1839,365191,0,677,364514
5/9/22,Qatar,25.3548,51.1839,365334,0,677,364657
5/10/22,Qatar,25.3548,51.1839,365495,0,677,364818
5/11/22,Qatar,25.3548,51.1839,365657,0,677,364980
5/12/22,Qatar,25.3548,51.1839,365815,0,677,365138
5/13/22,Qatar,25.3548,51.1839,365938,0,677,365261
5/14/22,Qatar,25.3548,51.1839,366034,0,677,365357
5/15/22,Qatar,25.3548,51.1839,366179,0,677,365502
5/16/22,Qatar,25.3548,51.1839,366343,0,677,365666
5/17/22,Qatar,25.3548,51.1839,366477,0,677,365800
5/18/22,Qatar,25.3548,51.1839,366603,0,677,365926
5/19/22,Qatar,25.3548,51.1839,366724,0,677,366047
5/20/22,Qatar,25.3548,51.1839,366851,0,677,366174
5/21/22,Qatar,25.3548,51.1839,366952,0,677,366275
5/22/22,Qatar,25.3548,51.1839,367099,0,677,366422
5/23/22,Qatar,25.3548,51.1839,367272,0,677,366595
5/24/22,Qatar,25.3548,51.1839,367436,0,677,366759
5/25/22,Qatar,25.3548,51.1839,367617,0,677,366940
5/26/22,Qatar,25.3548,51.1839,367807,0,677,367130
5/27/22,Qatar,25.3548,51.1839,367939,0,677,367262
5/28/22,Qatar,25.3548,51.1839,368087,0,677,367410
5/29/22,Qatar,25.3548,51.1839,368285,0,677,367608
5/30/22,Qatar,25.3548,51.1839,368519,0,677,367842
5/31/22,Qatar,25.3548,51.1839,368788,0,677,368111
6/1/22,Qatar,25.3548,51.1839,369049,0,677,368372
6/2/22,Qatar,25.3548,51.1839,369305,0,677,368628
6/3/22,Qatar,25.3548,51.1839,369526,0,677,368849
6/4/22,Qatar,25.3548,51.1839,369526,0,677,368849
6/5/22,Qatar,25.3548,51.1839,369929,0,677,369252
6/6/22,Qatar,25.3548,51.1839,370235,0,677,369558
6/7/22,Qatar,25.3548,51.1839,370551,0,677,369874
6/8/22,Qatar,25.3548,51.1839,370924,0,677,370247
6/9/22,Qatar,25.3548,51.1839,371247,0,677,370570
6/10/22,Qatar,25.3548,51.1839,371585,0,677,370908
6/11/22,Qatar,25.3548,51.1839,371846,0,677,371169
6/12/22,Qatar,25.3548,51.1839,372261,0,677,371584
6/13/22,Qatar,25.3548,51.1839,372704,0,677,372027
6/14/22,Qatar,25.3548,51.1839,373178,0,677,372501
6/15/22,Qatar,25.3548,51.1839,373691,0,677,373014
6/16/22,Qatar,25.3548,51.1839,374149,0,678,373471
6/17/22,Qatar,25.3548,51.1839,374591,0,678,373913
6/18/22,Qatar,25.3548,51.1839,374923,0,678,374245
6/19/22,Qatar,25.3548,51.1839,375481,0,678,374803
6/20/22,Qatar,25.3548,51.1839,376149,0,678,375471
6/21/22,Qatar,25.3548,51.1839,376811,0,678,376133
6/22/22,Qatar,25.3548,51.1839,377482,0,678,376804
6/23/22,Qatar,25.3548,51.1839,378176,0,678,377498
6/24/22,Qatar,25.3548,51.1839,378818,0,678,378140
6/25/22,Qatar,25.3548,51.1839,379277,0,678,378599
6/26/22,Qatar,25.3548,51.1839,379862,0,679,379183
6/27/22,Qatar,25.3548,51.1839,380530,0,679,379851
6/28/22,Qatar,25.3548,51.1839,381269,0,679,380590
6/29/22,Qatar,25.3548,51.1839,381976,0,679,381297
6/30/22,Qatar,25.3548,51.1839,382635,0,679,381956
7/1/22,Qatar,25.3548,51.1839,383292,0,679,382613
7/2/22,Qatar,25.3548,51.1839,383807,0,679,383128
7/3/22,Qatar,25.3548,51.1839,383807,0,679,383128
7/4/22,Qatar,25.3548,51.1839,385163,0,679,384484
7/5/22,Qatar,25.3548,51.1839,385830,0,679,385151
7/6/22,Qatar,25.3548,51.1839,386528,0,679,385849
7/7/22,Qatar,25.3548,51.1839,387208,0,679,386529
7/8/22,Qatar,25.3548,51.1839,387845,0,679,387166
7/9/22,Qatar,25.3548,51.1839,388381,0,679,387702
7/10/22,Qatar,25.3548,51.1839,388849,0,680,388169
7/11/22,Qatar,25.3548,51.1839,389415,0,680,388735
7/12/22,Qatar,25.3548,51.1839,390055,0,680,389375
7/13/22,Qatar,25.3548,51.1839,390918,0,680,390238
7/14/22,Qatar,25.3548,51.1839,391945,0,680,391265
7/15/22,Qatar,25.3548,51.1839,392916,0,680,392236
7/16/22,Qatar,25.3548,51.1839,393834,0,680,393154
7/17/22,Qatar,25.3548,51.1839,395051,0,680,394371
7/18/22,Qatar,25.3548,51.1839,396344,0,680,395664
7/19/22,Qatar,25.3548,51.1839,397446,0,680,396766
7/20/22,Qatar,25.3548,51.1839,398558,0,680,397878
7/21/22,Qatar,25.3548,51.1839,399553,0,680,398873
7/22/22,Qatar,25.3548,51.1839,400520,0,680,399840
7/23/22,Qatar,25.3548,51.1839,401322,0,680,400642
7/24/22,Qatar,25.3548,51.1839,402330,0,680,401650
7/25/22,Qatar,25.3548,51.1839,403444,0,680,402764
7/26/22,Qatar,25.3548,51.1839,404408,0,680,403728
7/27/22,Qatar,25.3548,51.1839,405312,0,680,404632
7/28/22,Qatar,25.3548,51.1839,406225,0,680,405545
7/29/22,Qatar,25.3548,51.1839,406987,0,680,406307
7/30/22,Qatar,25.3548,51.1839,407749,0,681,407068
7/31/22,Qatar,25.3548,51.1839,408656,0,681,407975
8/1/22,Qatar,25.3548,51.1839,409622,0,681,408941
8/2/22,Qatar,25.3548,51.1839,410568,0,681,409887
8/3/22,Qatar,25.3548,51.1839,411405,0,681,410724
8/4/22,Qatar,25.3548,51.1839,412137,0,681,411456
8/5/22,Qatar,25.3548,51.1839,412897,0,681,412216
8/6/22,Qatar,25.3548,51.1839,413489,0,681,412808
8/7/22,Qatar,25.3548,51.1839,414310,0,681,413629
8/8/22,Qatar,25.3548,51.1839,415129,0,681,414448
8/9/22,Qatar,25.3548,51.1839,415876,0,681,415195
8/10/22,Qatar,25.3548,51.1839,416636,0,681,415955
8/11/22,Qatar,25.3548,51.1839,417390,0,681,416709
8/12/22,Qatar,25.3548,51.1839,418039,0,681,417358
8/13/22,Qatar,25.3548,51.1839,418622,0,681,417941
8/14/22,Qatar,25.3548,51.1839,419370,0,681,418689
8/15/22,Qatar,25.3548,51.1839,420143,0,681,419462
8/16/22,Qatar,25.3548,51.1839,420895,0,681,420214
8/17/22,Qatar,25.3548,51.1839,421532,0,681,420851
8/18/22,Qatar,25.3548,51.1839,422130,0,681,421449
8/19/22,Qatar,25.3548,51.1839,422686,0,681,422005
8/20/22,Qatar,25.3548,51.1839,423118,0,681,422437
8/21/22,Qatar,25.3548,51.1839,423772,0,681,423091
8/22/22,Qatar,25.3548,51.1839,424419,0,681,423738
8/23/22,Qatar,25.3548,51.1839,424999,0,681,424318
8/24/22,Qatar,25.3548,51.1839,425582,0,681,424901
8/25/22,Qatar,25.3548,51.1839,426083,0,681,425402
8/26/22,Qatar,25.3548,51.1839,426586,0,681,425905
8/27/22,Qatar,25.3548,51.1839,427001,0,681,426320
8/28/22,Qatar,25.3548,51.1839,427563,0,681,426882
8/29/22,Qatar,25.3548,51.1839,428147,0,681,427466
8/30/22,Qatar,25.3548,51.1839,428791,0,681,428110
8/31/22,Qatar,25.3548,51.1839,429396,0,681,428715
9/1/22,Qatar,25.3548,51.1839,429963,0,681,429282
9/2/22,Qatar,25.3548,51.1839,430484,0,681,429803
9/3/22,Qatar,25.3548,51.1839,430945,0,681,430264
9/4/22,Qatar,25.3548,51.1839,431519,0,681,430838
9/5/22,Qatar,25.3548,51.1839,432202,0,681,431521
9/6/22,Qatar,25.3548,51.1839,432846,0,681,432165
9/7/22,Qatar,25.3548,51.1839,433531,0,681,432850
9/8/22,Qatar,25.3548,51.1839,434153,0,681,433472
9/9/22,Qatar,25.3548,51.1839,434714,0,682,434032
9/10/22,Qatar,25.3548,51.1839,435192,0,682,434510
9/11/22,Qatar,25.3548,51.1839,435890,0,682,435208
9/12/22,Qatar,25.3548,51.1839,436820,0,682,436138
9/13/22,Qatar,25.3548,51.1839,437709,0,682,437027
9/14/22,Qatar,25.3548,51.1839,438499,0,682,437817
9/15/22,Qatar,25.3548,51.1839,439287,0,682,438605
9/16/22,Qatar,25.3548,51.1839,440060,0,682,439378
9/17/22,Qatar,25.3548,51.1839,440580,0,682,439898
9/18/22,Qatar,25.3548,51.1839,441445,0,682,440763
9/19/22,Qatar,25.3548,51.1839,442389,0,682,441707
9/20/22,Qatar,25.3548,51.1839,443303,0,682,442621
9/21/22,Qatar,25.3548,51.1839,444174,0,682,443492
9/22/22,Qatar,25.3548,51.1839,445027,0,682,444345
9/23/22,Qatar,25.3548,51.1839,445749,0,682,445067
9/24/22,Qatar,25.3548,51.1839,446277,0,682,445595
9/25/22,Qatar,25.3548,51.1839,446277,0,682,445595
9/26/22,Qatar,25.3548,51.1839,447133,0,682,446451
9/27/22,Qatar,25.3548,51.1839,448750,0,682,448068
9/28/22,Qatar,25.3548,51.1839,449602,0,682,448920
9/29/22,Qatar,25.3548,51.1839,450448,0,682,449766
9/30/22,Qatar,25.3548,51.1839,451168,0,682,450486
10/1/22,Qatar,25.3548,51.1839,451675,0,682,450993
10/2/22,Qatar,25.3548,51.1839,452533,0,682,451851
10/3/22,Qatar,25.3548,51.1839,453496,0,682,452814
10/4/22,Qatar,25.3548,51.1839,454244,0,682,453562
10/5/22,Qatar,25.3548,51.1839,455021,0,682,454339
10/6/22,Qatar,25.3548,51.1839,455714,0,682,455032
10/7/22,Qatar,25.3548,51.1839,456371,0,682,455689
10/8/22,Qatar,25.3548,51.1839,456819,0,682,456137
10/9/22,Qatar,25.3548,51.1839,457552,0,682,456870
10/10/22,Qatar,25.3548,51.1839,458391,0,682,457709
10/11/22,Qatar,25.3548,51.1839,459122,0,682,458440
10/12/22,Qatar,25.3548,51.1839,459798,0,682,459116
10/13/22,Qatar,25.3548,51.1839,460449,0,682,459767
10/14/22,Qatar,25.3548,51.1839,460970,0,682,460288
10/15/22,Qatar,25.3548,51.1839,460970,0,682,460288
10/16/22,Qatar,25.3548,51.1839,461980,0,683,461297
10/17/22,Qatar,25.3548,51.1839,462716,0,683,462033
10/18/22,Qatar,25.3548,51.1839,463328,0,683,462645
10/19/22,Qatar,25.3548,51.1839,463888,0,683,463205
10/20/22,Qatar,25.3548,51.1839,464385,0,684,463701
10/21/22,Qatar,25.3548,51.1839,464820,0,684,464136
10/22/22,Qatar,25.3548,51.1839,465130,0,684,464446
10/23/22,Qatar,25.3548,51.1839,465616,0,684,464932
10/24/22,Qatar,25.3548,51.1839,466145,0,684,465461
10/25/22,Qatar,25.3548,51.1839,466626,0,684,465942
10/26/22,Qatar,25.3548,51.1839,467092,0,684,466408
10/27/22,Qatar,25.3548,51.1839,467574,0,684,466890
10/28/22,Qatar,25.3548,51.1839,467980,0,684,467296
10/29/22,Qatar,25.3548,51.1839,468302,0,684,467618
10/30/22,Qatar,25.3548,51.1839,468737,0,684,468053
10/31/22,Qatar,25.3548,51.1839,469267,0,684,468583
11/1/22,Qatar,25.3548,51.1839,469709,0,684,469025
11/2/22,Qatar,25.3548,51.1839,470098,0,684,469414
11/3/22,Qatar,25.3548,51.1839,470433,0,684,469749
11/4/22,Qatar,25.3548,51.1839,470756,0,684,470072
11/5/22,Qatar,25.3548,51.1839,471004,0,684,470320
11/6/22,Qatar,25.3548,51.1839,471357,0,684,470673
11/7/22,Qatar,25.3548,51.1839,471816,0,684,471132
11/8/22,Qatar,25.3548,51.1839,472226,0,684,471542
11/9/22,Qatar,25.3548,51.1839,472587,0,684,471903
11/10/22,Qatar,25.3548,51.1839,472927,0,684,472243
11/11/22,Qatar,25.3548,51.1839,473234,0,684,472550
11/12/22,Qatar,25.3548,51.1839,473440,0,684,472756
11/13/22,Qatar,25.3548,51.1839,473694,0,684,473010
11/14/22,Qatar,25.3548,51.1839,474111,0,684,473427
11/15/22,Qatar,25.3548,51.1839,474473,0,684,473789
11/16/22,Qatar,25.3548,51.1839,474883,0,684,474199
11/17/22,Qatar,25.3548,51.1839,475199,0,684,474515
11/18/22,Qatar,25.3548,51.1839,475479,0,684,474795
11/19/22,Qatar,25.3548,51.1839,475626,0,684,474942
11/20/22,Qatar,25.3548,51.1839,475897,0,684,475213
11/21/22,Qatar,25.3548,51.1839,476171,0,684,475487
11/22/22,Qatar,25.3548,51.1839,476454,0,684,475770
11/23/22,Qatar,25.3548,51.1839,476683,0,684,475999
11/24/22,Qatar,25.3548,51.1839,476976,0,684,476292
11/25/22,Qatar,25.3548,51.1839,477206,0,685,476521
11/26/22,Qatar,25.3548,51.1839,477420,0,685,476735
11/27/22,Qatar,25.3548,51.1839,477680,0,685,476995
11/28/22,Qatar,25.3548,51.1839,478047,0,685,477362
11/29/22,Qatar,25.3548,51.1839,478418,0,685,477733
11/30/22,Qatar,25.3548,51.1839,478848,0,685,478163
12/1/22,Qatar,25.3548,51.1839,478848,0,685,478163
12/2/22,Qatar,25.3548,51.1839,479334,0,685,478649
12/3/22,Qatar,25.3548,51.1839,480099,0,685,479414
12/4/22,Qatar,25.3548,51.1839,480630,0,685,479945
12/5/22,Qatar,25.3548,51.1839,481296,0,685,480611
12/6/22,Qatar,25.3548,51.1839,481904,0,685,481219
12/7/22,Qatar,25.3548,51.1839,482499,0,685,481814
12/8/22,Qatar,25.3548,51.1839,483041,0,685,482356
12/9/22,Qatar,25.3548,51.1839,483552,0,685,482867
12/10/22,Qatar,25.3548,51.1839,483821,0,685,483136
12/11/22,Qatar,25.3548,51.1839,484180,0,685,483495
12/12/22,Qatar,25.3548,51.1839,484658,0,685,483973
12/13/22,Qatar,25.3548,51.1839,485064,0,685,484379
12/14/22,Qatar,25.3548,51.1839,485440,0,685,484755
12/15/22,Qatar,25.3548,51.1839,485781,0,685,485096
12/16/22,Qatar,25.3548,51.1839,486052,0,685,485367
12/17/22,Qatar,25.3548,51.1839,486227,0,685,485542
1/1/22,Romania,45.9432,24.9668,1810342,0,58779,1751563
1/2/22,Romania,45.9432,24.9668,1811300,0,58796,1752504
1/3/22,Romania,45.9432,24.9668,1813056,0,58814,1754242
1/4/22,Romania,45.9432,24.9668,1816956,0,58866,1758090
1/5/22,Romania,45.9432,24.9668,1821849,0,58896,1762953
1/6/22,Romania,45.9432,24.9668,1827867,0,58940,1768927
1/7/22,Romania,45.9432,24.9668,1833789,0,58971,1774818
1/8/22,Romania,45.9432,24.9668,1839825,0,58997,1780828
1/9/22,Romania,45.9432,24.9668,1844537,0,59011,1785526
1/10/22,Romania,45.9432,24.9668,1848641,0,59027,1789614
1/11/22,Romania,45.9432,24.9668,1857502,0,59070,1798432
1/12/22,Romania,45.9432,24.9668,1866102,0,59114,1806988
1/13/22,Romania,45.9432,24.9668,1875887,0,59150,1816737
1/14/22,Romania,45.9432,24.9668,1885771,0,59180,1826591
1/15/22,Romania,45.9432,24.9668,1895833,0,59212,1836621
1/16/22,Romania,45.9432,24.9668,1903428,0,59240,1844188
1/17/22,Romania,45.9432,24.9668,1911546,0,59257,1852289
1/18/22,Romania,45.9432,24.9668,1928306,0,59327,1868979
1/19/22,Romania,45.9432,24.9668,1944916,0,59385,1885531
1/20/22,Romania,45.9432,24.9668,1964021,0,59428,1904593
1/21/22,Romania,45.9432,24.9668,1983670,0,59477,1924193
1/22/22,Romania,45.9432,24.9668,2003041,0,59525,1943516
1/23/22,Romania,45.9432,24.9668,2017129,0,59547,1957582
1/24/22,Romania,45.9432,24.9668,2029211,0,59588,1969623
1/25/22,Romania,45.9432,24.9668,2048896,0,59632,1989264
1/26/22,Romania,45.9432,24.9668,2083151,0,59726,2023425
1/27/22,Romania,45.9432,24.9668,2114834,0,59797,2055037
1/28/22,Romania,45.9432,24.9668,2146558,0,59857,2086701
1/29/22,Romania,45.9432,24.9668,2176726,0,59932,2116794
1/30/22,Romania,45.9432,24.9668,2196394,0,59984,2136410
1/31/22,Romania,45.9432,24.9668,2216525,0,60025,2156500
2/1/22,Romania,45.9432,24.9668,2256543,0,60122,2196421
2/2/22,Romania,45.9432,24.9668,2292345,0,60242,2232103
2/3/22,Romania,45.9432,24.9668,2325016,0,60353,2264663
2/4/22,Romania,45.9432,24.9668,2356792,0,60450,2296342
2/5/22,Romania,45.9432,24.9668,2385713,0,60560,2325153
2/6/22,Romania,45.9432,24.9668,2401821,0,60642,2341179
2/7/22,Romania,45.9432,24.9668,2418779,0,60723,2358056
2/8/22,Romania,45.9432,24.9668,2455048,0,60916,2394132
2/9/22,Romania,45.9432,24.9668,2482394,0,61092,2421302
2/10/22,Romania,45.9432,24.9668,2508860,0,61231,2447629
2/11/22,Romania,45.9432,24.9668,2531597,0,61363,2470234
2/12/22,Romania,45.9432,24.9668,2550348,0,61520,2488828
2/13/22,Romania,45.9432,24.9668,2562315,0,61601,2500714
2/14/22,Romania,45.9432,24.9668,2574384,0,61676,2512708
2/15/22,Romania,45.9432,24.9668,2596269,0,61880,2534389
2/16/22,Romania,45.9432,24.9668,2613716,0,62063,2551653
2/17/22,Romania,45.9432,24.9668,2629090,0,62188,2566902
2/18/22,Romania,45.9432,24.9668,2643614,0,62323,2581291
2/19/22,Romania,45.9432,24.9668,2655933,0,62471,2593462
2/20/22,Romania,45.9432,24.9668,2663630,0,62539,2601091
2/21/22,Romania,45.9432,24.9668,2671314,0,62624,2608690
2/22/22,Romania,45.9432,24.9668,2686089,0,62839,2623250
2/23/22,Romania,45.9432,24.9668,2697566,0,62958,2634608
2/24/22,Romania,45.9432,24.9668,2708315,0,63073,2645242
2/25/22,Romania,45.9432,24.9668,2717289,0,63193,2654096
2/26/22,Romania,45.9432,24.9668,2724480,0,63294,2661186
2/27/22,Romania,45.9432,24.9668,2728727,0,63353,2665374
2/28/22,Romania,45.9432,24.9668,2733484,0,63414,2670070
3/1/22,Romania,45.9432,24.9668,2741945,0,63578,2678367
3/2/22,Romania,45.9432,24.9668,2748777,0,63668,2685109
3/3/22,Romania,45.9432,24.9668,2754730,0,63782,2690948
3/4/22,Romania,45.9432,24.9668,2760332,0,63849,2696483
3/5/22,Romania,45.9432,24.9668,2765169,0,63931,2701238
3/6/22,Romania,45.9432,24.9668,2768261,0,63961,2704300
3/7/22,Romania,45.9432,24.9668,2771449,0,63993,2707456
3/8/22,Romania,45.9432,24.9668,2776910,0,64094,2712816
3/9/22,Romania,45.9432,24.9668,2781086,0,64156,2716930
3/10/22,Romania,45.9432,24.9668,2784651,0,64226,2720425
3/11/22,Romania,45.9432,24.9668,2787625,0,64276,2723349
3/12/22,Romania,45.9432,24.9668,2790368,0,64335,2726033
3/13/22,Romania,45.9432,24.9668,2791994,0,64361,2727633
3/14/22,Romania,45.9432,24.9668,2794081,0,64381,2729700
3/15/22,Romania,45.9432,24.9668,2798935,0,64450,2734485
3/16/22,Romania,45.9432,24.9668,2802848,0,64518,2738330
3/17/22,Romania,45.9432,24.9668,2806881,0,64581,2742300
3/18/22,Romania,45.9432,24.9668,2810630,0,64625,2746005
3/19/22,Romania,45.9432,24.9668,2813798,0,64669,2749129
3/20/22,Romania,45.9432,24.9668,2816039,0,64685,2751354
3/21/22,Romania,45.9432,24.9668,2818275,0,64697,2753578
3/22/22,Romania,45.9432,24.9668,2823415,0,64749,2758666
3/23/22,Romania,45.9432,24.9668,2827936,0,64789,2763147
3/24/22,Romania,45.9432,24.9668,2832024,0,64826,2767198
3/25/22,Romania,45.9432,24.9668,2835749,0,64867,2770882
3/26/22,Romania,45.9432,24.9668,2838849,0,64895,2773954
3/27/22,Romania,45.9432,24.9668,2840788,0,64905,2775883
3/28/22,Romania,45.9432,24.9668,2842739,0,64913,2777826
3/29/22,Romania,45.9432,24.9668,2847015,0,64958,2782057
3/30/22,Romania,45.9432,24.9668,2850598,0,64994,2785604
3/31/22,Romania,45.9432,24.9668,2853570,0,65015,2788555
4/1/22,Romania,45.9432,24.9668,2856491,0,65042,2791449
4/2/22,Romania,45.9432,24.9668,2858665,0,65079,2793586
4/3/22,Romania,45.9432,24.9668,2860094,0,65090,2795004
4/4/22,Romania,45.9432,24.9668,2861426,0,65102,2796324
4/5/22,Romania,45.9432,24.9668,2864473,0,65129,2799344
4/6/22,Romania,45.9432,24.9668,2866793,0,65147,2801646
4/7/22,Romania,45.9432,24.9668,2868777,0,65170,2803607
4/8/22,Romania,45.9432,24.9668,2870486,0,65179,2805307
4/9/22,Romania,45.9432,24.9668,2871937,0,65198,2806739
4/10/22,Romania,45.9432,24.9668,2872849,0,65207,2807642
4/11/22,Romania,45.9432,24.9668,2873875,0,65210,2808665
4/12/22,Romania,45.9432,24.9668,2875942,0,65249,2810693
4/13/22,Romania,45.9432,24.9668,2877544,0,65285,2812259
4/14/22,Romania,45.9432,24.9668,2879021,0,65297,2813724
4/15/22,Romania,45.9432,24.9668,2880276,0,65310,2814966
4/16/22,Romania,45.9432,24.9668,2881322,0,65331,2815991
4/17/22,Romania,45.9432,24.9668,2881904,0,65337,2816567
4/18/22,Romania,45.9432,24.9668,2882590,0,65340,2817250
4/19/22,Romania,45.9432,24.9668,2884114,0,65366,2818748
4/20/22,Romania,45.9432,24.9668,2885221,0,65384,2819837
4/21/22,Romania,45.9432,24.9668,2886284,0,65403,2820881
4/22/22,Romania,45.9432,24.9668,2887258,0,65412,2821846
4/23/22,Romania,45.9432,24.9668,2887824,0,65421,2822403
4/24/22,Romania,45.9432,24.9668,2888318,0,65427,2822891
4/25/22,Romania,45.9432,24.9668,2888639,0,65428,2823211
4/26/22,Romania,45.9432,24.9668,2889363,0,65430,2823933
4/27/22,Romania,45.9432,24.9668,2890827,0,65456,2825371
4/28/22,Romania,45.9432,24.9668,2891973,0,65471,2826502
4/29/22,Romania,45.9432,24.9668,2892989,0,65478,2827511
4/30/22,Romania,45.9432,24.9668,2893876,0,65486,2828390
5/1/22,Romania,45.9432,24.9668,2894368,0,65493,2828875
5/2/22,Romania,45.9432,24.9668,2894896,0,65496,2829400
5/3/22,Romania,45.9432,24.9668,2896012,0,65510,2830502
5/4/22,Romania,45.9432,24.9668,2896012,0,65510,2830502
5/5/22,Romania,45.9432,24.9668,2897528,0,65540,2831988
5/6/22,Romania,45.9432,24.9668,2898258,0,65551,2832707
5/7/22,Romania,45.9432,24.9668,2898258,0,65551,2832707
5/8/22,Romania,45.9432,24.9668,2899178,0,65562,2833616
5/9/22,Romania,45.9432,24.9668,2899563,0,65566,2833997
5/10/22,Romania,45.9432,24.9668,2900375,0,65581,2834794
5/11/22,Romania,45.9432,24.9668,2901080,0,65589,2835491
5/12/22,Romania,45.9432,24.9668,2901682,0,65595,2836087
5/13/22,Romania,45.9432,24.9668,2902270,0,65599,2836671
5/14/22,Romania,45.9432,24.9668,2902790,0,65606,2837184
5/15/22,Romania,45.9432,24.9668,2903072,0,65612,2837460
5/16/22,Romania,45.9432,24.9668,2903394,0,65612,2837782
5/17/22,Romania,45.9432,24.9668,2904075,0,65625,2838450
5/18/22,Romania,45.9432,24.9668,2904588,0,65636,2838952
5/19/22,Romania,45.9432,24.9668,2905055,0,65640,2839415
5/20/22,Romania,45.9432,24.9668,2905539,0,65644,2839895
5/21/22,Romania,45.9432,24.9668,2905859,0,65651,2840208
5/22/22,Romania,45.9432,24.9668,2906051,0,65652,2840399
5/23/22,Romania,45.9432,24.9668,2906285,0,65654,2840631
5/24/22,Romania,45.9432,24.9668,2906776,0,65663,2841113
5/25/22,Romania,45.9432,24.9668,2907210,0,65664,2841546
5/26/22,Romania,45.9432,24.9668,2907591,0,65669,2841922
5/27/22,Romania,45.9432,24.9668,2908018,0,65676,2842342
5/28/22,Romania,45.9432,24.9668,2908313,0,65677,2842636
5/29/22,Romania,45.9432,24.9668,2908516,0,65678,2842838
5/30/22,Romania,45.9432,24.9668,2908704,0,65678,2843026
5/31/22,Romania,45.9432,24.9668,2909195,0,65684,2843511
6/1/22,Romania,45.9432,24.9668,2909495,0,65685,2843810
6/2/22,Romania,45.9432,24.9668,2909677,0,65686,2843991
6/3/22,Romania,45.9432,24.9668,2910081,0,65689,2844392
6/4/22,Romania,45.9432,24.9668,2910392,0,65691,2844701
6/5/22,Romania,45.9432,24.9668,2910553,0,65692,2844861
6/6/22,Romania,45.9432,24.9668,2910766,0,65693,2845073
6/7/22,Romania,45.9432,24.9668,2911170,0,65697,2845473
6/8/22,Romania,45.9432,24.9668,2911536,0,65700,2845836
6/9/22,Romania,45.9432,24.9668,2911877,0,65702,2846175
6/10/22,Romania,45.9432,24.9668,2912266,0,65706,2846560
6/11/22,Romania,45.9432,24.9668,2912537,0,65713,2846824
6/12/22,Romania,45.9432,24.9668,2912705,0,65714,2846991
6/13/22,Romania,45.9432,24.9668,2912878,0,65714,2847164
6/14/22,Romania,45.9432,24.9668,2912878,0,65714,2847164
6/15/22,Romania,45.9432,24.9668,2912878,0,65714,2847164
6/16/22,Romania,45.9432,24.9668,2912878,0,65714,2847164
6/17/22,Romania,45.9432,24.9668,2912878,0,65714,2847164
6/18/22,Romania,45.9432,24.9668,2912878,0,65714,2847164
6/19/22,Romania,45.9432,24.9668,2912878,0,65714,2847164
6/20/22,Romania,45.9432,24.9668,2915487,0,65726,2849761
6/21/22,Romania,45.9432,24.9668,2915487,0,65726,2849761
6/22/22,Romania,45.9432,24.9668,2915487,0,65726,2849761
6/23/22,Romania,45.9432,24.9668,2915487,0,65726,2849761
6/24/22,Romania,45.9432,24.9668,2915487,0,65726,2849761
6/25/22,Romania,45.9432,24.9668,2915487,0,65726,2849761
6/26/22,Romania,45.9432,24.9668,2915487,0,65726,2849761
6/27/22,Romania,45.9432,24.9668,2919461,0,65739,2853722
6/28/22,Romania,45.9432,24.9668,2919461,0,65739,2853722
6/29/22,Romania,45.9432,24.9668,2919461,0,65739,2853722
6/30/22,Romania,45.9432,24.9668,2919461,0,65739,2853722
7/1/22,Romania,45.9432,24.9668,2919461,0,65739,2853722
7/2/22,Romania,45.9432,24.9668,2919461,0,65739,2853722
7/3/22,Romania,45.9432,24.9668,2919461,0,65739,2853722
7/4/22,Romania,45.9432,24.9668,2927187,0,65755,2861432
7/5/22,Romania,45.9432,24.9668,2927187,0,65755,2861432
7/6/22,Romania,45.9432,24.9668,2927187,0,65755,2861432
7/7/22,Romania,45.9432,24.9668,2927187,0,65755,2861432
7/8/22,Romania,45.9432,24.9668,2927187,0,65755,2861432
7/9/22,Romania,45.9432,24.9668,2927187,0,65755,2861432
7/10/22,Romania,45.9432,24.9668,2927187,0,65755,2861432
7/11/22,Romania,45.9432,24.9668,2942130,0,65788,2876342
7/12/22,Romania,45.9432,24.9668,2946174,0,65797,2880377
7/13/22,Romania,45.9432,24.9668,2949951,0,65801,2884150
7/14/22,Romania,45.9432,24.9668,2953944,0,65802,2888142
7/15/22,Romania,45.9432,24.9668,2958051,0,65805,2892246
7/16/22,Romania,45.9432,24.9668,2961769,0,65812,2895957
7/17/22,Romania,45.9432,24.9668,2963934,0,65813,2898121
7/18/22,Romania,45.9432,24.9668,2967222,0,65815,2901407
7/19/22,Romania,45.9432,24.9668,2974880,0,65824,2909056
7/20/22,Romania,45.9432,24.9668,2981659,0,65836,2915823
7/21/22,Romania,45.9432,24.9668,2988788,0,65839,2922949
7/22/22,Romania,45.9432,24.9668,2996178,0,65846,2930332
7/23/22,Romania,45.9432,24.9668,3002662,0,65853,2936809
7/24/22,Romania,45.9432,24.9668,3006756,0,65857,2940899
7/25/22,Romania,45.9432,24.9668,3011711,0,65862,2945849
7/26/22,Romania,45.9432,24.9668,3024064,0,65894,2958170
7/27/22,Romania,45.9432,24.9668,3033866,0,65923,2967943
7/28/22,Romania,45.9432,24.9668,3043205,0,65935,2977270
7/29/22,Romania,45.9432,24.9668,3052036,0,65963,2986073
7/30/22,Romania,45.9432,24.9668,3059568,0,65983,2993585
7/31/22,Romania,45.9432,24.9668,3063647,0,65999,2997648
8/1/22,Romania,45.9432,24.9668,3068849,0,66011,3002838
8/2/22,Romania,45.9432,24.9668,3080545,0,66049,3014496
8/3/22,Romania,45.9432,24.9668,3089651,0,66090,3023561
8/4/22,Romania,45.9432,24.9668,3098268,0,66117,3032151
8/5/22,Romania,45.9432,24.9668,3106033,0,66143,3039890
8/6/22,Romania,45.9432,24.9668,3112474,0,66171,3046303
8/7/22,Romania,45.9432,24.9668,3115992,0,66179,3049813
8/8/22,Romania,45.9432,24.9668,3120681,0,66193,3054488
8/9/22,Romania,45.9432,24.9668,3130545,0,66236,3064309
8/10/22,Romania,45.9432,24.9668,3137858,0,66262,3071596
8/11/22,Romania,45.9432,24.9668,3144327,0,66291,3078036
8/12/22,Romania,45.9432,24.9668,3150037,0,66311,3083726
8/13/22,Romania,45.9432,24.9668,3154721,0,66336,3088385
8/14/22,Romania,45.9432,24.9668,3157372,0,66348,3091024
8/15/22,Romania,45.9432,24.9668,3159626,0,66357,3093269
8/16/22,Romania,45.9432,24.9668,3163226,0,66375,3096851
8/17/22,Romania,45.9432,24.9668,3170726,0,66417,3104309
8/18/22,Romania,45.9432,24.9668,3176211,0,66441,3109770
8/19/22,Romania,45.9432,24.9668,3181065,0,66462,3114603
8/20/22,Romania,45.9432,24.9668,3184930,0,66483,3118447
8/21/22,Romania,45.9432,24.9668,3186995,0,66490,3120505
8/22/22,Romania,45.9432,24.9668,3189594,0,66500,3123094
8/23/22,Romania,45.9432,24.9668,3195253,0,66547,3128706
8/24/22,Romania,45.9432,24.9668,3199216,0,66576,3132640
8/25/22,Romania,45.9432,24.9668,3202866,0,66596,3136270
8/26/22,Romania,45.9432,24.9668,3206185,0,66612,3139573
8/27/22,Romania,45.9432,24.9668,3208903,0,66631,3142272
8/28/22,Romania,45.9432,24.9668,3210306,0,66637,3143669
8/29/22,Romania,45.9432,24.9668,3212211,0,66639,3145572
8/30/22,Romania,45.9432,24.9668,3216257,0,66673,3149584
8/31/22,Romania,45.9432,24.9668,3219354,0,66709,3152645
9/1/22,Romania,45.9432,24.9668,3221984,0,66728,3155256
9/2/22,Romania,45.9432,24.9668,3224382,0,66751,3157631
9/3/22,Romania,45.9432,24.9668,3226207,0,66766,3159441
9/4/22,Romania,45.9432,24.9668,3227188,0,66772,3160416
9/5/22,Romania,45.9432,24.9668,3228364,0,66779,3161585
9/6/22,Romania,45.9432,24.9668,3231240,0,66795,3164445
9/7/22,Romania,45.9432,24.9668,3233467,0,66810,3166657
9/8/22,Romania,45.9432,24.9668,3235527,0,66825,3168702
9/9/22,Romania,45.9432,24.9668,3237590,0,66838,3170752
9/10/22,Romania,45.9432,24.9668,3239392,0,66849,3172543
9/11/22,Romania,45.9432,24.9668,3240298,0,66853,3173445
9/12/22,Romania,45.9432,24.9668,3241772,0,66856,3174916
9/13/22,Romania,45.9432,24.9668,3244886,0,66874,3178012
9/14/22,Romania,45.9432,24.9668,3247140,0,66882,3180258
9/15/22,Romania,45.9432,24.9668,3249108,0,66888,3182220
9/16/22,Romania,45.9432,24.9668,3249108,0,66888,3182220
9/17/22,Romania,45.9432,24.9668,3252363,0,66912,3185451
9/18/22,Romania,45.9432,24.9668,3253082,0,66919,3186163
9/19/22,Romania,45.9432,24.9668,3254049,0,66921,3187128
9/20/22,Romania,45.9432,24.9668,3256352,0,66937,3189415
9/21/22,Romania,45.9432,24.9668,3257997,0,66950,3191047
9/22/22,Romania,45.9432,24.9668,3259328,0,66962,3192366
9/23/22,Romania,45.9432,24.9668,3260555,0,66968,3193587
9/24/22,Romania,45.9432,24.9668,3261614,0,66972,3194642
9/25/22,Romania,45.9432,24.9668,3262053,0,66978,3195075
9/26/22,Romania,45.9432,24.9668,3262909,0,66981,3195928
9/27/22,Romania,45.9432,24.9668,3264771,0,66992,3197779
9/28/22,Romania,45.9432,24.9668,3266196,0,67003,3199193
9/29/22,Romania,45.9432,24.9668,3267370,0,67016,3200354
9/30/22,Romania,45.9432,24.9668,3268562,0,67021,3201541
10/1/22,Romania,45.9432,24.9668,3269497,0,67027,3202470
10/2/22,Romania,45.9432,24.9668,3269941,0,67031,3202910
10/3/22,Romania,45.9432,24.9668,3270591,0,67034,3203557
10/4/22,Romania,45.9432,24.9668,3272010,0,67054,3204956
10/5/22,Romania,45.9432,24.9668,3273069,0,67066,3206003
10/6/22,Romania,45.9432,24.9668,3273914,0,67069,3206845
10/7/22,Romania,45.9432,24.9668,3274607,0,67072,3207535
10/8/22,Romania,45.9432,24.9668,3275276,0,67076,3208200
10/9/22,Romania,45.9432,24.9668,3275276,0,67076,3208200
10/10/22,Romania,45.9432,24.9668,3276020,0,67084,3208936
10/11/22,Romania,45.9432,24.9668,3277020,0,67097,3209923
10/12/22,Romania,45.9432,24.9668,3277831,0,67103,3210728
10/13/22,Romania,45.9432,24.9668,3278510,0,67110,3211400
10/14/22,Romania,45.9432,24.9668,3279145,0,67113,3212032
10/15/22,Romania,45.9432,24.9668,3279623,0,67119,3212504
10/16/22,Romania,45.9432,24.9668,3279860,0,67120,3212740
10/17/22,Romania,45.9432,24.9668,3280165,0,67124,3213041
10/18/22,Romania,45.9432,24.9668,3281047,0,67131,3213916
10/19/22,Romania,45.9432,24.9668,3281666,0,67145,3214521
10/20/22,Romania,45.9432,24.9668,3282224,0,67155,3215069
10/21/22,Romania,45.9432,24.9668,3282751,0,67161,3215590
10/22/22,Romania,45.9432,24.9668,3283147,0,67161,3215986
10/23/22,Romania,45.9432,24.9668,3283353,0,67163,3216190
10/24/22,Romania,45.9432,24.9668,3283658,0,67165,3216493
10/25/22,Romania,45.9432,24.9668,3284350,0,67168,3217182
10/26/22,Romania,45.9432,24.9668,3284916,0,67169,3217747
10/27/22,Romania,45.9432,24.9668,3285394,0,67174,3218220
10/28/22,Romania,45.9432,24.9668,3285833,0,67179,3218654
10/29/22,Romania,45.9432,24.9668,3286185,0,67186,3218999
10/30/22,Romania,45.9432,24.9668,3286394,0,67186,3219208
10/31/22,Romania,45.9432,24.9668,3286735,0,67186,3219549
11/1/22,Romania,45.9432,24.9668,3287394,0,67195,3220199
11/2/22,Romania,45.9432,24.9668,3287870,0,67198,3220672
11/3/22,Romania,45.9432,24.9668,3288315,0,67203,3221112
11/4/22,Romania,45.9432,24.9668,3288685,0,67206,3221479
11/5/22,Romania,45.9432,24.9668,3288755,0,67211,3221544
11/6/22,Romania,45.9432,24.9668,3289184,0,67213,3221971
11/7/22,Romania,45.9432,24.9668,3289442,0,67213,3222229
11/8/22,Romania,45.9432,24.9668,3290030,0,67217,3222813
11/9/22,Romania,45.9432,24.9668,3290564,0,67220,3223344
11/10/22,Romania,45.9432,24.9668,3290987,0,67224,3223763
11/11/22,Romania,45.9432,24.9668,3291348,0,67231,3224117
11/12/22,Romania,45.9432,24.9668,3291589,0,67236,3224353
11/13/22,Romania,45.9432,24.9668,3291730,0,67236,3224494
11/14/22,Romania,45.9432,24.9668,3291986,0,67237,3224749
11/15/22,Romania,45.9432,24.9668,3292476,0,67243,3225233
11/16/22,Romania,45.9432,24.9668,3292905,0,67246,3225659
11/17/22,Romania,45.9432,24.9668,3293346,0,67249,3226097
11/18/22,Romania,45.9432,24.9668,3293742,0,67250,3226492
11/19/22,Romania,45.9432,24.9668,3294065,0,67253,3226812
11/20/22,Romania,45.9432,24.9668,3294232,0,67253,3226979
11/21/22,Romania,45.9432,24.9668,3294447,0,67253,3227194
11/22/22,Romania,45.9432,24.9668,3294447,0,67253,3227194
11/23/22,Romania,45.9432,24.9668,3294447,0,67253,3227194
11/24/22,Romania,45.9432,24.9668,3294447,0,67253,3227194
11/25/22,Romania,45.9432,24.9668,3294447,0,67253,3227194
11/26/22,Romania,45.9432,24.9668,3294447,0,67253,3227194
11/27/22,Romania,45.9432,24.9668,3294447,0,67253,3227194
11/28/22,Romania,45.9432,24.9668,3296834,0,67276,3229558
11/29/22,Romania,45.9432,24.9668,3296834,0,67276,3229558
11/30/22,Romania,45.9432,24.9668,3296834,0,67276,3229558
12/1/22,Romania,45.9432,24.9668,3296834,0,67276,3229558
12/2/22,Romania,45.9432,24.9668,3296834,0,67276,3229558
12/3/22,Romania,45.9432,24.9668,3296834,0,67276,3229558
12/4/22,Romania,45.9432,24.9668,3296834,0,67276,3229558
12/5/22,Romania,45.9432,24.9668,3298738,0,67289,3231449
12/6/22,Romania,45.9432,24.9668,3298738,0,67289,3231449
12/7/22,Romania,45.9432,24.9668,3298738,0,67289,3231449
12/8/22,Romania,45.9432,24.9668,3298738,0,67289,3231449
12/9/22,Romania,45.9432,24.9668,3298738,0,67289,3231449
12/10/22,Romania,45.9432,24.9668,3298738,0,67289,3231449
12/11/22,Romania,45.9432,24.9668,3298738,0,67289,3231449
12/12/22,Romania,45.9432,24.9668,3301662,0,67310,3234352
12/13/22,Romania,45.9432,24.9668,3301662,0,67310,3234352
12/14/22,Romania,45.9432,24.9668,3301662,0,67310,3234352
12/15/22,Romania,45.9432,24.9668,3301662,0,67310,3234352
12/16/22,Romania,45.9432,24.9668,3301662,0,67310,3234352
12/17/22,Romania,45.9432,24.9668,3301662,0,67310,3234352
1/1/22,Russia,61.52401,105.318756,10340011,0,303496,10036515
1/2/22,Russia,61.52401,105.318756,10358099,0,304284,10053815
1/3/22,Russia,61.52401,105.318756,10374292,0,305096,10069196
1/4/22,Russia,61.52401,105.318756,10390052,0,305906,10084146
1/5/22,Russia,61.52401,105.318756,10405684,0,306710,10098974
1/6/22,Russia,61.52401,105.318756,10420863,0,307488,10113375
1/7/22,Russia,61.52401,105.318756,10437471,0,308258,10129213
1/8/22,Russia,61.52401,105.318756,10453895,0,309041,10144854
1/9/22,Russia,61.52401,105.318756,10470006,0,309787,10160219
1/10/22,Russia,61.52401,105.318756,10485705,0,310513,10175192
1/11/22,Russia,61.52401,105.318756,10503101,0,311281,10191820
1/12/22,Russia,61.52401,105.318756,10520898,0,312010,10208888
1/13/22,Russia,61.52401,105.318756,10541870,0,312733,10229137
1/14/22,Russia,61.52401,105.318756,10565484,0,313458,10252026
1/15/22,Russia,61.52401,105.318756,10592433,0,314166,10278267
1/16/22,Russia,61.52401,105.318756,10621410,0,314838,10306572
1/17/22,Russia,61.52401,105.318756,10651867,0,315495,10336372
1/18/22,Russia,61.52401,105.318756,10682826,0,316168,10366658
1/19/22,Russia,61.52401,105.318756,10716397,0,316852,10399545
1/20/22,Russia,61.52401,105.318756,10754905,0,317523,10437382
1/21/22,Russia,61.52401,105.318756,10804032,0,318200,10485832
1/22/22,Russia,61.52401,105.318756,10860799,0,318869,10541930
1/23/22,Russia,61.52401,105.318756,10923494,0,319536,10603958
1/24/22,Russia,61.52401,105.318756,10988027,0,320178,10667849
1/25/22,Russia,61.52401,105.318756,11055246,0,320844,10734402
1/26/22,Russia,61.52401,105.318756,11129318,0,321484,10807834
1/27/22,Russia,61.52401,105.318756,11217423,0,322135,10895288
1/28/22,Russia,61.52401,105.318756,11314707,0,322796,10991911
1/29/22,Russia,61.52401,105.318756,11427009,0,323452,11103557
1/30/22,Russia,61.52401,105.318756,11547333,0,324060,11223273
1/31/22,Russia,61.52401,105.318756,11670366,0,324672,11345694
2/1/22,Russia,61.52401,105.318756,11795059,0,325321,11469738
2/2/22,Russia,61.52401,105.318756,11936064,0,325986,11610078
2/3/22,Russia,61.52401,105.318756,12090707,0,326642,11764065
2/4/22,Russia,61.52401,105.318756,12257664,0,327310,11930354
2/5/22,Russia,61.52401,105.318756,12433643,0,328014,12105629
2/6/22,Russia,61.52401,105.318756,12612259,0,328664,12283595
2/7/22,Russia,61.52401,105.318756,12782791,0,329264,12453527
2/8/22,Russia,61.52401,105.318756,12946888,0,329951,12616937
2/9/22,Russia,61.52401,105.318756,13128679,0,330609,12798070
2/10/22,Russia,61.52401,105.318756,13323972,0,331300,12992672
2/11/22,Russia,61.52401,105.318756,13526183,0,332010,13194173
2/12/22,Russia,61.52401,105.318756,13728138,0,332727,13395411
2/13/22,Russia,61.52401,105.318756,13923951,0,333421,13590530
2/14/22,Russia,61.52401,105.318756,14102736,0,334093,13768643
2/15/22,Russia,61.52401,105.318756,14267875,0,334785,13933090
2/16/22,Russia,61.52401,105.318756,14445698,0,335521,14110177
2/17/22,Russia,61.52401,105.318756,14624423,0,336299,14288124
2/18/22,Russia,61.52401,105.318756,14802439,0,337074,14465365
2/19/22,Russia,61.52401,105.318756,14979363,0,337860,14641503
2/20/22,Russia,61.52401,105.318756,15147762,0,338595,14809167
2/21/22,Russia,61.52401,105.318756,15297628,0,339319,14958309
2/22/22,Russia,61.52401,105.318756,15430540,0,340101,15090439
2/23/22,Russia,61.52401,105.318756,15566425,0,340872,15225553
2/24/22,Russia,61.52401,105.318756,15697674,0,341624,15356050
2/25/22,Russia,61.52401,105.318756,15819594,0,342397,15477197
2/26/22,Russia,61.52401,105.318756,15941241,0,343178,15598063
2/27/22,Russia,61.52401,105.318756,16055851,0,343934,15711917
2/28/22,Russia,61.52401,105.318756,16161596,0,344655,15816941
3/1/22,Russia,61.52401,105.318756,16257688,0,345427,15912261
3/2/22,Russia,61.52401,105.318756,16353868,0,346197,16007671
3/3/22,Russia,61.52401,105.318756,16445802,0,346967,16098835
3/4/22,Russia,61.52401,105.318756,16533932,0,347730,16186202
3/5/22,Russia,61.52401,105.318756,16619507,0,348467,16271040
3/6/22,Russia,61.52401,105.318756,16698139,0,349196,16348943
3/7/22,Russia,61.52401,105.318756,16770275,0,349853,16420422
3/8/22,Russia,61.52401,105.318756,16835844,0,350490,16485354
3/9/22,Russia,61.52401,105.318756,16893631,0,351124,16542507
3/10/22,Russia,61.52401,105.318756,16943915,0,351776,16592139
3/11/22,Russia,61.52401,105.318756,16993625,0,352437,16641188
3/12/22,Russia,61.52401,105.318756,17040721,0,353054,16687667
3/13/22,Russia,61.52401,105.318756,17084672,0,353635,16731037
3/14/22,Russia,61.52401,105.318756,17124792,0,354157,16770635
3/15/22,Russia,61.52401,105.318756,17160872,0,354702,16806170
3/16/22,Russia,61.52401,105.318756,17196841,0,355267,16841574
3/17/22,Russia,61.52401,105.318756,17231013,0,355816,16875197
3/18/22,Russia,61.52401,105.318756,17264828,0,356327,16908501
3/19/22,Russia,61.52401,105.318756,17297181,0,356812,16940369
3/20/22,Russia,61.52401,105.318756,17327694,0,357234,16970460
3/21/22,Russia,61.52401,105.318756,17356036,0,357634,16998402
3/22/22,Russia,61.52401,105.318756,17382051,0,358093,17023958
3/23/22,Russia,61.52401,105.318756,17408475,0,358510,17049965
3/24/22,Russia,61.52401,105.318756,17433393,0,358919,17074474
3/25/22,Russia,61.52401,105.318756,17458275,0,359307,17098968
3/26/22,Russia,61.52401,105.318756,17481799,0,359693,17122106
3/27/22,Russia,61.52401,105.318756,17504537,0,360021,17144516
3/28/22,Russia,61.52401,105.318756,17525184,0,360347,17164837
3/29/22,Russia,61.52401,105.318756,17544419,0,360674,17183745
3/30/22,Russia,61.52401,105.318756,17564186,0,361014,17203172
3/31/22,Russia,61.52401,105.318756,17583111,0,361348,17221763
4/1/22,Russia,61.52401,105.318756,17601907,0,361679,17240228
4/2/22,Russia,61.52401,105.318756,17619521,0,362008,17257513
4/3/22,Russia,61.52401,105.318756,17636019,0,362304,17273715
4/4/22,Russia,61.52401,105.318756,17651048,0,362581,17288467
4/5/22,Russia,61.52401,105.318756,17664790,0,362890,17301900
4/6/22,Russia,61.52401,105.318756,17679300,0,363175,17316125
4/7/22,Russia,61.52401,105.318756,17693468,0,363455,17330013
4/8/22,Russia,61.52401,105.318756,17707591,0,363731,17343860
4/9/22,Russia,61.52401,105.318756,17720977,0,364011,17356966
4/10/22,Russia,61.52401,105.318756,17733809,0,364265,17369544
4/11/22,Russia,61.52401,105.318756,17745453,0,364506,17380947
4/12/22,Russia,61.52401,105.318756,17756183,0,364779,17391404
4/13/22,Russia,61.52401,105.318756,17767760,0,365038,17402722
4/14/22,Russia,61.52401,105.318756,17778928,0,365285,17413643
4/15/22,Russia,61.52401,105.318756,17790211,0,365540,17424671
4/16/22,Russia,61.52401,105.318756,17801103,0,365774,17435329
4/17/22,Russia,61.52401,105.318756,17811199,0,366001,17445198
4/18/22,Russia,61.52401,105.318756,17820486,0,366209,17454277
4/19/22,Russia,61.52401,105.318756,17829009,0,366436,17462573
4/20/22,Russia,61.52401,105.318756,17838087,0,366654,17471433
4/21/22,Russia,61.52401,105.318756,17846818,0,366845,17479973
4/22/22,Russia,61.52401,105.318756,17855661,0,367036,17488625
4/23/22,Russia,61.52401,105.318756,17864332,0,367203,17497129
4/24/22,Russia,61.52401,105.318756,17872625,0,367366,17505259
4/25/22,Russia,61.52401,105.318756,17880154,0,367521,17512633
4/26/22,Russia,61.52401,105.318756,17887152,0,367692,17519460
4/27/22,Russia,61.52401,105.318756,17894787,0,367850,17526937
4/28/22,Russia,61.52401,105.318756,17902334,0,368011,17534323
4/29/22,Russia,61.52401,105.318756,17909924,0,368166,17541758
4/30/22,Russia,61.52401,105.318756,17917191,0,368319,17548872
5/1/22,Russia,61.52401,105.318756,17924145,0,368463,17555682
5/2/22,Russia,61.52401,105.318756,17930267,0,368595,17561672
5/3/22,Russia,61.52401,105.318756,17935641,0,368716,17566925
5/4/22,Russia,61.52401,105.318756,17940665,0,368840,17571825
5/5/22,Russia,61.52401,105.318756,17945617,0,368974,17576643
5/6/22,Russia,61.52401,105.318756,17951065,0,369106,17581959
5/7/22,Russia,61.52401,105.318756,17956472,0,369236,17587236
5/8/22,Russia,61.52401,105.318756,17961837,0,369350,17592487
5/9/22,Russia,61.52401,105.318756,17966773,0,369451,17597322
5/10/22,Russia,61.52401,105.318756,17971207,0,369548,17601659
5/11/22,Russia,61.52401,105.318756,17975243,0,369644,17605599
5/12/22,Russia,61.52401,105.318756,17979272,0,369752,17609520
5/13/22,Russia,61.52401,105.318756,17984104,0,369855,17614249
5/14/22,Russia,61.52401,105.318756,17989065,0,369961,17619104
5/15/22,Russia,61.52401,105.318756,17993952,0,370057,17623895
5/16/22,Russia,61.52401,105.318756,17998438,0,370145,17628293
5/17/22,Russia,61.52401,105.318756,18002493,0,370252,17632241
5/18/22,Russia,61.52401,105.318756,18007169,0,370354,17636815
5/19/22,Russia,61.52401,105.318756,18012019,0,370449,17641570
5/20/22,Russia,61.52401,105.318756,18017039,0,370542,17646497
5/21/22,Russia,61.52401,105.318756,18022001,0,370642,17651359
5/22/22,Russia,61.52401,105.318756,18026628,0,370721,17655907
5/23/22,Russia,61.52401,105.318756,18030719,0,370795,17659924
5/24/22,Russia,61.52401,105.318756,18034423,0,370882,17663541
5/25/22,Russia,61.52401,105.318756,18038920,0,370972,17667948
5/26/22,Russia,61.52401,105.318756,18043539,0,371061,17672478
5/27/22,Russia,61.52401,105.318756,18048085,0,371141,17676944
5/28/22,Russia,61.52401,105.318756,18052544,0,371223,17681321
5/29/22,Russia,61.52401,105.318756,18056662,0,371306,17685356
5/30/22,Russia,61.52401,105.318756,18060405,0,371378,17689027
5/31/22,Russia,61.52401,105.318756,18063880,0,371464,17692416
6/1/22,Russia,61.52401,105.318756,18067977,0,371546,17696431
6/2/22,Russia,61.52401,105.318756,18072173,0,371628,17700545
6/3/22,Russia,61.52401,105.318756,18076286,0,371703,17704583
6/4/22,Russia,61.52401,105.318756,18080277,0,371781,17708496
6/5/22,Russia,61.52401,105.318756,18083984,0,371854,17712130
6/6/22,Russia,61.52401,105.318756,18087265,0,371915,17715350
6/7/22,Russia,61.52401,105.318756,18090459,0,371986,17718473
6/8/22,Russia,61.52401,105.318756,18094054,0,372062,17721992
6/9/22,Russia,61.52401,105.318756,18097767,0,372136,17725631
6/10/22,Russia,61.52401,105.318756,18101372,0,372205,17729167
6/11/22,Russia,61.52401,105.318756,18104944,0,372276,17732668
6/12/22,Russia,61.52401,105.318756,18108285,0,372338,17735947
6/13/22,Russia,61.52401,105.318756,18111240,0,372392,17738848
6/14/22,Russia,61.52401,105.318756,18113989,0,372452,17741537
6/15/22,Russia,61.52401,105.318756,18116672,0,372515,17744157
6/16/22,Russia,61.52401,105.318756,18119934,0,372579,17747355
6/17/22,Russia,61.52401,105.318756,18123257,0,372642,17750615
6/18/22,Russia,61.52401,105.318756,18126576,0,372707,17753869
6/19/22,Russia,61.52401,105.318756,18129625,0,372769,17756856
6/20/22,Russia,61.52401,105.318756,18132261,0,372821,17759440
6/21/22,Russia,61.52401,105.318756,18134735,0,372880,17761855
6/22/22,Russia,61.52401,105.318756,18137759,0,372943,17764816
6/23/22,Russia,61.52401,105.318756,18140893,0,373010,17767883
6/24/22,Russia,61.52401,105.318756,18144007,0,373075,17770932
6/25/22,Russia,61.52401,105.318756,18147044,0,373134,17773910
6/26/22,Russia,61.52401,105.318756,18150010,0,373189,17776821
6/27/22,Russia,61.52401,105.318756,18152652,0,373240,17779412
6/28/22,Russia,61.52401,105.318756,18155165,0,373297,17781868
6/29/22,Russia,61.52401,105.318756,18158163,0,373349,17784814
6/30/22,Russia,61.52401,105.318756,18161238,0,373404,17787834
7/1/22,Russia,61.52401,105.318756,18164348,0,373456,17790892
7/2/22,Russia,61.52401,105.318756,18167603,0,373505,17794098
7/3/22,Russia,61.52401,105.318756,18170656,0,373552,17797104
7/4/22,Russia,61.52401,105.318756,18173480,0,373595,17799885
7/5/22,Russia,61.52401,105.318756,18176132,0,373640,17802492
7/6/22,Russia,61.52401,105.318756,18179254,0,373683,17805571
7/7/22,Russia,61.52401,105.318756,18182578,0,373732,17808846
7/8/22,Russia,61.52401,105.318756,18185995,0,373779,17812216
7/9/22,Russia,61.52401,105.318756,18189499,0,373821,17815678
7/10/22,Russia,61.52401,105.318756,18192863,0,373859,17819004
7/11/22,Russia,61.52401,105.318756,18195924,0,373896,17822028
7/12/22,Russia,61.52401,105.318756,18198890,0,373942,17824948
7/13/22,Russia,61.52401,105.318756,18202785,0,373983,17828802
7/14/22,Russia,61.52401,105.318756,18206982,0,374024,17832958
7/15/22,Russia,61.52401,105.318756,18211383,0,374062,17837321
7/16/22,Russia,61.52401,105.318756,18216026,0,374102,17841924
7/17/22,Russia,61.52401,105.318756,18220633,0,374147,17846486
7/18/22,Russia,61.52401,105.318756,18225102,0,374182,17850920
7/19/22,Russia,61.52401,105.318756,18229239,0,374223,17855016
7/20/22,Russia,61.52401,105.318756,18234870,0,374259,17860611
7/21/22,Russia,61.52401,105.318756,18241184,0,374298,17866886
7/22/22,Russia,61.52401,105.318756,18247770,0,374338,17873432
7/23/22,Russia,61.52401,105.318756,18254644,0,374374,17880270
7/24/22,Russia,61.52401,105.318756,18262088,0,374411,17887677
7/25/22,Russia,61.52401,105.318756,18268570,0,374444,17894126
7/26/22,Russia,61.52401,105.318756,18274674,0,374490,17900184
7/27/22,Russia,61.52401,105.318756,18283628,0,374523,17909105
7/28/22,Russia,61.52401,105.318756,18295035,0,374563,17920472
7/29/22,Russia,61.52401,105.318756,18306326,0,374602,17931724
7/30/22,Russia,61.52401,105.318756,18318445,0,374645,17943800
7/31/22,Russia,61.52401,105.318756,18330786,0,374683,17956103
8/1/22,Russia,61.52401,105.318756,18341459,0,374719,17966740
8/2/22,Russia,61.52401,105.318756,18350864,0,374765,17976099
8/3/22,Russia,61.52401,105.318756,18365348,0,374807,17990541
8/4/22,Russia,61.52401,105.318756,18382278,0,374849,18007429
8/5/22,Russia,61.52401,105.318756,18400593,0,374895,18025698
8/6/22,Russia,61.52401,105.318756,18420288,0,374940,18045348
8/7/22,Russia,61.52401,105.318756,18440314,0,374983,18065331
8/8/22,Russia,61.52401,105.318756,18457892,0,375027,18082865
8/9/22,Russia,61.52401,105.318756,18473940,0,375085,18098855
8/10/22,Russia,61.52401,105.318756,18497489,0,375140,18122349
8/11/22,Russia,61.52401,105.318756,18523028,0,375192,18147836
8/12/22,Russia,61.52401,105.318756,18550522,0,375248,18175274
8/13/22,Russia,61.52401,105.318756,18578731,0,375306,18203425
8/14/22,Russia,61.52401,105.318756,18607284,0,375360,18231924
8/15/22,Russia,61.52401,105.318756,18632165,0,375413,18256752
8/16/22,Russia,61.52401,105.318756,18655654,0,375470,18280184
8/17/22,Russia,61.52401,105.318756,18688416,0,375532,18312884
8/18/22,Russia,61.52401,105.318756,18723731,0,375594,18348137
8/19/22,Russia,61.52401,105.318756,18760762,0,375658,18385104
8/20/22,Russia,61.52401,105.318756,18800180,0,375725,18424455
8/21/22,Russia,61.52401,105.318756,18839232,0,375788,18463444
8/22/22,Russia,61.52401,105.318756,18871701,0,375845,18495856
8/23/22,Russia,61.52401,105.318756,18902128,0,375912,18526216
8/24/22,Russia,61.52401,105.318756,18941817,0,375983,18565834
8/25/22,Russia,61.52401,105.318756,18985174,0,376052,18609122
8/26/22,Russia,61.52401,105.318756,19030966,0,376131,18654835
8/27/22,Russia,61.52401,105.318756,19077368,0,376219,18701149
8/28/22,Russia,61.52401,105.318756,19123501,0,376301,18747200
8/29/22,Russia,61.52401,105.318756,19162384,0,376377,18786007
8/30/22,Russia,61.52401,105.318756,19198863,0,376469,18822394
8/31/22,Russia,61.52401,105.318756,19244647,0,376558,18868089
9/1/22,Russia,61.52401,105.318756,19293663,0,376653,18917010
9/2/22,Russia,61.52401,105.318756,19343942,0,376743,18967199
9/3/22,Russia,61.52401,105.318756,19394864,0,376832,19018032
9/4/22,Russia,61.52401,105.318756,19442127,0,376918,19065209
9/5/22,Russia,61.52401,105.318756,19483167,0,376994,19106173
9/6/22,Russia,61.52401,105.318756,19521190,0,377088,19144102
9/7/22,Russia,61.52401,105.318756,19568544,0,377180,19191364
9/8/22,Russia,61.52401,105.318756,19618428,0,377273,19241155
9/9/22,Russia,61.52401,105.318756,19669848,0,377368,19292480
9/10/22,Russia,61.52401,105.318756,19722556,0,377462,19345094
9/11/22,Russia,61.52401,105.318756,19774711,0,377548,19397163
9/12/22,Russia,61.52401,105.318756,19820622,0,377629,19442993
9/13/22,Russia,61.52401,105.318756,19864164,0,377728,19486436
9/14/22,Russia,61.52401,105.318756,19915400,0,377823,19537577
9/15/22,Russia,61.52401,105.318756,19970827,0,377921,19592906
9/16/22,Russia,61.52401,105.318756,20029220,0,378029,19651191
9/17/22,Russia,61.52401,105.318756,20086979,0,378134,19708845
9/18/22,Russia,61.52401,105.318756,20143127,0,378234,19764893
9/19/22,Russia,61.52401,105.318756,20192164,0,378324,19813840
9/20/22,Russia,61.52401,105.318756,20238236,0,378419,19859817
9/21/22,Russia,61.52401,105.318756,20290869,0,378524,19912345
9/22/22,Russia,61.52401,105.318756,20343828,0,378628,19965200
9/23/22,Russia,61.52401,105.318756,20396766,0,378730,20018036
9/24/22,Russia,61.52401,105.318756,20447507,0,378840,20068667
9/25/22,Russia,61.52401,105.318756,20493730,0,378935,20114795
9/26/22,Russia,61.52401,105.318756,20533598,0,379019,20154579
9/27/22,Russia,61.52401,105.318756,20569954,0,379120,20190834
9/28/22,Russia,61.52401,105.318756,20609684,0,379227,20230457
9/29/22,Russia,61.52401,105.318756,20648073,0,379334,20268739
9/30/22,Russia,61.52401,105.318756,20684948,0,379438,20305510
10/1/22,Russia,61.52401,105.318756,20717823,0,379539,20338284
10/2/22,Russia,61.52401,105.318756,20747599,0,379635,20367964
10/3/22,Russia,61.52401,105.318756,20771538,0,379725,20391813
10/4/22,Russia,61.52401,105.318756,20793041,0,379829,20413212
10/5/22,Russia,61.52401,105.318756,20816640,0,379941,20436699
10/6/22,Russia,61.52401,105.318756,20839504,0,380048,20459456
10/7/22,Russia,61.52401,105.318756,20861561,0,380151,20481410
10/8/22,Russia,61.52401,105.318756,20881937,0,380255,20501682
10/9/22,Russia,61.52401,105.318756,20900611,0,380356,20520255
10/10/22,Russia,61.52401,105.318756,20916112,0,380451,20535661
10/11/22,Russia,61.52401,105.318756,20929929,0,380556,20549373
10/12/22,Russia,61.52401,105.318756,20945428,0,380658,20564770
10/13/22,Russia,61.52401,105.318756,20960802,0,380757,20580045
10/14/22,Russia,61.52401,105.318756,20975381,0,380854,20594527
10/15/22,Russia,61.52401,105.318756,20988638,0,380950,20607688
10/16/22,Russia,61.52401,105.318756,21000908,0,381043,20619865
10/17/22,Russia,61.52401,105.318756,21011201,0,381134,20630067
10/18/22,Russia,61.52401,105.318756,21020607,0,381224,20639383
10/19/22,Russia,61.52401,105.318756,21031202,0,381314,20649888
10/20/22,Russia,61.52401,105.318756,21041184,0,381402,20659782
10/21/22,Russia,61.52401,105.318756,21050850,0,381494,20669356
10/22/22,Russia,61.52401,105.318756,21060091,0,381582,20678509
10/23/22,Russia,61.52401,105.318756,21068678,0,381670,20687008
10/24/22,Russia,61.52401,105.318756,21075901,0,381758,20694143
10/25/22,Russia,61.52401,105.318756,21082412,0,381841,20700571
10/26/22,Russia,61.52401,105.318756,21089873,0,381920,20707953
10/27/22,Russia,61.52401,105.318756,21097662,0,382002,20715660
10/28/22,Russia,61.52401,105.318756,21105179,0,382079,20723100
10/29/22,Russia,61.52401,105.318756,21112216,0,382157,20730059
10/30/22,Russia,61.52401,105.318756,21118937,0,382231,20736706
10/31/22,Russia,61.52401,105.318756,21124658,0,382302,20742356
11/1/22,Russia,61.52401,105.318756,21129849,0,382372,20747477
11/2/22,Russia,61.52401,105.318756,21136186,0,382438,20753748
11/3/22,Russia,61.52401,105.318756,21142507,0,382510,20759997
11/4/22,Russia,61.52401,105.318756,21148598,0,382578,20766020
11/5/22,Russia,61.52401,105.318756,21154149,0,382644,20771505
11/6/22,Russia,61.52401,105.318756,21158672,0,382705,20775967
11/7/22,Russia,61.52401,105.318756,21163061,0,382765,20780296
11/8/22,Russia,61.52401,105.318756,21167353,0,382828,20784525
11/9/22,Russia,61.52401,105.318756,21172652,0,382890,20789762
11/10/22,Russia,61.52401,105.318756,21178202,0,382949,20795253
11/11/22,Russia,61.52401,105.318756,21183691,0,383014,20800677
11/12/22,Russia,61.52401,105.318756,21189139,0,383075,20806064
11/13/22,Russia,61.52401,105.318756,21194442,0,383134,20811308
11/14/22,Russia,61.52401,105.318756,21198961,0,383195,20815766
11/15/22,Russia,61.52401,105.318756,21203361,0,383258,20820103
11/16/22,Russia,61.52401,105.318756,21208695,0,383320,20825375
11/17/22,Russia,61.52401,105.318756,21214339,0,383381,20830958
11/18/22,Russia,61.52401,105.318756,21219827,0,383441,20836386
11/19/22,Russia,61.52401,105.318756,21225214,0,383503,20841711
11/20/22,Russia,61.52401,105.318756,21230367,0,383562,20846805
11/21/22,Russia,61.52401,105.318756,21234988,0,383617,20851371
11/22/22,Russia,61.52401,105.318756,21239400,0,383676,20855724
11/23/22,Russia,61.52401,105.318756,21244991,0,383728,20861263
11/24/22,Russia,61.52401,105.318756,21250733,0,383785,20866948
11/25/22,Russia,61.52401,105.318756,21256669,0,383841,20872828
11/26/22,Russia,61.52401,105.318756,21262695,0,383892,20878803
11/27/22,Russia,61.52401,105.318756,21268561,0,383943,20884618
11/28/22,Russia,61.52401,105.318756,21273541,0,383993,20889548
11/29/22,Russia,61.52401,105.318756,21278433,0,384044,20894389
11/30/22,Russia,61.52401,105.318756,21284476,0,384103,20900373
12/1/22,Russia,61.52401,105.318756,21291214,0,384159,20907055
12/2/22,Russia,61.52401,105.318756,21297883,0,384215,20913668
12/3/22,Russia,61.52401,105.318756,21304497,0,384272,20920225
12/4/22,Russia,61.52401,105.318756,21311047,0,384327,20926720
12/5/22,Russia,61.52401,105.318756,21316663,0,384379,20932284
12/6/22,Russia,61.52401,105.318756,21322168,0,384437,20937731
12/7/22,Russia,61.52401,105.318756,21329068,0,384494,20944574
12/8/22,Russia,61.52401,105.318756,21336448,0,384546,20951902
12/9/22,Russia,61.52401,105.318756,21343842,0,384597,20959245
12/10/22,Russia,61.52401,105.318756,21351196,0,384650,20966546
12/11/22,Russia,61.52401,105.318756,21358235,0,384700,20973535
12/12/22,Russia,61.52401,105.318756,21364571,0,384749,20979822
12/13/22,Russia,61.52401,105.318756,21370489,0,384807,20985682
12/14/22,Russia,61.52401,105.318756,21377974,0,384861,20993113
12/15/22,Russia,61.52401,105.318756,21385746,0,384916,21000830
12/16/22,Russia,61.52401,105.318756,21394122,0,384974,21009148
12/17/22,Russia,61.52401,105.318756,21401586,0,385032,21016554
1/1/22,Rwanda,-1.9403,29.8739,112654,0,1351,111303
1/2/22,Rwanda,-1.9403,29.8739,113582,0,1355,112227
1/3/22,Rwanda,-1.9403,29.8739,114580,0,1357,113223
1/4/22,Rwanda,-1.9403,29.8739,116057,0,1357,114700
1/5/22,Rwanda,-1.9403,29.8739,117123,0,1362,115761
1/6/22,Rwanda,-1.9403,29.8739,118342,0,1367,116975
1/7/22,Rwanda,-1.9403,29.8739,119421,0,1367,118054
1/8/22,Rwanda,-1.9403,29.8739,120374,0,1373,119001
1/9/22,Rwanda,-1.9403,29.8739,120984,0,1375,119609
1/10/22,Rwanda,-1.9403,29.8739,121742,0,1384,120358
1/11/22,Rwanda,-1.9403,29.8739,122403,0,1387,121016
1/12/22,Rwanda,-1.9403,29.8739,123166,0,1391,121775
1/13/22,Rwanda,-1.9403,29.8739,123886,0,1395,122491
1/14/22,Rwanda,-1.9403,29.8739,124419,0,1399,123020
1/15/22,Rwanda,-1.9403,29.8739,124802,0,1403,123399
1/16/22,Rwanda,-1.9403,29.8739,125166,0,1408,123758
1/17/22,Rwanda,-1.9403,29.8739,125568,0,1411,124157
1/18/22,Rwanda,-1.9403,29.8739,126133,0,1413,124720
1/19/22,Rwanda,-1.9403,29.8739,126685,0,1417,125268
1/20/22,Rwanda,-1.9403,29.8739,127227,0,1422,125805
1/21/22,Rwanda,-1.9403,29.8739,127655,0,1428,126227
1/22/22,Rwanda,-1.9403,29.8739,127902,0,1432,126470
1/23/22,Rwanda,-1.9403,29.8739,128009,0,1432,126577
1/24/22,Rwanda,-1.9403,29.8739,128205,0,1433,126772
1/25/22,Rwanda,-1.9403,29.8739,128378,0,1433,126945
1/26/22,Rwanda,-1.9403,29.8739,128509,0,1434,127075
1/27/22,Rwanda,-1.9403,29.8739,128629,0,1436,127193
1/28/22,Rwanda,-1.9403,29.8739,128708,0,1438,127270
1/29/22,Rwanda,-1.9403,29.8739,128802,0,1438,127364
1/30/22,Rwanda,-1.9403,29.8739,128841,0,1438,127403
1/31/22,Rwanda,-1.9403,29.8739,128891,0,1440,127451
2/1/22,Rwanda,-1.9403,29.8739,128933,0,1444,127489
2/2/22,Rwanda,-1.9403,29.8739,128971,0,1444,127527
2/3/22,Rwanda,-1.9403,29.8739,129039,0,1444,127595
2/4/22,Rwanda,-1.9403,29.8739,129084,0,1445,127639
2/5/22,Rwanda,-1.9403,29.8739,129125,0,1446,127679
2/6/22,Rwanda,-1.9403,29.8739,129141,0,1446,127695
2/7/22,Rwanda,-1.9403,29.8739,129157,0,1447,127710
2/8/22,Rwanda,-1.9403,29.8739,129177,0,1447,127730
2/9/22,Rwanda,-1.9403,29.8739,129210,0,1449,127761
2/10/22,Rwanda,-1.9403,29.8739,129234,0,1449,127785
2/11/22,Rwanda,-1.9403,29.8739,129278,0,1449,127829
2/12/22,Rwanda,-1.9403,29.8739,129295,0,1450,127845
2/13/22,Rwanda,-1.9403,29.8739,129298,0,1450,127848
2/14/22,Rwanda,-1.9403,29.8739,129311,0,1452,127859
2/15/22,Rwanda,-1.9403,29.8739,129326,0,1452,127874
2/16/22,Rwanda,-1.9403,29.8739,129337,0,1452,127885
2/17/22,Rwanda,-1.9403,29.8739,129345,0,1454,127891
2/18/22,Rwanda,-1.9403,29.8739,129359,0,1454,127905
2/19/22,Rwanda,-1.9403,29.8739,129369,0,1455,127914
2/20/22,Rwanda,-1.9403,29.8739,129372,0,1456,127916
2/21/22,Rwanda,-1.9403,29.8739,129378,0,1456,127922
2/22/22,Rwanda,-1.9403,29.8739,129419,0,1457,127962
2/23/22,Rwanda,-1.9403,29.8739,129436,0,1457,127979
2/24/22,Rwanda,-1.9403,29.8739,129468,0,1457,128011
2/25/22,Rwanda,-1.9403,29.8739,129483,0,1457,128026
2/26/22,Rwanda,-1.9403,29.8739,129485,0,1457,128028
2/27/22,Rwanda,-1.9403,29.8739,129489,0,1457,128032
2/28/22,Rwanda,-1.9403,29.8739,129502,0,1457,128045
3/1/22,Rwanda,-1.9403,29.8739,129516,0,1457,128059
3/2/22,Rwanda,-1.9403,29.8739,129533,0,1457,128076
3/3/22,Rwanda,-1.9403,29.8739,129543,0,1458,128085
3/4/22,Rwanda,-1.9403,29.8739,129548,0,1458,128090
3/5/22,Rwanda,-1.9403,29.8739,129551,0,1458,128093
3/6/22,Rwanda,-1.9403,29.8739,129556,0,1458,128098
3/7/22,Rwanda,-1.9403,29.8739,129560,0,1458,128102
3/8/22,Rwanda,-1.9403,29.8739,129567,0,1459,128108
3/9/22,Rwanda,-1.9403,29.8739,129569,0,1459,128110
3/10/22,Rwanda,-1.9403,29.8739,129576,0,1459,128117
3/11/22,Rwanda,-1.9403,29.8739,129589,0,1459,128130
3/12/22,Rwanda,-1.9403,29.8739,129596,0,1459,128137
3/13/22,Rwanda,-1.9403,29.8739,129601,0,1459,128142
3/14/22,Rwanda,-1.9403,29.8739,129602,0,1459,128143
3/15/22,Rwanda,-1.9403,29.8739,129610,0,1459,128151
3/16/22,Rwanda,-1.9403,29.8739,129615,0,1459,128156
3/17/22,Rwanda,-1.9403,29.8739,129623,0,1459,128164
3/18/22,Rwanda,-1.9403,29.8739,129635,0,1459,128176
3/19/22,Rwanda,-1.9403,29.8739,129637,0,1459,128178
3/20/22,Rwanda,-1.9403,29.8739,129647,0,1459,128188
3/21/22,Rwanda,-1.9403,29.8739,129658,0,1459,128199
3/22/22,Rwanda,-1.9403,29.8739,129674,0,1459,128215
3/23/22,Rwanda,-1.9403,29.8739,129693,0,1459,128234
3/24/22,Rwanda,-1.9403,29.8739,129705,0,1459,128246
3/25/22,Rwanda,-1.9403,29.8739,129706,0,1459,128247
3/26/22,Rwanda,-1.9403,29.8739,129708,0,1459,128249
3/27/22,Rwanda,-1.9403,29.8739,129709,0,1459,128250
3/28/22,Rwanda,-1.9403,29.8739,129712,0,1459,128253
3/29/22,Rwanda,-1.9403,29.8739,129714,0,1459,128255
3/30/22,Rwanda,-1.9403,29.8739,129718,0,1459,128259
3/31/22,Rwanda,-1.9403,29.8739,129722,0,1459,128263
4/1/22,Rwanda,-1.9403,29.8739,129726,0,1459,128267
4/2/22,Rwanda,-1.9403,29.8739,129726,0,1459,128267
4/3/22,Rwanda,-1.9403,29.8739,129728,0,1459,128269
4/4/22,Rwanda,-1.9403,29.8739,129733,0,1459,128274
4/5/22,Rwanda,-1.9403,29.8739,129736,0,1459,128277
4/6/22,Rwanda,-1.9403,29.8739,129739,0,1459,128280
4/7/22,Rwanda,-1.9403,29.8739,129742,0,1459,128283
4/8/22,Rwanda,-1.9403,29.8739,129743,0,1459,128284
4/9/22,Rwanda,-1.9403,29.8739,129748,0,1459,128289
4/10/22,Rwanda,-1.9403,29.8739,129750,0,1459,128291
4/11/22,Rwanda,-1.9403,29.8739,129757,0,1459,128298
4/12/22,Rwanda,-1.9403,29.8739,129757,0,1459,128298
4/13/22,Rwanda,-1.9403,29.8739,129759,0,1459,128300
4/14/22,Rwanda,-1.9403,29.8739,129760,0,1459,128301
4/15/22,Rwanda,-1.9403,29.8739,129760,0,1459,128301
4/16/22,Rwanda,-1.9403,29.8739,129760,0,1459,128301
4/17/22,Rwanda,-1.9403,29.8739,129760,0,1459,128301
4/18/22,Rwanda,-1.9403,29.8739,129760,0,1459,128301
4/19/22,Rwanda,-1.9403,29.8739,129769,0,1459,128310
4/20/22,Rwanda,-1.9403,29.8739,129769,0,1459,128310
4/21/22,Rwanda,-1.9403,29.8739,129769,0,1459,128310
4/22/22,Rwanda,-1.9403,29.8739,129772,0,1459,128313
4/23/22,Rwanda,-1.9403,29.8739,129772,0,1459,128313
4/24/22,Rwanda,-1.9403,29.8739,129772,0,1459,128313
4/25/22,Rwanda,-1.9403,29.8739,129785,0,1459,128326
4/26/22,Rwanda,-1.9403,29.8739,129788,0,1459,128329
4/27/22,Rwanda,-1.9403,29.8739,129791,0,1459,128332
4/28/22,Rwanda,-1.9403,29.8739,129797,0,1459,128338
4/29/22,Rwanda,-1.9403,29.8739,129799,0,1459,128340
4/30/22,Rwanda,-1.9403,29.8739,129806,0,1459,128347
5/1/22,Rwanda,-1.9403,29.8739,129810,0,1459,128351
5/2/22,Rwanda,-1.9403,29.8739,129834,0,1459,128375
5/3/22,Rwanda,-1.9403,29.8739,129834,0,1459,128375
5/4/22,Rwanda,-1.9403,29.8739,129839,0,1459,128380
5/5/22,Rwanda,-1.9403,29.8739,129843,0,1459,128384
5/6/22,Rwanda,-1.9403,29.8739,129849,0,1459,128390
5/7/22,Rwanda,-1.9403,29.8739,129849,0,1459,128390
5/8/22,Rwanda,-1.9403,29.8739,129849,0,1459,128390
5/9/22,Rwanda,-1.9403,29.8739,129872,0,1459,128413
5/10/22,Rwanda,-1.9403,29.8739,129875,0,1459,128416
5/11/22,Rwanda,-1.9403,29.8739,129875,0,1459,128416
5/12/22,Rwanda,-1.9403,29.8739,129898,0,1459,128439
5/13/22,Rwanda,-1.9403,29.8739,129898,0,1459,128439
5/14/22,Rwanda,-1.9403,29.8739,129907,0,1459,128448
5/15/22,Rwanda,-1.9403,29.8739,129910,0,1459,128451
5/16/22,Rwanda,-1.9403,29.8739,129931,0,1459,128472
5/17/22,Rwanda,-1.9403,29.8739,129931,0,1459,128472
5/18/22,Rwanda,-1.9403,29.8739,129942,0,1459,128483
5/19/22,Rwanda,-1.9403,29.8739,129951,0,1459,128492
5/20/22,Rwanda,-1.9403,29.8739,129970,0,1459,128511
5/21/22,Rwanda,-1.9403,29.8739,129971,0,1459,128512
5/22/22,Rwanda,-1.9403,29.8739,129978,0,1459,128519
5/23/22,Rwanda,-1.9403,29.8739,129988,0,1459,128529
5/24/22,Rwanda,-1.9403,29.8739,130003,0,1459,128544
5/25/22,Rwanda,-1.9403,29.8739,130013,0,1459,128554
5/26/22,Rwanda,-1.9403,29.8739,130023,0,1459,128564
5/27/22,Rwanda,-1.9403,29.8739,130026,0,1459,128567
5/28/22,Rwanda,-1.9403,29.8739,130026,0,1459,128567
5/29/22,Rwanda,-1.9403,29.8739,130026,0,1459,128567
5/30/22,Rwanda,-1.9403,29.8739,130052,0,1459,128593
5/31/22,Rwanda,-1.9403,29.8739,130057,0,1459,128598
6/1/22,Rwanda,-1.9403,29.8739,130061,0,1459,128602
6/2/22,Rwanda,-1.9403,29.8739,130116,0,1459,128657
6/3/22,Rwanda,-1.9403,29.8739,130141,0,1459,128682
6/4/22,Rwanda,-1.9403,29.8739,130159,0,1459,128700
6/5/22,Rwanda,-1.9403,29.8739,130180,0,1459,128721
6/6/22,Rwanda,-1.9403,29.8739,130197,0,1459,128738
6/7/22,Rwanda,-1.9403,29.8739,130215,0,1459,128756
6/8/22,Rwanda,-1.9403,29.8739,130240,0,1459,128781
6/9/22,Rwanda,-1.9403,29.8739,130278,0,1459,128819
6/10/22,Rwanda,-1.9403,29.8739,130294,0,1459,128835
6/11/22,Rwanda,-1.9403,29.8739,130319,0,1459,128860
6/12/22,Rwanda,-1.9403,29.8739,130345,0,1459,128886
6/13/22,Rwanda,-1.9403,29.8739,130375,0,1459,128916
6/14/22,Rwanda,-1.9403,29.8739,130413,0,1459,128954
6/15/22,Rwanda,-1.9403,29.8739,130443,0,1459,128984
6/16/22,Rwanda,-1.9403,29.8739,130472,0,1459,129013
6/17/22,Rwanda,-1.9403,29.8739,130510,0,1459,129051
6/18/22,Rwanda,-1.9403,29.8739,130531,0,1459,129072
6/19/22,Rwanda,-1.9403,29.8739,130568,0,1459,129109
6/20/22,Rwanda,-1.9403,29.8739,130608,0,1459,129149
6/21/22,Rwanda,-1.9403,29.8739,130646,0,1459,129187
6/22/22,Rwanda,-1.9403,29.8739,130685,0,1459,129226
6/23/22,Rwanda,-1.9403,29.8739,130723,0,1459,129264
6/24/22,Rwanda,-1.9403,29.8739,130749,0,1459,129290
6/25/22,Rwanda,-1.9403,29.8739,130787,0,1459,129328
6/26/22,Rwanda,-1.9403,29.8739,130819,0,1459,129360
6/27/22,Rwanda,-1.9403,29.8739,130859,0,1459,129400
6/28/22,Rwanda,-1.9403,29.8739,130902,0,1459,129443
6/29/22,Rwanda,-1.9403,29.8739,130952,0,1459,129493
6/30/22,Rwanda,-1.9403,29.8739,131021,0,1460,129561
7/1/22,Rwanda,-1.9403,29.8739,131084,0,1460,129624
7/2/22,Rwanda,-1.9403,29.8739,131154,0,1460,129694
7/3/22,Rwanda,-1.9403,29.8739,131233,0,1460,129773
7/4/22,Rwanda,-1.9403,29.8739,131270,0,1460,129810
7/5/22,Rwanda,-1.9403,29.8739,131347,0,1461,129886
7/6/22,Rwanda,-1.9403,29.8739,131420,0,1461,129959
7/7/22,Rwanda,-1.9403,29.8739,131490,0,1461,130029
7/8/22,Rwanda,-1.9403,29.8739,131566,0,1461,130105
7/9/22,Rwanda,-1.9403,29.8739,131630,0,1461,130169
7/10/22,Rwanda,-1.9403,29.8739,131668,0,1461,130207
7/11/22,Rwanda,-1.9403,29.8739,131691,0,1461,130230
7/12/22,Rwanda,-1.9403,29.8739,131734,0,1462,130272
7/13/22,Rwanda,-1.9403,29.8739,131766,0,1462,130304
7/14/22,Rwanda,-1.9403,29.8739,131808,0,1462,130346
7/15/22,Rwanda,-1.9403,29.8739,131832,0,1462,130370
7/16/22,Rwanda,-1.9403,29.8739,131857,0,1464,130393
7/17/22,Rwanda,-1.9403,29.8739,131880,0,1464,130416
7/18/22,Rwanda,-1.9403,29.8739,131906,0,1464,130442
7/19/22,Rwanda,-1.9403,29.8739,131944,0,1466,130478
7/20/22,Rwanda,-1.9403,29.8739,131950,0,1466,130484
7/21/22,Rwanda,-1.9403,29.8739,131970,0,1466,130504
7/22/22,Rwanda,-1.9403,29.8739,132028,0,1466,130562
7/23/22,Rwanda,-1.9403,29.8739,132044,0,1466,130578
7/24/22,Rwanda,-1.9403,29.8739,132057,0,1466,130591
7/25/22,Rwanda,-1.9403,29.8739,132121,0,1466,130655
7/26/22,Rwanda,-1.9403,29.8739,132171,0,1466,130705
7/27/22,Rwanda,-1.9403,29.8739,132198,0,1466,130732
7/28/22,Rwanda,-1.9403,29.8739,132211,0,1466,130745
7/29/22,Rwanda,-1.9403,29.8739,132236,0,1466,130770
7/30/22,Rwanda,-1.9403,29.8739,132236,0,1466,130770
7/31/22,Rwanda,-1.9403,29.8739,132239,0,1466,130773
8/1/22,Rwanda,-1.9403,29.8739,132242,0,1466,130776
8/2/22,Rwanda,-1.9403,29.8739,132267,0,1466,130801
8/3/22,Rwanda,-1.9403,29.8739,132280,0,1466,130814
8/4/22,Rwanda,-1.9403,29.8739,132285,0,1466,130819
8/5/22,Rwanda,-1.9403,29.8739,132299,0,1466,130833
8/6/22,Rwanda,-1.9403,29.8739,132299,0,1466,130833
8/7/22,Rwanda,-1.9403,29.8739,132299,0,1466,130833
8/8/22,Rwanda,-1.9403,29.8739,132326,0,1466,130860
8/9/22,Rwanda,-1.9403,29.8739,132326,0,1466,130860
8/10/22,Rwanda,-1.9403,29.8739,132331,0,1466,130865
8/11/22,Rwanda,-1.9403,29.8739,132336,0,1466,130870
8/12/22,Rwanda,-1.9403,29.8739,132343,0,1466,130877
8/13/22,Rwanda,-1.9403,29.8739,132354,0,1466,130888
8/14/22,Rwanda,-1.9403,29.8739,132357,0,1466,130891
8/15/22,Rwanda,-1.9403,29.8739,132362,0,1466,130896
8/16/22,Rwanda,-1.9403,29.8739,132367,0,1466,130901
8/17/22,Rwanda,-1.9403,29.8739,132370,0,1466,130904
8/18/22,Rwanda,-1.9403,29.8739,132376,0,1466,130910
8/19/22,Rwanda,-1.9403,29.8739,132385,0,1466,130919
8/20/22,Rwanda,-1.9403,29.8739,132386,0,1466,130920
8/21/22,Rwanda,-1.9403,29.8739,132390,0,1466,130924
8/22/22,Rwanda,-1.9403,29.8739,132391,0,1466,130925
8/23/22,Rwanda,-1.9403,29.8739,132398,0,1466,130932
8/24/22,Rwanda,-1.9403,29.8739,132401,0,1466,130935
8/25/22,Rwanda,-1.9403,29.8739,132408,0,1466,130942
8/26/22,Rwanda,-1.9403,29.8739,132412,0,1466,130946
8/27/22,Rwanda,-1.9403,29.8739,132414,0,1466,130948
8/28/22,Rwanda,-1.9403,29.8739,132415,0,1466,130949
8/29/22,Rwanda,-1.9403,29.8739,132421,0,1466,130955
8/30/22,Rwanda,-1.9403,29.8739,132427,0,1466,130961
8/31/22,Rwanda,-1.9403,29.8739,132439,0,1466,130973
9/1/22,Rwanda,-1.9403,29.8739,132443,0,1466,130977
9/2/22,Rwanda,-1.9403,29.8739,132448,0,1466,130982
9/3/22,Rwanda,-1.9403,29.8739,132449,0,1466,130983
9/4/22,Rwanda,-1.9403,29.8739,132453,0,1466,130987
9/5/22,Rwanda,-1.9403,29.8739,132455,0,1466,130989
9/6/22,Rwanda,-1.9403,29.8739,132458,0,1466,130992
9/7/22,Rwanda,-1.9403,29.8739,132466,0,1466,131000
9/8/22,Rwanda,-1.9403,29.8739,132471,0,1466,131005
9/9/22,Rwanda,-1.9403,29.8739,132472,0,1466,131006
9/10/22,Rwanda,-1.9403,29.8739,132472,0,1466,131006
9/11/22,Rwanda,-1.9403,29.8739,132472,0,1466,131006
9/12/22,Rwanda,-1.9403,29.8739,132474,0,1466,131008
9/13/22,Rwanda,-1.9403,29.8739,132475,0,1466,131009
9/14/22,Rwanda,-1.9403,29.8739,132478,0,1466,131012
9/15/22,Rwanda,-1.9403,29.8739,132480,0,1466,131014
9/16/22,Rwanda,-1.9403,29.8739,132481,0,1466,131015
9/17/22,Rwanda,-1.9403,29.8739,132483,0,1466,131017
9/18/22,Rwanda,-1.9403,29.8739,132486,0,1466,131020
9/19/22,Rwanda,-1.9403,29.8739,132486,0,1466,131020
9/20/22,Rwanda,-1.9403,29.8739,132521,0,1466,131055
9/21/22,Rwanda,-1.9403,29.8739,132521,0,1466,131055
9/22/22,Rwanda,-1.9403,29.8739,132521,0,1466,131055
9/23/22,Rwanda,-1.9403,29.8739,132521,0,1466,131055
9/24/22,Rwanda,-1.9403,29.8739,132521,0,1466,131055
9/25/22,Rwanda,-1.9403,29.8739,132521,0,1466,131055
9/26/22,Rwanda,-1.9403,29.8739,132495,0,1466,131029
9/27/22,Rwanda,-1.9403,29.8739,132496,0,1466,131030
9/28/22,Rwanda,-1.9403,29.8739,132496,0,1466,131030
9/29/22,Rwanda,-1.9403,29.8739,132498,0,1466,131032
9/30/22,Rwanda,-1.9403,29.8739,132500,0,1466,131034
10/1/22,Rwanda,-1.9403,29.8739,132501,0,1466,131035
10/2/22,Rwanda,-1.9403,29.8739,132503,0,1466,131037
10/3/22,Rwanda,-1.9403,29.8739,132504,0,1467,131037
10/4/22,Rwanda,-1.9403,29.8739,132504,0,1467,131037
10/5/22,Rwanda,-1.9403,29.8739,132507,0,1467,131040
10/6/22,Rwanda,-1.9403,29.8739,132508,0,1467,131041
10/7/22,Rwanda,-1.9403,29.8739,132508,0,1467,131041
10/8/22,Rwanda,-1.9403,29.8739,132511,0,1467,131044
10/9/22,Rwanda,-1.9403,29.8739,132512,0,1467,131045
10/10/22,Rwanda,-1.9403,29.8739,132518,0,1467,131051
10/11/22,Rwanda,-1.9403,29.8739,132523,0,1467,131056
10/12/22,Rwanda,-1.9403,29.8739,132523,0,1467,131056
10/13/22,Rwanda,-1.9403,29.8739,132525,0,1467,131058
10/14/22,Rwanda,-1.9403,29.8739,132526,0,1467,131059
10/15/22,Rwanda,-1.9403,29.8739,132526,0,1467,131059
10/16/22,Rwanda,-1.9403,29.8739,132528,0,1467,131061
10/17/22,Rwanda,-1.9403,29.8739,132530,0,1467,131063
10/18/22,Rwanda,-1.9403,29.8739,132530,0,1467,131063
10/19/22,Rwanda,-1.9403,29.8739,132533,0,1467,131066
10/20/22,Rwanda,-1.9403,29.8739,132533,0,1467,131066
10/21/22,Rwanda,-1.9403,29.8739,132533,0,1467,131066
10/22/22,Rwanda,-1.9403,29.8739,132533,0,1467,131066
10/23/22,Rwanda,-1.9403,29.8739,132533,0,1467,131066
10/24/22,Rwanda,-1.9403,29.8739,132556,0,1467,131089
10/25/22,Rwanda,-1.9403,29.8739,132556,0,1467,131089
10/26/22,Rwanda,-1.9403,29.8739,132556,0,1467,131089
10/27/22,Rwanda,-1.9403,29.8739,132556,0,1467,131089
10/28/22,Rwanda,-1.9403,29.8739,132556,0,1467,131089
10/29/22,Rwanda,-1.9403,29.8739,132556,0,1467,131089
10/30/22,Rwanda,-1.9403,29.8739,132584,0,1467,131117
10/31/22,Rwanda,-1.9403,29.8739,132584,0,1467,131117
11/1/22,Rwanda,-1.9403,29.8739,132584,0,1467,131117
11/2/22,Rwanda,-1.9403,29.8739,132584,0,1467,131117
11/3/22,Rwanda,-1.9403,29.8739,132584,0,1467,131117
11/4/22,Rwanda,-1.9403,29.8739,132584,0,1467,131117
11/5/22,Rwanda,-1.9403,29.8739,132584,0,1467,131117
11/6/22,Rwanda,-1.9403,29.8739,132584,0,1467,131117
11/7/22,Rwanda,-1.9403,29.8739,132584,0,1467,131117
11/8/22,Rwanda,-1.9403,29.8739,132611,0,1467,131144
11/9/22,Rwanda,-1.9403,29.8739,132611,0,1467,131144
11/10/22,Rwanda,-1.9403,29.8739,132611,0,1467,131144
11/11/22,Rwanda,-1.9403,29.8739,132611,0,1467,131144
11/12/22,Rwanda,-1.9403,29.8739,132611,0,1467,131144
11/13/22,Rwanda,-1.9403,29.8739,132611,0,1467,131144
11/14/22,Rwanda,-1.9403,29.8739,132643,0,1467,131176
11/15/22,Rwanda,-1.9403,29.8739,132643,0,1467,131176
11/16/22,Rwanda,-1.9403,29.8739,132643,0,1467,131176
11/17/22,Rwanda,-1.9403,29.8739,132643,0,1467,131176
11/18/22,Rwanda,-1.9403,29.8739,132643,0,1467,131176
11/19/22,Rwanda,-1.9403,29.8739,132643,0,1467,131176
11/20/22,Rwanda,-1.9403,29.8739,132643,0,1467,131176
11/21/22,Rwanda,-1.9403,29.8739,132643,0,1467,131176
11/22/22,Rwanda,-1.9403,29.8739,132643,0,1467,131176
11/23/22,Rwanda,-1.9403,29.8739,132681,0,1467,131214
11/24/22,Rwanda,-1.9403,29.8739,132681,0,1467,131214
11/25/22,Rwanda,-1.9403,29.8739,132681,0,1467,131214
11/26/22,Rwanda,-1.9403,29.8739,132681,0,1467,131214
11/27/22,Rwanda,-1.9403,29.8739,132681,0,1467,131214
11/28/22,Rwanda,-1.9403,29.8739,132681,0,1467,131214
11/29/22,Rwanda,-1.9403,29.8739,132681,0,1467,131214
11/30/22,Rwanda,-1.9403,29.8739,132762,0,1467,131295
12/1/22,Rwanda,-1.9403,29.8739,132762,0,1467,131295
12/2/22,Rwanda,-1.9403,29.8739,132762,0,1467,131295
12/3/22,Rwanda,-1.9403,29.8739,132762,0,1467,131295
12/4/22,Rwanda,-1.9403,29.8739,132762,0,1467,131295
12/5/22,Rwanda,-1.9403,29.8739,132762,0,1467,131295
12/6/22,Rwanda,-1.9403,29.8739,132811,0,1467,131344
12/7/22,Rwanda,-1.9403,29.8739,132811,0,1467,131344
12/8/22,Rwanda,-1.9403,29.8739,132811,0,1467,131344
12/9/22,Rwanda,-1.9403,29.8739,132811,0,1467,131344
12/10/22,Rwanda,-1.9403,29.8739,132811,0,1467,131344
12/11/22,Rwanda,-1.9403,29.8739,132811,0,1467,131344
12/12/22,Rwanda,-1.9403,29.8739,132811,0,1467,131344
12/13/22,Rwanda,-1.9403,29.8739,132811,0,1467,131344
12/14/22,Rwanda,-1.9403,29.8739,132811,0,1467,131344
12/15/22,Rwanda,-1.9403,29.8739,132811,0,1467,131344
12/16/22,Rwanda,-1.9403,29.8739,132811,0,1467,131344
12/17/22,Rwanda,-1.9403,29.8739,132811,0,1467,131344
1/1/22,Saint Kitts and Nevis,17.357822,-62.782998,3043,0,28,3015
1/2/22,Saint Kitts and Nevis,17.357822,-62.782998,3193,0,28,3165
1/3/22,Saint Kitts and Nevis,17.357822,-62.782998,3252,0,28,3224
1/4/22,Saint Kitts and Nevis,17.357822,-62.782998,3333,0,28,3305
1/5/22,Saint Kitts and Nevis,17.357822,-62.782998,3489,0,28,3461
1/6/22,Saint Kitts and Nevis,17.357822,-62.782998,3666,0,28,3638
1/7/22,Saint Kitts and Nevis,17.357822,-62.782998,3904,0,28,3876
1/8/22,Saint Kitts and Nevis,17.357822,-62.782998,4056,0,28,4028
1/9/22,Saint Kitts and Nevis,17.357822,-62.782998,4145,0,28,4117
1/10/22,Saint Kitts and Nevis,17.357822,-62.782998,4216,0,28,4188
1/11/22,Saint Kitts and Nevis,17.357822,-62.782998,4339,0,28,4311
1/12/22,Saint Kitts and Nevis,17.357822,-62.782998,4484,0,28,4456
1/13/22,Saint Kitts and Nevis,17.357822,-62.782998,4645,0,28,4617
1/14/22,Saint Kitts and Nevis,17.357822,-62.782998,4645,0,28,4617
1/15/22,Saint Kitts and Nevis,17.357822,-62.782998,4882,0,28,4854
1/16/22,Saint Kitts and Nevis,17.357822,-62.782998,4933,0,28,4905
1/17/22,Saint Kitts and Nevis,17.357822,-62.782998,4968,0,28,4940
1/18/22,Saint Kitts and Nevis,17.357822,-62.782998,5026,0,28,4998
1/19/22,Saint Kitts and Nevis,17.357822,-62.782998,5065,0,28,5037
1/20/22,Saint Kitts and Nevis,17.357822,-62.782998,5141,0,28,5113
1/21/22,Saint Kitts and Nevis,17.357822,-62.782998,5190,0,28,5162
1/22/22,Saint Kitts and Nevis,17.357822,-62.782998,5230,0,28,5202
1/23/22,Saint Kitts and Nevis,17.357822,-62.782998,5254,0,28,5226
1/24/22,Saint Kitts and Nevis,17.357822,-62.782998,5254,0,28,5226
1/25/22,Saint Kitts and Nevis,17.357822,-62.782998,5254,0,28,5226
1/26/22,Saint Kitts and Nevis,17.357822,-62.782998,5331,0,33,5298
1/27/22,Saint Kitts and Nevis,17.357822,-62.782998,5368,0,33,5335
1/28/22,Saint Kitts and Nevis,17.357822,-62.782998,5393,0,33,5360
1/29/22,Saint Kitts and Nevis,17.357822,-62.782998,5419,0,33,5386
1/30/22,Saint Kitts and Nevis,17.357822,-62.782998,5422,0,33,5389
1/31/22,Saint Kitts and Nevis,17.357822,-62.782998,5422,0,33,5389
2/1/22,Saint Kitts and Nevis,17.357822,-62.782998,5446,0,37,5409
2/2/22,Saint Kitts and Nevis,17.357822,-62.782998,5453,0,37,5416
2/3/22,Saint Kitts and Nevis,17.357822,-62.782998,5467,0,37,5430
2/4/22,Saint Kitts and Nevis,17.357822,-62.782998,5469,0,37,5432
2/5/22,Saint Kitts and Nevis,17.357822,-62.782998,5475,0,37,5438
2/6/22,Saint Kitts and Nevis,17.357822,-62.782998,5475,0,37,5438
2/7/22,Saint Kitts and Nevis,17.357822,-62.782998,5484,0,38,5446
2/8/22,Saint Kitts and Nevis,17.357822,-62.782998,5488,0,38,5450
2/9/22,Saint Kitts and Nevis,17.357822,-62.782998,5492,0,39,5453
2/10/22,Saint Kitts and Nevis,17.357822,-62.782998,5495,0,39,5456
2/11/22,Saint Kitts and Nevis,17.357822,-62.782998,5497,0,39,5458
2/12/22,Saint Kitts and Nevis,17.357822,-62.782998,5498,0,40,5458
2/13/22,Saint Kitts and Nevis,17.357822,-62.782998,5499,0,40,5459
2/14/22,Saint Kitts and Nevis,17.357822,-62.782998,5505,0,40,5465
2/15/22,Saint Kitts and Nevis,17.357822,-62.782998,5508,0,40,5468
2/16/22,Saint Kitts and Nevis,17.357822,-62.782998,5511,0,40,5471
2/17/22,Saint Kitts and Nevis,17.357822,-62.782998,5511,0,40,5471
2/18/22,Saint Kitts and Nevis,17.357822,-62.782998,5518,0,42,5476
2/19/22,Saint Kitts and Nevis,17.357822,-62.782998,5523,0,42,5481
2/20/22,Saint Kitts and Nevis,17.357822,-62.782998,5523,0,42,5481
2/21/22,Saint Kitts and Nevis,17.357822,-62.782998,5523,0,42,5481
2/22/22,Saint Kitts and Nevis,17.357822,-62.782998,5523,0,42,5481
2/23/22,Saint Kitts and Nevis,17.357822,-62.782998,5524,0,42,5482
2/24/22,Saint Kitts and Nevis,17.357822,-62.782998,5525,0,42,5483
2/25/22,Saint Kitts and Nevis,17.357822,-62.782998,5526,0,42,5484
2/26/22,Saint Kitts and Nevis,17.357822,-62.782998,5530,0,42,5488
2/27/22,Saint Kitts and Nevis,17.357822,-62.782998,5530,0,42,5488
2/28/22,Saint Kitts and Nevis,17.357822,-62.782998,5530,0,42,5488
3/1/22,Saint Kitts and Nevis,17.357822,-62.782998,5530,0,42,5488
3/2/22,Saint Kitts and Nevis,17.357822,-62.782998,5530,0,42,5488
3/3/22,Saint Kitts and Nevis,17.357822,-62.782998,5531,0,42,5489
3/4/22,Saint Kitts and Nevis,17.357822,-62.782998,5533,0,42,5491
3/5/22,Saint Kitts and Nevis,17.357822,-62.782998,5536,0,42,5494
3/6/22,Saint Kitts and Nevis,17.357822,-62.782998,5536,0,42,5494
3/7/22,Saint Kitts and Nevis,17.357822,-62.782998,5536,0,42,5494
3/8/22,Saint Kitts and Nevis,17.357822,-62.782998,5537,0,42,5495
3/9/22,Saint Kitts and Nevis,17.357822,-62.782998,5537,0,42,5495
3/10/22,Saint Kitts and Nevis,17.357822,-62.782998,5538,0,42,5496
3/11/22,Saint Kitts and Nevis,17.357822,-62.782998,5538,0,42,5496
3/12/22,Saint Kitts and Nevis,17.357822,-62.782998,5540,0,42,5498
3/13/22,Saint Kitts and Nevis,17.357822,-62.782998,5540,0,42,5498
3/14/22,Saint Kitts and Nevis,17.357822,-62.782998,5541,0,42,5499
3/15/22,Saint Kitts and Nevis,17.357822,-62.782998,5541,0,42,5499
3/16/22,Saint Kitts and Nevis,17.357822,-62.782998,5541,0,42,5499
3/17/22,Saint Kitts and Nevis,17.357822,-62.782998,5544,0,42,5502
3/18/22,Saint Kitts and Nevis,17.357822,-62.782998,5544,0,42,5502
3/19/22,Saint Kitts and Nevis,17.357822,-62.782998,5544,0,42,5502
3/20/22,Saint Kitts and Nevis,17.357822,-62.782998,5548,0,42,5506
3/21/22,Saint Kitts and Nevis,17.357822,-62.782998,5548,0,42,5506
3/22/22,Saint Kitts and Nevis,17.357822,-62.782998,5548,0,42,5506
3/23/22,Saint Kitts and Nevis,17.357822,-62.782998,5548,0,42,5506
3/24/22,Saint Kitts and Nevis,17.357822,-62.782998,5548,0,42,5506
3/25/22,Saint Kitts and Nevis,17.357822,-62.782998,5548,0,42,5506
3/26/22,Saint Kitts and Nevis,17.357822,-62.782998,5548,0,42,5506
3/27/22,Saint Kitts and Nevis,17.357822,-62.782998,5548,0,42,5506
3/28/22,Saint Kitts and Nevis,17.357822,-62.782998,5549,0,42,5507
3/29/22,Saint Kitts and Nevis,17.357822,-62.782998,5549,0,42,5507
3/30/22,Saint Kitts and Nevis,17.357822,-62.782998,5549,0,43,5506
3/31/22,Saint Kitts and Nevis,17.357822,-62.782998,5549,0,43,5506
4/1/22,Saint Kitts and Nevis,17.357822,-62.782998,5549,0,43,5506
4/2/22,Saint Kitts and Nevis,17.357822,-62.782998,5549,0,43,5506
4/3/22,Saint Kitts and Nevis,17.357822,-62.782998,5549,0,43,5506
4/4/22,Saint Kitts and Nevis,17.357822,-62.782998,5549,0,43,5506
4/5/22,Saint Kitts and Nevis,17.357822,-62.782998,5550,0,43,5507
4/6/22,Saint Kitts and Nevis,17.357822,-62.782998,5551,0,43,5508
4/7/22,Saint Kitts and Nevis,17.357822,-62.782998,5551,0,43,5508
4/8/22,Saint Kitts and Nevis,17.357822,-62.782998,5552,0,43,5509
4/9/22,Saint Kitts and Nevis,17.357822,-62.782998,5553,0,43,5510
4/10/22,Saint Kitts and Nevis,17.357822,-62.782998,5553,0,43,5510
4/11/22,Saint Kitts and Nevis,17.357822,-62.782998,5554,0,43,5511
4/12/22,Saint Kitts and Nevis,17.357822,-62.782998,5554,0,43,5511
4/13/22,Saint Kitts and Nevis,17.357822,-62.782998,5554,0,43,5511
4/14/22,Saint Kitts and Nevis,17.357822,-62.782998,5555,0,43,5512
4/15/22,Saint Kitts and Nevis,17.357822,-62.782998,5555,0,43,5512
4/16/22,Saint Kitts and Nevis,17.357822,-62.782998,5557,0,43,5514
4/17/22,Saint Kitts and Nevis,17.357822,-62.782998,5559,0,43,5516
4/18/22,Saint Kitts and Nevis,17.357822,-62.782998,5559,0,43,5516
4/19/22,Saint Kitts and Nevis,17.357822,-62.782998,5561,0,43,5518
4/20/22,Saint Kitts and Nevis,17.357822,-62.782998,5561,0,43,5518
4/21/22,Saint Kitts and Nevis,17.357822,-62.782998,5561,0,43,5518
4/22/22,Saint Kitts and Nevis,17.357822,-62.782998,5561,0,43,5518
4/23/22,Saint Kitts and Nevis,17.357822,-62.782998,5561,0,43,5518
4/24/22,Saint Kitts and Nevis,17.357822,-62.782998,5561,0,43,5518
4/25/22,Saint Kitts and Nevis,17.357822,-62.782998,5562,0,43,5519
4/26/22,Saint Kitts and Nevis,17.357822,-62.782998,5562,0,43,5519
4/27/22,Saint Kitts and Nevis,17.357822,-62.782998,5562,0,43,5519
4/28/22,Saint Kitts and Nevis,17.357822,-62.782998,5562,0,43,5519
4/29/22,Saint Kitts and Nevis,17.357822,-62.782998,5562,0,43,5519
4/30/22,Saint Kitts and Nevis,17.357822,-62.782998,5562,0,43,5519
5/1/22,Saint Kitts and Nevis,17.357822,-62.782998,5566,0,43,5523
5/2/22,Saint Kitts and Nevis,17.357822,-62.782998,5566,0,43,5523
5/3/22,Saint Kitts and Nevis,17.357822,-62.782998,5566,0,43,5523
5/4/22,Saint Kitts and Nevis,17.357822,-62.782998,5570,0,43,5527
5/5/22,Saint Kitts and Nevis,17.357822,-62.782998,5570,0,43,5527
5/6/22,Saint Kitts and Nevis,17.357822,-62.782998,5583,0,43,5540
5/7/22,Saint Kitts and Nevis,17.357822,-62.782998,5587,0,43,5544
5/8/22,Saint Kitts and Nevis,17.357822,-62.782998,5587,0,43,5544
5/9/22,Saint Kitts and Nevis,17.357822,-62.782998,5591,0,43,5548
5/10/22,Saint Kitts and Nevis,17.357822,-62.782998,5595,0,43,5552
5/11/22,Saint Kitts and Nevis,17.357822,-62.782998,5596,0,43,5553
5/12/22,Saint Kitts and Nevis,17.357822,-62.782998,5600,0,43,5557
5/13/22,Saint Kitts and Nevis,17.357822,-62.782998,5602,0,43,5559
5/14/22,Saint Kitts and Nevis,17.357822,-62.782998,5605,0,43,5562
5/15/22,Saint Kitts and Nevis,17.357822,-62.782998,5605,0,43,5562
5/16/22,Saint Kitts and Nevis,17.357822,-62.782998,5610,0,43,5567
5/17/22,Saint Kitts and Nevis,17.357822,-62.782998,5622,0,43,5579
5/18/22,Saint Kitts and Nevis,17.357822,-62.782998,5626,0,43,5583
5/19/22,Saint Kitts and Nevis,17.357822,-62.782998,5643,0,43,5600
5/20/22,Saint Kitts and Nevis,17.357822,-62.782998,5654,0,43,5611
5/21/22,Saint Kitts and Nevis,17.357822,-62.782998,5669,0,43,5626
5/22/22,Saint Kitts and Nevis,17.357822,-62.782998,5669,0,43,5626
5/23/22,Saint Kitts and Nevis,17.357822,-62.782998,5671,0,43,5628
5/24/22,Saint Kitts and Nevis,17.357822,-62.782998,5688,0,43,5645
5/25/22,Saint Kitts and Nevis,17.357822,-62.782998,5697,0,43,5654
5/26/22,Saint Kitts and Nevis,17.357822,-62.782998,5701,0,43,5658
5/27/22,Saint Kitts and Nevis,17.357822,-62.782998,5707,0,43,5664
5/28/22,Saint Kitts and Nevis,17.357822,-62.782998,5707,0,43,5664
5/29/22,Saint Kitts and Nevis,17.357822,-62.782998,5719,0,43,5676
5/30/22,Saint Kitts and Nevis,17.357822,-62.782998,5719,0,43,5676
5/31/22,Saint Kitts and Nevis,17.357822,-62.782998,5729,0,43,5686
6/1/22,Saint Kitts and Nevis,17.357822,-62.782998,5746,0,43,5703
6/2/22,Saint Kitts and Nevis,17.357822,-62.782998,5757,0,43,5714
6/3/22,Saint Kitts and Nevis,17.357822,-62.782998,5782,0,43,5739
6/4/22,Saint Kitts and Nevis,17.357822,-62.782998,5798,0,43,5755
6/5/22,Saint Kitts and Nevis,17.357822,-62.782998,5805,0,43,5762
6/6/22,Saint Kitts and Nevis,17.357822,-62.782998,5809,0,43,5766
6/7/22,Saint Kitts and Nevis,17.357822,-62.782998,5811,0,43,5768
6/8/22,Saint Kitts and Nevis,17.357822,-62.782998,5821,0,43,5778
6/9/22,Saint Kitts and Nevis,17.357822,-62.782998,5824,0,43,5781
6/10/22,Saint Kitts and Nevis,17.357822,-62.782998,5824,0,43,5781
6/11/22,Saint Kitts and Nevis,17.357822,-62.782998,5824,0,43,5781
6/12/22,Saint Kitts and Nevis,17.357822,-62.782998,5851,0,43,5808
6/13/22,Saint Kitts and Nevis,17.357822,-62.782998,5852,0,43,5809
6/14/22,Saint Kitts and Nevis,17.357822,-62.782998,5873,0,43,5830
6/15/22,Saint Kitts and Nevis,17.357822,-62.782998,5873,0,43,5830
6/16/22,Saint Kitts and Nevis,17.357822,-62.782998,5890,0,43,5847
6/17/22,Saint Kitts and Nevis,17.357822,-62.782998,5899,0,43,5856
6/18/22,Saint Kitts and Nevis,17.357822,-62.782998,5899,0,43,5856
6/19/22,Saint Kitts and Nevis,17.357822,-62.782998,5910,0,43,5867
6/20/22,Saint Kitts and Nevis,17.357822,-62.782998,5913,0,43,5870
6/21/22,Saint Kitts and Nevis,17.357822,-62.782998,5913,0,43,5870
6/22/22,Saint Kitts and Nevis,17.357822,-62.782998,5924,0,43,5881
6/23/22,Saint Kitts and Nevis,17.357822,-62.782998,5941,0,43,5898
6/24/22,Saint Kitts and Nevis,17.357822,-62.782998,5941,0,43,5898
6/25/22,Saint Kitts and Nevis,17.357822,-62.782998,5941,0,43,5898
6/26/22,Saint Kitts and Nevis,17.357822,-62.782998,5941,0,43,5898
6/27/22,Saint Kitts and Nevis,17.357822,-62.782998,5965,0,43,5922
6/28/22,Saint Kitts and Nevis,17.357822,-62.782998,5992,0,43,5949
6/29/22,Saint Kitts and Nevis,17.357822,-62.782998,6022,0,43,5979
6/30/22,Saint Kitts and Nevis,17.357822,-62.782998,6065,0,43,6022
7/1/22,Saint Kitts and Nevis,17.357822,-62.782998,6102,0,43,6059
7/2/22,Saint Kitts and Nevis,17.357822,-62.782998,6157,0,43,6114
7/3/22,Saint Kitts and Nevis,17.357822,-62.782998,6157,0,43,6114
7/4/22,Saint Kitts and Nevis,17.357822,-62.782998,6157,0,43,6114
7/5/22,Saint Kitts and Nevis,17.357822,-62.782998,6193,0,43,6150
7/6/22,Saint Kitts and Nevis,17.357822,-62.782998,6228,0,43,6185
7/7/22,Saint Kitts and Nevis,17.357822,-62.782998,6254,0,43,6211
7/8/22,Saint Kitts and Nevis,17.357822,-62.782998,6266,0,43,6223
7/9/22,Saint Kitts and Nevis,17.357822,-62.782998,6293,0,44,6249
7/10/22,Saint Kitts and Nevis,17.357822,-62.782998,6293,0,44,6249
7/11/22,Saint Kitts and Nevis,17.357822,-62.782998,6308,0,44,6264
7/12/22,Saint Kitts and Nevis,17.357822,-62.782998,6332,0,45,6287
7/13/22,Saint Kitts and Nevis,17.357822,-62.782998,6332,0,45,6287
7/14/22,Saint Kitts and Nevis,17.357822,-62.782998,6355,0,45,6310
7/15/22,Saint Kitts and Nevis,17.357822,-62.782998,6367,0,45,6322
7/16/22,Saint Kitts and Nevis,17.357822,-62.782998,6367,0,45,6322
7/17/22,Saint Kitts and Nevis,17.357822,-62.782998,6377,0,45,6332
7/18/22,Saint Kitts and Nevis,17.357822,-62.782998,6383,0,45,6338
7/19/22,Saint Kitts and Nevis,17.357822,-62.782998,6399,0,45,6354
7/20/22,Saint Kitts and Nevis,17.357822,-62.782998,6399,0,45,6354
7/21/22,Saint Kitts and Nevis,17.357822,-62.782998,6413,0,46,6367
7/22/22,Saint Kitts and Nevis,17.357822,-62.782998,6422,0,46,6376
7/23/22,Saint Kitts and Nevis,17.357822,-62.782998,6422,0,46,6376
7/24/22,Saint Kitts and Nevis,17.357822,-62.782998,6422,0,46,6376
7/25/22,Saint Kitts and Nevis,17.357822,-62.782998,6430,0,46,6384
7/26/22,Saint Kitts and Nevis,17.357822,-62.782998,6435,0,46,6389
7/27/22,Saint Kitts and Nevis,17.357822,-62.782998,6442,0,46,6396
7/28/22,Saint Kitts and Nevis,17.357822,-62.782998,6453,0,46,6407
7/29/22,Saint Kitts and Nevis,17.357822,-62.782998,6453,0,46,6407
7/30/22,Saint Kitts and Nevis,17.357822,-62.782998,6453,0,46,6407
7/31/22,Saint Kitts and Nevis,17.357822,-62.782998,6462,0,46,6416
8/1/22,Saint Kitts and Nevis,17.357822,-62.782998,6462,0,46,6416
8/2/22,Saint Kitts and Nevis,17.357822,-62.782998,6464,0,46,6418
8/3/22,Saint Kitts and Nevis,17.357822,-62.782998,6467,0,46,6421
8/4/22,Saint Kitts and Nevis,17.357822,-62.782998,6470,0,46,6424
8/5/22,Saint Kitts and Nevis,17.357822,-62.782998,6470,0,46,6424
8/6/22,Saint Kitts and Nevis,17.357822,-62.782998,6477,0,46,6431
8/7/22,Saint Kitts and Nevis,17.357822,-62.782998,6477,0,46,6431
8/8/22,Saint Kitts and Nevis,17.357822,-62.782998,6477,0,46,6431
8/9/22,Saint Kitts and Nevis,17.357822,-62.782998,6477,0,46,6431
8/10/22,Saint Kitts and Nevis,17.357822,-62.782998,6485,0,46,6439
8/11/22,Saint Kitts and Nevis,17.357822,-62.782998,6485,0,46,6439
8/12/22,Saint Kitts and Nevis,17.357822,-62.782998,6485,0,46,6439
8/13/22,Saint Kitts and Nevis,17.357822,-62.782998,6485,0,46,6439
8/14/22,Saint Kitts and Nevis,17.357822,-62.782998,6492,0,46,6446
8/15/22,Saint Kitts and Nevis,17.357822,-62.782998,6492,0,46,6446
8/16/22,Saint Kitts and Nevis,17.357822,-62.782998,6493,0,46,6447
8/17/22,Saint Kitts and Nevis,17.357822,-62.782998,6493,0,46,6447
8/18/22,Saint Kitts and Nevis,17.357822,-62.782998,6493,0,46,6447
8/19/22,Saint Kitts and Nevis,17.357822,-62.782998,6495,0,46,6449
8/20/22,Saint Kitts and Nevis,17.357822,-62.782998,6495,0,46,6449
8/21/22,Saint Kitts and Nevis,17.357822,-62.782998,6495,0,46,6449
8/22/22,Saint Kitts and Nevis,17.357822,-62.782998,6495,0,46,6449
8/23/22,Saint Kitts and Nevis,17.357822,-62.782998,6499,0,46,6453
8/24/22,Saint Kitts and Nevis,17.357822,-62.782998,6501,0,46,6455
8/25/22,Saint Kitts and Nevis,17.357822,-62.782998,6507,0,46,6461
8/26/22,Saint Kitts and Nevis,17.357822,-62.782998,6508,0,46,6462
8/27/22,Saint Kitts and Nevis,17.357822,-62.782998,6509,0,46,6463
8/28/22,Saint Kitts and Nevis,17.357822,-62.782998,6509,0,46,6463
8/29/22,Saint Kitts and Nevis,17.357822,-62.782998,6509,0,46,6463
8/30/22,Saint Kitts and Nevis,17.357822,-62.782998,6511,0,46,6465
8/31/22,Saint Kitts and Nevis,17.357822,-62.782998,6512,0,46,6466
9/1/22,Saint Kitts and Nevis,17.357822,-62.782998,6515,0,46,6469
9/2/22,Saint Kitts and Nevis,17.357822,-62.782998,6517,0,46,6471
9/3/22,Saint Kitts and Nevis,17.357822,-62.782998,6517,0,46,6471
9/4/22,Saint Kitts and Nevis,17.357822,-62.782998,6517,0,46,6471
9/5/22,Saint Kitts and Nevis,17.357822,-62.782998,6517,0,46,6471
9/6/22,Saint Kitts and Nevis,17.357822,-62.782998,6524,0,46,6478
9/7/22,Saint Kitts and Nevis,17.357822,-62.782998,6524,0,46,6478
9/8/22,Saint Kitts and Nevis,17.357822,-62.782998,6524,0,46,6478
9/9/22,Saint Kitts and Nevis,17.357822,-62.782998,6524,0,46,6478
9/10/22,Saint Kitts and Nevis,17.357822,-62.782998,6524,0,46,6478
9/11/22,Saint Kitts and Nevis,17.357822,-62.782998,6524,0,46,6478
9/12/22,Saint Kitts and Nevis,17.357822,-62.782998,6532,0,46,6486
9/13/22,Saint Kitts and Nevis,17.357822,-62.782998,6532,0,46,6486
9/14/22,Saint Kitts and Nevis,17.357822,-62.782998,6536,0,46,6490
9/15/22,Saint Kitts and Nevis,17.357822,-62.782998,6541,0,46,6495
9/16/22,Saint Kitts and Nevis,17.357822,-62.782998,6541,0,46,6495
9/17/22,Saint Kitts and Nevis,17.357822,-62.782998,6541,0,46,6495
9/18/22,Saint Kitts and Nevis,17.357822,-62.782998,6541,0,46,6495
9/19/22,Saint Kitts and Nevis,17.357822,-62.782998,6541,0,46,6495
9/20/22,Saint Kitts and Nevis,17.357822,-62.782998,6541,0,46,6495
9/21/22,Saint Kitts and Nevis,17.357822,-62.782998,6543,0,46,6497
9/22/22,Saint Kitts and Nevis,17.357822,-62.782998,6543,0,46,6497
9/23/22,Saint Kitts and Nevis,17.357822,-62.782998,6543,0,46,6497
9/24/22,Saint Kitts and Nevis,17.357822,-62.782998,6543,0,46,6497
9/25/22,Saint Kitts and Nevis,17.357822,-62.782998,6543,0,46,6497
9/26/22,Saint Kitts and Nevis,17.357822,-62.782998,6543,0,46,6497
9/27/22,Saint Kitts and Nevis,17.357822,-62.782998,6543,0,46,6497
9/28/22,Saint Kitts and Nevis,17.357822,-62.782998,6543,0,46,6497
9/29/22,Saint Kitts and Nevis,17.357822,-62.782998,6544,0,46,6498
9/30/22,Saint Kitts and Nevis,17.357822,-62.782998,6544,0,46,6498
10/1/22,Saint Kitts and Nevis,17.357822,-62.782998,6544,0,46,6498
10/2/22,Saint Kitts and Nevis,17.357822,-62.782998,6544,0,46,6498
10/3/22,Saint Kitts and Nevis,17.357822,-62.782998,6544,0,46,6498
10/4/22,Saint Kitts and Nevis,17.357822,-62.782998,6545,0,46,6499
10/5/22,Saint Kitts and Nevis,17.357822,-62.782998,6545,0,46,6499
10/6/22,Saint Kitts and Nevis,17.357822,-62.782998,6545,0,46,6499
10/7/22,Saint Kitts and Nevis,17.357822,-62.782998,6545,0,46,6499
10/8/22,Saint Kitts and Nevis,17.357822,-62.782998,6545,0,46,6499
10/9/22,Saint Kitts and Nevis,17.357822,-62.782998,6545,0,46,6499
10/10/22,Saint Kitts and Nevis,17.357822,-62.782998,6545,0,46,6499
10/11/22,Saint Kitts and Nevis,17.357822,-62.782998,6546,0,46,6500
10/12/22,Saint Kitts and Nevis,17.357822,-62.782998,6546,0,46,6500
10/13/22,Saint Kitts and Nevis,17.357822,-62.782998,6546,0,46,6500
10/14/22,Saint Kitts and Nevis,17.357822,-62.782998,6547,0,46,6501
10/15/22,Saint Kitts and Nevis,17.357822,-62.782998,6547,0,46,6501
10/16/22,Saint Kitts and Nevis,17.357822,-62.782998,6547,0,46,6501
10/17/22,Saint Kitts and Nevis,17.357822,-62.782998,6547,0,46,6501
10/18/22,Saint Kitts and Nevis,17.357822,-62.782998,6547,0,46,6501
10/19/22,Saint Kitts and Nevis,17.357822,-62.782998,6547,0,46,6501
10/20/22,Saint Kitts and Nevis,17.357822,-62.782998,6548,0,46,6502
10/21/22,Saint Kitts and Nevis,17.357822,-62.782998,6548,0,46,6502
10/22/22,Saint Kitts and Nevis,17.357822,-62.782998,6548,0,46,6502
10/23/22,Saint Kitts and Nevis,17.357822,-62.782998,6548,0,46,6502
10/24/22,Saint Kitts and Nevis,17.357822,-62.782998,6548,0,46,6502
10/25/22,Saint Kitts and Nevis,17.357822,-62.782998,6548,0,46,6502
10/26/22,Saint Kitts and Nevis,17.357822,-62.782998,6548,0,46,6502
10/27/22,Saint Kitts and Nevis,17.357822,-62.782998,6548,0,46,6502
10/28/22,Saint Kitts and Nevis,17.357822,-62.782998,6548,0,46,6502
10/29/22,Saint Kitts and Nevis,17.357822,-62.782998,6548,0,46,6502
10/30/22,Saint Kitts and Nevis,17.357822,-62.782998,6548,0,46,6502
10/31/22,Saint Kitts and Nevis,17.357822,-62.782998,6548,0,46,6502
11/1/22,Saint Kitts and Nevis,17.357822,-62.782998,6548,0,46,6502
11/2/22,Saint Kitts and Nevis,17.357822,-62.782998,6548,0,46,6502
11/3/22,Saint Kitts and Nevis,17.357822,-62.782998,6549,0,46,6503
11/4/22,Saint Kitts and Nevis,17.357822,-62.782998,6549,0,46,6503
11/5/22,Saint Kitts and Nevis,17.357822,-62.782998,6549,0,46,6503
11/6/22,Saint Kitts and Nevis,17.357822,-62.782998,6549,0,46,6503
11/7/22,Saint Kitts and Nevis,17.357822,-62.782998,6549,0,46,6503
11/8/22,Saint Kitts and Nevis,17.357822,-62.782998,6549,0,46,6503
11/9/22,Saint Kitts and Nevis,17.357822,-62.782998,6549,0,46,6503
11/10/22,Saint Kitts and Nevis,17.357822,-62.782998,6551,0,46,6505
11/11/22,Saint Kitts and Nevis,17.357822,-62.782998,6552,0,46,6506
11/12/22,Saint Kitts and Nevis,17.357822,-62.782998,6552,0,46,6506
11/13/22,Saint Kitts and Nevis,17.357822,-62.782998,6552,0,46,6506
11/14/22,Saint Kitts and Nevis,17.357822,-62.782998,6552,0,46,6506
11/15/22,Saint Kitts and Nevis,17.357822,-62.782998,6552,0,46,6506
11/16/22,Saint Kitts and Nevis,17.357822,-62.782998,6552,0,46,6506
11/17/22,Saint Kitts and Nevis,17.357822,-62.782998,6552,0,46,6506
11/18/22,Saint Kitts and Nevis,17.357822,-62.782998,6552,0,46,6506
11/19/22,Saint Kitts and Nevis,17.357822,-62.782998,6552,0,46,6506
11/20/22,Saint Kitts and Nevis,17.357822,-62.782998,6552,0,46,6506
11/21/22,Saint Kitts and Nevis,17.357822,-62.782998,6552,0,46,6506
11/22/22,Saint Kitts and Nevis,17.357822,-62.782998,6552,0,46,6506
11/23/22,Saint Kitts and Nevis,17.357822,-62.782998,6554,0,46,6508
11/24/22,Saint Kitts and Nevis,17.357822,-62.782998,6556,0,46,6510
11/25/22,Saint Kitts and Nevis,17.357822,-62.782998,6556,0,46,6510
11/26/22,Saint Kitts and Nevis,17.357822,-62.782998,6556,0,46,6510
11/27/22,Saint Kitts and Nevis,17.357822,-62.782998,6556,0,46,6510
11/28/22,Saint Kitts and Nevis,17.357822,-62.782998,6556,0,46,6510
11/29/22,Saint Kitts and Nevis,17.357822,-62.782998,6556,0,46,6510
11/30/22,Saint Kitts and Nevis,17.357822,-62.782998,6556,0,46,6510
12/1/22,Saint Kitts and Nevis,17.357822,-62.782998,6556,0,46,6510
12/2/22,Saint Kitts and Nevis,17.357822,-62.782998,6556,0,46,6510
12/3/22,Saint Kitts and Nevis,17.357822,-62.782998,6556,0,46,6510
12/4/22,Saint Kitts and Nevis,17.357822,-62.782998,6556,0,46,6510
12/5/22,Saint Kitts and Nevis,17.357822,-62.782998,6556,0,46,6510
12/6/22,Saint Kitts and Nevis,17.357822,-62.782998,6559,0,46,6513
12/7/22,Saint Kitts and Nevis,17.357822,-62.782998,6559,0,46,6513
12/8/22,Saint Kitts and Nevis,17.357822,-62.782998,6559,0,46,6513
12/9/22,Saint Kitts and Nevis,17.357822,-62.782998,6559,0,46,6513
12/10/22,Saint Kitts and Nevis,17.357822,-62.782998,6559,0,46,6513
12/11/22,Saint Kitts and Nevis,17.357822,-62.782998,6559,0,46,6513
12/12/22,Saint Kitts and Nevis,17.357822,-62.782998,6559,0,46,6513
12/13/22,Saint Kitts and Nevis,17.357822,-62.782998,6559,0,46,6513
12/14/22,Saint Kitts and Nevis,17.357822,-62.782998,6559,0,46,6513
12/15/22,Saint Kitts and Nevis,17.357822,-62.782998,6559,0,46,6513
12/16/22,Saint Kitts and Nevis,17.357822,-62.782998,6560,0,46,6514
12/17/22,Saint Kitts and Nevis,17.357822,-62.782998,6560,0,46,6514
1/1/22,Saint Lucia,13.9094,-60.9789,13640,0,301,13339
1/2/22,Saint Lucia,13.9094,-60.9789,13732,0,301,13431
1/3/22,Saint Lucia,13.9094,-60.9789,13816,0,301,13515
1/4/22,Saint Lucia,13.9094,-60.9789,13881,0,301,13580
1/5/22,Saint Lucia,13.9094,-60.9789,13974,0,305,13669
1/6/22,Saint Lucia,13.9094,-60.9789,14232,0,305,13927
1/7/22,Saint Lucia,13.9094,-60.9789,14414,0,305,14109
1/8/22,Saint Lucia,13.9094,-60.9789,14654,0,306,14348
1/9/22,Saint Lucia,13.9094,-60.9789,14874,0,306,14568
1/10/22,Saint Lucia,13.9094,-60.9789,15101,0,306,14795
1/11/22,Saint Lucia,13.9094,-60.9789,15372,0,310,15062
1/12/22,Saint Lucia,13.9094,-60.9789,15937,0,310,15627
1/13/22,Saint Lucia,13.9094,-60.9789,16505,0,311,16194
1/14/22,Saint Lucia,13.9094,-60.9789,16969,0,314,16655
1/15/22,Saint Lucia,13.9094,-60.9789,16969,0,314,16655
1/16/22,Saint Lucia,13.9094,-60.9789,17250,0,314,16936
1/17/22,Saint Lucia,13.9094,-60.9789,17531,0,314,17217
1/18/22,Saint Lucia,13.9094,-60.9789,17666,0,314,17352
1/19/22,Saint Lucia,13.9094,-60.9789,17871,0,316,17555
1/20/22,Saint Lucia,13.9094,-60.9789,18322,0,316,18006
1/21/22,Saint Lucia,13.9094,-60.9789,18746,0,316,18430
1/22/22,Saint Lucia,13.9094,-60.9789,19468,0,316,19152
1/23/22,Saint Lucia,13.9094,-60.9789,19680,0,316,19364
1/24/22,Saint Lucia,13.9094,-60.9789,19755,0,324,19431
1/25/22,Saint Lucia,13.9094,-60.9789,19967,0,326,19641
1/26/22,Saint Lucia,13.9094,-60.9789,20192,0,326,19866
1/27/22,Saint Lucia,13.9094,-60.9789,20417,0,326,20091
1/28/22,Saint Lucia,13.9094,-60.9789,20417,0,326,20091
1/29/22,Saint Lucia,13.9094,-60.9789,20798,0,326,20472
1/30/22,Saint Lucia,13.9094,-60.9789,20909,0,326,20583
1/31/22,Saint Lucia,13.9094,-60.9789,20942,0,328,20614
2/1/22,Saint Lucia,13.9094,-60.9789,20942,0,328,20614
2/2/22,Saint Lucia,13.9094,-60.9789,21081,0,333,20748
2/3/22,Saint Lucia,13.9094,-60.9789,21399,0,333,21066
2/4/22,Saint Lucia,13.9094,-60.9789,21399,0,333,21066
2/5/22,Saint Lucia,13.9094,-60.9789,21513,0,341,21172
2/6/22,Saint Lucia,13.9094,-60.9789,21513,0,341,21172
2/7/22,Saint Lucia,13.9094,-60.9789,21535,0,341,21194
2/8/22,Saint Lucia,13.9094,-60.9789,21768,0,342,21426
2/9/22,Saint Lucia,13.9094,-60.9789,21831,0,342,21489
2/10/22,Saint Lucia,13.9094,-60.9789,21873,0,346,21527
2/11/22,Saint Lucia,13.9094,-60.9789,21932,0,347,21585
2/12/22,Saint Lucia,13.9094,-60.9789,21932,0,347,21585
2/13/22,Saint Lucia,13.9094,-60.9789,22048,0,347,21701
2/14/22,Saint Lucia,13.9094,-60.9789,22121,0,347,21774
2/15/22,Saint Lucia,13.9094,-60.9789,22177,0,347,21830
2/16/22,Saint Lucia,13.9094,-60.9789,22269,0,353,21916
2/17/22,Saint Lucia,13.9094,-60.9789,22426,0,353,22073
2/18/22,Saint Lucia,13.9094,-60.9789,22468,0,356,22112
2/19/22,Saint Lucia,13.9094,-60.9789,22468,0,356,22112
2/20/22,Saint Lucia,13.9094,-60.9789,22468,0,356,22112
2/21/22,Saint Lucia,13.9094,-60.9789,22545,0,357,22188
2/22/22,Saint Lucia,13.9094,-60.9789,22568,0,357,22211
2/23/22,Saint Lucia,13.9094,-60.9789,22594,0,357,22237
2/24/22,Saint Lucia,13.9094,-60.9789,22627,0,358,22269
2/25/22,Saint Lucia,13.9094,-60.9789,22649,0,358,22291
2/26/22,Saint Lucia,13.9094,-60.9789,22649,0,358,22291
2/27/22,Saint Lucia,13.9094,-60.9789,22667,0,358,22309
2/28/22,Saint Lucia,13.9094,-60.9789,22694,0,358,22336
3/1/22,Saint Lucia,13.9094,-60.9789,22712,0,358,22354
3/2/22,Saint Lucia,13.9094,-60.9789,22729,0,360,22369
3/3/22,Saint Lucia,13.9094,-60.9789,22733,0,360,22373
3/4/22,Saint Lucia,13.9094,-60.9789,22733,0,360,22373
3/5/22,Saint Lucia,13.9094,-60.9789,22733,0,360,22373
3/6/22,Saint Lucia,13.9094,-60.9789,22779,0,362,22417
3/7/22,Saint Lucia,13.9094,-60.9789,22795,0,362,22433
3/8/22,Saint Lucia,13.9094,-60.9789,22808,0,364,22444
3/9/22,Saint Lucia,13.9094,-60.9789,22811,0,364,22447
3/10/22,Saint Lucia,13.9094,-60.9789,22822,0,364,22458
3/11/22,Saint Lucia,13.9094,-60.9789,22833,0,364,22469
3/12/22,Saint Lucia,13.9094,-60.9789,22833,0,365,22468
3/13/22,Saint Lucia,13.9094,-60.9789,22847,0,365,22482
3/14/22,Saint Lucia,13.9094,-60.9789,22853,0,365,22488
3/15/22,Saint Lucia,13.9094,-60.9789,22856,0,365,22491
3/16/22,Saint Lucia,13.9094,-60.9789,22862,0,365,22497
3/17/22,Saint Lucia,13.9094,-60.9789,22870,0,365,22505
3/18/22,Saint Lucia,13.9094,-60.9789,22878,0,365,22513
3/19/22,Saint Lucia,13.9094,-60.9789,22878,0,365,22513
3/20/22,Saint Lucia,13.9094,-60.9789,22884,0,365,22519
3/21/22,Saint Lucia,13.9094,-60.9789,22891,0,365,22526
3/22/22,Saint Lucia,13.9094,-60.9789,22892,0,365,22527
3/23/22,Saint Lucia,13.9094,-60.9789,22905,0,365,22540
3/24/22,Saint Lucia,13.9094,-60.9789,22907,0,365,22542
3/25/22,Saint Lucia,13.9094,-60.9789,22919,0,365,22554
3/26/22,Saint Lucia,13.9094,-60.9789,22919,0,365,22554
3/27/22,Saint Lucia,13.9094,-60.9789,22929,0,365,22564
3/28/22,Saint Lucia,13.9094,-60.9789,22941,0,365,22576
3/29/22,Saint Lucia,13.9094,-60.9789,22947,0,365,22582
3/30/22,Saint Lucia,13.9094,-60.9789,22953,0,365,22588
3/31/22,Saint Lucia,13.9094,-60.9789,22953,0,365,22588
4/1/22,Saint Lucia,13.9094,-60.9789,22959,0,365,22594
4/2/22,Saint Lucia,13.9094,-60.9789,22959,0,365,22594
4/3/22,Saint Lucia,13.9094,-60.9789,22964,0,365,22599
4/4/22,Saint Lucia,13.9094,-60.9789,22965,0,365,22600
4/5/22,Saint Lucia,13.9094,-60.9789,22977,0,365,22612
4/6/22,Saint Lucia,13.9094,-60.9789,22991,0,365,22626
4/7/22,Saint Lucia,13.9094,-60.9789,22998,0,365,22633
4/8/22,Saint Lucia,13.9094,-60.9789,23010,0,365,22645
4/9/22,Saint Lucia,13.9094,-60.9789,23029,0,365,22664
4/10/22,Saint Lucia,13.9094,-60.9789,23037,0,365,22672
4/11/22,Saint Lucia,13.9094,-60.9789,23045,0,365,22680
4/12/22,Saint Lucia,13.9094,-60.9789,23045,0,365,22680
4/13/22,Saint Lucia,13.9094,-60.9789,23045,0,365,22680
4/14/22,Saint Lucia,13.9094,-60.9789,23050,0,365,22685
4/15/22,Saint Lucia,13.9094,-60.9789,23050,0,365,22685
4/16/22,Saint Lucia,13.9094,-60.9789,23094,0,367,22727
4/17/22,Saint Lucia,13.9094,-60.9789,23094,0,367,22727
4/18/22,Saint Lucia,13.9094,-60.9789,23094,0,367,22727
4/19/22,Saint Lucia,13.9094,-60.9789,23111,0,367,22744
4/20/22,Saint Lucia,13.9094,-60.9789,23161,0,367,22794
4/21/22,Saint Lucia,13.9094,-60.9789,23161,0,368,22793
4/22/22,Saint Lucia,13.9094,-60.9789,23201,0,368,22833
4/23/22,Saint Lucia,13.9094,-60.9789,23239,0,368,22871
4/24/22,Saint Lucia,13.9094,-60.9789,23239,0,368,22871
4/25/22,Saint Lucia,13.9094,-60.9789,23285,0,368,22917
4/26/22,Saint Lucia,13.9094,-60.9789,23285,0,368,22917
4/27/22,Saint Lucia,13.9094,-60.9789,23285,0,368,22917
4/28/22,Saint Lucia,13.9094,-60.9789,23361,0,368,22993
4/29/22,Saint Lucia,13.9094,-60.9789,23394,0,368,23026
4/30/22,Saint Lucia,13.9094,-60.9789,23394,0,368,23026
5/1/22,Saint Lucia,13.9094,-60.9789,23394,0,368,23026
5/2/22,Saint Lucia,13.9094,-60.9789,23459,0,368,23091
5/3/22,Saint Lucia,13.9094,-60.9789,23482,0,368,23114
5/4/22,Saint Lucia,13.9094,-60.9789,23538,0,368,23170
5/5/22,Saint Lucia,13.9094,-60.9789,23612,0,368,23244
5/6/22,Saint Lucia,13.9094,-60.9789,23635,0,368,23267
5/7/22,Saint Lucia,13.9094,-60.9789,23635,0,368,23267
5/8/22,Saint Lucia,13.9094,-60.9789,23723,0,368,23355
5/9/22,Saint Lucia,13.9094,-60.9789,23778,0,368,23410
5/10/22,Saint Lucia,13.9094,-60.9789,23798,0,368,23430
5/11/22,Saint Lucia,13.9094,-60.9789,23978,0,368,23610
5/12/22,Saint Lucia,13.9094,-60.9789,23978,0,368,23610
5/13/22,Saint Lucia,13.9094,-60.9789,24164,0,368,23796
5/14/22,Saint Lucia,13.9094,-60.9789,24164,0,368,23796
5/15/22,Saint Lucia,13.9094,-60.9789,24267,0,368,23899
5/16/22,Saint Lucia,13.9094,-60.9789,24396,0,368,24028
5/17/22,Saint Lucia,13.9094,-60.9789,24514,0,368,24146
5/18/22,Saint Lucia,13.9094,-60.9789,24655,0,368,24287
5/19/22,Saint Lucia,13.9094,-60.9789,24780,0,368,24412
5/20/22,Saint Lucia,13.9094,-60.9789,24873,0,368,24505
5/21/22,Saint Lucia,13.9094,-60.9789,24873,0,368,24505
5/22/22,Saint Lucia,13.9094,-60.9789,24957,0,370,24587
5/23/22,Saint Lucia,13.9094,-60.9789,25054,0,370,24684
5/24/22,Saint Lucia,13.9094,-60.9789,25132,0,370,24762
5/25/22,Saint Lucia,13.9094,-60.9789,25315,0,370,24945
5/26/22,Saint Lucia,13.9094,-60.9789,25315,0,370,24945
5/27/22,Saint Lucia,13.9094,-60.9789,25538,0,371,25167
5/28/22,Saint Lucia,13.9094,-60.9789,25538,0,371,25167
5/29/22,Saint Lucia,13.9094,-60.9789,25593,0,371,25222
5/30/22,Saint Lucia,13.9094,-60.9789,25593,0,371,25222
5/31/22,Saint Lucia,13.9094,-60.9789,25593,0,371,25222
6/1/22,Saint Lucia,13.9094,-60.9789,25777,0,371,25406
6/2/22,Saint Lucia,13.9094,-60.9789,25877,0,371,25506
6/3/22,Saint Lucia,13.9094,-60.9789,25999,0,371,25628
6/4/22,Saint Lucia,13.9094,-60.9789,26092,0,371,25721
6/5/22,Saint Lucia,13.9094,-60.9789,26092,0,371,25721
6/6/22,Saint Lucia,13.9094,-60.9789,26206,0,371,25835
6/7/22,Saint Lucia,13.9094,-60.9789,26234,0,371,25863
6/8/22,Saint Lucia,13.9094,-60.9789,26250,0,371,25879
6/9/22,Saint Lucia,13.9094,-60.9789,26316,0,371,25945
6/10/22,Saint Lucia,13.9094,-60.9789,26453,0,371,26082
6/11/22,Saint Lucia,13.9094,-60.9789,26453,0,371,26082
6/12/22,Saint Lucia,13.9094,-60.9789,26538,0,371,26167
6/13/22,Saint Lucia,13.9094,-60.9789,26584,0,376,26208
6/14/22,Saint Lucia,13.9094,-60.9789,26629,0,376,26253
6/15/22,Saint Lucia,13.9094,-60.9789,26688,0,376,26312
6/16/22,Saint Lucia,13.9094,-60.9789,26704,0,376,26328
6/17/22,Saint Lucia,13.9094,-60.9789,26704,0,376,26328
6/18/22,Saint Lucia,13.9094,-60.9789,26722,0,376,26346
6/19/22,Saint Lucia,13.9094,-60.9789,26722,0,376,26346
6/20/22,Saint Lucia,13.9094,-60.9789,26763,0,376,26387
6/21/22,Saint Lucia,13.9094,-60.9789,26780,0,376,26404
6/22/22,Saint Lucia,13.9094,-60.9789,26816,0,376,26440
6/23/22,Saint Lucia,13.9094,-60.9789,26816,0,376,26440
6/24/22,Saint Lucia,13.9094,-60.9789,26885,0,380,26505
6/25/22,Saint Lucia,13.9094,-60.9789,26911,0,380,26531
6/26/22,Saint Lucia,13.9094,-60.9789,26937,0,380,26557
6/27/22,Saint Lucia,13.9094,-60.9789,26970,0,380,26590
6/28/22,Saint Lucia,13.9094,-60.9789,26984,0,380,26604
6/29/22,Saint Lucia,13.9094,-60.9789,27022,0,383,26639
6/30/22,Saint Lucia,13.9094,-60.9789,27022,0,383,26639
7/1/22,Saint Lucia,13.9094,-60.9789,27049,0,383,26666
7/2/22,Saint Lucia,13.9094,-60.9789,27094,0,383,26711
7/3/22,Saint Lucia,13.9094,-60.9789,27094,0,383,26711
7/4/22,Saint Lucia,13.9094,-60.9789,27094,0,383,26711
7/5/22,Saint Lucia,13.9094,-60.9789,27133,0,385,26748
7/6/22,Saint Lucia,13.9094,-60.9789,27133,0,385,26748
7/7/22,Saint Lucia,13.9094,-60.9789,27204,0,385,26819
7/8/22,Saint Lucia,13.9094,-60.9789,27252,0,385,26867
7/9/22,Saint Lucia,13.9094,-60.9789,27252,0,385,26867
7/10/22,Saint Lucia,13.9094,-60.9789,27252,0,385,26867
7/11/22,Saint Lucia,13.9094,-60.9789,27337,0,385,26952
7/12/22,Saint Lucia,13.9094,-60.9789,27337,0,385,26952
7/13/22,Saint Lucia,13.9094,-60.9789,27408,0,385,27023
7/14/22,Saint Lucia,13.9094,-60.9789,27408,0,385,27023
7/15/22,Saint Lucia,13.9094,-60.9789,27464,0,385,27079
7/16/22,Saint Lucia,13.9094,-60.9789,27464,0,385,27079
7/17/22,Saint Lucia,13.9094,-60.9789,27464,0,385,27079
7/18/22,Saint Lucia,13.9094,-60.9789,27464,0,385,27079
7/19/22,Saint Lucia,13.9094,-60.9789,27533,0,385,27148
7/20/22,Saint Lucia,13.9094,-60.9789,27533,0,385,27148
7/21/22,Saint Lucia,13.9094,-60.9789,27559,0,385,27174
7/22/22,Saint Lucia,13.9094,-60.9789,27654,0,385,27269
7/23/22,Saint Lucia,13.9094,-60.9789,27654,0,385,27269
7/24/22,Saint Lucia,13.9094,-60.9789,27654,0,385,27269
7/25/22,Saint Lucia,13.9094,-60.9789,27755,0,385,27370
7/26/22,Saint Lucia,13.9094,-60.9789,27755,0,385,27370
7/27/22,Saint Lucia,13.9094,-60.9789,27755,0,385,27370
7/28/22,Saint Lucia,13.9094,-60.9789,27843,0,385,27458
7/29/22,Saint Lucia,13.9094,-60.9789,27843,0,385,27458
7/30/22,Saint Lucia,13.9094,-60.9789,27966,0,385,27581
7/31/22,Saint Lucia,13.9094,-60.9789,27966,0,385,27581
8/1/22,Saint Lucia,13.9094,-60.9789,27966,0,385,27581
8/2/22,Saint Lucia,13.9094,-60.9789,27966,0,385,27581
8/3/22,Saint Lucia,13.9094,-60.9789,27966,0,385,27581
8/4/22,Saint Lucia,13.9094,-60.9789,28062,0,386,27676
8/5/22,Saint Lucia,13.9094,-60.9789,28161,0,387,27774
8/6/22,Saint Lucia,13.9094,-60.9789,28161,0,387,27774
8/7/22,Saint Lucia,13.9094,-60.9789,28161,0,387,27774
8/8/22,Saint Lucia,13.9094,-60.9789,28161,0,387,27774
8/9/22,Saint Lucia,13.9094,-60.9789,28233,0,387,27846
8/10/22,Saint Lucia,13.9094,-60.9789,28233,0,387,27846
8/11/22,Saint Lucia,13.9094,-60.9789,28233,0,387,27846
8/12/22,Saint Lucia,13.9094,-60.9789,28341,0,388,27953
8/13/22,Saint Lucia,13.9094,-60.9789,28341,0,388,27953
8/14/22,Saint Lucia,13.9094,-60.9789,28341,0,388,27953
8/15/22,Saint Lucia,13.9094,-60.9789,28341,0,388,27953
8/16/22,Saint Lucia,13.9094,-60.9789,28341,0,388,27953
8/17/22,Saint Lucia,13.9094,-60.9789,28379,0,388,27991
8/18/22,Saint Lucia,13.9094,-60.9789,28461,0,388,28073
8/19/22,Saint Lucia,13.9094,-60.9789,28542,0,388,28154
8/20/22,Saint Lucia,13.9094,-60.9789,28542,0,388,28154
8/21/22,Saint Lucia,13.9094,-60.9789,28542,0,388,28154
8/22/22,Saint Lucia,13.9094,-60.9789,28621,0,389,28232
8/23/22,Saint Lucia,13.9094,-60.9789,28621,0,389,28232
8/24/22,Saint Lucia,13.9094,-60.9789,28621,0,389,28232
8/25/22,Saint Lucia,13.9094,-60.9789,28621,0,389,28232
8/26/22,Saint Lucia,13.9094,-60.9789,28689,0,389,28300
8/27/22,Saint Lucia,13.9094,-60.9789,28689,0,389,28300
8/28/22,Saint Lucia,13.9094,-60.9789,28689,0,389,28300
8/29/22,Saint Lucia,13.9094,-60.9789,28689,0,389,28300
8/30/22,Saint Lucia,13.9094,-60.9789,28775,0,391,28384
8/31/22,Saint Lucia,13.9094,-60.9789,28775,0,391,28384
9/1/22,Saint Lucia,13.9094,-60.9789,28775,0,391,28384
9/2/22,Saint Lucia,13.9094,-60.9789,28832,0,391,28441
9/3/22,Saint Lucia,13.9094,-60.9789,28894,0,391,28503
9/4/22,Saint Lucia,13.9094,-60.9789,28894,0,391,28503
9/5/22,Saint Lucia,13.9094,-60.9789,28894,0,391,28503
9/6/22,Saint Lucia,13.9094,-60.9789,28894,0,391,28503
9/7/22,Saint Lucia,13.9094,-60.9789,28894,0,391,28503
9/8/22,Saint Lucia,13.9094,-60.9789,28894,0,391,28503
9/9/22,Saint Lucia,13.9094,-60.9789,28894,0,391,28503
9/10/22,Saint Lucia,13.9094,-60.9789,28894,0,391,28503
9/11/22,Saint Lucia,13.9094,-60.9789,28894,0,391,28503
9/12/22,Saint Lucia,13.9094,-60.9789,28894,0,391,28503
9/13/22,Saint Lucia,13.9094,-60.9789,28894,0,391,28503
9/14/22,Saint Lucia,13.9094,-60.9789,28959,0,393,28566
9/15/22,Saint Lucia,13.9094,-60.9789,28959,0,393,28566
9/16/22,Saint Lucia,13.9094,-60.9789,28959,0,393,28566
9/17/22,Saint Lucia,13.9094,-60.9789,28959,0,393,28566
9/18/22,Saint Lucia,13.9094,-60.9789,28959,0,393,28566
9/19/22,Saint Lucia,13.9094,-60.9789,28959,0,393,28566
9/20/22,Saint Lucia,13.9094,-60.9789,28959,0,393,28566
9/21/22,Saint Lucia,13.9094,-60.9789,28959,0,393,28566
9/22/22,Saint Lucia,13.9094,-60.9789,28959,0,393,28566
9/23/22,Saint Lucia,13.9094,-60.9789,28959,0,393,28566
9/24/22,Saint Lucia,13.9094,-60.9789,28959,0,393,28566
9/25/22,Saint Lucia,13.9094,-60.9789,29408,0,393,29015
9/26/22,Saint Lucia,13.9094,-60.9789,29408,0,393,29015
9/27/22,Saint Lucia,13.9094,-60.9789,29408,0,393,29015
9/28/22,Saint Lucia,13.9094,-60.9789,29408,0,393,29015
9/29/22,Saint Lucia,13.9094,-60.9789,29408,0,393,29015
9/30/22,Saint Lucia,13.9094,-60.9789,29408,0,393,29015
10/1/22,Saint Lucia,13.9094,-60.9789,29408,0,393,29015
10/2/22,Saint Lucia,13.9094,-60.9789,29408,0,393,29015
10/3/22,Saint Lucia,13.9094,-60.9789,29408,0,393,29015
10/4/22,Saint Lucia,13.9094,-60.9789,29517,0,400,29117
10/5/22,Saint Lucia,13.9094,-60.9789,29517,0,400,29117
10/6/22,Saint Lucia,13.9094,-60.9789,29517,0,400,29117
10/7/22,Saint Lucia,13.9094,-60.9789,29517,0,401,29116
10/8/22,Saint Lucia,13.9094,-60.9789,29550,0,404,29146
10/9/22,Saint Lucia,13.9094,-60.9789,29550,0,404,29146
10/10/22,Saint Lucia,13.9094,-60.9789,29550,0,404,29146
10/11/22,Saint Lucia,13.9094,-60.9789,29550,0,404,29146
10/12/22,Saint Lucia,13.9094,-60.9789,29550,0,405,29145
10/13/22,Saint Lucia,13.9094,-60.9789,29550,0,405,29145
10/14/22,Saint Lucia,13.9094,-60.9789,29550,0,405,29145
10/15/22,Saint Lucia,13.9094,-60.9789,29550,0,405,29145
10/16/22,Saint Lucia,13.9094,-60.9789,29550,0,405,29145
10/17/22,Saint Lucia,13.9094,-60.9789,29550,0,405,29145
10/18/22,Saint Lucia,13.9094,-60.9789,29550,0,405,29145
10/19/22,Saint Lucia,13.9094,-60.9789,29550,0,405,29145
10/20/22,Saint Lucia,13.9094,-60.9789,29550,0,405,29145
10/21/22,Saint Lucia,13.9094,-60.9789,29550,0,405,29145
10/22/22,Saint Lucia,13.9094,-60.9789,29550,0,405,29145
10/23/22,Saint Lucia,13.9094,-60.9789,29550,0,405,29145
10/24/22,Saint Lucia,13.9094,-60.9789,29550,0,405,29145
10/25/22,Saint Lucia,13.9094,-60.9789,29636,0,406,29230
10/26/22,Saint Lucia,13.9094,-60.9789,29636,0,406,29230
10/27/22,Saint Lucia,13.9094,-60.9789,29639,0,407,29232
10/28/22,Saint Lucia,13.9094,-60.9789,29639,0,407,29232
10/29/22,Saint Lucia,13.9094,-60.9789,29639,0,407,29232
10/30/22,Saint Lucia,13.9094,-60.9789,29639,0,407,29232
10/31/22,Saint Lucia,13.9094,-60.9789,29639,0,407,29232
11/1/22,Saint Lucia,13.9094,-60.9789,29654,0,407,29247
11/2/22,Saint Lucia,13.9094,-60.9789,29654,0,407,29247
11/3/22,Saint Lucia,13.9094,-60.9789,29654,0,407,29247
11/4/22,Saint Lucia,13.9094,-60.9789,29654,0,407,29247
11/5/22,Saint Lucia,13.9094,-60.9789,29654,0,407,29247
11/6/22,Saint Lucia,13.9094,-60.9789,29654,0,407,29247
11/7/22,Saint Lucia,13.9094,-60.9789,29654,0,407,29247
11/8/22,Saint Lucia,13.9094,-60.9789,29654,0,407,29247
11/9/22,Saint Lucia,13.9094,-60.9789,29654,0,407,29247
11/10/22,Saint Lucia,13.9094,-60.9789,29654,0,407,29247
11/11/22,Saint Lucia,13.9094,-60.9789,29676,0,408,29268
11/12/22,Saint Lucia,13.9094,-60.9789,29676,0,408,29268
11/13/22,Saint Lucia,13.9094,-60.9789,29676,0,408,29268
11/14/22,Saint Lucia,13.9094,-60.9789,29676,0,408,29268
11/15/22,Saint Lucia,13.9094,-60.9789,29676,0,408,29268
11/16/22,Saint Lucia,13.9094,-60.9789,29676,0,408,29268
11/17/22,Saint Lucia,13.9094,-60.9789,29692,0,408,29284
11/18/22,Saint Lucia,13.9094,-60.9789,29692,0,408,29284
11/19/22,Saint Lucia,13.9094,-60.9789,29692,0,408,29284
11/20/22,Saint Lucia,13.9094,-60.9789,29692,0,408,29284
11/21/22,Saint Lucia,13.9094,-60.9789,29692,0,408,29284
11/22/22,Saint Lucia,13.9094,-60.9789,29692,0,408,29284
11/23/22,Saint Lucia,13.9094,-60.9789,29692,0,408,29284
11/24/22,Saint Lucia,13.9094,-60.9789,29692,0,408,29284
11/25/22,Saint Lucia,13.9094,-60.9789,29692,0,408,29284
11/26/22,Saint Lucia,13.9094,-60.9789,29692,0,408,29284
11/27/22,Saint Lucia,13.9094,-60.9789,29692,0,408,29284
11/28/22,Saint Lucia,13.9094,-60.9789,29692,0,408,29284
11/29/22,Saint Lucia,13.9094,-60.9789,29711,0,408,29303
11/30/22,Saint Lucia,13.9094,-60.9789,29711,0,408,29303
12/1/22,Saint Lucia,13.9094,-60.9789,29711,0,408,29303
12/2/22,Saint Lucia,13.9094,-60.9789,29711,0,408,29303
12/3/22,Saint Lucia,13.9094,-60.9789,29711,0,408,29303
12/4/22,Saint Lucia,13.9094,-60.9789,29711,0,408,29303
12/5/22,Saint Lucia,13.9094,-60.9789,29711,0,408,29303
12/6/22,Saint Lucia,13.9094,-60.9789,29723,0,409,29314
12/7/22,Saint Lucia,13.9094,-60.9789,29723,0,409,29314
12/8/22,Saint Lucia,13.9094,-60.9789,29723,0,409,29314
12/9/22,Saint Lucia,13.9094,-60.9789,29723,0,409,29314
12/10/22,Saint Lucia,13.9094,-60.9789,29723,0,409,29314
12/11/22,Saint Lucia,13.9094,-60.9789,29723,0,409,29314
12/12/22,Saint Lucia,13.9094,-60.9789,29723,0,409,29314
12/13/22,Saint Lucia,13.9094,-60.9789,29729,0,409,29320
12/14/22,Saint Lucia,13.9094,-60.9789,29729,0,409,29320
12/15/22,Saint Lucia,13.9094,-60.9789,29729,0,409,29320
12/16/22,Saint Lucia,13.9094,-60.9789,29736,0,409,29327
12/17/22,Saint Lucia,13.9094,-60.9789,29736,0,409,29327
1/1/22,Saint Vincent and the Grenadines,12.9843,-61.2872,5850,0,81,5769
1/2/22,Saint Vincent and the Grenadines,12.9843,-61.2872,5952,0,83,5869
1/3/22,Saint Vincent and the Grenadines,12.9843,-61.2872,5991,0,83,5908
1/4/22,Saint Vincent and the Grenadines,12.9843,-61.2872,5991,0,83,5908
1/5/22,Saint Vincent and the Grenadines,12.9843,-61.2872,6039,0,83,5956
1/6/22,Saint Vincent and the Grenadines,12.9843,-61.2872,6247,0,84,6163
1/7/22,Saint Vincent and the Grenadines,12.9843,-61.2872,6247,0,84,6163
1/8/22,Saint Vincent and the Grenadines,12.9843,-61.2872,6247,0,84,6163
1/9/22,Saint Vincent and the Grenadines,12.9843,-61.2872,6247,0,84,6163
1/10/22,Saint Vincent and the Grenadines,12.9843,-61.2872,6247,0,84,6163
1/11/22,Saint Vincent and the Grenadines,12.9843,-61.2872,6562,0,85,6477
1/12/22,Saint Vincent and the Grenadines,12.9843,-61.2872,6562,0,85,6477
1/13/22,Saint Vincent and the Grenadines,12.9843,-61.2872,6575,0,85,6490
1/14/22,Saint Vincent and the Grenadines,12.9843,-61.2872,6581,0,85,6496
1/15/22,Saint Vincent and the Grenadines,12.9843,-61.2872,6581,0,85,6496
1/16/22,Saint Vincent and the Grenadines,12.9843,-61.2872,6581,0,85,6496
1/17/22,Saint Vincent and the Grenadines,12.9843,-61.2872,6599,0,87,6512
1/18/22,Saint Vincent and the Grenadines,12.9843,-61.2872,6604,0,88,6516
1/19/22,Saint Vincent and the Grenadines,12.9843,-61.2872,6604,0,88,6516
1/20/22,Saint Vincent and the Grenadines,12.9843,-61.2872,6615,0,90,6525
1/21/22,Saint Vincent and the Grenadines,12.9843,-61.2872,6615,0,90,6525
1/22/22,Saint Vincent and the Grenadines,12.9843,-61.2872,6615,0,90,6525
1/23/22,Saint Vincent and the Grenadines,12.9843,-61.2872,6615,0,90,6525
1/24/22,Saint Vincent and the Grenadines,12.9843,-61.2872,6660,0,92,6568
1/25/22,Saint Vincent and the Grenadines,12.9843,-61.2872,6662,0,92,6570
1/26/22,Saint Vincent and the Grenadines,12.9843,-61.2872,9385,0,92,9293
1/27/22,Saint Vincent and the Grenadines,12.9843,-61.2872,9447,0,92,9355
1/28/22,Saint Vincent and the Grenadines,12.9843,-61.2872,9447,0,93,9354
1/29/22,Saint Vincent and the Grenadines,12.9843,-61.2872,9447,0,93,9354
1/30/22,Saint Vincent and the Grenadines,12.9843,-61.2872,9447,0,93,9354
1/31/22,Saint Vincent and the Grenadines,12.9843,-61.2872,7903,0,94,7809
2/1/22,Saint Vincent and the Grenadines,12.9843,-61.2872,7929,0,94,7835
2/2/22,Saint Vincent and the Grenadines,12.9843,-61.2872,7939,0,95,7844
2/3/22,Saint Vincent and the Grenadines,12.9843,-61.2872,7939,0,95,7844
2/4/22,Saint Vincent and the Grenadines,12.9843,-61.2872,8035,0,95,7940
2/5/22,Saint Vincent and the Grenadines,12.9843,-61.2872,8035,0,99,7936
2/6/22,Saint Vincent and the Grenadines,12.9843,-61.2872,8035,0,99,7936
2/7/22,Saint Vincent and the Grenadines,12.9843,-61.2872,8114,0,99,8015
2/8/22,Saint Vincent and the Grenadines,12.9843,-61.2872,8134,0,99,8035
2/9/22,Saint Vincent and the Grenadines,12.9843,-61.2872,8144,0,101,8043
2/10/22,Saint Vincent and the Grenadines,12.9843,-61.2872,8144,0,101,8043
2/11/22,Saint Vincent and the Grenadines,12.9843,-61.2872,8144,0,101,8043
2/12/22,Saint Vincent and the Grenadines,12.9843,-61.2872,8144,0,102,8042
2/13/22,Saint Vincent and the Grenadines,12.9843,-61.2872,8144,0,102,8042
2/14/22,Saint Vincent and the Grenadines,12.9843,-61.2872,8246,0,103,8143
2/15/22,Saint Vincent and the Grenadines,12.9843,-61.2872,8248,0,103,8145
2/16/22,Saint Vincent and the Grenadines,12.9843,-61.2872,8248,0,103,8145
2/17/22,Saint Vincent and the Grenadines,12.9843,-61.2872,8278,0,103,8175
2/18/22,Saint Vincent and the Grenadines,12.9843,-61.2872,8278,0,104,8174
2/19/22,Saint Vincent and the Grenadines,12.9843,-61.2872,8278,0,104,8174
2/20/22,Saint Vincent and the Grenadines,12.9843,-61.2872,8278,0,104,8174
2/21/22,Saint Vincent and the Grenadines,12.9843,-61.2872,8278,0,105,8173
2/22/22,Saint Vincent and the Grenadines,12.9843,-61.2872,8297,0,106,8191
2/23/22,Saint Vincent and the Grenadines,12.9843,-61.2872,8301,0,106,8195
2/24/22,Saint Vincent and the Grenadines,12.9843,-61.2872,8303,0,106,8197
2/25/22,Saint Vincent and the Grenadines,12.9843,-61.2872,8305,0,106,8199
2/26/22,Saint Vincent and the Grenadines,12.9843,-61.2872,8305,0,106,8199
2/27/22,Saint Vincent and the Grenadines,12.9843,-61.2872,8305,0,106,8199
2/28/22,Saint Vincent and the Grenadines,12.9843,-61.2872,8309,0,106,8203
3/1/22,Saint Vincent and the Grenadines,12.9843,-61.2872,8311,0,106,8205
3/2/22,Saint Vincent and the Grenadines,12.9843,-61.2872,8311,0,106,8205
3/3/22,Saint Vincent and the Grenadines,12.9843,-61.2872,8313,0,106,8207
3/4/22,Saint Vincent and the Grenadines,12.9843,-61.2872,8316,0,106,8210
3/5/22,Saint Vincent and the Grenadines,12.9843,-61.2872,8316,0,106,8210
3/6/22,Saint Vincent and the Grenadines,12.9843,-61.2872,8316,0,106,8210
3/7/22,Saint Vincent and the Grenadines,12.9843,-61.2872,8320,0,106,8214
3/8/22,Saint Vincent and the Grenadines,12.9843,-61.2872,8321,0,106,8215
3/9/22,Saint Vincent and the Grenadines,12.9843,-61.2872,8321,0,106,8215
3/10/22,Saint Vincent and the Grenadines,12.9843,-61.2872,8321,0,106,8215
3/11/22,Saint Vincent and the Grenadines,12.9843,-61.2872,8323,0,106,8217
3/12/22,Saint Vincent and the Grenadines,12.9843,-61.2872,8323,0,106,8217
3/13/22,Saint Vincent and the Grenadines,12.9843,-61.2872,8323,0,106,8217
3/14/22,Saint Vincent and the Grenadines,12.9843,-61.2872,8323,0,106,8217
3/15/22,Saint Vincent and the Grenadines,12.9843,-61.2872,8323,0,106,8217
3/16/22,Saint Vincent and the Grenadines,12.9843,-61.2872,8326,0,106,8220
3/17/22,Saint Vincent and the Grenadines,12.9843,-61.2872,8326,0,106,8220
3/18/22,Saint Vincent and the Grenadines,12.9843,-61.2872,8326,0,106,8220
3/19/22,Saint Vincent and the Grenadines,12.9843,-61.2872,8326,0,106,8220
3/20/22,Saint Vincent and the Grenadines,12.9843,-61.2872,8326,0,106,8220
3/21/22,Saint Vincent and the Grenadines,12.9843,-61.2872,8329,0,106,8223
3/22/22,Saint Vincent and the Grenadines,12.9843,-61.2872,8330,0,106,8224
3/23/22,Saint Vincent and the Grenadines,12.9843,-61.2872,8330,0,106,8224
3/24/22,Saint Vincent and the Grenadines,12.9843,-61.2872,8330,0,106,8224
3/25/22,Saint Vincent and the Grenadines,12.9843,-61.2872,8332,0,106,8226
3/26/22,Saint Vincent and the Grenadines,12.9843,-61.2872,8332,0,106,8226
3/27/22,Saint Vincent and the Grenadines,12.9843,-61.2872,8332,0,106,8226
3/28/22,Saint Vincent and the Grenadines,12.9843,-61.2872,8333,0,106,8227
3/29/22,Saint Vincent and the Grenadines,12.9843,-61.2872,8335,0,106,8229
3/30/22,Saint Vincent and the Grenadines,12.9843,-61.2872,8335,0,106,8229
3/31/22,Saint Vincent and the Grenadines,12.9843,-61.2872,8335,0,106,8229
4/1/22,Saint Vincent and the Grenadines,12.9843,-61.2872,8335,0,106,8229
4/2/22,Saint Vincent and the Grenadines,12.9843,-61.2872,8335,0,106,8229
4/3/22,Saint Vincent and the Grenadines,12.9843,-61.2872,8335,0,106,8229
4/4/22,Saint Vincent and the Grenadines,12.9843,-61.2872,8335,0,106,8229
4/5/22,Saint Vincent and the Grenadines,12.9843,-61.2872,8338,0,106,8232
4/6/22,Saint Vincent and the Grenadines,12.9843,-61.2872,8338,0,106,8232
4/7/22,Saint Vincent and the Grenadines,12.9843,-61.2872,8339,0,106,8233
4/8/22,Saint Vincent and the Grenadines,12.9843,-61.2872,8339,0,106,8233
4/9/22,Saint Vincent and the Grenadines,12.9843,-61.2872,8339,0,106,8233
4/10/22,Saint Vincent and the Grenadines,12.9843,-61.2872,8339,0,106,8233
4/11/22,Saint Vincent and the Grenadines,12.9843,-61.2872,8342,0,106,8236
4/12/22,Saint Vincent and the Grenadines,12.9843,-61.2872,8344,0,106,8238
4/13/22,Saint Vincent and the Grenadines,12.9843,-61.2872,8344,0,106,8238
4/14/22,Saint Vincent and the Grenadines,12.9843,-61.2872,8348,0,106,8242
4/15/22,Saint Vincent and the Grenadines,12.9843,-61.2872,8348,0,106,8242
4/16/22,Saint Vincent and the Grenadines,12.9843,-61.2872,8348,0,106,8242
4/17/22,Saint Vincent and the Grenadines,12.9843,-61.2872,8348,0,106,8242
4/18/22,Saint Vincent and the Grenadines,12.9843,-61.2872,8348,0,106,8242
4/19/22,Saint Vincent and the Grenadines,12.9843,-61.2872,8352,0,106,8246
4/20/22,Saint Vincent and the Grenadines,12.9843,-61.2872,8355,0,106,8249
4/21/22,Saint Vincent and the Grenadines,12.9843,-61.2872,8378,0,106,8272
4/22/22,Saint Vincent and the Grenadines,12.9843,-61.2872,8383,0,106,8277
4/23/22,Saint Vincent and the Grenadines,12.9843,-61.2872,8383,0,106,8277
4/24/22,Saint Vincent and the Grenadines,12.9843,-61.2872,8383,0,106,8277
4/25/22,Saint Vincent and the Grenadines,12.9843,-61.2872,8394,0,106,8288
4/26/22,Saint Vincent and the Grenadines,12.9843,-61.2872,8404,0,106,8298
4/27/22,Saint Vincent and the Grenadines,12.9843,-61.2872,8406,0,106,8300
4/28/22,Saint Vincent and the Grenadines,12.9843,-61.2872,8413,0,106,8307
4/29/22,Saint Vincent and the Grenadines,12.9843,-61.2872,8419,0,106,8313
4/30/22,Saint Vincent and the Grenadines,12.9843,-61.2872,8419,0,106,8313
5/1/22,Saint Vincent and the Grenadines,12.9843,-61.2872,8419,0,106,8313
5/2/22,Saint Vincent and the Grenadines,12.9843,-61.2872,8419,0,106,8313
5/3/22,Saint Vincent and the Grenadines,12.9843,-61.2872,8425,0,106,8319
5/4/22,Saint Vincent and the Grenadines,12.9843,-61.2872,8425,0,106,8319
5/5/22,Saint Vincent and the Grenadines,12.9843,-61.2872,8428,0,106,8322
5/6/22,Saint Vincent and the Grenadines,12.9843,-61.2872,8439,0,106,8333
5/7/22,Saint Vincent and the Grenadines,12.9843,-61.2872,8439,0,106,8333
5/8/22,Saint Vincent and the Grenadines,12.9843,-61.2872,8439,0,106,8333
5/9/22,Saint Vincent and the Grenadines,12.9843,-61.2872,8450,0,106,8344
5/10/22,Saint Vincent and the Grenadines,12.9843,-61.2872,8472,0,106,8366
5/11/22,Saint Vincent and the Grenadines,12.9843,-61.2872,8479,0,106,8373
5/12/22,Saint Vincent and the Grenadines,12.9843,-61.2872,8484,0,106,8378
5/13/22,Saint Vincent and the Grenadines,12.9843,-61.2872,8494,0,106,8388
5/14/22,Saint Vincent and the Grenadines,12.9843,-61.2872,8494,0,106,8388
5/15/22,Saint Vincent and the Grenadines,12.9843,-61.2872,8494,0,106,8388
5/16/22,Saint Vincent and the Grenadines,12.9843,-61.2872,8500,0,106,8394
5/17/22,Saint Vincent and the Grenadines,12.9843,-61.2872,8527,0,106,8421
5/18/22,Saint Vincent and the Grenadines,12.9843,-61.2872,8527,0,106,8421
5/19/22,Saint Vincent and the Grenadines,12.9843,-61.2872,8570,0,106,8464
5/20/22,Saint Vincent and the Grenadines,12.9843,-61.2872,8591,0,106,8485
5/21/22,Saint Vincent and the Grenadines,12.9843,-61.2872,8591,0,106,8485
5/22/22,Saint Vincent and the Grenadines,12.9843,-61.2872,8591,0,106,8485
5/23/22,Saint Vincent and the Grenadines,12.9843,-61.2872,8591,0,106,8485
5/24/22,Saint Vincent and the Grenadines,12.9843,-61.2872,8626,0,106,8520
5/25/22,Saint Vincent and the Grenadines,12.9843,-61.2872,8641,0,106,8535
5/26/22,Saint Vincent and the Grenadines,12.9843,-61.2872,8657,0,106,8551
5/27/22,Saint Vincent and the Grenadines,12.9843,-61.2872,8670,0,106,8564
5/28/22,Saint Vincent and the Grenadines,12.9843,-61.2872,8670,0,106,8564
5/29/22,Saint Vincent and the Grenadines,12.9843,-61.2872,8670,0,106,8564
5/30/22,Saint Vincent and the Grenadines,12.9843,-61.2872,8670,0,106,8564
5/31/22,Saint Vincent and the Grenadines,12.9843,-61.2872,8670,0,107,8563
6/1/22,Saint Vincent and the Grenadines,12.9843,-61.2872,8717,0,107,8610
6/2/22,Saint Vincent and the Grenadines,12.9843,-61.2872,8741,0,108,8633
6/3/22,Saint Vincent and the Grenadines,12.9843,-61.2872,8762,0,108,8654
6/4/22,Saint Vincent and the Grenadines,12.9843,-61.2872,8762,0,108,8654
6/5/22,Saint Vincent and the Grenadines,12.9843,-61.2872,8762,0,108,8654
6/6/22,Saint Vincent and the Grenadines,12.9843,-61.2872,8762,0,108,8654
6/7/22,Saint Vincent and the Grenadines,12.9843,-61.2872,8807,0,108,8699
6/8/22,Saint Vincent and the Grenadines,12.9843,-61.2872,8807,0,108,8699
6/9/22,Saint Vincent and the Grenadines,12.9843,-61.2872,8807,0,108,8699
6/10/22,Saint Vincent and the Grenadines,12.9843,-61.2872,8883,0,108,8775
6/11/22,Saint Vincent and the Grenadines,12.9843,-61.2872,8883,0,108,8775
6/12/22,Saint Vincent and the Grenadines,12.9843,-61.2872,8883,0,108,8775
6/13/22,Saint Vincent and the Grenadines,12.9843,-61.2872,8883,0,108,8775
6/14/22,Saint Vincent and the Grenadines,12.9843,-61.2872,8916,0,109,8807
6/15/22,Saint Vincent and the Grenadines,12.9843,-61.2872,8929,0,109,8820
6/16/22,Saint Vincent and the Grenadines,12.9843,-61.2872,8936,0,109,8827
6/17/22,Saint Vincent and the Grenadines,12.9843,-61.2872,8956,0,110,8846
6/18/22,Saint Vincent and the Grenadines,12.9843,-61.2872,8956,0,110,8846
6/19/22,Saint Vincent and the Grenadines,12.9843,-61.2872,8956,0,110,8846
6/20/22,Saint Vincent and the Grenadines,12.9843,-61.2872,8956,0,110,8846
6/21/22,Saint Vincent and the Grenadines,12.9843,-61.2872,8995,0,111,8884
6/22/22,Saint Vincent and the Grenadines,12.9843,-61.2872,9000,0,111,8889
6/23/22,Saint Vincent and the Grenadines,12.9843,-61.2872,9008,0,111,8897
6/24/22,Saint Vincent and the Grenadines,12.9843,-61.2872,9026,0,111,8915
6/25/22,Saint Vincent and the Grenadines,12.9843,-61.2872,9026,0,111,8915
6/26/22,Saint Vincent and the Grenadines,12.9843,-61.2872,9026,0,111,8915
6/27/22,Saint Vincent and the Grenadines,12.9843,-61.2872,9026,0,111,8915
6/28/22,Saint Vincent and the Grenadines,12.9843,-61.2872,9038,0,111,8927
6/29/22,Saint Vincent and the Grenadines,12.9843,-61.2872,9045,0,112,8933
6/30/22,Saint Vincent and the Grenadines,12.9843,-61.2872,9051,0,112,8939
7/1/22,Saint Vincent and the Grenadines,12.9843,-61.2872,9058,0,112,8946
7/2/22,Saint Vincent and the Grenadines,12.9843,-61.2872,9058,0,112,8946
7/3/22,Saint Vincent and the Grenadines,12.9843,-61.2872,9058,0,114,8944
7/4/22,Saint Vincent and the Grenadines,12.9843,-61.2872,9058,0,114,8944
7/5/22,Saint Vincent and the Grenadines,12.9843,-61.2872,9060,0,114,8946
7/6/22,Saint Vincent and the Grenadines,12.9843,-61.2872,9075,0,114,8961
7/7/22,Saint Vincent and the Grenadines,12.9843,-61.2872,9076,0,114,8962
7/8/22,Saint Vincent and the Grenadines,12.9843,-61.2872,9083,0,114,8969
7/9/22,Saint Vincent and the Grenadines,12.9843,-61.2872,9083,0,114,8969
7/10/22,Saint Vincent and the Grenadines,12.9843,-61.2872,9083,0,114,8969
7/11/22,Saint Vincent and the Grenadines,12.9843,-61.2872,9083,0,114,8969
7/12/22,Saint Vincent and the Grenadines,12.9843,-61.2872,9127,0,114,9013
7/13/22,Saint Vincent and the Grenadines,12.9843,-61.2872,9162,0,114,9048
7/14/22,Saint Vincent and the Grenadines,12.9843,-61.2872,9183,0,114,9069
7/15/22,Saint Vincent and the Grenadines,12.9843,-61.2872,9183,0,115,9068
7/16/22,Saint Vincent and the Grenadines,12.9843,-61.2872,9183,0,115,9068
7/17/22,Saint Vincent and the Grenadines,12.9843,-61.2872,9183,0,115,9068
7/18/22,Saint Vincent and the Grenadines,12.9843,-61.2872,9183,0,115,9068
7/19/22,Saint Vincent and the Grenadines,12.9843,-61.2872,9240,0,115,9125
7/20/22,Saint Vincent and the Grenadines,12.9843,-61.2872,9240,0,115,9125
7/21/22,Saint Vincent and the Grenadines,12.9843,-61.2872,9267,0,115,9152
7/22/22,Saint Vincent and the Grenadines,12.9843,-61.2872,9282,0,115,9167
7/23/22,Saint Vincent and the Grenadines,12.9843,-61.2872,9282,0,115,9167
7/24/22,Saint Vincent and the Grenadines,12.9843,-61.2872,9282,0,115,9167
7/25/22,Saint Vincent and the Grenadines,12.9843,-61.2872,9282,0,115,9167
7/26/22,Saint Vincent and the Grenadines,12.9843,-61.2872,9321,0,115,9206
7/27/22,Saint Vincent and the Grenadines,12.9843,-61.2872,9330,0,115,9215
7/28/22,Saint Vincent and the Grenadines,12.9843,-61.2872,9330,0,115,9215
7/29/22,Saint Vincent and the Grenadines,12.9843,-61.2872,9354,0,115,9239
7/30/22,Saint Vincent and the Grenadines,12.9843,-61.2872,9354,0,115,9239
7/31/22,Saint Vincent and the Grenadines,12.9843,-61.2872,9354,0,115,9239
8/1/22,Saint Vincent and the Grenadines,12.9843,-61.2872,9354,0,115,9239
8/2/22,Saint Vincent and the Grenadines,12.9843,-61.2872,9370,0,115,9255
8/3/22,Saint Vincent and the Grenadines,12.9843,-61.2872,9370,0,115,9255
8/4/22,Saint Vincent and the Grenadines,12.9843,-61.2872,9378,0,115,9263
8/5/22,Saint Vincent and the Grenadines,12.9843,-61.2872,9390,0,115,9275
8/6/22,Saint Vincent and the Grenadines,12.9843,-61.2872,9390,0,115,9275
8/7/22,Saint Vincent and the Grenadines,12.9843,-61.2872,9390,0,115,9275
8/8/22,Saint Vincent and the Grenadines,12.9843,-61.2872,9390,0,115,9275
8/9/22,Saint Vincent and the Grenadines,12.9843,-61.2872,9396,0,115,9281
8/10/22,Saint Vincent and the Grenadines,12.9843,-61.2872,9396,0,115,9281
8/11/22,Saint Vincent and the Grenadines,12.9843,-61.2872,9396,0,115,9281
8/12/22,Saint Vincent and the Grenadines,12.9843,-61.2872,9404,0,115,9289
8/13/22,Saint Vincent and the Grenadines,12.9843,-61.2872,9404,0,115,9289
8/14/22,Saint Vincent and the Grenadines,12.9843,-61.2872,9404,0,115,9289
8/15/22,Saint Vincent and the Grenadines,12.9843,-61.2872,9404,0,115,9289
8/16/22,Saint Vincent and the Grenadines,12.9843,-61.2872,9405,0,115,9290
8/17/22,Saint Vincent and the Grenadines,12.9843,-61.2872,9405,0,115,9290
8/18/22,Saint Vincent and the Grenadines,12.9843,-61.2872,9412,0,115,9297
8/19/22,Saint Vincent and the Grenadines,12.9843,-61.2872,9412,0,115,9297
8/20/22,Saint Vincent and the Grenadines,12.9843,-61.2872,9412,0,115,9297
8/21/22,Saint Vincent and the Grenadines,12.9843,-61.2872,9412,0,115,9297
8/22/22,Saint Vincent and the Grenadines,12.9843,-61.2872,9412,0,115,9297
8/23/22,Saint Vincent and the Grenadines,12.9843,-61.2872,9414,0,115,9299
8/24/22,Saint Vincent and the Grenadines,12.9843,-61.2872,9415,0,115,9300
8/25/22,Saint Vincent and the Grenadines,12.9843,-61.2872,9415,0,115,9300
8/26/22,Saint Vincent and the Grenadines,12.9843,-61.2872,9420,0,115,9305
8/27/22,Saint Vincent and the Grenadines,12.9843,-61.2872,9420,0,115,9305
8/28/22,Saint Vincent and the Grenadines,12.9843,-61.2872,9420,0,115,9305
8/29/22,Saint Vincent and the Grenadines,12.9843,-61.2872,9420,0,115,9305
8/30/22,Saint Vincent and the Grenadines,12.9843,-61.2872,9428,0,115,9313
8/31/22,Saint Vincent and the Grenadines,12.9843,-61.2872,9428,0,115,9313
9/1/22,Saint Vincent and the Grenadines,12.9843,-61.2872,9429,0,115,9314
9/2/22,Saint Vincent and the Grenadines,12.9843,-61.2872,9430,0,115,9315
9/3/22,Saint Vincent and the Grenadines,12.9843,-61.2872,9430,0,115,9315
9/4/22,Saint Vincent and the Grenadines,12.9843,-61.2872,9430,0,115,9315
9/5/22,Saint Vincent and the Grenadines,12.9843,-61.2872,9430,0,115,9315
9/6/22,Saint Vincent and the Grenadines,12.9843,-61.2872,9430,0,115,9315
9/7/22,Saint Vincent and the Grenadines,12.9843,-61.2872,9430,0,115,9315
9/8/22,Saint Vincent and the Grenadines,12.9843,-61.2872,9430,0,115,9315
9/9/22,Saint Vincent and the Grenadines,12.9843,-61.2872,9430,0,115,9315
9/10/22,Saint Vincent and the Grenadines,12.9843,-61.2872,9430,0,115,9315
9/11/22,Saint Vincent and the Grenadines,12.9843,-61.2872,9430,0,115,9315
9/12/22,Saint Vincent and the Grenadines,12.9843,-61.2872,9446,0,116,9330
9/13/22,Saint Vincent and the Grenadines,12.9843,-61.2872,9446,0,116,9330
9/14/22,Saint Vincent and the Grenadines,12.9843,-61.2872,9446,0,116,9330
9/15/22,Saint Vincent and the Grenadines,12.9843,-61.2872,9446,0,116,9330
9/16/22,Saint Vincent and the Grenadines,12.9843,-61.2872,9446,0,116,9330
9/17/22,Saint Vincent and the Grenadines,12.9843,-61.2872,9446,0,116,9330
9/18/22,Saint Vincent and the Grenadines,12.9843,-61.2872,9446,0,116,9330
9/19/22,Saint Vincent and the Grenadines,12.9843,-61.2872,9446,0,116,9330
9/20/22,Saint Vincent and the Grenadines,12.9843,-61.2872,9448,0,116,9332
9/21/22,Saint Vincent and the Grenadines,12.9843,-61.2872,9448,0,116,9332
9/22/22,Saint Vincent and the Grenadines,12.9843,-61.2872,9448,0,116,9332
9/23/22,Saint Vincent and the Grenadines,12.9843,-61.2872,9448,0,116,9332
9/24/22,Saint Vincent and the Grenadines,12.9843,-61.2872,9448,0,116,9332
9/25/22,Saint Vincent and the Grenadines,12.9843,-61.2872,9448,0,116,9332
9/26/22,Saint Vincent and the Grenadines,12.9843,-61.2872,9448,0,116,9332
9/27/22,Saint Vincent and the Grenadines,12.9843,-61.2872,9448,0,116,9332
9/28/22,Saint Vincent and the Grenadines,12.9843,-61.2872,9448,0,116,9332
9/29/22,Saint Vincent and the Grenadines,12.9843,-61.2872,9448,0,116,9332
9/30/22,Saint Vincent and the Grenadines,12.9843,-61.2872,9448,0,116,9332
10/1/22,Saint Vincent and the Grenadines,12.9843,-61.2872,9448,0,116,9332
10/2/22,Saint Vincent and the Grenadines,12.9843,-61.2872,9448,0,116,9332
10/3/22,Saint Vincent and the Grenadines,12.9843,-61.2872,9448,0,116,9332
10/4/22,Saint Vincent and the Grenadines,12.9843,-61.2872,9448,0,116,9332
10/5/22,Saint Vincent and the Grenadines,12.9843,-61.2872,9448,0,116,9332
10/6/22,Saint Vincent and the Grenadines,12.9843,-61.2872,9448,0,116,9332
10/7/22,Saint Vincent and the Grenadines,12.9843,-61.2872,9448,0,116,9332
10/8/22,Saint Vincent and the Grenadines,12.9843,-61.2872,9448,0,116,9332
10/9/22,Saint Vincent and the Grenadines,12.9843,-61.2872,9448,0,116,9332
10/10/22,Saint Vincent and the Grenadines,12.9843,-61.2872,9448,0,116,9332
10/11/22,Saint Vincent and the Grenadines,12.9843,-61.2872,9448,0,116,9332
10/12/22,Saint Vincent and the Grenadines,12.9843,-61.2872,9448,0,116,9332
10/13/22,Saint Vincent and the Grenadines,12.9843,-61.2872,9448,0,116,9332
10/14/22,Saint Vincent and the Grenadines,12.9843,-61.2872,9450,0,116,9334
10/15/22,Saint Vincent and the Grenadines,12.9843,-61.2872,9450,0,116,9334
10/16/22,Saint Vincent and the Grenadines,12.9843,-61.2872,9450,0,116,9334
10/17/22,Saint Vincent and the Grenadines,12.9843,-61.2872,9450,0,116,9334
10/18/22,Saint Vincent and the Grenadines,12.9843,-61.2872,9450,0,116,9334
10/19/22,Saint Vincent and the Grenadines,12.9843,-61.2872,9452,0,116,9336
10/20/22,Saint Vincent and the Grenadines,12.9843,-61.2872,9452,0,116,9336
10/21/22,Saint Vincent and the Grenadines,12.9843,-61.2872,9452,0,116,9336
10/22/22,Saint Vincent and the Grenadines,12.9843,-61.2872,9452,0,116,9336
10/23/22,Saint Vincent and the Grenadines,12.9843,-61.2872,9452,0,116,9336
10/24/22,Saint Vincent and the Grenadines,12.9843,-61.2872,9452,0,116,9336
10/25/22,Saint Vincent and the Grenadines,12.9843,-61.2872,9452,0,116,9336
10/26/22,Saint Vincent and the Grenadines,12.9843,-61.2872,9457,0,116,9341
10/27/22,Saint Vincent and the Grenadines,12.9843,-61.2872,9457,0,116,9341
10/28/22,Saint Vincent and the Grenadines,12.9843,-61.2872,9457,0,116,9341
10/29/22,Saint Vincent and the Grenadines,12.9843,-61.2872,9457,0,116,9341
10/30/22,Saint Vincent and the Grenadines,12.9843,-61.2872,9457,0,116,9341
10/31/22,Saint Vincent and the Grenadines,12.9843,-61.2872,9457,0,116,9341
11/1/22,Saint Vincent and the Grenadines,12.9843,-61.2872,9457,0,116,9341
11/2/22,Saint Vincent and the Grenadines,12.9843,-61.2872,9459,0,116,9343
11/3/22,Saint Vincent and the Grenadines,12.9843,-61.2872,9459,0,116,9343
11/4/22,Saint Vincent and the Grenadines,12.9843,-61.2872,9459,0,116,9343
11/5/22,Saint Vincent and the Grenadines,12.9843,-61.2872,9459,0,116,9343
11/6/22,Saint Vincent and the Grenadines,12.9843,-61.2872,9459,0,116,9343
11/7/22,Saint Vincent and the Grenadines,12.9843,-61.2872,9459,0,116,9343
11/8/22,Saint Vincent and the Grenadines,12.9843,-61.2872,9459,0,116,9343
11/9/22,Saint Vincent and the Grenadines,12.9843,-61.2872,9459,0,116,9343
11/10/22,Saint Vincent and the Grenadines,12.9843,-61.2872,9459,0,116,9343
11/11/22,Saint Vincent and the Grenadines,12.9843,-61.2872,9459,0,116,9343
11/12/22,Saint Vincent and the Grenadines,12.9843,-61.2872,9459,0,116,9343
11/13/22,Saint Vincent and the Grenadines,12.9843,-61.2872,9459,0,116,9343
11/14/22,Saint Vincent and the Grenadines,12.9843,-61.2872,9459,0,116,9343
11/15/22,Saint Vincent and the Grenadines,12.9843,-61.2872,9462,0,116,9346
11/16/22,Saint Vincent and the Grenadines,12.9843,-61.2872,9462,0,116,9346
11/17/22,Saint Vincent and the Grenadines,12.9843,-61.2872,9462,0,116,9346
11/18/22,Saint Vincent and the Grenadines,12.9843,-61.2872,9462,0,116,9346
11/19/22,Saint Vincent and the Grenadines,12.9843,-61.2872,9462,0,116,9346
11/20/22,Saint Vincent and the Grenadines,12.9843,-61.2872,9462,0,116,9346
11/21/22,Saint Vincent and the Grenadines,12.9843,-61.2872,9462,0,116,9346
11/22/22,Saint Vincent and the Grenadines,12.9843,-61.2872,9462,0,116,9346
11/23/22,Saint Vincent and the Grenadines,12.9843,-61.2872,9462,0,116,9346
11/24/22,Saint Vincent and the Grenadines,12.9843,-61.2872,9462,0,116,9346
11/25/22,Saint Vincent and the Grenadines,12.9843,-61.2872,9462,0,116,9346
11/26/22,Saint Vincent and the Grenadines,12.9843,-61.2872,9462,0,116,9346
11/27/22,Saint Vincent and the Grenadines,12.9843,-61.2872,9462,0,116,9346
11/28/22,Saint Vincent and the Grenadines,12.9843,-61.2872,9462,0,116,9346
11/29/22,Saint Vincent and the Grenadines,12.9843,-61.2872,9468,0,116,9352
11/30/22,Saint Vincent and the Grenadines,12.9843,-61.2872,9474,0,116,9358
12/1/22,Saint Vincent and the Grenadines,12.9843,-61.2872,9474,0,116,9358
12/2/22,Saint Vincent and the Grenadines,12.9843,-61.2872,9474,0,116,9358
12/3/22,Saint Vincent and the Grenadines,12.9843,-61.2872,9474,0,116,9358
12/4/22,Saint Vincent and the Grenadines,12.9843,-61.2872,9474,0,116,9358
12/5/22,Saint Vincent and the Grenadines,12.9843,-61.2872,9474,0,116,9358
12/6/22,Saint Vincent and the Grenadines,12.9843,-61.2872,9474,0,116,9358
12/7/22,Saint Vincent and the Grenadines,12.9843,-61.2872,9474,0,116,9358
12/8/22,Saint Vincent and the Grenadines,12.9843,-61.2872,9474,0,116,9358
12/9/22,Saint Vincent and the Grenadines,12.9843,-61.2872,9482,0,116,9366
12/10/22,Saint Vincent and the Grenadines,12.9843,-61.2872,9482,0,116,9366
12/11/22,Saint Vincent and the Grenadines,12.9843,-61.2872,9482,0,116,9366
12/12/22,Saint Vincent and the Grenadines,12.9843,-61.2872,9500,0,116,9384
12/13/22,Saint Vincent and the Grenadines,12.9843,-61.2872,9500,0,116,9384
12/14/22,Saint Vincent and the Grenadines,12.9843,-61.2872,9500,0,116,9384
12/15/22,Saint Vincent and the Grenadines,12.9843,-61.2872,9500,0,116,9384
12/16/22,Saint Vincent and the Grenadines,12.9843,-61.2872,9500,0,116,9384
12/17/22,Saint Vincent and the Grenadines,12.9843,-61.2872,9500,0,116,9384
1/1/22,Samoa,-13.759,-172.1046,3,0,0,3
1/2/22,Samoa,-13.759,-172.1046,3,0,0,3
1/3/22,Samoa,-13.759,-172.1046,3,0,0,3
1/4/22,Samoa,-13.759,-172.1046,3,0,0,3
1/5/22,Samoa,-13.759,-172.1046,3,0,0,3
1/6/22,Samoa,-13.759,-172.1046,3,0,0,3
1/7/22,Samoa,-13.759,-172.1046,3,0,0,3
1/8/22,Samoa,-13.759,-172.1046,3,0,0,3
1/9/22,Samoa,-13.759,-172.1046,3,0,0,3
1/10/22,Samoa,-13.759,-172.1046,3,0,0,3
1/11/22,Samoa,-13.759,-172.1046,3,0,0,3
1/12/22,Samoa,-13.759,-172.1046,3,0,0,3
1/13/22,Samoa,-13.759,-172.1046,3,0,0,3
1/14/22,Samoa,-13.759,-172.1046,3,0,0,3
1/15/22,Samoa,-13.759,-172.1046,3,0,0,3
1/16/22,Samoa,-13.759,-172.1046,3,0,0,3
1/17/22,Samoa,-13.759,-172.1046,3,0,0,3
1/18/22,Samoa,-13.759,-172.1046,3,0,0,3
1/19/22,Samoa,-13.759,-172.1046,3,0,0,3
1/20/22,Samoa,-13.759,-172.1046,13,0,0,13
1/21/22,Samoa,-13.759,-172.1046,13,0,0,13
1/22/22,Samoa,-13.759,-172.1046,18,0,0,18
1/23/22,Samoa,-13.759,-172.1046,18,0,0,18
1/24/22,Samoa,-13.759,-172.1046,20,0,0,20
1/25/22,Samoa,-13.759,-172.1046,26,0,0,26
1/26/22,Samoa,-13.759,-172.1046,28,0,0,28
1/27/22,Samoa,-13.759,-172.1046,29,0,0,29
1/28/22,Samoa,-13.759,-172.1046,29,0,0,29
1/29/22,Samoa,-13.759,-172.1046,30,0,0,30
1/30/22,Samoa,-13.759,-172.1046,30,0,0,30
1/31/22,Samoa,-13.759,-172.1046,32,0,0,32
2/1/22,Samoa,-13.759,-172.1046,32,0,0,32
2/2/22,Samoa,-13.759,-172.1046,33,0,0,33
2/3/22,Samoa,-13.759,-172.1046,33,0,0,33
2/4/22,Samoa,-13.759,-172.1046,33,0,0,33
2/5/22,Samoa,-13.759,-172.1046,33,0,0,33
2/6/22,Samoa,-13.759,-172.1046,33,0,0,33
2/7/22,Samoa,-13.759,-172.1046,33,0,0,33
2/8/22,Samoa,-13.759,-172.1046,33,0,0,33
2/9/22,Samoa,-13.759,-172.1046,33,0,0,33
2/10/22,Samoa,-13.759,-172.1046,33,0,0,33
2/11/22,Samoa,-13.759,-172.1046,33,0,0,33
2/12/22,Samoa,-13.759,-172.1046,33,0,0,33
2/13/22,Samoa,-13.759,-172.1046,33,0,0,33
2/14/22,Samoa,-13.759,-172.1046,33,0,0,33
2/15/22,Samoa,-13.759,-172.1046,33,0,0,33
2/16/22,Samoa,-13.759,-172.1046,33,0,0,33
2/17/22,Samoa,-13.759,-172.1046,33,0,0,33
2/18/22,Samoa,-13.759,-172.1046,33,0,0,33
2/19/22,Samoa,-13.759,-172.1046,33,0,0,33
2/20/22,Samoa,-13.759,-172.1046,33,0,0,33
2/21/22,Samoa,-13.759,-172.1046,33,0,0,33
2/22/22,Samoa,-13.759,-172.1046,33,0,0,33
2/23/22,Samoa,-13.759,-172.1046,33,0,0,33
2/24/22,Samoa,-13.759,-172.1046,33,0,0,33
2/25/22,Samoa,-13.759,-172.1046,33,0,0,33
2/26/22,Samoa,-13.759,-172.1046,33,0,0,33
2/27/22,Samoa,-13.759,-172.1046,33,0,0,33
2/28/22,Samoa,-13.759,-172.1046,33,0,0,33
3/1/22,Samoa,-13.759,-172.1046,33,0,0,33
3/2/22,Samoa,-13.759,-172.1046,33,0,0,33
3/3/22,Samoa,-13.759,-172.1046,33,0,0,33
3/4/22,Samoa,-13.759,-172.1046,33,0,0,33
3/5/22,Samoa,-13.759,-172.1046,33,0,0,33
3/6/22,Samoa,-13.759,-172.1046,33,0,0,33
3/7/22,Samoa,-13.759,-172.1046,41,0,0,41
3/8/22,Samoa,-13.759,-172.1046,41,0,0,41
3/9/22,Samoa,-13.759,-172.1046,41,0,0,41
3/10/22,Samoa,-13.759,-172.1046,45,0,0,45
3/11/22,Samoa,-13.759,-172.1046,46,0,0,46
3/12/22,Samoa,-13.759,-172.1046,48,0,0,48
3/13/22,Samoa,-13.759,-172.1046,48,0,0,48
3/14/22,Samoa,-13.759,-172.1046,48,0,0,48
3/15/22,Samoa,-13.759,-172.1046,48,0,0,48
3/16/22,Samoa,-13.759,-172.1046,48,0,0,48
3/17/22,Samoa,-13.759,-172.1046,49,0,0,49
3/18/22,Samoa,-13.759,-172.1046,60,0,0,60
3/19/22,Samoa,-13.759,-172.1046,60,0,0,60
3/20/22,Samoa,-13.759,-172.1046,111,0,0,111
3/21/22,Samoa,-13.759,-172.1046,229,0,0,229
3/22/22,Samoa,-13.759,-172.1046,295,0,0,295
3/23/22,Samoa,-13.759,-172.1046,295,0,0,295
3/24/22,Samoa,-13.759,-172.1046,796,0,0,796
3/25/22,Samoa,-13.759,-172.1046,796,0,0,796
3/26/22,Samoa,-13.759,-172.1046,889,0,0,889
3/27/22,Samoa,-13.759,-172.1046,1105,0,0,1105
3/28/22,Samoa,-13.759,-172.1046,1105,0,0,1105
3/29/22,Samoa,-13.759,-172.1046,1541,0,0,1541
3/30/22,Samoa,-13.759,-172.1046,1541,0,0,1541
3/31/22,Samoa,-13.759,-172.1046,1713,0,0,1713
4/1/22,Samoa,-13.759,-172.1046,2128,0,1,2127
4/2/22,Samoa,-13.759,-172.1046,2331,0,1,2330
4/3/22,Samoa,-13.759,-172.1046,2331,0,1,2330
4/4/22,Samoa,-13.759,-172.1046,2622,0,2,2620
4/5/22,Samoa,-13.759,-172.1046,2622,0,2,2620
4/6/22,Samoa,-13.759,-172.1046,2782,0,2,2780
4/7/22,Samoa,-13.759,-172.1046,3320,0,3,3317
4/8/22,Samoa,-13.759,-172.1046,3320,0,3,3317
4/9/22,Samoa,-13.759,-172.1046,3320,0,3,3317
4/10/22,Samoa,-13.759,-172.1046,3665,0,7,3658
4/11/22,Samoa,-13.759,-172.1046,3665,0,7,3658
4/12/22,Samoa,-13.759,-172.1046,4092,0,9,4083
4/13/22,Samoa,-13.759,-172.1046,4092,0,9,4083
4/14/22,Samoa,-13.759,-172.1046,4092,0,9,4083
4/15/22,Samoa,-13.759,-172.1046,4793,0,10,4783
4/16/22,Samoa,-13.759,-172.1046,4793,0,10,4783
4/17/22,Samoa,-13.759,-172.1046,5947,0,12,5935
4/18/22,Samoa,-13.759,-172.1046,5947,0,12,5935
4/19/22,Samoa,-13.759,-172.1046,6309,0,13,6296
4/20/22,Samoa,-13.759,-172.1046,6794,0,13,6781
4/21/22,Samoa,-13.759,-172.1046,6794,0,13,6781
4/22/22,Samoa,-13.759,-172.1046,7185,0,13,7172
4/23/22,Samoa,-13.759,-172.1046,7185,0,13,7172
4/24/22,Samoa,-13.759,-172.1046,7185,0,13,7172
4/25/22,Samoa,-13.759,-172.1046,7185,0,13,7172
4/26/22,Samoa,-13.759,-172.1046,8351,0,16,8335
4/27/22,Samoa,-13.759,-172.1046,8351,0,16,8335
4/28/22,Samoa,-13.759,-172.1046,8995,0,16,8979
4/29/22,Samoa,-13.759,-172.1046,9592,0,19,9573
4/30/22,Samoa,-13.759,-172.1046,9592,0,19,9573
5/1/22,Samoa,-13.759,-172.1046,9592,0,19,9573
5/2/22,Samoa,-13.759,-172.1046,9592,0,19,9573
5/3/22,Samoa,-13.759,-172.1046,10210,0,20,10190
5/4/22,Samoa,-13.759,-172.1046,10210,0,20,10190
5/5/22,Samoa,-13.759,-172.1046,10210,0,20,10190
5/6/22,Samoa,-13.759,-172.1046,10210,0,20,10190
5/7/22,Samoa,-13.759,-172.1046,10210,0,20,10190
5/8/22,Samoa,-13.759,-172.1046,10659,0,20,10639
5/9/22,Samoa,-13.759,-172.1046,10926,0,22,10904
5/10/22,Samoa,-13.759,-172.1046,10926,0,22,10904
5/11/22,Samoa,-13.759,-172.1046,11045,0,23,11022
5/12/22,Samoa,-13.759,-172.1046,11045,0,23,11022
5/13/22,Samoa,-13.759,-172.1046,11313,0,24,11289
5/14/22,Samoa,-13.759,-172.1046,11313,0,24,11289
5/15/22,Samoa,-13.759,-172.1046,11671,0,24,11647
5/16/22,Samoa,-13.759,-172.1046,11671,0,24,11647
5/17/22,Samoa,-13.759,-172.1046,12051,0,24,12027
5/18/22,Samoa,-13.759,-172.1046,12051,0,24,12027
5/19/22,Samoa,-13.759,-172.1046,12051,0,24,12027
5/20/22,Samoa,-13.759,-172.1046,12382,0,25,12357
5/21/22,Samoa,-13.759,-172.1046,12382,0,25,12357
5/22/22,Samoa,-13.759,-172.1046,12382,0,25,12357
5/23/22,Samoa,-13.759,-172.1046,12382,0,25,12357
5/24/22,Samoa,-13.759,-172.1046,12843,0,25,12818
5/25/22,Samoa,-13.759,-172.1046,12843,0,25,12818
5/26/22,Samoa,-13.759,-172.1046,13145,0,25,13120
5/27/22,Samoa,-13.759,-172.1046,13145,0,25,13120
5/28/22,Samoa,-13.759,-172.1046,13380,0,25,13355
5/29/22,Samoa,-13.759,-172.1046,13380,0,25,13355
5/30/22,Samoa,-13.759,-172.1046,13499,0,26,13473
5/31/22,Samoa,-13.759,-172.1046,13499,0,26,13473
6/1/22,Samoa,-13.759,-172.1046,13499,0,26,13473
6/2/22,Samoa,-13.759,-172.1046,13499,0,26,13473
6/3/22,Samoa,-13.759,-172.1046,13796,0,27,13769
6/4/22,Samoa,-13.759,-172.1046,13796,0,27,13769
6/5/22,Samoa,-13.759,-172.1046,13924,0,27,13897
6/6/22,Samoa,-13.759,-172.1046,13924,0,27,13897
6/7/22,Samoa,-13.759,-172.1046,13924,0,27,13897
6/8/22,Samoa,-13.759,-172.1046,13924,0,27,13897
6/9/22,Samoa,-13.759,-172.1046,13924,0,27,13897
6/10/22,Samoa,-13.759,-172.1046,13924,0,27,13897
6/11/22,Samoa,-13.759,-172.1046,14187,0,28,14159
6/12/22,Samoa,-13.759,-172.1046,14187,0,28,14159
6/13/22,Samoa,-13.759,-172.1046,14315,0,28,14287
6/14/22,Samoa,-13.759,-172.1046,14422,0,28,14394
6/15/22,Samoa,-13.759,-172.1046,14422,0,28,14394
6/16/22,Samoa,-13.759,-172.1046,14497,0,28,14469
6/17/22,Samoa,-13.759,-172.1046,14497,0,28,14469
6/18/22,Samoa,-13.759,-172.1046,14497,0,28,14469
6/19/22,Samoa,-13.759,-172.1046,14497,0,28,14469
6/20/22,Samoa,-13.759,-172.1046,14497,0,28,14469
6/21/22,Samoa,-13.759,-172.1046,14772,0,28,14744
6/22/22,Samoa,-13.759,-172.1046,14772,0,28,14744
6/23/22,Samoa,-13.759,-172.1046,14812,0,29,14783
6/24/22,Samoa,-13.759,-172.1046,14812,0,29,14783
6/25/22,Samoa,-13.759,-172.1046,14812,0,29,14783
6/26/22,Samoa,-13.759,-172.1046,14812,0,29,14783
6/27/22,Samoa,-13.759,-172.1046,14843,0,29,14814
6/28/22,Samoa,-13.759,-172.1046,14906,0,29,14877
6/29/22,Samoa,-13.759,-172.1046,14906,0,29,14877
6/30/22,Samoa,-13.759,-172.1046,14906,0,29,14877
7/1/22,Samoa,-13.759,-172.1046,14964,0,29,14935
7/2/22,Samoa,-13.759,-172.1046,14964,0,29,14935
7/3/22,Samoa,-13.759,-172.1046,14964,0,29,14935
7/4/22,Samoa,-13.759,-172.1046,14995,0,29,14966
7/5/22,Samoa,-13.759,-172.1046,14995,0,29,14966
7/6/22,Samoa,-13.759,-172.1046,14996,0,29,14967
7/7/22,Samoa,-13.759,-172.1046,15052,0,29,15023
7/8/22,Samoa,-13.759,-172.1046,15052,0,29,15023
7/9/22,Samoa,-13.759,-172.1046,15052,0,29,15023
7/10/22,Samoa,-13.759,-172.1046,15052,0,29,15023
7/11/22,Samoa,-13.759,-172.1046,15115,0,29,15086
7/12/22,Samoa,-13.759,-172.1046,15134,0,29,15105
7/13/22,Samoa,-13.759,-172.1046,15134,0,29,15105
7/14/22,Samoa,-13.759,-172.1046,15134,0,29,15105
7/15/22,Samoa,-13.759,-172.1046,15155,0,29,15126
7/16/22,Samoa,-13.759,-172.1046,15155,0,29,15126
7/17/22,Samoa,-13.759,-172.1046,15178,0,29,15149
7/18/22,Samoa,-13.759,-172.1046,15178,0,29,15149
7/19/22,Samoa,-13.759,-172.1046,15183,0,29,15154
7/20/22,Samoa,-13.759,-172.1046,15183,0,29,15154
7/21/22,Samoa,-13.759,-172.1046,15243,0,29,15214
7/22/22,Samoa,-13.759,-172.1046,15243,0,29,15214
7/23/22,Samoa,-13.759,-172.1046,15243,0,29,15214
7/24/22,Samoa,-13.759,-172.1046,15318,0,29,15289
7/25/22,Samoa,-13.759,-172.1046,15318,0,29,15289
7/26/22,Samoa,-13.759,-172.1046,15318,0,29,15289
7/27/22,Samoa,-13.759,-172.1046,15374,0,29,15345
7/28/22,Samoa,-13.759,-172.1046,15374,0,29,15345
7/29/22,Samoa,-13.759,-172.1046,15374,0,29,15345
7/30/22,Samoa,-13.759,-172.1046,15374,0,29,15345
7/31/22,Samoa,-13.759,-172.1046,15405,0,29,15376
8/1/22,Samoa,-13.759,-172.1046,15405,0,29,15376
8/2/22,Samoa,-13.759,-172.1046,15405,0,29,15376
8/3/22,Samoa,-13.759,-172.1046,15405,0,29,15376
8/4/22,Samoa,-13.759,-172.1046,15405,0,29,15376
8/5/22,Samoa,-13.759,-172.1046,15405,0,29,15376
8/6/22,Samoa,-13.759,-172.1046,15405,0,29,15376
8/7/22,Samoa,-13.759,-172.1046,15405,0,29,15376
8/8/22,Samoa,-13.759,-172.1046,15405,0,29,15376
8/9/22,Samoa,-13.759,-172.1046,15405,0,29,15376
8/10/22,Samoa,-13.759,-172.1046,15405,0,29,15376
8/11/22,Samoa,-13.759,-172.1046,15405,0,29,15376
8/12/22,Samoa,-13.759,-172.1046,15405,0,29,15376
8/13/22,Samoa,-13.759,-172.1046,15405,0,29,15376
8/14/22,Samoa,-13.759,-172.1046,15405,0,29,15376
8/15/22,Samoa,-13.759,-172.1046,15405,0,29,15376
8/16/22,Samoa,-13.759,-172.1046,15405,0,29,15376
8/17/22,Samoa,-13.759,-172.1046,15405,0,29,15376
8/18/22,Samoa,-13.759,-172.1046,15405,0,29,15376
8/19/22,Samoa,-13.759,-172.1046,15405,0,29,15376
8/20/22,Samoa,-13.759,-172.1046,15405,0,29,15376
8/21/22,Samoa,-13.759,-172.1046,15405,0,29,15376
8/22/22,Samoa,-13.759,-172.1046,15703,0,29,15674
8/23/22,Samoa,-13.759,-172.1046,15767,0,29,15738
8/24/22,Samoa,-13.759,-172.1046,15767,0,29,15738
8/25/22,Samoa,-13.759,-172.1046,15767,0,29,15738
8/26/22,Samoa,-13.759,-172.1046,15767,0,29,15738
8/27/22,Samoa,-13.759,-172.1046,15767,0,29,15738
8/28/22,Samoa,-13.759,-172.1046,15767,0,29,15738
8/29/22,Samoa,-13.759,-172.1046,15767,0,29,15738
8/30/22,Samoa,-13.759,-172.1046,15839,0,29,15810
8/31/22,Samoa,-13.759,-172.1046,15839,0,29,15810
9/1/22,Samoa,-13.759,-172.1046,15839,0,29,15810
9/2/22,Samoa,-13.759,-172.1046,15839,0,29,15810
9/3/22,Samoa,-13.759,-172.1046,15839,0,29,15810
9/4/22,Samoa,-13.759,-172.1046,15839,0,29,15810
9/5/22,Samoa,-13.759,-172.1046,15839,0,29,15810
9/6/22,Samoa,-13.759,-172.1046,15839,0,29,15810
9/7/22,Samoa,-13.759,-172.1046,15839,0,29,15810
9/8/22,Samoa,-13.759,-172.1046,15839,0,29,15810
9/9/22,Samoa,-13.759,-172.1046,15839,0,29,15810
9/10/22,Samoa,-13.759,-172.1046,15889,0,29,15860
9/11/22,Samoa,-13.759,-172.1046,15889,0,29,15860
9/12/22,Samoa,-13.759,-172.1046,15889,0,29,15860
9/13/22,Samoa,-13.759,-172.1046,15889,0,29,15860
9/14/22,Samoa,-13.759,-172.1046,15889,0,29,15860
9/15/22,Samoa,-13.759,-172.1046,15889,0,29,15860
9/16/22,Samoa,-13.759,-172.1046,15889,0,29,15860
9/17/22,Samoa,-13.759,-172.1046,15889,0,29,15860
9/18/22,Samoa,-13.759,-172.1046,15889,0,29,15860
9/19/22,Samoa,-13.759,-172.1046,15889,0,29,15860
9/20/22,Samoa,-13.759,-172.1046,15889,0,29,15860
9/21/22,Samoa,-13.759,-172.1046,15925,0,29,15896
9/22/22,Samoa,-13.759,-172.1046,15925,0,29,15896
9/23/22,Samoa,-13.759,-172.1046,15925,0,29,15896
9/24/22,Samoa,-13.759,-172.1046,15925,0,29,15896
9/25/22,Samoa,-13.759,-172.1046,15925,0,29,15896
9/26/22,Samoa,-13.759,-172.1046,15925,0,29,15896
9/27/22,Samoa,-13.759,-172.1046,15925,0,29,15896
9/28/22,Samoa,-13.759,-172.1046,15925,0,29,15896
9/29/22,Samoa,-13.759,-172.1046,15925,0,29,15896
9/30/22,Samoa,-13.759,-172.1046,15925,0,29,15896
10/1/22,Samoa,-13.759,-172.1046,15925,0,29,15896
10/2/22,Samoa,-13.759,-172.1046,15941,0,29,15912
10/3/22,Samoa,-13.759,-172.1046,15941,0,29,15912
10/4/22,Samoa,-13.759,-172.1046,15941,0,29,15912
10/5/22,Samoa,-13.759,-172.1046,15941,0,29,15912
10/6/22,Samoa,-13.759,-172.1046,15942,0,29,15913
10/7/22,Samoa,-13.759,-172.1046,15942,0,29,15913
10/8/22,Samoa,-13.759,-172.1046,15942,0,29,15913
10/9/22,Samoa,-13.759,-172.1046,15942,0,29,15913
10/10/22,Samoa,-13.759,-172.1046,15942,0,29,15913
10/11/22,Samoa,-13.759,-172.1046,15942,0,29,15913
10/12/22,Samoa,-13.759,-172.1046,15942,0,29,15913
10/13/22,Samoa,-13.759,-172.1046,15942,0,29,15913
10/14/22,Samoa,-13.759,-172.1046,15942,0,29,15913
10/15/22,Samoa,-13.759,-172.1046,15942,0,29,15913
10/16/22,Samoa,-13.759,-172.1046,15942,0,29,15913
10/17/22,Samoa,-13.759,-172.1046,15942,0,29,15913
10/18/22,Samoa,-13.759,-172.1046,15942,0,29,15913
10/19/22,Samoa,-13.759,-172.1046,15946,0,29,15917
10/20/22,Samoa,-13.759,-172.1046,15946,0,29,15917
10/21/22,Samoa,-13.759,-172.1046,15946,0,29,15917
10/22/22,Samoa,-13.759,-172.1046,15946,0,29,15917
10/23/22,Samoa,-13.759,-172.1046,15946,0,29,15917
10/24/22,Samoa,-13.759,-172.1046,15946,0,29,15917
10/25/22,Samoa,-13.759,-172.1046,15946,0,29,15917
10/26/22,Samoa,-13.759,-172.1046,15946,0,29,15917
10/27/22,Samoa,-13.759,-172.1046,15946,0,29,15917
10/28/22,Samoa,-13.759,-172.1046,15946,0,29,15917
10/29/22,Samoa,-13.759,-172.1046,15946,0,29,15917
10/30/22,Samoa,-13.759,-172.1046,15946,0,29,15917
10/31/22,Samoa,-13.759,-172.1046,15946,0,29,15917
11/1/22,Samoa,-13.759,-172.1046,15946,0,29,15917
11/2/22,Samoa,-13.759,-172.1046,15946,0,29,15917
11/3/22,Samoa,-13.759,-172.1046,15946,0,29,15917
11/4/22,Samoa,-13.759,-172.1046,15946,0,29,15917
11/5/22,Samoa,-13.759,-172.1046,15946,0,29,15917
11/6/22,Samoa,-13.759,-172.1046,15946,0,29,15917
11/7/22,Samoa,-13.759,-172.1046,15949,0,29,15920
11/8/22,Samoa,-13.759,-172.1046,15949,0,29,15920
11/9/22,Samoa,-13.759,-172.1046,15949,0,29,15920
11/10/22,Samoa,-13.759,-172.1046,15949,0,29,15920
11/11/22,Samoa,-13.759,-172.1046,15949,0,29,15920
11/12/22,Samoa,-13.759,-172.1046,15949,0,29,15920
11/13/22,Samoa,-13.759,-172.1046,15949,0,29,15920
11/14/22,Samoa,-13.759,-172.1046,15949,0,29,15920
11/15/22,Samoa,-13.759,-172.1046,15949,0,29,15920
11/16/22,Samoa,-13.759,-172.1046,15949,0,29,15920
11/17/22,Samoa,-13.759,-172.1046,15949,0,29,15920
11/18/22,Samoa,-13.759,-172.1046,15949,0,29,15920
11/19/22,Samoa,-13.759,-172.1046,15949,0,29,15920
11/20/22,Samoa,-13.759,-172.1046,15949,0,29,15920
11/21/22,Samoa,-13.759,-172.1046,15949,0,29,15920
11/22/22,Samoa,-13.759,-172.1046,15964,0,29,15935
11/23/22,Samoa,-13.759,-172.1046,15964,0,29,15935
11/24/22,Samoa,-13.759,-172.1046,15967,0,29,15938
11/25/22,Samoa,-13.759,-172.1046,15967,0,29,15938
11/26/22,Samoa,-13.759,-172.1046,15967,0,29,15938
11/27/22,Samoa,-13.759,-172.1046,15967,0,29,15938
11/28/22,Samoa,-13.759,-172.1046,15967,0,29,15938
11/29/22,Samoa,-13.759,-172.1046,15967,0,29,15938
11/30/22,Samoa,-13.759,-172.1046,15967,0,29,15938
12/1/22,Samoa,-13.759,-172.1046,15967,0,29,15938
12/2/22,Samoa,-13.759,-172.1046,15967,0,29,15938
12/3/22,Samoa,-13.759,-172.1046,15967,0,29,15938
12/4/22,Samoa,-13.759,-172.1046,15967,0,29,15938
12/5/22,Samoa,-13.759,-172.1046,15968,0,29,15939
12/6/22,Samoa,-13.759,-172.1046,15968,0,29,15939
12/7/22,Samoa,-13.759,-172.1046,15968,0,29,15939
12/8/22,Samoa,-13.759,-172.1046,15968,0,29,15939
12/9/22,Samoa,-13.759,-172.1046,15970,0,29,15941
12/10/22,Samoa,-13.759,-172.1046,15970,0,29,15941
12/11/22,Samoa,-13.759,-172.1046,15970,0,29,15941
12/12/22,Samoa,-13.759,-172.1046,15970,0,29,15941
12/13/22,Samoa,-13.759,-172.1046,15970,0,29,15941
12/14/22,Samoa,-13.759,-172.1046,15970,0,29,15941
12/15/22,Samoa,-13.759,-172.1046,15970,0,29,15941
12/16/22,Samoa,-13.759,-172.1046,15970,0,29,15941
12/17/22,Samoa,-13.759,-172.1046,15970,0,29,15941
1/1/22,San Marino,43.9424,12.4578,8202,0,100,8102
1/2/22,San Marino,43.9424,12.4578,8202,0,100,8102
1/3/22,San Marino,43.9424,12.4578,8487,0,102,8385
1/4/22,San Marino,43.9424,12.4578,8682,0,102,8580
1/5/22,San Marino,43.9424,12.4578,8847,0,103,8744
1/6/22,San Marino,43.9424,12.4578,8847,0,103,8744
1/7/22,San Marino,43.9424,12.4578,9095,0,103,8992
1/8/22,San Marino,43.9424,12.4578,9095,0,103,8992
1/9/22,San Marino,43.9424,12.4578,9095,0,103,8992
1/10/22,San Marino,43.9424,12.4578,9518,0,103,9415
1/11/22,San Marino,43.9424,12.4578,9518,0,103,9415
1/12/22,San Marino,43.9424,12.4578,10009,0,103,9906
1/13/22,San Marino,43.9424,12.4578,10189,0,103,10086
1/14/22,San Marino,43.9424,12.4578,10350,0,103,10247
1/15/22,San Marino,43.9424,12.4578,10350,0,103,10247
1/16/22,San Marino,43.9424,12.4578,10350,0,103,10247
1/17/22,San Marino,43.9424,12.4578,10641,0,103,10538
1/18/22,San Marino,43.9424,12.4578,10856,0,103,10753
1/19/22,San Marino,43.9424,12.4578,11077,0,105,10972
1/20/22,San Marino,43.9424,12.4578,11278,0,106,11172
1/21/22,San Marino,43.9424,12.4578,11466,0,107,11359
1/22/22,San Marino,43.9424,12.4578,11466,0,107,11359
1/23/22,San Marino,43.9424,12.4578,11466,0,107,11359
1/24/22,San Marino,43.9424,12.4578,11786,0,108,11678
1/25/22,San Marino,43.9424,12.4578,11786,0,108,11678
1/26/22,San Marino,43.9424,12.4578,11995,0,109,11886
1/27/22,San Marino,43.9424,12.4578,12229,0,109,12120
1/28/22,San Marino,43.9424,12.4578,12462,0,109,12353
1/29/22,San Marino,43.9424,12.4578,12462,0,109,12353
1/30/22,San Marino,43.9424,12.4578,12462,0,109,12353
1/31/22,San Marino,43.9424,12.4578,12884,0,109,12775
2/1/22,San Marino,43.9424,12.4578,12884,0,109,12775
2/2/22,San Marino,43.9424,12.4578,13085,0,109,12976
2/3/22,San Marino,43.9424,12.4578,13328,0,109,13219
2/4/22,San Marino,43.9424,12.4578,13328,0,109,13219
2/5/22,San Marino,43.9424,12.4578,13328,0,109,13219
2/6/22,San Marino,43.9424,12.4578,13328,0,109,13219
2/7/22,San Marino,43.9424,12.4578,13571,0,109,13462
2/8/22,San Marino,43.9424,12.4578,13572,0,109,13463
2/9/22,San Marino,43.9424,12.4578,13788,0,109,13679
2/10/22,San Marino,43.9424,12.4578,13852,0,110,13742
2/11/22,San Marino,43.9424,12.4578,13861,0,110,13751
2/12/22,San Marino,43.9424,12.4578,13861,0,110,13751
2/13/22,San Marino,43.9424,12.4578,13861,0,110,13751
2/14/22,San Marino,43.9424,12.4578,13988,0,110,13878
2/15/22,San Marino,43.9424,12.4578,14044,0,110,13934
2/16/22,San Marino,43.9424,12.4578,14086,0,110,13976
2/17/22,San Marino,43.9424,12.4578,14086,0,110,13976
2/18/22,San Marino,43.9424,12.4578,14147,0,112,14035
2/19/22,San Marino,43.9424,12.4578,14147,0,112,14035
2/20/22,San Marino,43.9424,12.4578,14147,0,112,14035
2/21/22,San Marino,43.9424,12.4578,14207,0,112,14095
2/22/22,San Marino,43.9424,12.4578,14207,0,112,14095
2/23/22,San Marino,43.9424,12.4578,14262,0,112,14150
2/24/22,San Marino,43.9424,12.4578,14291,0,112,14179
2/25/22,San Marino,43.9424,12.4578,14310,0,112,14198
2/26/22,San Marino,43.9424,12.4578,14310,0,112,14198
2/27/22,San Marino,43.9424,12.4578,14310,0,112,14198
2/28/22,San Marino,43.9424,12.4578,14369,0,112,14257
3/1/22,San Marino,43.9424,12.4578,14414,0,112,14302
3/2/22,San Marino,43.9424,12.4578,14435,0,112,14323
3/3/22,San Marino,43.9424,12.4578,14466,0,112,14354
3/4/22,San Marino,43.9424,12.4578,14487,0,112,14375
3/5/22,San Marino,43.9424,12.4578,14487,0,112,14375
3/6/22,San Marino,43.9424,12.4578,14487,0,112,14375
3/7/22,San Marino,43.9424,12.4578,14523,0,112,14411
3/8/22,San Marino,43.9424,12.4578,14581,0,112,14469
3/9/22,San Marino,43.9424,12.4578,14629,0,112,14517
3/10/22,San Marino,43.9424,12.4578,14653,0,112,14541
3/11/22,San Marino,43.9424,12.4578,14691,0,112,14579
3/12/22,San Marino,43.9424,12.4578,14691,0,112,14579
3/13/22,San Marino,43.9424,12.4578,14691,0,112,14579
3/14/22,San Marino,43.9424,12.4578,14726,0,112,14614
3/15/22,San Marino,43.9424,12.4578,14789,0,112,14677
3/16/22,San Marino,43.9424,12.4578,14834,0,112,14722
3/17/22,San Marino,43.9424,12.4578,14834,0,112,14722
3/18/22,San Marino,43.9424,12.4578,14870,0,112,14758
3/19/22,San Marino,43.9424,12.4578,14870,0,112,14758
3/20/22,San Marino,43.9424,12.4578,14870,0,112,14758
3/21/22,San Marino,43.9424,12.4578,14968,0,112,14856
3/22/22,San Marino,43.9424,12.4578,15034,0,112,14922
3/23/22,San Marino,43.9424,12.4578,15079,0,112,14967
3/24/22,San Marino,43.9424,12.4578,15125,0,112,15013
3/25/22,San Marino,43.9424,12.4578,15125,0,112,15013
3/26/22,San Marino,43.9424,12.4578,15125,0,112,15013
3/27/22,San Marino,43.9424,12.4578,15125,0,112,15013
3/28/22,San Marino,43.9424,12.4578,15181,0,113,15068
3/29/22,San Marino,43.9424,12.4578,15272,0,113,15159
3/30/22,San Marino,43.9424,12.4578,15307,0,113,15194
3/31/22,San Marino,43.9424,12.4578,15345,0,113,15232
4/1/22,San Marino,43.9424,12.4578,15345,0,113,15232
4/2/22,San Marino,43.9424,12.4578,15345,0,113,15232
4/3/22,San Marino,43.9424,12.4578,15345,0,113,15232
4/4/22,San Marino,43.9424,12.4578,15345,0,113,15232
4/5/22,San Marino,43.9424,12.4578,15345,0,113,15232
4/6/22,San Marino,43.9424,12.4578,15538,0,114,15424
4/7/22,San Marino,43.9424,12.4578,15581,0,114,15467
4/8/22,San Marino,43.9424,12.4578,15629,0,114,15515
4/9/22,San Marino,43.9424,12.4578,15629,0,114,15515
4/10/22,San Marino,43.9424,12.4578,15629,0,114,15515
4/11/22,San Marino,43.9424,12.4578,15683,0,114,15569
4/12/22,San Marino,43.9424,12.4578,15779,0,114,15665
4/13/22,San Marino,43.9424,12.4578,15827,0,114,15713
4/14/22,San Marino,43.9424,12.4578,15874,0,114,15760
4/15/22,San Marino,43.9424,12.4578,15874,0,114,15760
4/16/22,San Marino,43.9424,12.4578,15874,0,114,15760
4/17/22,San Marino,43.9424,12.4578,15874,0,114,15760
4/18/22,San Marino,43.9424,12.4578,15874,0,114,15760
4/19/22,San Marino,43.9424,12.4578,15981,0,114,15867
4/20/22,San Marino,43.9424,12.4578,16076,0,114,15962
4/21/22,San Marino,43.9424,12.4578,16140,0,114,16026
4/22/22,San Marino,43.9424,12.4578,16186,0,114,16072
4/23/22,San Marino,43.9424,12.4578,16186,0,114,16072
4/24/22,San Marino,43.9424,12.4578,16186,0,114,16072
4/25/22,San Marino,43.9424,12.4578,16186,0,114,16072
4/26/22,San Marino,43.9424,12.4578,16186,0,114,16072
4/27/22,San Marino,43.9424,12.4578,16186,0,114,16072
4/28/22,San Marino,43.9424,12.4578,16186,0,114,16072
4/29/22,San Marino,43.9424,12.4578,16437,0,115,16322
4/30/22,San Marino,43.9424,12.4578,16437,0,115,16322
5/1/22,San Marino,43.9424,12.4578,16437,0,115,16322
5/2/22,San Marino,43.9424,12.4578,16476,0,115,16361
5/3/22,San Marino,43.9424,12.4578,16524,0,115,16409
5/4/22,San Marino,43.9424,12.4578,16561,0,115,16446
5/5/22,San Marino,43.9424,12.4578,16561,0,115,16446
5/6/22,San Marino,43.9424,12.4578,16624,0,115,16509
5/7/22,San Marino,43.9424,12.4578,16624,0,115,16509
5/8/22,San Marino,43.9424,12.4578,16624,0,115,16509
5/9/22,San Marino,43.9424,12.4578,16666,0,115,16551
5/10/22,San Marino,43.9424,12.4578,16743,0,115,16628
5/11/22,San Marino,43.9424,12.4578,16785,0,115,16670
5/12/22,San Marino,43.9424,12.4578,16823,0,115,16708
5/13/22,San Marino,43.9424,12.4578,16852,0,115,16737
5/14/22,San Marino,43.9424,12.4578,16852,0,115,16737
5/15/22,San Marino,43.9424,12.4578,16852,0,115,16737
5/16/22,San Marino,43.9424,12.4578,16852,0,115,16737
5/17/22,San Marino,43.9424,12.4578,16852,0,115,16737
5/18/22,San Marino,43.9424,12.4578,16852,0,115,16737
5/19/22,San Marino,43.9424,12.4578,16852,0,115,16737
5/20/22,San Marino,43.9424,12.4578,16991,0,115,16876
5/21/22,San Marino,43.9424,12.4578,16991,0,115,16876
5/22/22,San Marino,43.9424,12.4578,16991,0,115,16876
5/23/22,San Marino,43.9424,12.4578,17023,0,115,16908
5/24/22,San Marino,43.9424,12.4578,17045,0,115,16930
5/25/22,San Marino,43.9424,12.4578,17059,0,115,16944
5/26/22,San Marino,43.9424,12.4578,17059,0,115,16944
5/27/22,San Marino,43.9424,12.4578,17083,0,115,16968
5/28/22,San Marino,43.9424,12.4578,17083,0,115,16968
5/29/22,San Marino,43.9424,12.4578,17083,0,115,16968
5/30/22,San Marino,43.9424,12.4578,17105,0,115,16990
5/31/22,San Marino,43.9424,12.4578,17124,0,115,17009
6/1/22,San Marino,43.9424,12.4578,17124,0,115,17009
6/2/22,San Marino,43.9424,12.4578,17124,0,115,17009
6/3/22,San Marino,43.9424,12.4578,17124,0,115,17009
6/4/22,San Marino,43.9424,12.4578,17124,0,115,17009
6/5/22,San Marino,43.9424,12.4578,17124,0,115,17009
6/6/22,San Marino,43.9424,12.4578,17124,0,115,17009
6/7/22,San Marino,43.9424,12.4578,17124,0,115,17009
6/8/22,San Marino,43.9424,12.4578,17124,0,115,17009
6/9/22,San Marino,43.9424,12.4578,17124,0,115,17009
6/10/22,San Marino,43.9424,12.4578,17124,0,115,17009
6/11/22,San Marino,43.9424,12.4578,17124,0,115,17009
6/12/22,San Marino,43.9424,12.4578,17124,0,115,17009
6/13/22,San Marino,43.9424,12.4578,17124,0,115,17009
6/14/22,San Marino,43.9424,12.4578,17124,0,115,17009
6/15/22,San Marino,43.9424,12.4578,17376,0,115,17261
6/16/22,San Marino,43.9424,12.4578,17376,0,115,17261
6/17/22,San Marino,43.9424,12.4578,17413,0,115,17298
6/18/22,San Marino,43.9424,12.4578,17413,0,115,17298
6/19/22,San Marino,43.9424,12.4578,17413,0,115,17298
6/20/22,San Marino,43.9424,12.4578,17502,0,115,17387
6/21/22,San Marino,43.9424,12.4578,17570,0,115,17455
6/22/22,San Marino,43.9424,12.4578,17631,0,115,17516
6/23/22,San Marino,43.9424,12.4578,17631,0,115,17516
6/24/22,San Marino,43.9424,12.4578,17719,0,115,17604
6/25/22,San Marino,43.9424,12.4578,17719,0,115,17604
6/26/22,San Marino,43.9424,12.4578,17719,0,115,17604
6/27/22,San Marino,43.9424,12.4578,17767,0,115,17652
6/28/22,San Marino,43.9424,12.4578,17767,0,115,17652
6/29/22,San Marino,43.9424,12.4578,17961,0,115,17846
6/30/22,San Marino,43.9424,12.4578,18016,0,115,17901
7/1/22,San Marino,43.9424,12.4578,18092,0,115,17977
7/2/22,San Marino,43.9424,12.4578,18092,0,115,17977
7/3/22,San Marino,43.9424,12.4578,18092,0,115,17977
7/4/22,San Marino,43.9424,12.4578,18236,0,115,18121
7/5/22,San Marino,43.9424,12.4578,18361,0,115,18246
7/6/22,San Marino,43.9424,12.4578,18361,0,115,18246
7/7/22,San Marino,43.9424,12.4578,18361,0,115,18246
7/8/22,San Marino,43.9424,12.4578,18361,0,115,18246
7/9/22,San Marino,43.9424,12.4578,18710,0,115,18595
7/10/22,San Marino,43.9424,12.4578,18710,0,115,18595
7/11/22,San Marino,43.9424,12.4578,18734,0,116,18618
7/12/22,San Marino,43.9424,12.4578,18886,0,116,18770
7/13/22,San Marino,43.9424,12.4578,18977,0,116,18861
7/14/22,San Marino,43.9424,12.4578,18977,0,116,18861
7/15/22,San Marino,43.9424,12.4578,19132,0,116,19016
7/16/22,San Marino,43.9424,12.4578,19200,0,116,19084
7/17/22,San Marino,43.9424,12.4578,19200,0,116,19084
7/18/22,San Marino,43.9424,12.4578,19253,0,117,19136
7/19/22,San Marino,43.9424,12.4578,19353,0,117,19236
7/20/22,San Marino,43.9424,12.4578,19421,0,117,19304
7/21/22,San Marino,43.9424,12.4578,19474,0,117,19357
7/22/22,San Marino,43.9424,12.4578,19532,0,117,19415
7/23/22,San Marino,43.9424,12.4578,19532,0,117,19415
7/24/22,San Marino,43.9424,12.4578,19532,0,117,19415
7/25/22,San Marino,43.9424,12.4578,19619,0,118,19501
7/26/22,San Marino,43.9424,12.4578,19701,0,118,19583
7/27/22,San Marino,43.9424,12.4578,19752,0,118,19634
7/28/22,San Marino,43.9424,12.4578,19752,0,118,19634
7/29/22,San Marino,43.9424,12.4578,19793,0,118,19675
7/30/22,San Marino,43.9424,12.4578,19793,0,118,19675
7/31/22,San Marino,43.9424,12.4578,19793,0,118,19675
8/1/22,San Marino,43.9424,12.4578,19890,0,118,19772
8/2/22,San Marino,43.9424,12.4578,19942,0,118,19824
8/3/22,San Marino,43.9424,12.4578,19965,0,118,19847
8/4/22,San Marino,43.9424,12.4578,19983,0,118,19865
8/5/22,San Marino,43.9424,12.4578,20007,0,118,19889
8/6/22,San Marino,43.9424,12.4578,20007,0,118,19889
8/7/22,San Marino,43.9424,12.4578,20007,0,118,19889
8/8/22,San Marino,43.9424,12.4578,20042,0,118,19924
8/9/22,San Marino,43.9424,12.4578,20074,0,118,19956
8/10/22,San Marino,43.9424,12.4578,20094,0,118,19976
8/11/22,San Marino,43.9424,12.4578,20113,0,118,19995
8/12/22,San Marino,43.9424,12.4578,20130,0,118,20012
8/13/22,San Marino,43.9424,12.4578,20130,0,118,20012
8/14/22,San Marino,43.9424,12.4578,20130,0,118,20012
8/15/22,San Marino,43.9424,12.4578,20130,0,118,20012
8/16/22,San Marino,43.9424,12.4578,20160,0,118,20042
8/17/22,San Marino,43.9424,12.4578,20196,0,118,20078
8/18/22,San Marino,43.9424,12.4578,20215,0,118,20097
8/19/22,San Marino,43.9424,12.4578,20224,0,118,20106
8/20/22,San Marino,43.9424,12.4578,20224,0,118,20106
8/21/22,San Marino,43.9424,12.4578,20224,0,118,20106
8/22/22,San Marino,43.9424,12.4578,20242,0,118,20124
8/23/22,San Marino,43.9424,12.4578,20280,0,118,20162
8/24/22,San Marino,43.9424,12.4578,20292,0,118,20174
8/25/22,San Marino,43.9424,12.4578,20310,0,118,20192
8/26/22,San Marino,43.9424,12.4578,20323,0,118,20205
8/27/22,San Marino,43.9424,12.4578,20323,0,118,20205
8/28/22,San Marino,43.9424,12.4578,20323,0,118,20205
8/29/22,San Marino,43.9424,12.4578,20341,0,118,20223
8/30/22,San Marino,43.9424,12.4578,20365,0,118,20247
8/31/22,San Marino,43.9424,12.4578,20373,0,118,20255
9/1/22,San Marino,43.9424,12.4578,20385,0,118,20267
9/2/22,San Marino,43.9424,12.4578,20398,0,118,20280
9/3/22,San Marino,43.9424,12.4578,20398,0,118,20280
9/4/22,San Marino,43.9424,12.4578,20398,0,118,20280
9/5/22,San Marino,43.9424,12.4578,20412,0,118,20294
9/6/22,San Marino,43.9424,12.4578,20438,0,118,20320
9/7/22,San Marino,43.9424,12.4578,20456,0,118,20338
9/8/22,San Marino,43.9424,12.4578,20456,0,118,20338
9/9/22,San Marino,43.9424,12.4578,20486,0,118,20368
9/10/22,San Marino,43.9424,12.4578,20486,0,118,20368
9/11/22,San Marino,43.9424,12.4578,20486,0,118,20368
9/12/22,San Marino,43.9424,12.4578,20500,0,118,20382
9/13/22,San Marino,43.9424,12.4578,20533,0,118,20415
9/14/22,San Marino,43.9424,12.4578,20540,0,118,20422
9/15/22,San Marino,43.9424,12.4578,20552,0,118,20434
9/16/22,San Marino,43.9424,12.4578,20552,0,118,20434
9/17/22,San Marino,43.9424,12.4578,20552,0,118,20434
9/18/22,San Marino,43.9424,12.4578,20552,0,118,20434
9/19/22,San Marino,43.9424,12.4578,20567,0,118,20449
9/20/22,San Marino,43.9424,12.4578,20593,0,118,20475
9/21/22,San Marino,43.9424,12.4578,20607,0,118,20489
9/22/22,San Marino,43.9424,12.4578,20628,0,118,20510
9/23/22,San Marino,43.9424,12.4578,20646,0,118,20528
9/24/22,San Marino,43.9424,12.4578,20646,0,118,20528
9/25/22,San Marino,43.9424,12.4578,20646,0,118,20528
9/26/22,San Marino,43.9424,12.4578,20671,0,118,20553
9/27/22,San Marino,43.9424,12.4578,20729,0,118,20611
9/28/22,San Marino,43.9424,12.4578,20753,0,118,20635
9/29/22,San Marino,43.9424,12.4578,20763,0,118,20645
9/30/22,San Marino,43.9424,12.4578,20793,0,118,20675
10/1/22,San Marino,43.9424,12.4578,20793,0,118,20675
10/2/22,San Marino,43.9424,12.4578,20793,0,118,20675
10/3/22,San Marino,43.9424,12.4578,20828,0,118,20710
10/4/22,San Marino,43.9424,12.4578,20892,0,118,20774
10/5/22,San Marino,43.9424,12.4578,20920,0,118,20802
10/6/22,San Marino,43.9424,12.4578,20957,0,118,20839
10/7/22,San Marino,43.9424,12.4578,21002,0,118,20884
10/8/22,San Marino,43.9424,12.4578,21002,0,118,20884
10/9/22,San Marino,43.9424,12.4578,21002,0,118,20884
10/10/22,San Marino,43.9424,12.4578,21053,0,118,20935
10/11/22,San Marino,43.9424,12.4578,21134,0,118,21016
10/12/22,San Marino,43.9424,12.4578,21178,0,118,21060
10/13/22,San Marino,43.9424,12.4578,21201,0,118,21083
10/14/22,San Marino,43.9424,12.4578,21245,0,118,21127
10/15/22,San Marino,43.9424,12.4578,21245,0,118,21127
10/16/22,San Marino,43.9424,12.4578,21245,0,118,21127
10/17/22,San Marino,43.9424,12.4578,21291,0,118,21173
10/18/22,San Marino,43.9424,12.4578,21363,0,118,21245
10/19/22,San Marino,43.9424,12.4578,21400,0,118,21282
10/20/22,San Marino,43.9424,12.4578,21400,0,118,21282
10/21/22,San Marino,43.9424,12.4578,21452,0,119,21333
10/22/22,San Marino,43.9424,12.4578,21452,0,119,21333
10/23/22,San Marino,43.9424,12.4578,21452,0,119,21333
10/24/22,San Marino,43.9424,12.4578,21473,0,119,21354
10/25/22,San Marino,43.9424,12.4578,21526,0,119,21407
10/26/22,San Marino,43.9424,12.4578,21544,0,119,21425
10/27/22,San Marino,43.9424,12.4578,21565,0,119,21446
10/28/22,San Marino,43.9424,12.4578,21584,0,119,21465
10/29/22,San Marino,43.9424,12.4578,21584,0,119,21465
10/30/22,San Marino,43.9424,12.4578,21584,0,119,21465
10/31/22,San Marino,43.9424,12.4578,21604,0,119,21485
11/1/22,San Marino,43.9424,12.4578,21604,0,119,21485
11/2/22,San Marino,43.9424,12.4578,21604,0,119,21485
11/3/22,San Marino,43.9424,12.4578,21627,0,119,21508
11/4/22,San Marino,43.9424,12.4578,21662,0,119,21543
11/5/22,San Marino,43.9424,12.4578,21662,0,119,21543
11/6/22,San Marino,43.9424,12.4578,21662,0,119,21543
11/7/22,San Marino,43.9424,12.4578,21681,0,119,21562
11/8/22,San Marino,43.9424,12.4578,21723,0,119,21604
11/9/22,San Marino,43.9424,12.4578,21739,0,119,21620
11/10/22,San Marino,43.9424,12.4578,21739,0,119,21620
11/11/22,San Marino,43.9424,12.4578,21739,0,119,21620
11/12/22,San Marino,43.9424,12.4578,21739,0,119,21620
11/13/22,San Marino,43.9424,12.4578,21739,0,119,21620
11/14/22,San Marino,43.9424,12.4578,21798,0,119,21679
11/15/22,San Marino,43.9424,12.4578,21798,0,119,21679
11/16/22,San Marino,43.9424,12.4578,21798,0,119,21679
11/17/22,San Marino,43.9424,12.4578,21798,0,119,21679
11/18/22,San Marino,43.9424,12.4578,21798,0,119,21679
11/19/22,San Marino,43.9424,12.4578,21798,0,119,21679
11/20/22,San Marino,43.9424,12.4578,21798,0,119,21679
11/21/22,San Marino,43.9424,12.4578,21798,0,119,21679
11/22/22,San Marino,43.9424,12.4578,21798,0,119,21679
11/23/22,San Marino,43.9424,12.4578,21798,0,119,21679
11/24/22,San Marino,43.9424,12.4578,22091,0,119,21972
11/25/22,San Marino,43.9424,12.4578,22091,0,119,21972
11/26/22,San Marino,43.9424,12.4578,22091,0,119,21972
11/27/22,San Marino,43.9424,12.4578,22091,0,119,21972
11/28/22,San Marino,43.9424,12.4578,22167,0,119,22048
11/29/22,San Marino,43.9424,12.4578,22167,0,119,22048
11/30/22,San Marino,43.9424,12.4578,22167,0,119,22048
12/1/22,San Marino,43.9424,12.4578,22167,0,119,22048
12/2/22,San Marino,43.9424,12.4578,22167,0,119,22048
12/3/22,San Marino,43.9424,12.4578,22167,0,119,22048
12/4/22,San Marino,43.9424,12.4578,22167,0,119,22048
12/5/22,San Marino,43.9424,12.4578,22406,0,119,22287
12/6/22,San Marino,43.9424,12.4578,22406,0,119,22287
12/7/22,San Marino,43.9424,12.4578,22406,0,119,22287
12/8/22,San Marino,43.9424,12.4578,22406,0,119,22287
12/9/22,San Marino,43.9424,12.4578,22406,0,119,22287
12/10/22,San Marino,43.9424,12.4578,22406,0,119,22287
12/11/22,San Marino,43.9424,12.4578,22406,0,119,22287
12/12/22,San Marino,43.9424,12.4578,22615,0,120,22495
12/13/22,San Marino,43.9424,12.4578,22615,0,120,22495
12/14/22,San Marino,43.9424,12.4578,22615,0,120,22495
12/15/22,San Marino,43.9424,12.4578,22615,0,120,22495
12/16/22,San Marino,43.9424,12.4578,22615,0,120,22495
12/17/22,San Marino,43.9424,12.4578,22615,0,120,22495
1/1/22,Sao Tome and Principe,0.1864,6.6131,3903,0,57,3846
1/2/22,Sao Tome and Principe,0.1864,6.6131,3912,0,57,3855
1/3/22,Sao Tome and Principe,0.1864,6.6131,3945,0,58,3887
1/4/22,Sao Tome and Principe,0.1864,6.6131,4010,0,58,3952
1/5/22,Sao Tome and Principe,0.1864,6.6131,4034,0,61,3973
1/6/22,Sao Tome and Principe,0.1864,6.6131,4151,0,61,4090
1/7/22,Sao Tome and Principe,0.1864,6.6131,4416,0,62,4354
1/8/22,Sao Tome and Principe,0.1864,6.6131,4735,0,63,4672
1/9/22,Sao Tome and Principe,0.1864,6.6131,4892,0,63,4829
1/10/22,Sao Tome and Principe,0.1864,6.6131,4916,0,63,4853
1/11/22,Sao Tome and Principe,0.1864,6.6131,5052,0,65,4987
1/12/22,Sao Tome and Principe,0.1864,6.6131,5235,0,65,5170
1/13/22,Sao Tome and Principe,0.1864,6.6131,5404,0,65,5339
1/14/22,Sao Tome and Principe,0.1864,6.6131,5458,0,65,5393
1/15/22,Sao Tome and Principe,0.1864,6.6131,5495,0,65,5430
1/16/22,Sao Tome and Principe,0.1864,6.6131,5525,0,66,5459
1/17/22,Sao Tome and Principe,0.1864,6.6131,5569,0,66,5503
1/18/22,Sao Tome and Principe,0.1864,6.6131,5634,0,66,5568
1/19/22,Sao Tome and Principe,0.1864,6.6131,5651,0,66,5585
1/20/22,Sao Tome and Principe,0.1864,6.6131,5785,0,67,5718
1/21/22,Sao Tome and Principe,0.1864,6.6131,5798,0,68,5730
1/22/22,Sao Tome and Principe,0.1864,6.6131,5816,0,68,5748
1/23/22,Sao Tome and Principe,0.1864,6.6131,5832,0,69,5763
1/24/22,Sao Tome and Principe,0.1864,6.6131,5836,0,69,5767
1/25/22,Sao Tome and Principe,0.1864,6.6131,5849,0,69,5780
1/26/22,Sao Tome and Principe,0.1864,6.6131,5856,0,69,5787
1/27/22,Sao Tome and Principe,0.1864,6.6131,5867,0,69,5798
1/28/22,Sao Tome and Principe,0.1864,6.6131,5873,0,69,5804
1/29/22,Sao Tome and Principe,0.1864,6.6131,5883,0,69,5814
1/30/22,Sao Tome and Principe,0.1864,6.6131,5885,0,69,5816
1/31/22,Sao Tome and Principe,0.1864,6.6131,5890,0,69,5821
2/1/22,Sao Tome and Principe,0.1864,6.6131,5899,0,70,5829
2/2/22,Sao Tome and Principe,0.1864,6.6131,5903,0,70,5833
2/3/22,Sao Tome and Principe,0.1864,6.6131,5907,0,70,5837
2/4/22,Sao Tome and Principe,0.1864,6.6131,5908,0,70,5838
2/5/22,Sao Tome and Principe,0.1864,6.6131,5911,0,71,5840
2/6/22,Sao Tome and Principe,0.1864,6.6131,5912,0,71,5841
2/7/22,Sao Tome and Principe,0.1864,6.6131,5912,0,71,5841
2/8/22,Sao Tome and Principe,0.1864,6.6131,5912,0,71,5841
2/9/22,Sao Tome and Principe,0.1864,6.6131,5913,0,71,5842
2/10/22,Sao Tome and Principe,0.1864,6.6131,5916,0,71,5845
2/11/22,Sao Tome and Principe,0.1864,6.6131,5919,0,71,5848
2/12/22,Sao Tome and Principe,0.1864,6.6131,5920,0,71,5849
2/13/22,Sao Tome and Principe,0.1864,6.6131,5920,0,71,5849
2/14/22,Sao Tome and Principe,0.1864,6.6131,5920,0,71,5849
2/15/22,Sao Tome and Principe,0.1864,6.6131,5920,0,71,5849
2/16/22,Sao Tome and Principe,0.1864,6.6131,5922,0,71,5851
2/17/22,Sao Tome and Principe,0.1864,6.6131,5922,0,71,5851
2/18/22,Sao Tome and Principe,0.1864,6.6131,5924,0,71,5853
2/19/22,Sao Tome and Principe,0.1864,6.6131,5925,0,71,5854
2/20/22,Sao Tome and Principe,0.1864,6.6131,5926,0,71,5855
2/21/22,Sao Tome and Principe,0.1864,6.6131,5930,0,72,5858
2/22/22,Sao Tome and Principe,0.1864,6.6131,5930,0,72,5858
2/23/22,Sao Tome and Principe,0.1864,6.6131,5932,0,72,5860
2/24/22,Sao Tome and Principe,0.1864,6.6131,5932,0,72,5860
2/25/22,Sao Tome and Principe,0.1864,6.6131,5933,0,72,5861
2/26/22,Sao Tome and Principe,0.1864,6.6131,5933,0,72,5861
2/27/22,Sao Tome and Principe,0.1864,6.6131,5934,0,72,5862
2/28/22,Sao Tome and Principe,0.1864,6.6131,5934,0,72,5862
3/1/22,Sao Tome and Principe,0.1864,6.6131,5934,0,72,5862
3/2/22,Sao Tome and Principe,0.1864,6.6131,5934,0,72,5862
3/3/22,Sao Tome and Principe,0.1864,6.6131,5934,0,72,5862
3/4/22,Sao Tome and Principe,0.1864,6.6131,5939,0,72,5867
3/5/22,Sao Tome and Principe,0.1864,6.6131,5939,0,72,5867
3/6/22,Sao Tome and Principe,0.1864,6.6131,5939,0,72,5867
3/7/22,Sao Tome and Principe,0.1864,6.6131,5939,0,72,5867
3/8/22,Sao Tome and Principe,0.1864,6.6131,5939,0,72,5867
3/9/22,Sao Tome and Principe,0.1864,6.6131,5939,0,72,5867
3/10/22,Sao Tome and Principe,0.1864,6.6131,5939,0,72,5867
3/11/22,Sao Tome and Principe,0.1864,6.6131,5939,0,72,5867
3/12/22,Sao Tome and Principe,0.1864,6.6131,5939,0,72,5867
3/13/22,Sao Tome and Principe,0.1864,6.6131,5939,0,72,5867
3/14/22,Sao Tome and Principe,0.1864,6.6131,5936,0,72,5864
3/15/22,Sao Tome and Principe,0.1864,6.6131,5937,0,72,5865
3/16/22,Sao Tome and Principe,0.1864,6.6131,5938,0,72,5866
3/17/22,Sao Tome and Principe,0.1864,6.6131,5938,0,72,5866
3/18/22,Sao Tome and Principe,0.1864,6.6131,5938,0,72,5866
3/19/22,Sao Tome and Principe,0.1864,6.6131,5940,0,73,5867
3/20/22,Sao Tome and Principe,0.1864,6.6131,5941,0,73,5868
3/21/22,Sao Tome and Principe,0.1864,6.6131,5941,0,73,5868
3/22/22,Sao Tome and Principe,0.1864,6.6131,5943,0,73,5870
3/23/22,Sao Tome and Principe,0.1864,6.6131,5943,0,73,5870
3/24/22,Sao Tome and Principe,0.1864,6.6131,5943,0,73,5870
3/25/22,Sao Tome and Principe,0.1864,6.6131,5944,0,73,5871
3/26/22,Sao Tome and Principe,0.1864,6.6131,5945,0,73,5872
3/27/22,Sao Tome and Principe,0.1864,6.6131,5945,0,73,5872
3/28/22,Sao Tome and Principe,0.1864,6.6131,5945,0,73,5872
3/29/22,Sao Tome and Principe,0.1864,6.6131,5945,0,73,5872
3/30/22,Sao Tome and Principe,0.1864,6.6131,5945,0,73,5872
3/31/22,Sao Tome and Principe,0.1864,6.6131,5945,0,73,5872
4/1/22,Sao Tome and Principe,0.1864,6.6131,5945,0,73,5872
4/2/22,Sao Tome and Principe,0.1864,6.6131,5945,0,73,5872
4/3/22,Sao Tome and Principe,0.1864,6.6131,5945,0,73,5872
4/4/22,Sao Tome and Principe,0.1864,6.6131,5948,0,73,5875
4/5/22,Sao Tome and Principe,0.1864,6.6131,5948,0,73,5875
4/6/22,Sao Tome and Principe,0.1864,6.6131,5948,0,73,5875
4/7/22,Sao Tome and Principe,0.1864,6.6131,5948,0,73,5875
4/8/22,Sao Tome and Principe,0.1864,6.6131,5948,0,73,5875
4/9/22,Sao Tome and Principe,0.1864,6.6131,5948,0,73,5875
4/10/22,Sao Tome and Principe,0.1864,6.6131,5948,0,73,5875
4/11/22,Sao Tome and Principe,0.1864,6.6131,5948,0,73,5875
4/12/22,Sao Tome and Principe,0.1864,6.6131,5948,0,73,5875
4/13/22,Sao Tome and Principe,0.1864,6.6131,5948,0,73,5875
4/14/22,Sao Tome and Principe,0.1864,6.6131,5948,0,73,5875
4/15/22,Sao Tome and Principe,0.1864,6.6131,5948,0,73,5875
4/16/22,Sao Tome and Principe,0.1864,6.6131,5948,0,73,5875
4/17/22,Sao Tome and Principe,0.1864,6.6131,5948,0,73,5875
4/18/22,Sao Tome and Principe,0.1864,6.6131,5953,0,73,5880
4/19/22,Sao Tome and Principe,0.1864,6.6131,5953,0,73,5880
4/20/22,Sao Tome and Principe,0.1864,6.6131,5953,0,73,5880
4/21/22,Sao Tome and Principe,0.1864,6.6131,5953,0,73,5880
4/22/22,Sao Tome and Principe,0.1864,6.6131,5953,0,73,5880
4/23/22,Sao Tome and Principe,0.1864,6.6131,5953,0,73,5880
4/24/22,Sao Tome and Principe,0.1864,6.6131,5953,0,73,5880
4/25/22,Sao Tome and Principe,0.1864,6.6131,5957,0,73,5884
4/26/22,Sao Tome and Principe,0.1864,6.6131,5957,0,73,5884
4/27/22,Sao Tome and Principe,0.1864,6.6131,5957,0,73,5884
4/28/22,Sao Tome and Principe,0.1864,6.6131,5957,0,73,5884
4/29/22,Sao Tome and Principe,0.1864,6.6131,5957,0,73,5884
4/30/22,Sao Tome and Principe,0.1864,6.6131,5957,0,73,5884
5/1/22,Sao Tome and Principe,0.1864,6.6131,5957,0,73,5884
5/2/22,Sao Tome and Principe,0.1864,6.6131,5964,0,73,5891
5/3/22,Sao Tome and Principe,0.1864,6.6131,5964,0,73,5891
5/4/22,Sao Tome and Principe,0.1864,6.6131,5964,0,73,5891
5/5/22,Sao Tome and Principe,0.1864,6.6131,5964,0,73,5891
5/6/22,Sao Tome and Principe,0.1864,6.6131,5964,0,73,5891
5/7/22,Sao Tome and Principe,0.1864,6.6131,5964,0,73,5891
5/8/22,Sao Tome and Principe,0.1864,6.6131,5964,0,73,5891
5/9/22,Sao Tome and Principe,0.1864,6.6131,5970,0,73,5897
5/10/22,Sao Tome and Principe,0.1864,6.6131,5970,0,73,5897
5/11/22,Sao Tome and Principe,0.1864,6.6131,5970,0,73,5897
5/12/22,Sao Tome and Principe,0.1864,6.6131,5970,0,73,5897
5/13/22,Sao Tome and Principe,0.1864,6.6131,5970,0,73,5897
5/14/22,Sao Tome and Principe,0.1864,6.6131,5970,0,73,5897
5/15/22,Sao Tome and Principe,0.1864,6.6131,5970,0,73,5897
5/16/22,Sao Tome and Principe,0.1864,6.6131,5973,0,73,5900
5/17/22,Sao Tome and Principe,0.1864,6.6131,5973,0,73,5900
5/18/22,Sao Tome and Principe,0.1864,6.6131,5973,0,73,5900
5/19/22,Sao Tome and Principe,0.1864,6.6131,5973,0,73,5900
5/20/22,Sao Tome and Principe,0.1864,6.6131,5973,0,73,5900
5/21/22,Sao Tome and Principe,0.1864,6.6131,5973,0,73,5900
5/22/22,Sao Tome and Principe,0.1864,6.6131,5973,0,73,5900
5/23/22,Sao Tome and Principe,0.1864,6.6131,5982,0,73,5909
5/24/22,Sao Tome and Principe,0.1864,6.6131,5982,0,73,5909
5/25/22,Sao Tome and Principe,0.1864,6.6131,5982,0,73,5909
5/26/22,Sao Tome and Principe,0.1864,6.6131,5982,0,73,5909
5/27/22,Sao Tome and Principe,0.1864,6.6131,5982,0,73,5909
5/28/22,Sao Tome and Principe,0.1864,6.6131,5982,0,73,5909
5/29/22,Sao Tome and Principe,0.1864,6.6131,5982,0,73,5909
5/30/22,Sao Tome and Principe,0.1864,6.6131,5991,0,73,5918
5/31/22,Sao Tome and Principe,0.1864,6.6131,5991,0,73,5918
6/1/22,Sao Tome and Principe,0.1864,6.6131,5991,0,73,5918
6/2/22,Sao Tome and Principe,0.1864,6.6131,5991,0,73,5918
6/3/22,Sao Tome and Principe,0.1864,6.6131,5991,0,73,5918
6/4/22,Sao Tome and Principe,0.1864,6.6131,5991,0,73,5918
6/5/22,Sao Tome and Principe,0.1864,6.6131,5991,0,73,5918
6/6/22,Sao Tome and Principe,0.1864,6.6131,6003,0,73,5930
6/7/22,Sao Tome and Principe,0.1864,6.6131,6003,0,73,5930
6/8/22,Sao Tome and Principe,0.1864,6.6131,6003,0,73,5930
6/9/22,Sao Tome and Principe,0.1864,6.6131,6003,0,73,5930
6/10/22,Sao Tome and Principe,0.1864,6.6131,6003,0,73,5930
6/11/22,Sao Tome and Principe,0.1864,6.6131,6003,0,73,5930
6/12/22,Sao Tome and Principe,0.1864,6.6131,6003,0,73,5930
6/13/22,Sao Tome and Principe,0.1864,6.6131,6010,0,73,5937
6/14/22,Sao Tome and Principe,0.1864,6.6131,6010,0,73,5937
6/15/22,Sao Tome and Principe,0.1864,6.6131,6010,0,73,5937
6/16/22,Sao Tome and Principe,0.1864,6.6131,6010,0,73,5937
6/17/22,Sao Tome and Principe,0.1864,6.6131,6010,0,73,5937
6/18/22,Sao Tome and Principe,0.1864,6.6131,6010,0,73,5937
6/19/22,Sao Tome and Principe,0.1864,6.6131,6010,0,73,5937
6/20/22,Sao Tome and Principe,0.1864,6.6131,6023,0,73,5950
6/21/22,Sao Tome and Principe,0.1864,6.6131,6023,0,73,5950
6/22/22,Sao Tome and Principe,0.1864,6.6131,6023,0,73,5950
6/23/22,Sao Tome and Principe,0.1864,6.6131,6023,0,73,5950
6/24/22,Sao Tome and Principe,0.1864,6.6131,6023,0,73,5950
6/25/22,Sao Tome and Principe,0.1864,6.6131,6023,0,73,5950
6/26/22,Sao Tome and Principe,0.1864,6.6131,6023,0,73,5950
6/27/22,Sao Tome and Principe,0.1864,6.6131,6043,0,73,5970
6/28/22,Sao Tome and Principe,0.1864,6.6131,6043,0,73,5970
6/29/22,Sao Tome and Principe,0.1864,6.6131,6043,0,73,5970
6/30/22,Sao Tome and Principe,0.1864,6.6131,6043,0,73,5970
7/1/22,Sao Tome and Principe,0.1864,6.6131,6043,0,73,5970
7/2/22,Sao Tome and Principe,0.1864,6.6131,6043,0,73,5970
7/3/22,Sao Tome and Principe,0.1864,6.6131,6043,0,73,5970
7/4/22,Sao Tome and Principe,0.1864,6.6131,6064,0,74,5990
7/5/22,Sao Tome and Principe,0.1864,6.6131,6064,0,74,5990
7/6/22,Sao Tome and Principe,0.1864,6.6131,6064,0,74,5990
7/7/22,Sao Tome and Principe,0.1864,6.6131,6064,0,74,5990
7/8/22,Sao Tome and Principe,0.1864,6.6131,6064,0,74,5990
7/9/22,Sao Tome and Principe,0.1864,6.6131,6064,0,74,5990
7/10/22,Sao Tome and Principe,0.1864,6.6131,6064,0,74,5990
7/11/22,Sao Tome and Principe,0.1864,6.6131,6064,0,74,5990
7/12/22,Sao Tome and Principe,0.1864,6.6131,6079,0,74,6005
7/13/22,Sao Tome and Principe,0.1864,6.6131,6079,0,74,6005
7/14/22,Sao Tome and Principe,0.1864,6.6131,6079,0,74,6005
7/15/22,Sao Tome and Principe,0.1864,6.6131,6079,0,74,6005
7/16/22,Sao Tome and Principe,0.1864,6.6131,6079,0,74,6005
7/17/22,Sao Tome and Principe,0.1864,6.6131,6079,0,74,6005
7/18/22,Sao Tome and Principe,0.1864,6.6131,6087,0,74,6013
7/19/22,Sao Tome and Principe,0.1864,6.6131,6087,0,74,6013
7/20/22,Sao Tome and Principe,0.1864,6.6131,6087,0,74,6013
7/21/22,Sao Tome and Principe,0.1864,6.6131,6087,0,74,6013
7/22/22,Sao Tome and Principe,0.1864,6.6131,6087,0,74,6013
7/23/22,Sao Tome and Principe,0.1864,6.6131,6087,0,74,6013
7/24/22,Sao Tome and Principe,0.1864,6.6131,6087,0,74,6013
7/25/22,Sao Tome and Principe,0.1864,6.6131,6087,0,74,6013
7/26/22,Sao Tome and Principe,0.1864,6.6131,6100,0,74,6026
7/27/22,Sao Tome and Principe,0.1864,6.6131,6100,0,74,6026
7/28/22,Sao Tome and Principe,0.1864,6.6131,6100,0,74,6026
7/29/22,Sao Tome and Principe,0.1864,6.6131,6100,0,74,6026
7/30/22,Sao Tome and Principe,0.1864,6.6131,6100,0,74,6026
7/31/22,Sao Tome and Principe,0.1864,6.6131,6100,0,74,6026
8/1/22,Sao Tome and Principe,0.1864,6.6131,6115,0,75,6040
8/2/22,Sao Tome and Principe,0.1864,6.6131,6115,0,75,6040
8/3/22,Sao Tome and Principe,0.1864,6.6131,6115,0,75,6040
8/4/22,Sao Tome and Principe,0.1864,6.6131,6115,0,75,6040
8/5/22,Sao Tome and Principe,0.1864,6.6131,6115,0,75,6040
8/6/22,Sao Tome and Principe,0.1864,6.6131,6115,0,75,6040
8/7/22,Sao Tome and Principe,0.1864,6.6131,6115,0,75,6040
8/8/22,Sao Tome and Principe,0.1864,6.6131,6115,0,75,6040
8/9/22,Sao Tome and Principe,0.1864,6.6131,6120,0,76,6044
8/10/22,Sao Tome and Principe,0.1864,6.6131,6120,0,76,6044
8/11/22,Sao Tome and Principe,0.1864,6.6131,6120,0,76,6044
8/12/22,Sao Tome and Principe,0.1864,6.6131,6120,0,76,6044
8/13/22,Sao Tome and Principe,0.1864,6.6131,6120,0,76,6044
8/14/22,Sao Tome and Principe,0.1864,6.6131,6120,0,76,6044
8/15/22,Sao Tome and Principe,0.1864,6.6131,6123,0,76,6047
8/16/22,Sao Tome and Principe,0.1864,6.6131,6123,0,76,6047
8/17/22,Sao Tome and Principe,0.1864,6.6131,6123,0,76,6047
8/18/22,Sao Tome and Principe,0.1864,6.6131,6123,0,76,6047
8/19/22,Sao Tome and Principe,0.1864,6.6131,6123,0,76,6047
8/20/22,Sao Tome and Principe,0.1864,6.6131,6123,0,76,6047
8/21/22,Sao Tome and Principe,0.1864,6.6131,6123,0,76,6047
8/22/22,Sao Tome and Principe,0.1864,6.6131,6136,0,76,6060
8/23/22,Sao Tome and Principe,0.1864,6.6131,6136,0,76,6060
8/24/22,Sao Tome and Principe,0.1864,6.6131,6136,0,76,6060
8/25/22,Sao Tome and Principe,0.1864,6.6131,6136,0,76,6060
8/26/22,Sao Tome and Principe,0.1864,6.6131,6136,0,76,6060
8/27/22,Sao Tome and Principe,0.1864,6.6131,6136,0,76,6060
8/28/22,Sao Tome and Principe,0.1864,6.6131,6136,0,76,6060
8/29/22,Sao Tome and Principe,0.1864,6.6131,6153,0,76,6077
8/30/22,Sao Tome and Principe,0.1864,6.6131,6153,0,76,6077
8/31/22,Sao Tome and Principe,0.1864,6.6131,6153,0,76,6077
9/1/22,Sao Tome and Principe,0.1864,6.6131,6153,0,76,6077
9/2/22,Sao Tome and Principe,0.1864,6.6131,6153,0,76,6077
9/3/22,Sao Tome and Principe,0.1864,6.6131,6153,0,76,6077
9/4/22,Sao Tome and Principe,0.1864,6.6131,6153,0,76,6077
9/5/22,Sao Tome and Principe,0.1864,6.6131,6177,0,76,6101
9/6/22,Sao Tome and Principe,0.1864,6.6131,6177,0,76,6101
9/7/22,Sao Tome and Principe,0.1864,6.6131,6177,0,76,6101
9/8/22,Sao Tome and Principe,0.1864,6.6131,6177,0,76,6101
9/9/22,Sao Tome and Principe,0.1864,6.6131,6177,0,76,6101
9/10/22,Sao Tome and Principe,0.1864,6.6131,6177,0,76,6101
9/11/22,Sao Tome and Principe,0.1864,6.6131,6177,0,76,6101
9/12/22,Sao Tome and Principe,0.1864,6.6131,6193,0,76,6117
9/13/22,Sao Tome and Principe,0.1864,6.6131,6193,0,76,6117
9/14/22,Sao Tome and Principe,0.1864,6.6131,6193,0,76,6117
9/15/22,Sao Tome and Principe,0.1864,6.6131,6193,0,76,6117
9/16/22,Sao Tome and Principe,0.1864,6.6131,6193,0,76,6117
9/17/22,Sao Tome and Principe,0.1864,6.6131,6193,0,76,6117
9/18/22,Sao Tome and Principe,0.1864,6.6131,6193,0,76,6117
9/19/22,Sao Tome and Principe,0.1864,6.6131,6193,0,76,6117
9/20/22,Sao Tome and Principe,0.1864,6.6131,6209,0,77,6132
9/21/22,Sao Tome and Principe,0.1864,6.6131,6209,0,77,6132
9/22/22,Sao Tome and Principe,0.1864,6.6131,6209,0,77,6132
9/23/22,Sao Tome and Principe,0.1864,6.6131,6209,0,77,6132
9/24/22,Sao Tome and Principe,0.1864,6.6131,6209,0,77,6132
9/25/22,Sao Tome and Principe,0.1864,6.6131,6209,0,77,6132
9/26/22,Sao Tome and Principe,0.1864,6.6131,6230,0,77,6153
9/27/22,Sao Tome and Principe,0.1864,6.6131,6230,0,77,6153
9/28/22,Sao Tome and Principe,0.1864,6.6131,6230,0,77,6153
9/29/22,Sao Tome and Principe,0.1864,6.6131,6230,0,77,6153
9/30/22,Sao Tome and Principe,0.1864,6.6131,6230,0,77,6153
10/1/22,Sao Tome and Principe,0.1864,6.6131,6230,0,77,6153
10/2/22,Sao Tome and Principe,0.1864,6.6131,6230,0,77,6153
10/3/22,Sao Tome and Principe,0.1864,6.6131,6230,0,77,6153
10/4/22,Sao Tome and Principe,0.1864,6.6131,6230,0,77,6153
10/5/22,Sao Tome and Principe,0.1864,6.6131,6236,0,77,6159
10/6/22,Sao Tome and Principe,0.1864,6.6131,6236,0,77,6159
10/7/22,Sao Tome and Principe,0.1864,6.6131,6236,0,77,6159
10/8/22,Sao Tome and Principe,0.1864,6.6131,6236,0,77,6159
10/9/22,Sao Tome and Principe,0.1864,6.6131,6236,0,77,6159
10/10/22,Sao Tome and Principe,0.1864,6.6131,6252,0,77,6175
10/11/22,Sao Tome and Principe,0.1864,6.6131,6252,0,77,6175
10/12/22,Sao Tome and Principe,0.1864,6.6131,6252,0,77,6175
10/13/22,Sao Tome and Principe,0.1864,6.6131,6252,0,77,6175
10/14/22,Sao Tome and Principe,0.1864,6.6131,6252,0,77,6175
10/15/22,Sao Tome and Principe,0.1864,6.6131,6252,0,77,6175
10/16/22,Sao Tome and Principe,0.1864,6.6131,6252,0,77,6175
10/17/22,Sao Tome and Principe,0.1864,6.6131,6252,0,77,6175
10/18/22,Sao Tome and Principe,0.1864,6.6131,6263,0,77,6186
10/19/22,Sao Tome and Principe,0.1864,6.6131,6263,0,77,6186
10/20/22,Sao Tome and Principe,0.1864,6.6131,6263,0,77,6186
10/21/22,Sao Tome and Principe,0.1864,6.6131,6263,0,77,6186
10/22/22,Sao Tome and Principe,0.1864,6.6131,6263,0,77,6186
10/23/22,Sao Tome and Principe,0.1864,6.6131,6263,0,77,6186
10/24/22,Sao Tome and Principe,0.1864,6.6131,6263,0,77,6186
10/25/22,Sao Tome and Principe,0.1864,6.6131,6263,0,77,6186
10/26/22,Sao Tome and Principe,0.1864,6.6131,6266,0,77,6189
10/27/22,Sao Tome and Principe,0.1864,6.6131,6266,0,77,6189
10/28/22,Sao Tome and Principe,0.1864,6.6131,6266,0,77,6189
10/29/22,Sao Tome and Principe,0.1864,6.6131,6266,0,77,6189
10/30/22,Sao Tome and Principe,0.1864,6.6131,6266,0,77,6189
10/31/22,Sao Tome and Principe,0.1864,6.6131,6266,0,77,6189
11/1/22,Sao Tome and Principe,0.1864,6.6131,6270,0,77,6193
11/2/22,Sao Tome and Principe,0.1864,6.6131,6270,0,77,6193
11/3/22,Sao Tome and Principe,0.1864,6.6131,6270,0,77,6193
11/4/22,Sao Tome and Principe,0.1864,6.6131,6270,0,77,6193
11/5/22,Sao Tome and Principe,0.1864,6.6131,6270,0,77,6193
11/6/22,Sao Tome and Principe,0.1864,6.6131,6270,0,77,6193
11/7/22,Sao Tome and Principe,0.1864,6.6131,6270,0,77,6193
11/8/22,Sao Tome and Principe,0.1864,6.6131,6275,0,77,6198
11/9/22,Sao Tome and Principe,0.1864,6.6131,6275,0,77,6198
11/10/22,Sao Tome and Principe,0.1864,6.6131,6275,0,77,6198
11/11/22,Sao Tome and Principe,0.1864,6.6131,6275,0,77,6198
11/12/22,Sao Tome and Principe,0.1864,6.6131,6275,0,77,6198
11/13/22,Sao Tome and Principe,0.1864,6.6131,6275,0,77,6198
11/14/22,Sao Tome and Principe,0.1864,6.6131,6275,0,77,6198
11/15/22,Sao Tome and Principe,0.1864,6.6131,6275,0,77,6198
11/16/22,Sao Tome and Principe,0.1864,6.6131,6275,0,77,6198
11/17/22,Sao Tome and Principe,0.1864,6.6131,6275,0,77,6198
11/18/22,Sao Tome and Principe,0.1864,6.6131,6275,0,77,6198
11/19/22,Sao Tome and Principe,0.1864,6.6131,6275,0,77,6198
11/20/22,Sao Tome and Principe,0.1864,6.6131,6275,0,77,6198
11/21/22,Sao Tome and Principe,0.1864,6.6131,6275,0,77,6198
11/22/22,Sao Tome and Principe,0.1864,6.6131,6278,0,77,6201
11/23/22,Sao Tome and Principe,0.1864,6.6131,6278,0,77,6201
11/24/22,Sao Tome and Principe,0.1864,6.6131,6278,0,77,6201
11/25/22,Sao Tome and Principe,0.1864,6.6131,6278,0,77,6201
11/26/22,Sao Tome and Principe,0.1864,6.6131,6278,0,77,6201
11/27/22,Sao Tome and Principe,0.1864,6.6131,6278,0,77,6201
11/28/22,Sao Tome and Principe,0.1864,6.6131,6278,0,77,6201
11/29/22,Sao Tome and Principe,0.1864,6.6131,6278,0,77,6201
11/30/22,Sao Tome and Principe,0.1864,6.6131,6278,0,77,6201
12/1/22,Sao Tome and Principe,0.1864,6.6131,6278,0,77,6201
12/2/22,Sao Tome and Principe,0.1864,6.6131,6278,0,77,6201
12/3/22,Sao Tome and Principe,0.1864,6.6131,6278,0,77,6201
12/4/22,Sao Tome and Principe,0.1864,6.6131,6278,0,77,6201
12/5/22,Sao Tome and Principe,0.1864,6.6131,6278,0,77,6201
12/6/22,Sao Tome and Principe,0.1864,6.6131,6279,0,77,6202
12/7/22,Sao Tome and Principe,0.1864,6.6131,6279,0,77,6202
12/8/22,Sao Tome and Principe,0.1864,6.6131,6279,0,77,6202
12/9/22,Sao Tome and Principe,0.1864,6.6131,6279,0,77,6202
12/10/22,Sao Tome and Principe,0.1864,6.6131,6279,0,77,6202
12/11/22,Sao Tome and Principe,0.1864,6.6131,6279,0,77,6202
12/12/22,Sao Tome and Principe,0.1864,6.6131,6279,0,77,6202
12/13/22,Sao Tome and Principe,0.1864,6.6131,6279,0,77,6202
12/14/22,Sao Tome and Principe,0.1864,6.6131,6279,0,77,6202
12/15/22,Sao Tome and Principe,0.1864,6.6131,6279,0,77,6202
12/16/22,Sao Tome and Principe,0.1864,6.6131,6279,0,77,6202
12/17/22,Sao Tome and Principe,0.1864,6.6131,6279,0,77,6202
1/1/22,Saudi Arabia,23.885942,45.079162,557082,0,8878,548204
1/2/22,Saudi Arabia,23.885942,45.079162,558106,0,8879,549227
1/3/22,Saudi Arabia,23.885942,45.079162,559852,0,8881,550971
1/4/22,Saudi Arabia,23.885942,45.079162,562437,0,8883,553554
1/5/22,Saudi Arabia,23.885942,45.079162,565482,0,8886,556596
1/6/22,Saudi Arabia,23.885942,45.079162,568650,0,8888,559762
1/7/22,Saudi Arabia,23.885942,45.079162,572225,0,8890,563335
1/8/22,Saudi Arabia,23.885942,45.079162,575293,0,8892,566401
1/9/22,Saudi Arabia,23.885942,45.079162,578753,0,8893,569860
1/10/22,Saudi Arabia,23.885942,45.079162,583531,0,8895,574636
1/11/22,Saudi Arabia,23.885942,45.079162,588183,0,8897,579286
1/12/22,Saudi Arabia,23.885942,45.079162,593545,0,8899,584646
1/13/22,Saudi Arabia,23.885942,45.079162,599044,0,8901,590143
1/14/22,Saudi Arabia,23.885942,45.079162,604672,0,8903,595769
1/15/22,Saudi Arabia,23.885942,45.079162,609953,0,8905,601048
1/16/22,Saudi Arabia,23.885942,45.079162,615430,0,8906,606524
1/17/22,Saudi Arabia,23.885942,45.079162,620935,0,8908,612027
1/18/22,Saudi Arabia,23.885942,45.079162,626808,0,8910,617898
1/19/22,Saudi Arabia,23.885942,45.079162,632736,0,8912,623824
1/20/22,Saudi Arabia,23.885942,45.079162,638327,0,8914,629413
1/21/22,Saudi Arabia,23.885942,45.079162,643211,0,8916,634295
1/22/22,Saudi Arabia,23.885942,45.079162,647819,0,8918,638901
1/23/22,Saudi Arabia,23.885942,45.079162,652354,0,8920,643434
1/24/22,Saudi Arabia,23.885942,45.079162,657192,0,8922,648270
1/25/22,Saudi Arabia,23.885942,45.079162,661733,0,8924,652809
1/26/22,Saudi Arabia,23.885942,45.079162,666259,0,8927,657332
1/27/22,Saudi Arabia,23.885942,45.079162,670997,0,8929,662068
1/28/22,Saudi Arabia,23.885942,45.079162,675471,0,8931,666540
1/29/22,Saudi Arabia,23.885942,45.079162,679384,0,8933,670451
1/30/22,Saudi Arabia,23.885942,45.079162,683053,0,8936,674117
1/31/22,Saudi Arabia,23.885942,45.079162,687264,0,8940,678324
2/1/22,Saudi Arabia,23.885942,45.079162,691125,0,8941,682184
2/2/22,Saudi Arabia,23.885942,45.079162,695217,0,8943,686274
2/3/22,Saudi Arabia,23.885942,45.079162,699069,0,8947,690122
2/4/22,Saudi Arabia,23.885942,45.079162,702624,0,8950,693674
2/5/22,Saudi Arabia,23.885942,45.079162,705637,0,8953,696684
2/6/22,Saudi Arabia,23.885942,45.079162,708897,0,8954,699943
2/7/22,Saudi Arabia,23.885942,45.079162,712644,0,8957,703687
2/8/22,Saudi Arabia,23.885942,45.079162,715974,0,8959,707015
2/9/22,Saudi Arabia,23.885942,45.079162,719136,0,8962,710174
2/10/22,Saudi Arabia,23.885942,45.079162,722002,0,8965,713037
2/11/22,Saudi Arabia,23.885942,45.079162,724525,0,8969,715556
2/12/22,Saudi Arabia,23.885942,45.079162,726251,0,8971,717280
2/13/22,Saudi Arabia,23.885942,45.079162,728387,0,8973,719414
2/14/22,Saudi Arabia,23.885942,45.079162,730614,0,8974,721640
2/15/22,Saudi Arabia,23.885942,45.079162,732596,0,8975,723621
2/16/22,Saudi Arabia,23.885942,45.079162,734389,0,8977,725412
2/17/22,Saudi Arabia,23.885942,45.079162,735958,0,8978,726980
2/18/22,Saudi Arabia,23.885942,45.079162,737334,0,8981,728353
2/19/22,Saudi Arabia,23.885942,45.079162,738331,0,8982,729349
2/20/22,Saudi Arabia,23.885942,45.079162,739344,0,8984,730360
2/21/22,Saudi Arabia,23.885942,45.079162,740396,0,8986,731410
2/22/22,Saudi Arabia,23.885942,45.079162,741237,0,8987,732250
2/23/22,Saudi Arabia,23.885942,45.079162,741864,0,8990,732874
2/24/22,Saudi Arabia,23.885942,45.079162,742541,0,8991,733550
2/25/22,Saudi Arabia,23.885942,45.079162,743205,0,8993,734212
2/26/22,Saudi Arabia,23.885942,45.079162,743742,0,8994,734748
2/27/22,Saudi Arabia,23.885942,45.079162,744374,0,8996,735378
2/28/22,Saudi Arabia,23.885942,45.079162,745027,0,8998,736029
3/1/22,Saudi Arabia,23.885942,45.079162,745590,0,9001,736589
3/2/22,Saudi Arabia,23.885942,45.079162,746066,0,9002,737064
3/3/22,Saudi Arabia,23.885942,45.079162,746473,0,9004,737469
3/4/22,Saudi Arabia,23.885942,45.079162,746836,0,9005,737831
3/5/22,Saudi Arabia,23.885942,45.079162,747119,0,9006,738113
3/6/22,Saudi Arabia,23.885942,45.079162,747436,0,9008,738428
3/7/22,Saudi Arabia,23.885942,45.079162,747715,0,9009,738706
3/8/22,Saudi Arabia,23.885942,45.079162,747934,0,9011,738923
3/9/22,Saudi Arabia,23.885942,45.079162,748121,0,9013,739108
3/10/22,Saudi Arabia,23.885942,45.079162,748311,0,9014,739297
3/11/22,Saudi Arabia,23.885942,45.079162,748489,0,9016,739473
3/12/22,Saudi Arabia,23.885942,45.079162,748624,0,9017,739607
3/13/22,Saudi Arabia,23.885942,45.079162,748769,0,9018,739751
3/14/22,Saudi Arabia,23.885942,45.079162,748915,0,9020,739895
3/15/22,Saudi Arabia,23.885942,45.079162,749044,0,9021,740023
3/16/22,Saudi Arabia,23.885942,45.079162,749171,0,9023,740148
3/17/22,Saudi Arabia,23.885942,45.079162,749268,0,9024,740244
3/18/22,Saudi Arabia,23.885942,45.079162,749373,0,9025,740348
3/19/22,Saudi Arabia,23.885942,45.079162,749471,0,9027,740444
3/20/22,Saudi Arabia,23.885942,45.079162,749597,0,9028,740569
3/21/22,Saudi Arabia,23.885942,45.079162,749730,0,9030,740700
3/22/22,Saudi Arabia,23.885942,45.079162,749855,0,9032,740823
3/23/22,Saudi Arabia,23.885942,45.079162,749965,0,9033,740932
3/24/22,Saudi Arabia,23.885942,45.079162,750080,0,9034,741046
3/25/22,Saudi Arabia,23.885942,45.079162,750179,0,9036,741143
3/26/22,Saudi Arabia,23.885942,45.079162,750258,0,9038,741220
3/27/22,Saudi Arabia,23.885942,45.079162,750356,0,9039,741317
3/28/22,Saudi Arabia,23.885942,45.079162,750483,0,9040,741443
3/29/22,Saudi Arabia,23.885942,45.079162,750589,0,9042,741547
3/30/22,Saudi Arabia,23.885942,45.079162,750707,0,9043,741664
3/31/22,Saudi Arabia,23.885942,45.079162,750814,0,9045,741769
4/1/22,Saudi Arabia,23.885942,45.079162,750910,0,9046,741864
4/2/22,Saudi Arabia,23.885942,45.079162,750998,0,9047,741951
4/3/22,Saudi Arabia,23.885942,45.079162,751076,0,9048,742028
4/4/22,Saudi Arabia,23.885942,45.079162,751180,0,9050,742130
4/5/22,Saudi Arabia,23.885942,45.079162,751296,0,9050,742246
4/6/22,Saudi Arabia,23.885942,45.079162,751404,0,9053,742351
4/7/22,Saudi Arabia,23.885942,45.079162,751518,0,9054,742464
4/8/22,Saudi Arabia,23.885942,45.079162,751622,0,9055,742567
4/9/22,Saudi Arabia,23.885942,45.079162,751717,0,9055,742662
4/10/22,Saudi Arabia,23.885942,45.079162,751813,0,9058,742755
4/11/22,Saudi Arabia,23.885942,45.079162,751943,0,9058,742885
4/12/22,Saudi Arabia,23.885942,45.079162,752078,0,9060,743018
4/13/22,Saudi Arabia,23.885942,45.079162,752188,0,9062,743126
4/14/22,Saudi Arabia,23.885942,45.079162,752291,0,9063,743228
4/15/22,Saudi Arabia,23.885942,45.079162,752396,0,9066,743330
4/16/22,Saudi Arabia,23.885942,45.079162,752479,0,9068,743411
4/17/22,Saudi Arabia,23.885942,45.079162,752572,0,9069,743503
4/18/22,Saudi Arabia,23.885942,45.079162,752705,0,9069,743636
4/19/22,Saudi Arabia,23.885942,45.079162,752848,0,9072,743776
4/20/22,Saudi Arabia,23.885942,45.079162,752994,0,9074,743920
4/21/22,Saudi Arabia,23.885942,45.079162,753124,0,9075,744049
4/22/22,Saudi Arabia,23.885942,45.079162,753241,0,9075,744166
4/23/22,Saudi Arabia,23.885942,45.079162,753332,0,9076,744256
4/24/22,Saudi Arabia,23.885942,45.079162,753417,0,9078,744339
4/25/22,Saudi Arabia,23.885942,45.079162,753526,0,9079,744447
4/26/22,Saudi Arabia,23.885942,45.079162,753632,0,9082,744550
4/27/22,Saudi Arabia,23.885942,45.079162,753730,0,9084,744646
4/28/22,Saudi Arabia,23.885942,45.079162,753822,0,9085,744737
4/29/22,Saudi Arabia,23.885942,45.079162,753921,0,9086,744835
4/30/22,Saudi Arabia,23.885942,45.079162,754011,0,9088,744923
5/1/22,Saudi Arabia,23.885942,45.079162,754110,0,9089,745021
5/2/22,Saudi Arabia,23.885942,45.079162,754238,0,9093,745145
5/3/22,Saudi Arabia,23.885942,45.079162,754340,0,9093,745247
5/4/22,Saudi Arabia,23.885942,45.079162,754464,0,9094,745370
5/5/22,Saudi Arabia,23.885942,45.079162,754623,0,9096,745527
5/6/22,Saudi Arabia,23.885942,45.079162,754842,0,9099,745743
5/7/22,Saudi Arabia,23.885942,45.079162,755076,0,9099,745977
5/8/22,Saudi Arabia,23.885942,45.079162,755415,0,9103,746312
5/9/22,Saudi Arabia,23.885942,45.079162,755980,0,9104,746876
5/10/22,Saudi Arabia,23.885942,45.079162,756549,0,9104,747445
5/11/22,Saudi Arabia,23.885942,45.079162,757191,0,9108,748083
5/12/22,Saudi Arabia,23.885942,45.079162,757802,0,9110,748692
5/13/22,Saudi Arabia,23.885942,45.079162,758361,0,9111,749250
5/14/22,Saudi Arabia,23.885942,45.079162,758795,0,9114,749681
5/15/22,Saudi Arabia,23.885942,45.079162,759226,0,9116,750110
5/16/22,Saudi Arabia,23.885942,45.079162,759856,0,9118,750738
5/17/22,Saudi Arabia,23.885942,45.079162,760477,0,9121,751356
5/18/22,Saudi Arabia,23.885942,45.079162,761079,0,9123,751956
5/19/22,Saudi Arabia,23.885942,45.079162,761624,0,9124,752500
5/20/22,Saudi Arabia,23.885942,45.079162,762164,0,9127,753037
5/21/22,Saudi Arabia,23.885942,45.079162,762575,0,9128,753447
5/22/22,Saudi Arabia,23.885942,45.079162,763042,0,9130,753912
5/23/22,Saudi Arabia,23.885942,45.079162,763692,0,9131,754561
5/24/22,Saudi Arabia,23.885942,45.079162,764249,0,9134,755115
5/25/22,Saudi Arabia,23.885942,45.079162,764789,0,9135,755654
5/26/22,Saudi Arabia,23.885942,45.079162,765305,0,9138,756167
5/27/22,Saudi Arabia,23.885942,45.079162,765788,0,9140,756648
5/28/22,Saudi Arabia,23.885942,45.079162,766196,0,9143,757053
5/29/22,Saudi Arabia,23.885942,45.079162,766726,0,9144,757582
5/30/22,Saudi Arabia,23.885942,45.079162,767412,0,9145,758267
5/31/22,Saudi Arabia,23.885942,45.079162,768079,0,9148,758931
6/1/22,Saudi Arabia,23.885942,45.079162,768648,0,9149,759499
6/2/22,Saudi Arabia,23.885942,45.079162,769423,0,9151,760272
6/3/22,Saudi Arabia,23.885942,45.079162,770085,0,9152,760933
6/4/22,Saudi Arabia,23.885942,45.079162,770650,0,9155,761495
6/5/22,Saudi Arabia,23.885942,45.079162,771302,0,9156,762146
6/6/22,Saudi Arabia,23.885942,45.079162,772269,0,9158,763111
6/7/22,Saudi Arabia,23.885942,45.079162,773221,0,9160,764061
6/8/22,Saudi Arabia,23.885942,45.079162,774250,0,9163,765087
6/9/22,Saudi Arabia,23.885942,45.079162,775205,0,9165,766040
6/10/22,Saudi Arabia,23.885942,45.079162,776137,0,9167,766970
6/11/22,Saudi Arabia,23.885942,45.079162,776890,0,9170,767720
6/12/22,Saudi Arabia,23.885942,45.079162,777795,0,9173,768622
6/13/22,Saudi Arabia,23.885942,45.079162,778983,0,9175,769808
6/14/22,Saudi Arabia,23.885942,45.079162,780135,0,9176,770959
6/15/22,Saudi Arabia,23.885942,45.079162,781168,0,9179,771989
6/16/22,Saudi Arabia,23.885942,45.079162,782131,0,9180,772951
6/17/22,Saudi Arabia,23.885942,45.079162,783076,0,9183,773893
6/18/22,Saudi Arabia,23.885942,45.079162,783907,0,9185,774722
6/19/22,Saudi Arabia,23.885942,45.079162,784837,0,9188,775649
6/20/22,Saudi Arabia,23.885942,45.079162,786069,0,9189,776880
6/21/22,Saudi Arabia,23.885942,45.079162,787212,0,9191,778021
6/22/22,Saudi Arabia,23.885942,45.079162,788294,0,9194,779100
6/23/22,Saudi Arabia,23.885942,45.079162,788294,0,9194,779100
6/24/22,Saudi Arabia,23.885942,45.079162,788294,0,9194,779100
6/25/22,Saudi Arabia,23.885942,45.079162,788294,0,9194,779100
6/26/22,Saudi Arabia,23.885942,45.079162,791784,0,9201,782583
6/27/22,Saudi Arabia,23.885942,45.079162,792860,0,9202,783658
6/28/22,Saudi Arabia,23.885942,45.079162,793729,0,9205,784524
6/29/22,Saudi Arabia,23.885942,45.079162,794488,0,9207,785281
6/30/22,Saudi Arabia,23.885942,45.079162,795186,0,9208,785978
7/1/22,Saudi Arabia,23.885942,45.079162,795811,0,9209,786602
7/2/22,Saudi Arabia,23.885942,45.079162,796268,0,9211,787057
7/3/22,Saudi Arabia,23.885942,45.079162,796771,0,9211,787560
7/4/22,Saudi Arabia,23.885942,45.079162,797374,0,9211,788163
7/5/22,Saudi Arabia,23.885942,45.079162,797940,0,9212,788728
7/6/22,Saudi Arabia,23.885942,45.079162,798474,0,9215,789259
7/7/22,Saudi Arabia,23.885942,45.079162,798977,0,9218,789759
7/8/22,Saudi Arabia,23.885942,45.079162,799435,0,9219,790216
7/9/22,Saudi Arabia,23.885942,45.079162,799788,0,9220,790568
7/10/22,Saudi Arabia,23.885942,45.079162,800087,0,9221,790866
7/11/22,Saudi Arabia,23.885942,45.079162,800462,0,9221,791241
7/12/22,Saudi Arabia,23.885942,45.079162,800869,0,9223,791646
7/13/22,Saudi Arabia,23.885942,45.079162,801349,0,9225,792124
7/14/22,Saudi Arabia,23.885942,45.079162,801935,0,9228,792707
7/15/22,Saudi Arabia,23.885942,45.079162,802586,0,9229,793357
7/16/22,Saudi Arabia,23.885942,45.079162,803158,0,9230,793928
7/17/22,Saudi Arabia,23.885942,45.079162,803764,0,9232,794532
7/18/22,Saudi Arabia,23.885942,45.079162,804570,0,9233,795337
7/19/22,Saudi Arabia,23.885942,45.079162,805277,0,9233,796044
7/20/22,Saudi Arabia,23.885942,45.079162,805879,0,9233,796646
7/21/22,Saudi Arabia,23.885942,45.079162,806401,0,9236,797165
7/22/22,Saudi Arabia,23.885942,45.079162,806877,0,9237,797640
7/23/22,Saudi Arabia,23.885942,45.079162,807215,0,9238,797977
7/24/22,Saudi Arabia,23.885942,45.079162,807591,0,9239,798352
7/25/22,Saudi Arabia,23.885942,45.079162,808053,0,9240,798813
7/26/22,Saudi Arabia,23.885942,45.079162,808419,0,9243,799176
7/27/22,Saudi Arabia,23.885942,45.079162,808742,0,9243,799499
7/28/22,Saudi Arabia,23.885942,45.079162,809026,0,9245,799781
7/29/22,Saudi Arabia,23.885942,45.079162,809274,0,9247,800027
7/30/22,Saudi Arabia,23.885942,45.079162,809449,0,9250,800199
7/31/22,Saudi Arabia,23.885942,45.079162,809672,0,9251,800421
8/1/22,Saudi Arabia,23.885942,45.079162,809960,0,9252,800708
8/2/22,Saudi Arabia,23.885942,45.079162,810187,0,9255,800932
8/3/22,Saudi Arabia,23.885942,45.079162,810394,0,9255,801139
8/4/22,Saudi Arabia,23.885942,45.079162,810583,0,9257,801326
8/5/22,Saudi Arabia,23.885942,45.079162,810760,0,9257,801503
8/6/22,Saudi Arabia,23.885942,45.079162,810887,0,9260,801627
8/7/22,Saudi Arabia,23.885942,45.079162,811034,0,9261,801773
8/8/22,Saudi Arabia,23.885942,45.079162,811217,0,9261,801956
8/9/22,Saudi Arabia,23.885942,45.079162,811362,0,9263,802099
8/10/22,Saudi Arabia,23.885942,45.079162,811512,0,9264,802248
8/11/22,Saudi Arabia,23.885942,45.079162,811642,0,9265,802377
8/12/22,Saudi Arabia,23.885942,45.079162,811748,0,9266,802482
8/13/22,Saudi Arabia,23.885942,45.079162,811853,0,9269,802584
8/14/22,Saudi Arabia,23.885942,45.079162,811958,0,9269,802689
8/15/22,Saudi Arabia,23.885942,45.079162,812093,0,9271,802822
8/16/22,Saudi Arabia,23.885942,45.079162,812196,0,9272,802924
8/17/22,Saudi Arabia,23.885942,45.079162,812300,0,9272,803028
8/18/22,Saudi Arabia,23.885942,45.079162,812397,0,9273,803124
8/19/22,Saudi Arabia,23.885942,45.079162,812486,0,9274,803212
8/20/22,Saudi Arabia,23.885942,45.079162,812550,0,9276,803274
8/21/22,Saudi Arabia,23.885942,45.079162,812624,0,9277,803347
8/22/22,Saudi Arabia,23.885942,45.079162,812736,0,9280,803456
8/23/22,Saudi Arabia,23.885942,45.079162,812824,0,9280,803544
8/24/22,Saudi Arabia,23.885942,45.079162,812903,0,9282,803621
8/25/22,Saudi Arabia,23.885942,45.079162,812975,0,9284,803691
8/26/22,Saudi Arabia,23.885942,45.079162,813042,0,9287,803755
8/27/22,Saudi Arabia,23.885942,45.079162,813107,0,9288,803819
8/28/22,Saudi Arabia,23.885942,45.079162,813186,0,9289,803897
8/29/22,Saudi Arabia,23.885942,45.079162,813284,0,9292,803992
8/30/22,Saudi Arabia,23.885942,45.079162,813376,0,9293,804083
8/31/22,Saudi Arabia,23.885942,45.079162,813461,0,9295,804166
9/1/22,Saudi Arabia,23.885942,45.079162,813542,0,9297,804245
9/2/22,Saudi Arabia,23.885942,45.079162,813616,0,9299,804317
9/3/22,Saudi Arabia,23.885942,45.079162,813682,0,9302,804380
9/4/22,Saudi Arabia,23.885942,45.079162,813764,0,9303,804461
9/5/22,Saudi Arabia,23.885942,45.079162,813878,0,9306,804572
9/6/22,Saudi Arabia,23.885942,45.079162,813986,0,9309,804677
9/7/22,Saudi Arabia,23.885942,45.079162,814088,0,9310,804778
9/8/22,Saudi Arabia,23.885942,45.079162,814192,0,9312,804880
9/9/22,Saudi Arabia,23.885942,45.079162,814278,0,9313,804965
9/10/22,Saudi Arabia,23.885942,45.079162,814356,0,9315,805041
9/11/22,Saudi Arabia,23.885942,45.079162,814465,0,9316,805149
9/12/22,Saudi Arabia,23.885942,45.079162,814597,0,9317,805280
9/13/22,Saudi Arabia,23.885942,45.079162,814722,0,9320,805402
9/14/22,Saudi Arabia,23.885942,45.079162,814829,0,9322,805507
9/15/22,Saudi Arabia,23.885942,45.079162,814937,0,9324,805613
9/16/22,Saudi Arabia,23.885942,45.079162,815035,0,9327,805708
9/17/22,Saudi Arabia,23.885942,45.079162,815097,0,9330,805767
9/18/22,Saudi Arabia,23.885942,45.079162,815195,0,9331,805864
9/19/22,Saudi Arabia,23.885942,45.079162,815326,0,9332,805994
9/20/22,Saudi Arabia,23.885942,45.079162,815431,0,9333,806098
9/21/22,Saudi Arabia,23.885942,45.079162,815529,0,9335,806194
9/22/22,Saudi Arabia,23.885942,45.079162,815609,0,9337,806272
9/23/22,Saudi Arabia,23.885942,45.079162,815686,0,9340,806346
9/24/22,Saudi Arabia,23.885942,45.079162,815743,0,9341,806402
9/25/22,Saudi Arabia,23.885942,45.079162,815839,0,9342,806497
9/26/22,Saudi Arabia,23.885942,45.079162,816000,0,9344,806656
9/27/22,Saudi Arabia,23.885942,45.079162,816130,0,9347,806783
9/28/22,Saudi Arabia,23.885942,45.079162,816262,0,9350,806912
9/29/22,Saudi Arabia,23.885942,45.079162,816389,0,9351,807038
9/30/22,Saudi Arabia,23.885942,45.079162,816498,0,9352,807146
10/1/22,Saudi Arabia,23.885942,45.079162,816575,0,9353,807222
10/2/22,Saudi Arabia,23.885942,45.079162,816664,0,9355,807309
10/3/22,Saudi Arabia,23.885942,45.079162,816820,0,9357,807463
10/4/22,Saudi Arabia,23.885942,45.079162,816975,0,9360,807615
10/5/22,Saudi Arabia,23.885942,45.079162,817127,0,9361,807766
10/6/22,Saudi Arabia,23.885942,45.079162,817264,0,9362,807902
10/7/22,Saudi Arabia,23.885942,45.079162,817403,0,9364,808039
10/8/22,Saudi Arabia,23.885942,45.079162,817490,0,9365,808125
10/9/22,Saudi Arabia,23.885942,45.079162,817612,0,9368,808244
10/10/22,Saudi Arabia,23.885942,45.079162,817838,0,9369,808469
10/11/22,Saudi Arabia,23.885942,45.079162,818033,0,9372,808661
10/12/22,Saudi Arabia,23.885942,45.079162,818236,0,9374,808862
10/13/22,Saudi Arabia,23.885942,45.079162,818427,0,9376,809051
10/14/22,Saudi Arabia,23.885942,45.079162,818592,0,9379,809213
10/15/22,Saudi Arabia,23.885942,45.079162,818592,0,9379,809213
10/16/22,Saudi Arabia,23.885942,45.079162,818837,0,9381,809456
10/17/22,Saudi Arabia,23.885942,45.079162,819083,0,9383,809700
10/18/22,Saudi Arabia,23.885942,45.079162,819323,0,9384,809939
10/19/22,Saudi Arabia,23.885942,45.079162,819570,0,9387,810183
10/20/22,Saudi Arabia,23.885942,45.079162,819811,0,9390,810421
10/21/22,Saudi Arabia,23.885942,45.079162,820027,0,9391,810636
10/22/22,Saudi Arabia,23.885942,45.079162,820156,0,9392,810764
10/23/22,Saudi Arabia,23.885942,45.079162,820334,0,9393,810941
10/24/22,Saudi Arabia,23.885942,45.079162,820644,0,9395,811249
10/25/22,Saudi Arabia,23.885942,45.079162,820920,0,9397,811523
10/26/22,Saudi Arabia,23.885942,45.079162,821246,0,9400,811846
10/27/22,Saudi Arabia,23.885942,45.079162,821540,0,9401,812139
10/28/22,Saudi Arabia,23.885942,45.079162,821777,0,9403,812374
10/29/22,Saudi Arabia,23.885942,45.079162,821937,0,9405,812532
10/30/22,Saudi Arabia,23.885942,45.079162,822132,0,9406,812726
10/31/22,Saudi Arabia,23.885942,45.079162,822459,0,9407,813052
11/1/22,Saudi Arabia,23.885942,45.079162,822718,0,9409,813309
11/2/22,Saudi Arabia,23.885942,45.079162,822976,0,9412,813564
11/3/22,Saudi Arabia,23.885942,45.079162,823203,0,9415,813788
11/4/22,Saudi Arabia,23.885942,45.079162,823388,0,9416,813972
11/5/22,Saudi Arabia,23.885942,45.079162,823494,0,9417,814077
11/6/22,Saudi Arabia,23.885942,45.079162,823624,0,9418,814206
11/7/22,Saudi Arabia,23.885942,45.079162,823834,0,9421,814413
11/8/22,Saudi Arabia,23.885942,45.079162,824003,0,9423,814580
11/9/22,Saudi Arabia,23.885942,45.079162,824151,0,9425,814726
11/10/22,Saudi Arabia,23.885942,45.079162,824273,0,9426,814847
11/11/22,Saudi Arabia,23.885942,45.079162,824377,0,9429,814948
11/12/22,Saudi Arabia,23.885942,45.079162,824438,0,9432,815006
11/13/22,Saudi Arabia,23.885942,45.079162,824513,0,9433,815080
11/14/22,Saudi Arabia,23.885942,45.079162,824640,0,9435,815205
11/15/22,Saudi Arabia,23.885942,45.079162,824747,0,9438,815309
11/16/22,Saudi Arabia,23.885942,45.079162,824834,0,9440,815394
11/17/22,Saudi Arabia,23.885942,45.079162,824917,0,9442,815475
11/18/22,Saudi Arabia,23.885942,45.079162,824984,0,9443,815541
11/19/22,Saudi Arabia,23.885942,45.079162,825029,0,9446,815583
11/20/22,Saudi Arabia,23.885942,45.079162,825087,0,9447,815640
11/21/22,Saudi Arabia,23.885942,45.079162,825176,0,9448,815728
11/22/22,Saudi Arabia,23.885942,45.079162,825239,0,9449,815790
11/23/22,Saudi Arabia,23.885942,45.079162,825290,0,9451,815839
11/24/22,Saudi Arabia,23.885942,45.079162,825332,0,9454,815878
11/25/22,Saudi Arabia,23.885942,45.079162,825372,0,9456,815916
11/26/22,Saudi Arabia,23.885942,45.079162,825402,0,9457,815945
11/27/22,Saudi Arabia,23.885942,45.079162,825436,0,9458,815978
11/28/22,Saudi Arabia,23.885942,45.079162,825497,0,9459,816038
11/29/22,Saudi Arabia,23.885942,45.079162,825549,0,9461,816088
11/30/22,Saudi Arabia,23.885942,45.079162,825597,0,9464,816133
12/1/22,Saudi Arabia,23.885942,45.079162,825640,0,9465,816175
12/2/22,Saudi Arabia,23.885942,45.079162,825681,0,9468,816213
12/3/22,Saudi Arabia,23.885942,45.079162,825718,0,9471,816247
12/4/22,Saudi Arabia,23.885942,45.079162,825773,0,9472,816301
12/5/22,Saudi Arabia,23.885942,45.079162,825859,0,9474,816385
12/6/22,Saudi Arabia,23.885942,45.079162,825936,0,9476,816460
12/7/22,Saudi Arabia,23.885942,45.079162,826009,0,9477,816532
12/8/22,Saudi Arabia,23.885942,45.079162,826064,0,9480,816584
12/9/22,Saudi Arabia,23.885942,45.079162,826117,0,9481,816636
12/10/22,Saudi Arabia,23.885942,45.079162,826153,0,9482,816671
12/11/22,Saudi Arabia,23.885942,45.079162,826191,0,9484,816707
12/12/22,Saudi Arabia,23.885942,45.079162,826259,0,9486,816773
12/13/22,Saudi Arabia,23.885942,45.079162,826312,0,9487,816825
12/14/22,Saudi Arabia,23.885942,45.079162,826365,0,9490,816875
12/15/22,Saudi Arabia,23.885942,45.079162,826410,0,9491,816919
12/16/22,Saudi Arabia,23.885942,45.079162,826450,0,9492,816958
12/17/22,Saudi Arabia,23.885942,45.079162,826478,0,9494,816984
1/1/22,Senegal,14.4974,-14.4524,75337,0,1890,73447
1/2/22,Senegal,14.4974,-14.4524,75671,0,1890,73781
1/3/22,Senegal,14.4974,-14.4524,75959,0,1890,74069
1/4/22,Senegal,14.4974,-14.4524,76233,0,1891,74342
1/5/22,Senegal,14.4974,-14.4524,76753,0,1892,74861
1/6/22,Senegal,14.4974,-14.4524,77272,0,1892,75380
1/7/22,Senegal,14.4974,-14.4524,77935,0,1895,76040
1/8/22,Senegal,14.4974,-14.4524,78624,0,1896,76728
1/9/22,Senegal,14.4974,-14.4524,79290,0,1898,77392
1/10/22,Senegal,14.4974,-14.4524,79766,0,1899,77867
1/11/22,Senegal,14.4974,-14.4524,80154,0,1901,78253
1/12/22,Senegal,14.4974,-14.4524,80758,0,1901,78857
1/13/22,Senegal,14.4974,-14.4524,81366,0,1903,79463
1/14/22,Senegal,14.4974,-14.4524,81868,0,1904,79964
1/15/22,Senegal,14.4974,-14.4524,82271,0,1908,80363
1/16/22,Senegal,14.4974,-14.4524,82712,0,1908,80804
1/17/22,Senegal,14.4974,-14.4524,82986,0,1909,81077
1/18/22,Senegal,14.4974,-14.4524,83174,0,1912,81262
1/19/22,Senegal,14.4974,-14.4524,83487,0,1913,81574
1/20/22,Senegal,14.4974,-14.4524,83752,0,1917,81835
1/21/22,Senegal,14.4974,-14.4524,83855,0,1921,81934
1/22/22,Senegal,14.4974,-14.4524,84118,0,1923,82195
1/23/22,Senegal,14.4974,-14.4524,84295,0,1925,82370
1/24/22,Senegal,14.4974,-14.4524,84374,0,1929,82445
1/25/22,Senegal,14.4974,-14.4524,84453,0,1933,82520
1/26/22,Senegal,14.4974,-14.4524,84613,0,1937,82676
1/27/22,Senegal,14.4974,-14.4524,84709,0,1939,82770
1/28/22,Senegal,14.4974,-14.4524,84786,0,1941,82845
1/29/22,Senegal,14.4974,-14.4524,84856,0,1941,82915
1/30/22,Senegal,14.4974,-14.4524,84936,0,1944,82992
1/31/22,Senegal,14.4974,-14.4524,84999,0,1946,83053
2/1/22,Senegal,14.4974,-14.4524,85038,0,1949,83089
2/2/22,Senegal,14.4974,-14.4524,85072,0,1949,83123
2/3/22,Senegal,14.4974,-14.4524,85117,0,1950,83167
2/4/22,Senegal,14.4974,-14.4524,85143,0,1953,83190
2/5/22,Senegal,14.4974,-14.4524,85178,0,1955,83223
2/6/22,Senegal,14.4974,-14.4524,85206,0,1956,83250
2/7/22,Senegal,14.4974,-14.4524,85237,0,1956,83281
2/8/22,Senegal,14.4974,-14.4524,85256,0,1956,83300
2/9/22,Senegal,14.4974,-14.4524,85282,0,1956,83326
2/10/22,Senegal,14.4974,-14.4524,85308,0,1956,83352
2/11/22,Senegal,14.4974,-14.4524,85346,0,1956,83390
2/12/22,Senegal,14.4974,-14.4524,85370,0,1956,83414
2/13/22,Senegal,14.4974,-14.4524,85412,0,1957,83455
2/14/22,Senegal,14.4974,-14.4524,85440,0,1957,83483
2/15/22,Senegal,14.4974,-14.4524,85454,0,1957,83497
2/16/22,Senegal,14.4974,-14.4524,85469,0,1957,83512
2/17/22,Senegal,14.4974,-14.4524,85495,0,1958,83537
2/18/22,Senegal,14.4974,-14.4524,85521,0,1958,83563
2/19/22,Senegal,14.4974,-14.4524,85545,0,1958,83587
2/20/22,Senegal,14.4974,-14.4524,85564,0,1958,83606
2/21/22,Senegal,14.4974,-14.4524,85588,0,1958,83630
2/22/22,Senegal,14.4974,-14.4524,85600,0,1959,83641
2/23/22,Senegal,14.4974,-14.4524,85619,0,1960,83659
2/24/22,Senegal,14.4974,-14.4524,85637,0,1960,83677
2/25/22,Senegal,14.4974,-14.4524,85651,0,1960,83691
2/26/22,Senegal,14.4974,-14.4524,85666,0,1960,83706
2/27/22,Senegal,14.4974,-14.4524,85676,0,1960,83716
2/28/22,Senegal,14.4974,-14.4524,85693,0,1960,83733
3/1/22,Senegal,14.4974,-14.4524,85699,0,1960,83739
3/2/22,Senegal,14.4974,-14.4524,85712,0,1960,83752
3/3/22,Senegal,14.4974,-14.4524,85729,0,1960,83769
3/4/22,Senegal,14.4974,-14.4524,85739,0,1961,83778
3/5/22,Senegal,14.4974,-14.4524,85747,0,1961,83786
3/6/22,Senegal,14.4974,-14.4524,85757,0,1961,83796
3/7/22,Senegal,14.4974,-14.4524,85768,0,1962,83806
3/8/22,Senegal,14.4974,-14.4524,85772,0,1962,83810
3/9/22,Senegal,14.4974,-14.4524,85775,0,1962,83813
3/10/22,Senegal,14.4974,-14.4524,85782,0,1962,83820
3/11/22,Senegal,14.4974,-14.4524,85785,0,1964,83821
3/12/22,Senegal,14.4974,-14.4524,85785,0,1964,83821
3/13/22,Senegal,14.4974,-14.4524,85797,0,1964,83833
3/14/22,Senegal,14.4974,-14.4524,85806,0,1964,83842
3/15/22,Senegal,14.4974,-14.4524,85808,0,1964,83844
3/16/22,Senegal,14.4974,-14.4524,85815,0,1964,83851
3/17/22,Senegal,14.4974,-14.4524,85818,0,1964,83854
3/18/22,Senegal,14.4974,-14.4524,85820,0,1964,83856
3/19/22,Senegal,14.4974,-14.4524,85821,0,1964,83857
3/20/22,Senegal,14.4974,-14.4524,85827,0,1964,83863
3/21/22,Senegal,14.4974,-14.4524,85831,0,1964,83867
3/22/22,Senegal,14.4974,-14.4524,85832,0,1964,83868
3/23/22,Senegal,14.4974,-14.4524,85838,0,1988,83850
3/24/22,Senegal,14.4974,-14.4524,85842,0,1964,83878
3/25/22,Senegal,14.4974,-14.4524,85854,0,1964,83890
3/26/22,Senegal,14.4974,-14.4524,85860,0,1964,83896
3/27/22,Senegal,14.4974,-14.4524,85868,0,1964,83904
3/28/22,Senegal,14.4974,-14.4524,85876,0,1964,83912
3/29/22,Senegal,14.4974,-14.4524,85880,0,1964,83916
3/30/22,Senegal,14.4974,-14.4524,85886,0,1964,83922
3/31/22,Senegal,14.4974,-14.4524,85895,0,1964,83931
4/1/22,Senegal,14.4974,-14.4524,85901,0,1964,83937
4/2/22,Senegal,14.4974,-14.4524,85911,0,1964,83947
4/3/22,Senegal,14.4974,-14.4524,85919,0,1965,83954
4/4/22,Senegal,14.4974,-14.4524,85920,0,1965,83955
4/5/22,Senegal,14.4974,-14.4524,85924,0,1965,83959
4/6/22,Senegal,14.4974,-14.4524,85931,0,1965,83966
4/7/22,Senegal,14.4974,-14.4524,85940,0,1965,83975
4/8/22,Senegal,14.4974,-14.4524,85947,0,1965,83982
4/9/22,Senegal,14.4974,-14.4524,85949,0,1965,83984
4/10/22,Senegal,14.4974,-14.4524,85950,0,1965,83985
4/11/22,Senegal,14.4974,-14.4524,85952,0,1965,83987
4/12/22,Senegal,14.4974,-14.4524,85952,0,1965,83987
4/13/22,Senegal,14.4974,-14.4524,85954,0,1965,83989
4/14/22,Senegal,14.4974,-14.4524,85961,0,1965,83996
4/15/22,Senegal,14.4974,-14.4524,85965,0,1965,84000
4/16/22,Senegal,14.4974,-14.4524,85967,0,1965,84002
4/17/22,Senegal,14.4974,-14.4524,85968,0,1965,84003
4/18/22,Senegal,14.4974,-14.4524,85971,0,1965,84006
4/19/22,Senegal,14.4974,-14.4524,85972,0,1965,84007
4/20/22,Senegal,14.4974,-14.4524,85975,0,1965,84010
4/21/22,Senegal,14.4974,-14.4524,85978,0,1965,84013
4/22/22,Senegal,14.4974,-14.4524,85982,0,1965,84017
4/23/22,Senegal,14.4974,-14.4524,85984,0,1966,84018
4/24/22,Senegal,14.4974,-14.4524,85988,0,1967,84021
4/25/22,Senegal,14.4974,-14.4524,85989,0,1967,84022
4/26/22,Senegal,14.4974,-14.4524,85991,0,1967,84024
4/27/22,Senegal,14.4974,-14.4524,85993,0,1967,84026
4/28/22,Senegal,14.4974,-14.4524,85994,0,1967,84027
4/29/22,Senegal,14.4974,-14.4524,85995,0,1967,84028
4/30/22,Senegal,14.4974,-14.4524,85997,0,1967,84030
5/1/22,Senegal,14.4974,-14.4524,85997,0,1967,84030
5/2/22,Senegal,14.4974,-14.4524,86005,0,1966,84039
5/3/22,Senegal,14.4974,-14.4524,86007,0,1966,84041
5/4/22,Senegal,14.4974,-14.4524,86010,0,1966,84044
5/5/22,Senegal,14.4974,-14.4524,86012,0,1966,84046
5/6/22,Senegal,14.4974,-14.4524,86012,0,1966,84046
5/7/22,Senegal,14.4974,-14.4524,86012,0,1966,84046
5/8/22,Senegal,14.4974,-14.4524,86012,0,1966,84046
5/9/22,Senegal,14.4974,-14.4524,86016,0,1966,84050
5/10/22,Senegal,14.4974,-14.4524,86019,0,1966,84053
5/11/22,Senegal,14.4974,-14.4524,86023,0,1966,84057
5/12/22,Senegal,14.4974,-14.4524,86029,0,1966,84063
5/13/22,Senegal,14.4974,-14.4524,86032,0,1966,84066
5/14/22,Senegal,14.4974,-14.4524,86035,0,1966,84069
5/15/22,Senegal,14.4974,-14.4524,86039,0,1966,84073
5/16/22,Senegal,14.4974,-14.4524,86045,0,1966,84079
5/17/22,Senegal,14.4974,-14.4524,86051,0,1966,84085
5/18/22,Senegal,14.4974,-14.4524,86055,0,1966,84089
5/19/22,Senegal,14.4974,-14.4524,86058,0,1966,84092
5/20/22,Senegal,14.4974,-14.4524,86063,0,1966,84097
5/21/22,Senegal,14.4974,-14.4524,86067,0,1966,84101
5/22/22,Senegal,14.4974,-14.4524,86073,0,1966,84107
5/23/22,Senegal,14.4974,-14.4524,86075,0,1966,84109
5/24/22,Senegal,14.4974,-14.4524,86087,0,1966,84121
5/25/22,Senegal,14.4974,-14.4524,86093,0,1966,84127
5/26/22,Senegal,14.4974,-14.4524,86095,0,1966,84129
5/27/22,Senegal,14.4974,-14.4524,86101,0,1966,84135
5/28/22,Senegal,14.4974,-14.4524,86101,0,1966,84135
5/29/22,Senegal,14.4974,-14.4524,86108,0,1966,84142
5/30/22,Senegal,14.4974,-14.4524,86109,0,1966,84143
5/31/22,Senegal,14.4974,-14.4524,86111,0,1966,84145
6/1/22,Senegal,14.4974,-14.4524,86117,0,1966,84151
6/2/22,Senegal,14.4974,-14.4524,86118,0,1966,84152
6/3/22,Senegal,14.4974,-14.4524,86126,0,1966,84160
6/4/22,Senegal,14.4974,-14.4524,86133,0,1966,84167
6/5/22,Senegal,14.4974,-14.4524,86135,0,1967,84168
6/6/22,Senegal,14.4974,-14.4524,86137,0,1967,84170
6/7/22,Senegal,14.4974,-14.4524,86140,0,1967,84173
6/8/22,Senegal,14.4974,-14.4524,86142,0,1967,84175
6/9/22,Senegal,14.4974,-14.4524,86147,0,1967,84180
6/10/22,Senegal,14.4974,-14.4524,86150,0,1967,84183
6/11/22,Senegal,14.4974,-14.4524,86150,0,1967,84183
6/12/22,Senegal,14.4974,-14.4524,86150,0,1967,84183
6/13/22,Senegal,14.4974,-14.4524,86170,0,1967,84203
6/14/22,Senegal,14.4974,-14.4524,86175,0,1967,84208
6/15/22,Senegal,14.4974,-14.4524,86186,0,1968,84218
6/16/22,Senegal,14.4974,-14.4524,86201,0,1968,84233
6/17/22,Senegal,14.4974,-14.4524,86201,0,1968,84233
6/18/22,Senegal,14.4974,-14.4524,86201,0,1968,84233
6/19/22,Senegal,14.4974,-14.4524,86201,0,1968,84233
6/20/22,Senegal,14.4974,-14.4524,86230,0,1968,84262
6/21/22,Senegal,14.4974,-14.4524,86231,0,1968,84263
6/22/22,Senegal,14.4974,-14.4524,86243,0,1968,84275
6/23/22,Senegal,14.4974,-14.4524,86254,0,1968,84286
6/24/22,Senegal,14.4974,-14.4524,86266,0,1968,84298
6/25/22,Senegal,14.4974,-14.4524,86275,0,1968,84307
6/26/22,Senegal,14.4974,-14.4524,86280,0,1968,84312
6/27/22,Senegal,14.4974,-14.4524,86286,0,1968,84318
6/28/22,Senegal,14.4974,-14.4524,86289,0,1968,84321
6/29/22,Senegal,14.4974,-14.4524,86305,0,1968,84337
6/30/22,Senegal,14.4974,-14.4524,86325,0,1968,84357
7/1/22,Senegal,14.4974,-14.4524,86335,0,1968,84367
7/2/22,Senegal,14.4974,-14.4524,86348,0,1968,84380
7/3/22,Senegal,14.4974,-14.4524,86363,0,1968,84395
7/4/22,Senegal,14.4974,-14.4524,86382,0,1968,84414
7/5/22,Senegal,14.4974,-14.4524,86399,0,1968,84431
7/6/22,Senegal,14.4974,-14.4524,86411,0,1968,84443
7/7/22,Senegal,14.4974,-14.4524,86434,0,1968,84466
7/8/22,Senegal,14.4974,-14.4524,86455,0,1968,84487
7/9/22,Senegal,14.4974,-14.4524,86481,0,1968,84513
7/10/22,Senegal,14.4974,-14.4524,86504,0,1968,84536
7/11/22,Senegal,14.4974,-14.4524,86504,0,1968,84536
7/12/22,Senegal,14.4974,-14.4524,86526,0,1968,84558
7/13/22,Senegal,14.4974,-14.4524,86594,0,1968,84626
7/14/22,Senegal,14.4974,-14.4524,86631,0,1968,84663
7/15/22,Senegal,14.4974,-14.4524,86679,0,1968,84711
7/16/22,Senegal,14.4974,-14.4524,86744,0,1968,84776
7/17/22,Senegal,14.4974,-14.4524,86791,0,1968,84823
7/18/22,Senegal,14.4974,-14.4524,86791,0,1968,84823
7/19/22,Senegal,14.4974,-14.4524,86854,0,1968,84886
7/20/22,Senegal,14.4974,-14.4524,86891,0,1968,84923
7/21/22,Senegal,14.4974,-14.4524,86938,0,1968,84970
7/22/22,Senegal,14.4974,-14.4524,86986,0,1968,85018
7/23/22,Senegal,14.4974,-14.4524,86986,0,1968,85018
7/24/22,Senegal,14.4974,-14.4524,87071,0,1968,85103
7/25/22,Senegal,14.4974,-14.4524,87118,0,1968,85150
7/26/22,Senegal,14.4974,-14.4524,87148,0,1968,85180
7/27/22,Senegal,14.4974,-14.4524,87194,0,1968,85226
7/28/22,Senegal,14.4974,-14.4524,87237,0,1968,85269
7/29/22,Senegal,14.4974,-14.4524,87295,0,1968,85327
7/30/22,Senegal,14.4974,-14.4524,87342,0,1968,85374
7/31/22,Senegal,14.4974,-14.4524,87386,0,1968,85418
8/1/22,Senegal,14.4974,-14.4524,87423,0,1968,85455
8/2/22,Senegal,14.4974,-14.4524,87445,0,1968,85477
8/3/22,Senegal,14.4974,-14.4524,87479,0,1968,85511
8/4/22,Senegal,14.4974,-14.4524,87513,0,1968,85545
8/5/22,Senegal,14.4974,-14.4524,87550,0,1968,85582
8/6/22,Senegal,14.4974,-14.4524,87550,0,1968,85582
8/7/22,Senegal,14.4974,-14.4524,87615,0,1968,85647
8/8/22,Senegal,14.4974,-14.4524,87641,0,1968,85673
8/9/22,Senegal,14.4974,-14.4524,87641,0,1968,85673
8/10/22,Senegal,14.4974,-14.4524,87696,0,1968,85728
8/11/22,Senegal,14.4974,-14.4524,87723,0,1968,85755
8/12/22,Senegal,14.4974,-14.4524,87752,0,1968,85784
8/13/22,Senegal,14.4974,-14.4524,87752,0,1968,85784
8/14/22,Senegal,14.4974,-14.4524,87752,0,1968,85784
8/15/22,Senegal,14.4974,-14.4524,87752,0,1968,85784
8/16/22,Senegal,14.4974,-14.4524,87835,0,1968,85867
8/17/22,Senegal,14.4974,-14.4524,87835,0,1968,85867
8/18/22,Senegal,14.4974,-14.4524,87835,0,1968,85867
8/19/22,Senegal,14.4974,-14.4524,87890,0,1968,85922
8/20/22,Senegal,14.4974,-14.4524,87890,0,1968,85922
8/21/22,Senegal,14.4974,-14.4524,87890,0,1968,85922
8/22/22,Senegal,14.4974,-14.4524,87920,0,1968,85952
8/23/22,Senegal,14.4974,-14.4524,87920,0,1968,85952
8/24/22,Senegal,14.4974,-14.4524,87987,0,1968,86019
8/25/22,Senegal,14.4974,-14.4524,87987,0,1968,86019
8/26/22,Senegal,14.4974,-14.4524,88008,0,1968,86040
8/27/22,Senegal,14.4974,-14.4524,88024,0,1968,86056
8/28/22,Senegal,14.4974,-14.4524,88024,0,1968,86056
8/29/22,Senegal,14.4974,-14.4524,88052,0,1968,86084
8/30/22,Senegal,14.4974,-14.4524,88082,0,1968,86114
8/31/22,Senegal,14.4974,-14.4524,88098,0,1968,86130
9/1/22,Senegal,14.4974,-14.4524,88098,0,1968,86130
9/2/22,Senegal,14.4974,-14.4524,88102,0,1968,86134
9/3/22,Senegal,14.4974,-14.4524,88102,0,1968,86134
9/4/22,Senegal,14.4974,-14.4524,88102,0,1968,86134
9/5/22,Senegal,14.4974,-14.4524,88132,0,1968,86164
9/6/22,Senegal,14.4974,-14.4524,88132,0,1968,86164
9/7/22,Senegal,14.4974,-14.4524,88153,0,1968,86185
9/8/22,Senegal,14.4974,-14.4524,88153,0,1968,86185
9/9/22,Senegal,14.4974,-14.4524,88172,0,1968,86204
9/10/22,Senegal,14.4974,-14.4524,88172,0,1968,86204
9/11/22,Senegal,14.4974,-14.4524,88172,0,1968,86204
9/12/22,Senegal,14.4974,-14.4524,88199,0,1968,86231
9/13/22,Senegal,14.4974,-14.4524,88224,0,1968,86256
9/14/22,Senegal,14.4974,-14.4524,88230,0,1968,86262
9/15/22,Senegal,14.4974,-14.4524,88230,0,1968,86262
9/16/22,Senegal,14.4974,-14.4524,88230,0,1968,86262
9/17/22,Senegal,14.4974,-14.4524,88230,0,1968,86262
9/18/22,Senegal,14.4974,-14.4524,88268,0,1968,86300
9/19/22,Senegal,14.4974,-14.4524,88268,0,1968,86300
9/20/22,Senegal,14.4974,-14.4524,88299,0,1968,86331
9/21/22,Senegal,14.4974,-14.4524,88299,0,1968,86331
9/22/22,Senegal,14.4974,-14.4524,88318,0,1968,86350
9/23/22,Senegal,14.4974,-14.4524,88324,0,1968,86356
9/24/22,Senegal,14.4974,-14.4524,88324,0,1968,86356
9/25/22,Senegal,14.4974,-14.4524,88324,0,1968,86356
9/26/22,Senegal,14.4974,-14.4524,88339,0,1968,86371
9/27/22,Senegal,14.4974,-14.4524,88355,0,1968,86387
9/28/22,Senegal,14.4974,-14.4524,88373,0,1968,86405
9/29/22,Senegal,14.4974,-14.4524,88373,0,1968,86405
9/30/22,Senegal,14.4974,-14.4524,88398,0,1968,86430
10/1/22,Senegal,14.4974,-14.4524,88398,0,1968,86430
10/2/22,Senegal,14.4974,-14.4524,88398,0,1968,86430
10/3/22,Senegal,14.4974,-14.4524,88408,0,1968,86440
10/4/22,Senegal,14.4974,-14.4524,88408,0,1968,86440
10/5/22,Senegal,14.4974,-14.4524,88462,0,1968,86494
10/6/22,Senegal,14.4974,-14.4524,88477,0,1968,86509
10/7/22,Senegal,14.4974,-14.4524,88477,0,1968,86509
10/8/22,Senegal,14.4974,-14.4524,88506,0,1968,86538
10/9/22,Senegal,14.4974,-14.4524,88506,0,1968,86538
10/10/22,Senegal,14.4974,-14.4524,88506,0,1968,86538
10/11/22,Senegal,14.4974,-14.4524,88544,0,1968,86576
10/12/22,Senegal,14.4974,-14.4524,88544,0,1968,86576
10/13/22,Senegal,14.4974,-14.4524,88555,0,1968,86587
10/14/22,Senegal,14.4974,-14.4524,88555,0,1968,86587
10/15/22,Senegal,14.4974,-14.4524,88555,0,1968,86587
10/16/22,Senegal,14.4974,-14.4524,88555,0,1968,86587
10/17/22,Senegal,14.4974,-14.4524,88630,0,1968,86662
10/18/22,Senegal,14.4974,-14.4524,88630,0,1968,86662
10/19/22,Senegal,14.4974,-14.4524,88630,0,1968,86662
10/20/22,Senegal,14.4974,-14.4524,88630,0,1968,86662
10/21/22,Senegal,14.4974,-14.4524,88630,0,1968,86662
10/22/22,Senegal,14.4974,-14.4524,88630,0,1968,86662
10/23/22,Senegal,14.4974,-14.4524,88630,0,1968,86662
10/24/22,Senegal,14.4974,-14.4524,88679,0,1968,86711
10/25/22,Senegal,14.4974,-14.4524,88679,0,1968,86711
10/26/22,Senegal,14.4974,-14.4524,88679,0,1968,86711
10/27/22,Senegal,14.4974,-14.4524,88679,0,1968,86711
10/28/22,Senegal,14.4974,-14.4524,88679,0,1968,86711
10/29/22,Senegal,14.4974,-14.4524,88679,0,1968,86711
10/30/22,Senegal,14.4974,-14.4524,88679,0,1968,86711
10/31/22,Senegal,14.4974,-14.4524,88679,0,1968,86711
11/1/22,Senegal,14.4974,-14.4524,88679,0,1968,86711
11/2/22,Senegal,14.4974,-14.4524,88679,0,1968,86711
11/3/22,Senegal,14.4974,-14.4524,88679,0,1968,86711
11/4/22,Senegal,14.4974,-14.4524,88679,0,1968,86711
11/5/22,Senegal,14.4974,-14.4524,88679,0,1968,86711
11/6/22,Senegal,14.4974,-14.4524,88679,0,1968,86711
11/7/22,Senegal,14.4974,-14.4524,88817,0,1968,86849
11/8/22,Senegal,14.4974,-14.4524,88817,0,1968,86849
11/9/22,Senegal,14.4974,-14.4524,88817,0,1968,86849
11/10/22,Senegal,14.4974,-14.4524,88826,0,1968,86858
11/11/22,Senegal,14.4974,-14.4524,88832,0,1968,86864
11/12/22,Senegal,14.4974,-14.4524,88832,0,1968,86864
11/13/22,Senegal,14.4974,-14.4524,88832,0,1968,86864
11/14/22,Senegal,14.4974,-14.4524,88832,0,1968,86864
11/15/22,Senegal,14.4974,-14.4524,88842,0,1968,86874
11/16/22,Senegal,14.4974,-14.4524,88842,0,1968,86874
11/17/22,Senegal,14.4974,-14.4524,88842,0,1968,86874
11/18/22,Senegal,14.4974,-14.4524,88842,0,1968,86874
11/19/22,Senegal,14.4974,-14.4524,88842,0,1968,86874
11/20/22,Senegal,14.4974,-14.4524,88842,0,1968,86874
11/21/22,Senegal,14.4974,-14.4524,88859,0,1968,86891
11/22/22,Senegal,14.4974,-14.4524,88859,0,1968,86891
11/23/22,Senegal,14.4974,-14.4524,88859,0,1968,86891
11/24/22,Senegal,14.4974,-14.4524,88859,0,1968,86891
11/25/22,Senegal,14.4974,-14.4524,88859,0,1968,86891
11/26/22,Senegal,14.4974,-14.4524,88859,0,1968,86891
11/27/22,Senegal,14.4974,-14.4524,88859,0,1968,86891
11/28/22,Senegal,14.4974,-14.4524,88859,0,1968,86891
11/29/22,Senegal,14.4974,-14.4524,88873,0,1968,86905
11/30/22,Senegal,14.4974,-14.4524,88873,0,1968,86905
12/1/22,Senegal,14.4974,-14.4524,88873,0,1968,86905
12/2/22,Senegal,14.4974,-14.4524,88873,0,1968,86905
12/3/22,Senegal,14.4974,-14.4524,88873,0,1968,86905
12/4/22,Senegal,14.4974,-14.4524,88873,0,1968,86905
12/5/22,Senegal,14.4974,-14.4524,88873,0,1968,86905
12/6/22,Senegal,14.4974,-14.4524,88887,0,1968,86919
12/7/22,Senegal,14.4974,-14.4524,88887,0,1968,86919
12/8/22,Senegal,14.4974,-14.4524,88887,0,1968,86919
12/9/22,Senegal,14.4974,-14.4524,88887,0,1968,86919
12/10/22,Senegal,14.4974,-14.4524,88887,0,1968,86919
12/11/22,Senegal,14.4974,-14.4524,88887,0,1968,86919
12/12/22,Senegal,14.4974,-14.4524,88887,0,1968,86919
12/13/22,Senegal,14.4974,-14.4524,88887,0,1968,86919
12/14/22,Senegal,14.4974,-14.4524,88891,0,1968,86923
12/15/22,Senegal,14.4974,-14.4524,88891,0,1968,86923
12/16/22,Senegal,14.4974,-14.4524,88891,0,1968,86923
12/17/22,Senegal,14.4974,-14.4524,88891,0,1968,86923
1/1/22,Serbia,44.0165,21.0059,1300949,0,12739,1288210
1/2/22,Serbia,44.0165,21.0059,1302856,0,12760,1290096
1/3/22,Serbia,44.0165,21.0059,1305621,0,12787,1292834
1/4/22,Serbia,44.0165,21.0059,1310845,0,12806,1298039
1/5/22,Serbia,44.0165,21.0059,1318333,0,12831,1305502
1/6/22,Serbia,44.0165,21.0059,1327455,0,12850,1314605
1/7/22,Serbia,44.0165,21.0059,1334994,0,12867,1322127
1/8/22,Serbia,44.0165,21.0059,1342646,0,12890,1329756
1/9/22,Serbia,44.0165,21.0059,1350595,0,12912,1337683
1/10/22,Serbia,44.0165,21.0059,1359544,0,12936,1346608
1/11/22,Serbia,44.0165,21.0059,1359544,0,12936,1346608
1/12/22,Serbia,44.0165,21.0059,1386114,0,12958,1373156
1/13/22,Serbia,44.0165,21.0059,1399867,0,13003,1386864
1/14/22,Serbia,44.0165,21.0059,1412588,0,13026,1399562
1/15/22,Serbia,44.0165,21.0059,1425147,0,13045,1412102
1/16/22,Serbia,44.0165,21.0059,1436395,0,13071,1423324
1/17/22,Serbia,44.0165,21.0059,1449192,0,13098,1436094
1/18/22,Serbia,44.0165,21.0059,1467198,0,13124,1454074
1/19/22,Serbia,44.0165,21.0059,1484516,0,13152,1471364
1/20/22,Serbia,44.0165,21.0059,1501621,0,13181,1488440
1/21/22,Serbia,44.0165,21.0059,1518024,0,13211,1504813
1/22/22,Serbia,44.0165,21.0059,1532741,0,13239,1519502
1/23/22,Serbia,44.0165,21.0059,1544900,0,13271,1531629
1/24/22,Serbia,44.0165,21.0059,1559946,0,13306,1546640
1/25/22,Serbia,44.0165,21.0059,1579847,0,13340,1566507
1/26/22,Serbia,44.0165,21.0059,1579847,0,13340,1566507
1/27/22,Serbia,44.0165,21.0059,1616584,0,13417,1603167
1/28/22,Serbia,44.0165,21.0059,1633868,0,13459,1620409
1/29/22,Serbia,44.0165,21.0059,1649293,0,13513,1635780
1/30/22,Serbia,44.0165,21.0059,1662446,0,13570,1648876
1/31/22,Serbia,44.0165,21.0059,1677798,0,13629,1664169
2/1/22,Serbia,44.0165,21.0059,1697012,0,13687,1683325
2/2/22,Serbia,44.0165,21.0059,1714863,0,13748,1701115
2/3/22,Serbia,44.0165,21.0059,1730486,0,13807,1716679
2/4/22,Serbia,44.0165,21.0059,1745005,0,13868,1731137
2/5/22,Serbia,44.0165,21.0059,1757741,0,13928,1743813
2/6/22,Serbia,44.0165,21.0059,1768343,0,13991,1754352
2/7/22,Serbia,44.0165,21.0059,1779782,0,14054,1765728
2/8/22,Serbia,44.0165,21.0059,1793554,0,14113,1779441
2/9/22,Serbia,44.0165,21.0059,1806086,0,14171,1791915
2/10/22,Serbia,44.0165,21.0059,1817207,0,14234,1802973
2/11/22,Serbia,44.0165,21.0059,1826787,0,14299,1812488
2/12/22,Serbia,44.0165,21.0059,1834974,0,14366,1820608
2/13/22,Serbia,44.0165,21.0059,1841010,0,14427,1826583
2/14/22,Serbia,44.0165,21.0059,1848040,0,14494,1833546
2/15/22,Serbia,44.0165,21.0059,1855174,0,14553,1840621
2/16/22,Serbia,44.0165,21.0059,1861413,0,14611,1846802
2/17/22,Serbia,44.0165,21.0059,1867836,0,14666,1853170
2/18/22,Serbia,44.0165,21.0059,1874134,0,14728,1859406
2/19/22,Serbia,44.0165,21.0059,1874134,0,14728,1859406
2/20/22,Serbia,44.0165,21.0059,1883113,0,14849,1868264
2/21/22,Serbia,44.0165,21.0059,1887596,0,14904,1872692
2/22/22,Serbia,44.0165,21.0059,1892187,0,14958,1877229
2/23/22,Serbia,44.0165,21.0059,1896575,0,15010,1881565
2/24/22,Serbia,44.0165,21.0059,1900293,0,15059,1885234
2/25/22,Serbia,44.0165,21.0059,1903494,0,15110,1888384
2/26/22,Serbia,44.0165,21.0059,1906142,0,15155,1890987
2/27/22,Serbia,44.0165,21.0059,1908272,0,15199,1893073
2/28/22,Serbia,44.0165,21.0059,1910975,0,15241,1895734
3/1/22,Serbia,44.0165,21.0059,1913861,0,15280,1898581
3/2/22,Serbia,44.0165,21.0059,1916707,0,15315,1901392
3/3/22,Serbia,44.0165,21.0059,1919327,0,15346,1903981
3/4/22,Serbia,44.0165,21.0059,1921831,0,15375,1906456
3/5/22,Serbia,44.0165,21.0059,1923977,0,15405,1908572
3/6/22,Serbia,44.0165,21.0059,1925618,0,15437,1910181
3/7/22,Serbia,44.0165,21.0059,1927849,0,15463,1912386
3/8/22,Serbia,44.0165,21.0059,1930437,0,15488,1914949
3/9/22,Serbia,44.0165,21.0059,1932814,0,15512,1917302
3/10/22,Serbia,44.0165,21.0059,1934953,0,15533,1919420
3/11/22,Serbia,44.0165,21.0059,1937183,0,15552,1921631
3/12/22,Serbia,44.0165,21.0059,1939150,0,15570,1923580
3/13/22,Serbia,44.0165,21.0059,1940516,0,15587,1924929
3/14/22,Serbia,44.0165,21.0059,1942727,0,15604,1927123
3/15/22,Serbia,44.0165,21.0059,1945142,0,15619,1929523
3/16/22,Serbia,44.0165,21.0059,1947591,0,15633,1931958
3/17/22,Serbia,44.0165,21.0059,1949953,0,15647,1934306
3/18/22,Serbia,44.0165,21.0059,1952029,0,15662,1936367
3/19/22,Serbia,44.0165,21.0059,1953897,0,15676,1938221
3/20/22,Serbia,44.0165,21.0059,1955280,0,15687,1939593
3/21/22,Serbia,44.0165,21.0059,1957450,0,15696,1941754
3/22/22,Serbia,44.0165,21.0059,1959699,0,15706,1943993
3/23/22,Serbia,44.0165,21.0059,1962013,0,15718,1946295
3/24/22,Serbia,44.0165,21.0059,1964129,0,15727,1948402
3/25/22,Serbia,44.0165,21.0059,1966078,0,15737,1950341
3/26/22,Serbia,44.0165,21.0059,1967771,0,15746,1952025
3/27/22,Serbia,44.0165,21.0059,1969044,0,15758,1953286
3/28/22,Serbia,44.0165,21.0059,1970827,0,15768,1955059
3/29/22,Serbia,44.0165,21.0059,1972760,0,15779,1956981
3/30/22,Serbia,44.0165,21.0059,1974652,0,15788,1958864
3/31/22,Serbia,44.0165,21.0059,1976567,0,15799,1960768
4/1/22,Serbia,44.0165,21.0059,1978228,0,15809,1962419
4/2/22,Serbia,44.0165,21.0059,1979729,0,15818,1963911
4/3/22,Serbia,44.0165,21.0059,1980722,0,15825,1964897
4/4/22,Serbia,44.0165,21.0059,1982193,0,15834,1966359
4/5/22,Serbia,44.0165,21.0059,1983734,0,15842,1967892
4/6/22,Serbia,44.0165,21.0059,1985085,0,15850,1969235
4/7/22,Serbia,44.0165,21.0059,1986439,0,15862,1970577
4/8/22,Serbia,44.0165,21.0059,1987756,0,15869,1971887
4/9/22,Serbia,44.0165,21.0059,1988716,0,15877,1972839
4/10/22,Serbia,44.0165,21.0059,1989415,0,15884,1973531
4/11/22,Serbia,44.0165,21.0059,1990511,0,15890,1974621
4/12/22,Serbia,44.0165,21.0059,1991620,0,15899,1975721
4/13/22,Serbia,44.0165,21.0059,1992677,0,15906,1976771
4/14/22,Serbia,44.0165,21.0059,1993661,0,15913,1977748
4/15/22,Serbia,44.0165,21.0059,1994623,0,15916,1978707
4/16/22,Serbia,44.0165,21.0059,1995351,0,15923,1979428
4/17/22,Serbia,44.0165,21.0059,1995986,0,15927,1980059
4/18/22,Serbia,44.0165,21.0059,1996868,0,15933,1980935
4/19/22,Serbia,44.0165,21.0059,1997855,0,15936,1981919
4/20/22,Serbia,44.0165,21.0059,1998776,0,15940,1982836
4/21/22,Serbia,44.0165,21.0059,1999753,0,15945,1983808
4/22/22,Serbia,44.0165,21.0059,2000516,0,15948,1984568
4/23/22,Serbia,44.0165,21.0059,2001144,0,15953,1985191
4/24/22,Serbia,44.0165,21.0059,2001654,0,15956,1985698
4/25/22,Serbia,44.0165,21.0059,2002353,0,15960,1986393
4/26/22,Serbia,44.0165,21.0059,2003334,0,15969,1987365
4/27/22,Serbia,44.0165,21.0059,2004255,0,15976,1988279
4/28/22,Serbia,44.0165,21.0059,2005072,0,15980,1989092
4/29/22,Serbia,44.0165,21.0059,2005832,0,15984,1989848
4/30/22,Serbia,44.0165,21.0059,2006353,0,15991,1990362
5/1/22,Serbia,44.0165,21.0059,2006695,0,15999,1990696
5/2/22,Serbia,44.0165,21.0059,2007091,0,16002,1991089
5/3/22,Serbia,44.0165,21.0059,2007554,0,16007,1991547
5/4/22,Serbia,44.0165,21.0059,2008143,0,16013,1992130
5/5/22,Serbia,44.0165,21.0059,2008740,0,16015,1992725
5/6/22,Serbia,44.0165,21.0059,2009249,0,16019,1993230
5/7/22,Serbia,44.0165,21.0059,2009677,0,16024,1993653
5/8/22,Serbia,44.0165,21.0059,2009979,0,16028,1993951
5/9/22,Serbia,44.0165,21.0059,2010495,0,16033,1994462
5/10/22,Serbia,44.0165,21.0059,2010495,0,16037,1994458
5/11/22,Serbia,44.0165,21.0059,2011399,0,16037,1995362
5/12/22,Serbia,44.0165,21.0059,2011825,0,16042,1995783
5/13/22,Serbia,44.0165,21.0059,2012270,0,16045,1996225
5/14/22,Serbia,44.0165,21.0059,2012597,0,16046,1996551
5/15/22,Serbia,44.0165,21.0059,2012836,0,16049,1996787
5/16/22,Serbia,44.0165,21.0059,2013240,0,16050,1997190
5/17/22,Serbia,44.0165,21.0059,2013622,0,16053,1997569
5/18/22,Serbia,44.0165,21.0059,2013983,0,16055,1997928
5/19/22,Serbia,44.0165,21.0059,2014317,0,16057,1998260
5/20/22,Serbia,44.0165,21.0059,2014653,0,16060,1998593
5/21/22,Serbia,44.0165,21.0059,2014900,0,16063,1998837
5/22/22,Serbia,44.0165,21.0059,2015086,0,16065,1999021
5/23/22,Serbia,44.0165,21.0059,2015382,0,16068,1999314
5/24/22,Serbia,44.0165,21.0059,2015711,0,16070,1999641
5/25/22,Serbia,44.0165,21.0059,2016002,0,16074,1999928
5/26/22,Serbia,44.0165,21.0059,2016266,0,16076,2000190
5/27/22,Serbia,44.0165,21.0059,2016576,0,16077,2000499
5/28/22,Serbia,44.0165,21.0059,2016793,0,16078,2000715
5/29/22,Serbia,44.0165,21.0059,2016921,0,16079,2000842
5/30/22,Serbia,44.0165,21.0059,2017189,0,16080,2001109
5/31/22,Serbia,44.0165,21.0059,2017454,0,16081,2001373
6/1/22,Serbia,44.0165,21.0059,2017703,0,16083,2001620
6/2/22,Serbia,44.0165,21.0059,2017945,0,16083,2001862
6/3/22,Serbia,44.0165,21.0059,2018216,0,16085,2002131
6/4/22,Serbia,44.0165,21.0059,2018437,0,16087,2002350
6/5/22,Serbia,44.0165,21.0059,2018609,0,16088,2002521
6/6/22,Serbia,44.0165,21.0059,2018890,0,16091,2002799
6/7/22,Serbia,44.0165,21.0059,2019171,0,16094,2003077
6/8/22,Serbia,44.0165,21.0059,2019429,0,16096,2003333
6/9/22,Serbia,44.0165,21.0059,2019706,0,16096,2003610
6/10/22,Serbia,44.0165,21.0059,2019978,0,16098,2003880
6/11/22,Serbia,44.0165,21.0059,2020173,0,16099,2004074
6/12/22,Serbia,44.0165,21.0059,2020338,0,16101,2004237
6/13/22,Serbia,44.0165,21.0059,2020596,0,16101,2004495
6/14/22,Serbia,44.0165,21.0059,2020952,0,16103,2004849
6/15/22,Serbia,44.0165,21.0059,2021264,0,16105,2005159
6/16/22,Serbia,44.0165,21.0059,2021601,0,16105,2005496
6/17/22,Serbia,44.0165,21.0059,2021926,0,16106,2005820
6/18/22,Serbia,44.0165,21.0059,2022252,0,16108,2006144
6/19/22,Serbia,44.0165,21.0059,2022494,0,16109,2006385
6/20/22,Serbia,44.0165,21.0059,2022902,0,16112,2006790
6/21/22,Serbia,44.0165,21.0059,2023409,0,16113,2007296
6/22/22,Serbia,44.0165,21.0059,2023889,0,16118,2007771
6/23/22,Serbia,44.0165,21.0059,2024455,0,16119,2008336
6/24/22,Serbia,44.0165,21.0059,2025042,0,16120,2008922
6/25/22,Serbia,44.0165,21.0059,2025577,0,16120,2009457
6/26/22,Serbia,44.0165,21.0059,2026045,0,16121,2009924
6/27/22,Serbia,44.0165,21.0059,2026796,0,16124,2010672
6/28/22,Serbia,44.0165,21.0059,2027606,0,16125,2011481
6/29/22,Serbia,44.0165,21.0059,2028482,0,16125,2012357
6/30/22,Serbia,44.0165,21.0059,2029403,0,16126,2013277
7/1/22,Serbia,44.0165,21.0059,2030363,0,16126,2014237
7/2/22,Serbia,44.0165,21.0059,2031171,0,16129,2015042
7/3/22,Serbia,44.0165,21.0059,2031920,0,16131,2015789
7/4/22,Serbia,44.0165,21.0059,2033180,0,16132,2017048
7/5/22,Serbia,44.0165,21.0059,2034544,0,16135,2018409
7/6/22,Serbia,44.0165,21.0059,2035878,0,16138,2019740
7/7/22,Serbia,44.0165,21.0059,2037347,0,16141,2021206
7/8/22,Serbia,44.0165,21.0059,2038946,0,16146,2022800
7/9/22,Serbia,44.0165,21.0059,2040227,0,16147,2024080
7/10/22,Serbia,44.0165,21.0059,2041175,0,16150,2025025
7/11/22,Serbia,44.0165,21.0059,2043051,0,16152,2026899
7/12/22,Serbia,44.0165,21.0059,2045101,0,16155,2028946
7/13/22,Serbia,44.0165,21.0059,2047170,0,16158,2031012
7/14/22,Serbia,44.0165,21.0059,2049388,0,16162,2033226
7/15/22,Serbia,44.0165,21.0059,2052116,0,16166,2035950
7/16/22,Serbia,44.0165,21.0059,2054636,0,16168,2038468
7/17/22,Serbia,44.0165,21.0059,2056691,0,16169,2040522
7/18/22,Serbia,44.0165,21.0059,2059982,0,16173,2043809
7/19/22,Serbia,44.0165,21.0059,2063894,0,16178,2047716
7/20/22,Serbia,44.0165,21.0059,2067840,0,16185,2051655
7/21/22,Serbia,44.0165,21.0059,2072089,0,16193,2055896
7/22/22,Serbia,44.0165,21.0059,2076589,0,16199,2060390
7/23/22,Serbia,44.0165,21.0059,2080389,0,16206,2064183
7/24/22,Serbia,44.0165,21.0059,2083861,0,16215,2067646
7/25/22,Serbia,44.0165,21.0059,2088966,0,16223,2072743
7/26/22,Serbia,44.0165,21.0059,2095066,0,16229,2078837
7/27/22,Serbia,44.0165,21.0059,2101168,0,16239,2084929
7/28/22,Serbia,44.0165,21.0059,2107150,0,16253,2090897
7/29/22,Serbia,44.0165,21.0059,2113101,0,16265,2096836
7/30/22,Serbia,44.0165,21.0059,2118673,0,16271,2102402
7/31/22,Serbia,44.0165,21.0059,2123025,0,16280,2106745
8/1/22,Serbia,44.0165,21.0059,2129016,0,16286,2112730
8/2/22,Serbia,44.0165,21.0059,2135952,0,16296,2119656
8/3/22,Serbia,44.0165,21.0059,2142148,0,16313,2125835
8/4/22,Serbia,44.0165,21.0059,2148615,0,16319,2132296
8/5/22,Serbia,44.0165,21.0059,2154973,0,16334,2138639
8/6/22,Serbia,44.0165,21.0059,2160253,0,16347,2143906
8/7/22,Serbia,44.0165,21.0059,2164435,0,16356,2148079
8/8/22,Serbia,44.0165,21.0059,2170933,0,16370,2154563
8/9/22,Serbia,44.0165,21.0059,2178198,0,16380,2161818
8/10/22,Serbia,44.0165,21.0059,2185259,0,16394,2168865
8/11/22,Serbia,44.0165,21.0059,2191562,0,16409,2175153
8/12/22,Serbia,44.0165,21.0059,2197784,0,16424,2181360
8/13/22,Serbia,44.0165,21.0059,2203039,0,16438,2186601
8/14/22,Serbia,44.0165,21.0059,2206806,0,16449,2190357
8/15/22,Serbia,44.0165,21.0059,2212702,0,16463,2196239
8/16/22,Serbia,44.0165,21.0059,2212702,0,16481,2196221
8/17/22,Serbia,44.0165,21.0059,2225382,0,16491,2208891
8/18/22,Serbia,44.0165,21.0059,2231095,0,16503,2214592
8/19/22,Serbia,44.0165,21.0059,2236301,0,16509,2219792
8/20/22,Serbia,44.0165,21.0059,2240552,0,16525,2224027
8/21/22,Serbia,44.0165,21.0059,2243706,0,16536,2227170
8/22/22,Serbia,44.0165,21.0059,2248288,0,16545,2231743
8/23/22,Serbia,44.0165,21.0059,2253282,0,16561,2236721
8/24/22,Serbia,44.0165,21.0059,2257659,0,16574,2241085
8/25/22,Serbia,44.0165,21.0059,2261899,0,16593,2245306
8/26/22,Serbia,44.0165,21.0059,2265924,0,16616,2249308
8/27/22,Serbia,44.0165,21.0059,2269421,0,16631,2252790
8/28/22,Serbia,44.0165,21.0059,2272000,0,16643,2255357
8/29/22,Serbia,44.0165,21.0059,2275675,0,16657,2259018
8/30/22,Serbia,44.0165,21.0059,2279485,0,16672,2262813
8/31/22,Serbia,44.0165,21.0059,2283195,0,16684,2266511
9/1/22,Serbia,44.0165,21.0059,2286511,0,16695,2269816
9/2/22,Serbia,44.0165,21.0059,2289516,0,16707,2272809
9/3/22,Serbia,44.0165,21.0059,2292170,0,16718,2275452
9/4/22,Serbia,44.0165,21.0059,2294006,0,16737,2277269
9/5/22,Serbia,44.0165,21.0059,2297227,0,16750,2280477
9/6/22,Serbia,44.0165,21.0059,2300688,0,16765,2283923
9/7/22,Serbia,44.0165,21.0059,2304039,0,16779,2287260
9/8/22,Serbia,44.0165,21.0059,2307305,0,16786,2290519
9/9/22,Serbia,44.0165,21.0059,2310601,0,16794,2293807
9/10/22,Serbia,44.0165,21.0059,2313346,0,16809,2296537
9/11/22,Serbia,44.0165,21.0059,2315536,0,16822,2298714
9/12/22,Serbia,44.0165,21.0059,2318677,0,16829,2301848
9/13/22,Serbia,44.0165,21.0059,2321849,0,16837,2305012
9/14/22,Serbia,44.0165,21.0059,2324719,0,16846,2307873
9/15/22,Serbia,44.0165,21.0059,2327601,0,16855,2310746
9/16/22,Serbia,44.0165,21.0059,2330341,0,16865,2313476
9/17/22,Serbia,44.0165,21.0059,2332509,0,16874,2315635
9/18/22,Serbia,44.0165,21.0059,2333969,0,16882,2317087
9/19/22,Serbia,44.0165,21.0059,2336368,0,16891,2319477
9/20/22,Serbia,44.0165,21.0059,2338834,0,16902,2321932
9/21/22,Serbia,44.0165,21.0059,2341269,0,16913,2324356
9/22/22,Serbia,44.0165,21.0059,2343470,0,16922,2326548
9/23/22,Serbia,44.0165,21.0059,2345665,0,16931,2328734
9/24/22,Serbia,44.0165,21.0059,2347506,0,16940,2330566
9/25/22,Serbia,44.0165,21.0059,2349040,0,16950,2332090
9/26/22,Serbia,44.0165,21.0059,2351526,0,16960,2334566
9/27/22,Serbia,44.0165,21.0059,2354273,0,16974,2337299
9/28/22,Serbia,44.0165,21.0059,2356982,0,16983,2339999
9/29/22,Serbia,44.0165,21.0059,2359530,0,17000,2342530
9/30/22,Serbia,44.0165,21.0059,2361738,0,17006,2344732
10/1/22,Serbia,44.0165,21.0059,2363388,0,17012,2346376
10/2/22,Serbia,44.0165,21.0059,2364814,0,17018,2347796
10/3/22,Serbia,44.0165,21.0059,2367015,0,17031,2349984
10/4/22,Serbia,44.0165,21.0059,2369245,0,17042,2352203
10/5/22,Serbia,44.0165,21.0059,2371474,0,17050,2354424
10/6/22,Serbia,44.0165,21.0059,2373346,0,17057,2356289
10/7/22,Serbia,44.0165,21.0059,2375224,0,17066,2358158
10/8/22,Serbia,44.0165,21.0059,2376699,0,17077,2359622
10/9/22,Serbia,44.0165,21.0059,2377762,0,17086,2360676
10/10/22,Serbia,44.0165,21.0059,2379620,0,17093,2362527
10/11/22,Serbia,44.0165,21.0059,2381680,0,17099,2364581
10/12/22,Serbia,44.0165,21.0059,2383411,0,17108,2366303
10/13/22,Serbia,44.0165,21.0059,2385062,0,17117,2367945
10/14/22,Serbia,44.0165,21.0059,2386508,0,17122,2369386
10/15/22,Serbia,44.0165,21.0059,2387682,0,17128,2370554
10/16/22,Serbia,44.0165,21.0059,2388554,0,17134,2371420
10/17/22,Serbia,44.0165,21.0059,2389987,0,17144,2372843
10/18/22,Serbia,44.0165,21.0059,2391427,0,17154,2374273
10/19/22,Serbia,44.0165,21.0059,2392745,0,17162,2375583
10/20/22,Serbia,44.0165,21.0059,2393928,0,17169,2376759
10/21/22,Serbia,44.0165,21.0059,2394984,0,17171,2377813
10/22/22,Serbia,44.0165,21.0059,2395887,0,17176,2378711
10/23/22,Serbia,44.0165,21.0059,2396512,0,17186,2379326
10/24/22,Serbia,44.0165,21.0059,2397685,0,17193,2380492
10/25/22,Serbia,44.0165,21.0059,2398900,0,17199,2381701
10/26/22,Serbia,44.0165,21.0059,2400037,0,17209,2382828
10/27/22,Serbia,44.0165,21.0059,2400037,0,17209,2382828
10/28/22,Serbia,44.0165,21.0059,2401945,0,17220,2384725
10/29/22,Serbia,44.0165,21.0059,2402754,0,17228,2385526
10/30/22,Serbia,44.0165,21.0059,2403249,0,17235,2386014
10/31/22,Serbia,44.0165,21.0059,2404112,0,17242,2386870
11/1/22,Serbia,44.0165,21.0059,2405146,0,17250,2387896
11/2/22,Serbia,44.0165,21.0059,2406002,0,17256,2388746
11/3/22,Serbia,44.0165,21.0059,2406834,0,17261,2389573
11/4/22,Serbia,44.0165,21.0059,2407595,0,17270,2390325
11/5/22,Serbia,44.0165,21.0059,2408130,0,17275,2390855
11/6/22,Serbia,44.0165,21.0059,2408606,0,17283,2391323
11/7/22,Serbia,44.0165,21.0059,2409415,0,17290,2392125
11/8/22,Serbia,44.0165,21.0059,2410231,0,17294,2392937
11/9/22,Serbia,44.0165,21.0059,2410954,0,17298,2393656
11/10/22,Serbia,44.0165,21.0059,2411691,0,17301,2394390
11/11/22,Serbia,44.0165,21.0059,2412298,0,17303,2394995
11/12/22,Serbia,44.0165,21.0059,2412750,0,17308,2395442
11/13/22,Serbia,44.0165,21.0059,2413142,0,17310,2395832
11/14/22,Serbia,44.0165,21.0059,2413933,0,17314,2396619
11/15/22,Serbia,44.0165,21.0059,2414734,0,17324,2397410
11/16/22,Serbia,44.0165,21.0059,2415439,0,17326,2398113
11/17/22,Serbia,44.0165,21.0059,2416113,0,17332,2398781
11/18/22,Serbia,44.0165,21.0059,2416771,0,17336,2399435
11/19/22,Serbia,44.0165,21.0059,2416771,0,17336,2399435
11/20/22,Serbia,44.0165,21.0059,2416771,0,17336,2399435
11/21/22,Serbia,44.0165,21.0059,2418306,0,17347,2400959
11/22/22,Serbia,44.0165,21.0059,2418973,0,17350,2401623
11/23/22,Serbia,44.0165,21.0059,2419618,0,17352,2402266
11/24/22,Serbia,44.0165,21.0059,2420189,0,17353,2402836
11/25/22,Serbia,44.0165,21.0059,2420801,0,17357,2403444
11/26/22,Serbia,44.0165,21.0059,2421274,0,17365,2403909
11/27/22,Serbia,44.0165,21.0059,2421591,0,17371,2404220
11/28/22,Serbia,44.0165,21.0059,2422181,0,17374,2404807
11/29/22,Serbia,44.0165,21.0059,2422813,0,17382,2405431
11/30/22,Serbia,44.0165,21.0059,2423385,0,17387,2405998
12/1/22,Serbia,44.0165,21.0059,2424048,0,17392,2406656
12/2/22,Serbia,44.0165,21.0059,2424595,0,17395,2407200
12/3/22,Serbia,44.0165,21.0059,2425077,0,17399,2407678
12/4/22,Serbia,44.0165,21.0059,2425445,0,17404,2408041
12/5/22,Serbia,44.0165,21.0059,2426176,0,17412,2408764
12/6/22,Serbia,44.0165,21.0059,2426848,0,17418,2409430
12/7/22,Serbia,44.0165,21.0059,2427599,0,17420,2410179
12/8/22,Serbia,44.0165,21.0059,2428291,0,17426,2410865
12/9/22,Serbia,44.0165,21.0059,2428978,0,17429,2411549
12/10/22,Serbia,44.0165,21.0059,2429520,0,17433,2412087
12/11/22,Serbia,44.0165,21.0059,2429910,0,17438,2412472
12/12/22,Serbia,44.0165,21.0059,2430656,0,17441,2413215
12/13/22,Serbia,44.0165,21.0059,2440825,0,17449,2423376
12/14/22,Serbia,44.0165,21.0059,2432186,0,17451,2414735
12/15/22,Serbia,44.0165,21.0059,2432914,0,17451,2415463
12/16/22,Serbia,44.0165,21.0059,2433648,0,17459,2416189
12/17/22,Serbia,44.0165,21.0059,2434277,0,17465,2416812
1/1/22,Seychelles,-4.6796,55.492,24788,0,134,24654
1/2/22,Seychelles,-4.6796,55.492,24788,0,134,24654
1/3/22,Seychelles,-4.6796,55.492,24788,0,134,24654
1/4/22,Seychelles,-4.6796,55.492,25610,0,134,25476
1/5/22,Seychelles,-4.6796,55.492,26255,0,134,26121
1/6/22,Seychelles,-4.6796,55.492,26968,0,134,26834
1/7/22,Seychelles,-4.6796,55.492,26968,0,134,26834
1/8/22,Seychelles,-4.6796,55.492,26968,0,134,26834
1/9/22,Seychelles,-4.6796,55.492,26968,0,134,26834
1/10/22,Seychelles,-4.6796,55.492,29030,0,134,28896
1/11/22,Seychelles,-4.6796,55.492,29030,0,134,28896
1/12/22,Seychelles,-4.6796,55.492,29030,0,134,28896
1/13/22,Seychelles,-4.6796,55.492,31098,0,136,30962
1/14/22,Seychelles,-4.6796,55.492,31098,0,136,30962
1/15/22,Seychelles,-4.6796,55.492,31098,0,136,30962
1/16/22,Seychelles,-4.6796,55.492,31098,0,136,30962
1/17/22,Seychelles,-4.6796,55.492,32846,0,140,32706
1/18/22,Seychelles,-4.6796,55.492,32846,0,140,32706
1/19/22,Seychelles,-4.6796,55.492,32850,0,140,32710
1/20/22,Seychelles,-4.6796,55.492,34367,0,143,34224
1/21/22,Seychelles,-4.6796,55.492,34367,0,143,34224
1/22/22,Seychelles,-4.6796,55.492,34367,0,143,34224
1/23/22,Seychelles,-4.6796,55.492,34367,0,143,34224
1/24/22,Seychelles,-4.6796,55.492,35178,0,143,35035
1/25/22,Seychelles,-4.6796,55.492,35606,0,143,35463
1/26/22,Seychelles,-4.6796,55.492,35606,0,143,35463
1/27/22,Seychelles,-4.6796,55.492,36559,0,149,36410
1/28/22,Seychelles,-4.6796,55.492,36559,0,149,36410
1/29/22,Seychelles,-4.6796,55.492,36559,0,149,36410
1/30/22,Seychelles,-4.6796,55.492,36559,0,149,36410
1/31/22,Seychelles,-4.6796,55.492,37190,0,154,37036
2/1/22,Seychelles,-4.6796,55.492,37190,0,154,37036
2/2/22,Seychelles,-4.6796,55.492,37194,0,154,37040
2/3/22,Seychelles,-4.6796,55.492,37771,0,154,37617
2/4/22,Seychelles,-4.6796,55.492,37771,0,154,37617
2/5/22,Seychelles,-4.6796,55.492,37771,0,154,37617
2/6/22,Seychelles,-4.6796,55.492,37771,0,154,37617
2/7/22,Seychelles,-4.6796,55.492,38120,0,157,37963
2/8/22,Seychelles,-4.6796,55.492,38124,0,157,37967
2/9/22,Seychelles,-4.6796,55.492,38293,0,157,38136
2/10/22,Seychelles,-4.6796,55.492,38293,0,157,38136
2/11/22,Seychelles,-4.6796,55.492,38395,0,157,38238
2/12/22,Seychelles,-4.6796,55.492,38395,0,157,38238
2/13/22,Seychelles,-4.6796,55.492,38395,0,157,38238
2/14/22,Seychelles,-4.6796,55.492,38659,0,157,38502
2/15/22,Seychelles,-4.6796,55.492,38766,0,159,38607
2/16/22,Seychelles,-4.6796,55.492,38829,0,159,38670
2/17/22,Seychelles,-4.6796,55.492,38916,0,159,38757
2/18/22,Seychelles,-4.6796,55.492,38916,0,159,38757
2/19/22,Seychelles,-4.6796,55.492,38916,0,159,38757
2/20/22,Seychelles,-4.6796,55.492,38916,0,159,38757
2/21/22,Seychelles,-4.6796,55.492,39181,0,160,39021
2/22/22,Seychelles,-4.6796,55.492,39181,0,160,39021
2/23/22,Seychelles,-4.6796,55.492,39181,0,160,39021
2/24/22,Seychelles,-4.6796,55.492,39251,0,160,39091
2/25/22,Seychelles,-4.6796,55.492,39251,0,160,39091
2/26/22,Seychelles,-4.6796,55.492,39251,0,160,39091
2/27/22,Seychelles,-4.6796,55.492,39251,0,160,39091
2/28/22,Seychelles,-4.6796,55.492,39336,0,163,39173
3/1/22,Seychelles,-4.6796,55.492,39403,0,163,39240
3/2/22,Seychelles,-4.6796,55.492,39403,0,163,39240
3/3/22,Seychelles,-4.6796,55.492,39408,0,163,39245
3/4/22,Seychelles,-4.6796,55.492,39427,0,163,39264
3/5/22,Seychelles,-4.6796,55.492,39427,0,163,39264
3/6/22,Seychelles,-4.6796,55.492,39427,0,163,39264
3/7/22,Seychelles,-4.6796,55.492,39427,0,163,39264
3/8/22,Seychelles,-4.6796,55.492,39605,0,163,39442
3/9/22,Seychelles,-4.6796,55.492,39605,0,163,39442
3/10/22,Seychelles,-4.6796,55.492,39605,0,163,39442
3/11/22,Seychelles,-4.6796,55.492,39605,0,163,39442
3/12/22,Seychelles,-4.6796,55.492,39605,0,163,39442
3/13/22,Seychelles,-4.6796,55.492,39605,0,163,39442
3/14/22,Seychelles,-4.6796,55.492,39653,0,163,39490
3/15/22,Seychelles,-4.6796,55.492,39761,0,163,39598
3/16/22,Seychelles,-4.6796,55.492,39761,0,163,39598
3/17/22,Seychelles,-4.6796,55.492,39771,0,163,39608
3/18/22,Seychelles,-4.6796,55.492,39797,0,163,39634
3/19/22,Seychelles,-4.6796,55.492,39797,0,163,39634
3/20/22,Seychelles,-4.6796,55.492,39797,0,163,39634
3/21/22,Seychelles,-4.6796,55.492,39883,0,163,39720
3/22/22,Seychelles,-4.6796,55.492,39991,0,163,39828
3/23/22,Seychelles,-4.6796,55.492,39991,0,163,39828
3/24/22,Seychelles,-4.6796,55.492,40009,0,163,39846
3/25/22,Seychelles,-4.6796,55.492,40044,0,163,39881
3/26/22,Seychelles,-4.6796,55.492,40044,0,163,39881
3/27/22,Seychelles,-4.6796,55.492,40044,0,163,39881
3/28/22,Seychelles,-4.6796,55.492,40209,0,164,40045
3/29/22,Seychelles,-4.6796,55.492,40209,0,164,40045
3/30/22,Seychelles,-4.6796,55.492,40421,0,164,40257
3/31/22,Seychelles,-4.6796,55.492,40421,0,164,40257
4/1/22,Seychelles,-4.6796,55.492,40421,0,164,40257
4/2/22,Seychelles,-4.6796,55.492,40421,0,164,40257
4/3/22,Seychelles,-4.6796,55.492,40421,0,164,40257
4/4/22,Seychelles,-4.6796,55.492,40866,0,164,40702
4/5/22,Seychelles,-4.6796,55.492,40866,0,164,40702
4/6/22,Seychelles,-4.6796,55.492,40866,0,164,40702
4/7/22,Seychelles,-4.6796,55.492,40866,0,164,40702
4/8/22,Seychelles,-4.6796,55.492,41059,0,164,40895
4/9/22,Seychelles,-4.6796,55.492,41059,0,164,40895
4/10/22,Seychelles,-4.6796,55.492,41059,0,164,40895
4/11/22,Seychelles,-4.6796,55.492,41147,0,164,40983
4/12/22,Seychelles,-4.6796,55.492,41147,0,164,40983
4/13/22,Seychelles,-4.6796,55.492,41234,0,164,41070
4/14/22,Seychelles,-4.6796,55.492,41660,0,164,41496
4/15/22,Seychelles,-4.6796,55.492,41660,0,164,41496
4/16/22,Seychelles,-4.6796,55.492,41660,0,164,41496
4/17/22,Seychelles,-4.6796,55.492,41660,0,164,41496
4/18/22,Seychelles,-4.6796,55.492,41660,0,164,41496
4/19/22,Seychelles,-4.6796,55.492,41660,0,164,41496
4/20/22,Seychelles,-4.6796,55.492,41660,0,164,41496
4/21/22,Seychelles,-4.6796,55.492,42079,0,165,41914
4/22/22,Seychelles,-4.6796,55.492,42079,0,165,41914
4/23/22,Seychelles,-4.6796,55.492,42079,0,165,41914
4/24/22,Seychelles,-4.6796,55.492,42079,0,165,41914
4/25/22,Seychelles,-4.6796,55.492,42236,0,165,42071
4/26/22,Seychelles,-4.6796,55.492,42474,0,166,42308
4/27/22,Seychelles,-4.6796,55.492,42474,0,166,42308
4/28/22,Seychelles,-4.6796,55.492,42502,0,166,42336
4/29/22,Seychelles,-4.6796,55.492,42502,0,166,42336
4/30/22,Seychelles,-4.6796,55.492,42502,0,166,42336
5/1/22,Seychelles,-4.6796,55.492,42502,0,166,42336
5/2/22,Seychelles,-4.6796,55.492,42548,0,166,42382
5/3/22,Seychelles,-4.6796,55.492,42548,0,166,42382
5/4/22,Seychelles,-4.6796,55.492,42690,0,166,42524
5/5/22,Seychelles,-4.6796,55.492,42841,0,166,42675
5/6/22,Seychelles,-4.6796,55.492,42841,0,166,42675
5/7/22,Seychelles,-4.6796,55.492,42841,0,166,42675
5/8/22,Seychelles,-4.6796,55.492,42841,0,166,42675
5/9/22,Seychelles,-4.6796,55.492,42841,0,166,42675
5/10/22,Seychelles,-4.6796,55.492,42841,0,166,42675
5/11/22,Seychelles,-4.6796,55.492,43235,0,167,43068
5/12/22,Seychelles,-4.6796,55.492,43235,0,167,43068
5/13/22,Seychelles,-4.6796,55.492,43387,0,167,43220
5/14/22,Seychelles,-4.6796,55.492,43387,0,167,43220
5/15/22,Seychelles,-4.6796,55.492,43387,0,167,43220
5/16/22,Seychelles,-4.6796,55.492,43387,0,167,43220
5/17/22,Seychelles,-4.6796,55.492,43473,0,167,43306
5/18/22,Seychelles,-4.6796,55.492,43563,0,167,43396
5/19/22,Seychelles,-4.6796,55.492,43632,0,167,43465
5/20/22,Seychelles,-4.6796,55.492,43729,0,167,43562
5/21/22,Seychelles,-4.6796,55.492,43729,0,167,43562
5/22/22,Seychelles,-4.6796,55.492,43729,0,167,43562
5/23/22,Seychelles,-4.6796,55.492,43729,0,167,43562
5/24/22,Seychelles,-4.6796,55.492,43776,0,167,43609
5/25/22,Seychelles,-4.6796,55.492,43776,0,167,43609
5/26/22,Seychelles,-4.6796,55.492,43889,0,167,43722
5/27/22,Seychelles,-4.6796,55.492,43959,0,167,43792
5/28/22,Seychelles,-4.6796,55.492,43959,0,167,43792
5/29/22,Seychelles,-4.6796,55.492,43959,0,167,43792
5/30/22,Seychelles,-4.6796,55.492,44016,0,167,43849
5/31/22,Seychelles,-4.6796,55.492,44016,0,167,43849
6/1/22,Seychelles,-4.6796,55.492,44016,0,167,43849
6/2/22,Seychelles,-4.6796,55.492,44089,0,167,43922
6/3/22,Seychelles,-4.6796,55.492,44145,0,167,43978
6/4/22,Seychelles,-4.6796,55.492,44145,0,167,43978
6/5/22,Seychelles,-4.6796,55.492,44145,0,167,43978
6/6/22,Seychelles,-4.6796,55.492,44199,0,167,44032
6/7/22,Seychelles,-4.6796,55.492,44199,0,167,44032
6/8/22,Seychelles,-4.6796,55.492,44199,0,167,44032
6/9/22,Seychelles,-4.6796,55.492,44199,0,167,44032
6/10/22,Seychelles,-4.6796,55.492,44363,0,167,44196
6/11/22,Seychelles,-4.6796,55.492,44363,0,167,44196
6/12/22,Seychelles,-4.6796,55.492,44363,0,167,44196
6/13/22,Seychelles,-4.6796,55.492,44363,0,167,44196
6/14/22,Seychelles,-4.6796,55.492,44397,0,167,44230
6/15/22,Seychelles,-4.6796,55.492,44397,0,167,44230
6/16/22,Seychelles,-4.6796,55.492,44397,0,167,44230
6/17/22,Seychelles,-4.6796,55.492,44521,0,167,44354
6/18/22,Seychelles,-4.6796,55.492,44521,0,167,44354
6/19/22,Seychelles,-4.6796,55.492,44521,0,167,44354
6/20/22,Seychelles,-4.6796,55.492,44521,0,167,44354
6/21/22,Seychelles,-4.6796,55.492,44521,0,167,44354
6/22/22,Seychelles,-4.6796,55.492,44669,0,167,44502
6/23/22,Seychelles,-4.6796,55.492,44669,0,167,44502
6/24/22,Seychelles,-4.6796,55.492,44669,0,167,44502
6/25/22,Seychelles,-4.6796,55.492,44669,0,167,44502
6/26/22,Seychelles,-4.6796,55.492,44669,0,167,44502
6/27/22,Seychelles,-4.6796,55.492,44669,0,167,44502
6/28/22,Seychelles,-4.6796,55.492,44669,0,167,44502
6/29/22,Seychelles,-4.6796,55.492,44669,0,167,44502
6/30/22,Seychelles,-4.6796,55.492,44669,0,167,44502
7/1/22,Seychelles,-4.6796,55.492,44847,0,167,44680
7/2/22,Seychelles,-4.6796,55.492,44847,0,167,44680
7/3/22,Seychelles,-4.6796,55.492,44847,0,167,44680
7/4/22,Seychelles,-4.6796,55.492,44847,0,167,44680
7/5/22,Seychelles,-4.6796,55.492,44932,0,167,44765
7/6/22,Seychelles,-4.6796,55.492,45000,0,167,44833
7/7/22,Seychelles,-4.6796,55.492,45000,0,167,44833
7/8/22,Seychelles,-4.6796,55.492,45000,0,167,44833
7/9/22,Seychelles,-4.6796,55.492,45000,0,167,44833
7/10/22,Seychelles,-4.6796,55.492,45000,0,167,44833
7/11/22,Seychelles,-4.6796,55.492,45000,0,167,44833
7/12/22,Seychelles,-4.6796,55.492,45076,0,167,44909
7/13/22,Seychelles,-4.6796,55.492,45076,0,167,44909
7/14/22,Seychelles,-4.6796,55.492,45185,0,167,45018
7/15/22,Seychelles,-4.6796,55.492,45185,0,167,45018
7/16/22,Seychelles,-4.6796,55.492,45185,0,167,45018
7/17/22,Seychelles,-4.6796,55.492,45185,0,167,45018
7/18/22,Seychelles,-4.6796,55.492,45233,0,168,45065
7/19/22,Seychelles,-4.6796,55.492,45269,0,168,45101
7/20/22,Seychelles,-4.6796,55.492,45269,0,168,45101
7/21/22,Seychelles,-4.6796,55.492,45269,0,168,45101
7/22/22,Seychelles,-4.6796,55.492,45269,0,168,45101
7/23/22,Seychelles,-4.6796,55.492,45269,0,168,45101
7/24/22,Seychelles,-4.6796,55.492,45269,0,168,45101
7/25/22,Seychelles,-4.6796,55.492,45429,0,168,45261
7/26/22,Seychelles,-4.6796,55.492,45429,0,168,45261
7/27/22,Seychelles,-4.6796,55.492,45429,0,168,45261
7/28/22,Seychelles,-4.6796,55.492,45429,0,168,45261
7/29/22,Seychelles,-4.6796,55.492,45429,0,168,45261
7/30/22,Seychelles,-4.6796,55.492,45429,0,168,45261
7/31/22,Seychelles,-4.6796,55.492,45429,0,168,45261
8/1/22,Seychelles,-4.6796,55.492,45429,0,168,45261
8/2/22,Seychelles,-4.6796,55.492,45540,0,168,45372
8/3/22,Seychelles,-4.6796,55.492,45540,0,168,45372
8/4/22,Seychelles,-4.6796,55.492,45540,0,168,45372
8/5/22,Seychelles,-4.6796,55.492,45540,0,168,45372
8/6/22,Seychelles,-4.6796,55.492,45540,0,168,45372
8/7/22,Seychelles,-4.6796,55.492,45540,0,168,45372
8/8/22,Seychelles,-4.6796,55.492,45692,0,168,45524
8/9/22,Seychelles,-4.6796,55.492,45692,0,168,45524
8/10/22,Seychelles,-4.6796,55.492,45692,0,168,45524
8/11/22,Seychelles,-4.6796,55.492,45692,0,168,45524
8/12/22,Seychelles,-4.6796,55.492,45692,0,168,45524
8/13/22,Seychelles,-4.6796,55.492,45692,0,168,45524
8/14/22,Seychelles,-4.6796,55.492,45692,0,168,45524
8/15/22,Seychelles,-4.6796,55.492,45692,0,168,45524
8/16/22,Seychelles,-4.6796,55.492,45852,0,168,45684
8/17/22,Seychelles,-4.6796,55.492,45852,0,168,45684
8/18/22,Seychelles,-4.6796,55.492,45852,0,168,45684
8/19/22,Seychelles,-4.6796,55.492,45852,0,168,45684
8/20/22,Seychelles,-4.6796,55.492,45852,0,168,45684
8/21/22,Seychelles,-4.6796,55.492,45852,0,168,45684
8/22/22,Seychelles,-4.6796,55.492,45852,0,168,45684
8/23/22,Seychelles,-4.6796,55.492,45852,0,168,45684
8/24/22,Seychelles,-4.6796,55.492,45852,0,168,45684
8/25/22,Seychelles,-4.6796,55.492,45852,0,168,45684
8/26/22,Seychelles,-4.6796,55.492,45852,0,168,45684
8/27/22,Seychelles,-4.6796,55.492,45852,0,168,45684
8/28/22,Seychelles,-4.6796,55.492,45852,0,168,45684
8/29/22,Seychelles,-4.6796,55.492,45852,0,168,45684
8/30/22,Seychelles,-4.6796,55.492,46081,0,169,45912
8/31/22,Seychelles,-4.6796,55.492,46081,0,169,45912
9/1/22,Seychelles,-4.6796,55.492,46081,0,169,45912
9/2/22,Seychelles,-4.6796,55.492,46081,0,169,45912
9/3/22,Seychelles,-4.6796,55.492,46081,0,169,45912
9/4/22,Seychelles,-4.6796,55.492,46081,0,169,45912
9/5/22,Seychelles,-4.6796,55.492,46081,0,169,45912
9/6/22,Seychelles,-4.6796,55.492,46175,0,169,46006
9/7/22,Seychelles,-4.6796,55.492,46175,0,169,46006
9/8/22,Seychelles,-4.6796,55.492,46175,0,169,46006
9/9/22,Seychelles,-4.6796,55.492,46175,0,169,46006
9/10/22,Seychelles,-4.6796,55.492,46175,0,169,46006
9/11/22,Seychelles,-4.6796,55.492,46175,0,169,46006
9/12/22,Seychelles,-4.6796,55.492,46358,0,169,46189
9/13/22,Seychelles,-4.6796,55.492,46358,0,169,46189
9/14/22,Seychelles,-4.6796,55.492,46358,0,169,46189
9/15/22,Seychelles,-4.6796,55.492,46358,0,169,46189
9/16/22,Seychelles,-4.6796,55.492,46358,0,169,46189
9/17/22,Seychelles,-4.6796,55.492,46358,0,169,46189
9/18/22,Seychelles,-4.6796,55.492,46358,0,169,46189
9/19/22,Seychelles,-4.6796,55.492,46358,0,169,46189
9/20/22,Seychelles,-4.6796,55.492,46358,0,169,46189
9/21/22,Seychelles,-4.6796,55.492,46358,0,169,46189
9/22/22,Seychelles,-4.6796,55.492,46358,0,169,46189
9/23/22,Seychelles,-4.6796,55.492,46358,0,169,46189
9/24/22,Seychelles,-4.6796,55.492,46358,0,169,46189
9/25/22,Seychelles,-4.6796,55.492,46358,0,169,46189
9/26/22,Seychelles,-4.6796,55.492,46358,0,169,46189
9/27/22,Seychelles,-4.6796,55.492,46358,0,169,46189
9/28/22,Seychelles,-4.6796,55.492,46358,0,169,46189
9/29/22,Seychelles,-4.6796,55.492,47141,0,169,46972
9/30/22,Seychelles,-4.6796,55.492,47141,0,169,46972
10/1/22,Seychelles,-4.6796,55.492,47141,0,169,46972
10/2/22,Seychelles,-4.6796,55.492,47141,0,169,46972
10/3/22,Seychelles,-4.6796,55.492,47141,0,169,46972
10/4/22,Seychelles,-4.6796,55.492,47141,0,169,46972
10/5/22,Seychelles,-4.6796,55.492,47141,0,169,46972
10/6/22,Seychelles,-4.6796,55.492,47141,0,169,46972
10/7/22,Seychelles,-4.6796,55.492,47141,0,169,46972
10/8/22,Seychelles,-4.6796,55.492,47141,0,169,46972
10/9/22,Seychelles,-4.6796,55.492,47141,0,169,46972
10/10/22,Seychelles,-4.6796,55.492,47141,0,169,46972
10/11/22,Seychelles,-4.6796,55.492,47141,0,169,46972
10/12/22,Seychelles,-4.6796,55.492,47141,0,169,46972
10/13/22,Seychelles,-4.6796,55.492,47141,0,169,46972
10/14/22,Seychelles,-4.6796,55.492,47141,0,169,46972
10/15/22,Seychelles,-4.6796,55.492,47141,0,169,46972
10/16/22,Seychelles,-4.6796,55.492,47141,0,169,46972
10/17/22,Seychelles,-4.6796,55.492,47141,0,170,46971
10/18/22,Seychelles,-4.6796,55.492,47141,0,170,46971
10/19/22,Seychelles,-4.6796,55.492,47141,0,170,46971
10/20/22,Seychelles,-4.6796,55.492,47141,0,170,46971
10/21/22,Seychelles,-4.6796,55.492,47141,0,170,46971
10/22/22,Seychelles,-4.6796,55.492,47141,0,170,46971
10/23/22,Seychelles,-4.6796,55.492,47141,0,170,46971
10/24/22,Seychelles,-4.6796,55.492,48183,0,170,48013
10/25/22,Seychelles,-4.6796,55.492,49035,0,171,48864
10/26/22,Seychelles,-4.6796,55.492,49035,0,171,48864
10/27/22,Seychelles,-4.6796,55.492,49035,0,171,48864
10/28/22,Seychelles,-4.6796,55.492,49035,0,171,48864
10/29/22,Seychelles,-4.6796,55.492,49035,0,171,48864
10/30/22,Seychelles,-4.6796,55.492,49035,0,171,48864
10/31/22,Seychelles,-4.6796,55.492,49035,0,171,48864
11/1/22,Seychelles,-4.6796,55.492,49035,0,171,48864
11/2/22,Seychelles,-4.6796,55.492,49035,0,171,48864
11/3/22,Seychelles,-4.6796,55.492,49035,0,171,48864
11/4/22,Seychelles,-4.6796,55.492,49380,0,171,49209
11/5/22,Seychelles,-4.6796,55.492,49380,0,171,49209
11/6/22,Seychelles,-4.6796,55.492,49380,0,171,49209
11/7/22,Seychelles,-4.6796,55.492,49380,0,171,49209
11/8/22,Seychelles,-4.6796,55.492,49380,0,171,49209
11/9/22,Seychelles,-4.6796,55.492,49380,0,171,49209
11/10/22,Seychelles,-4.6796,55.492,49380,0,171,49209
11/11/22,Seychelles,-4.6796,55.492,49380,0,171,49209
11/12/22,Seychelles,-4.6796,55.492,49380,0,171,49209
11/13/22,Seychelles,-4.6796,55.492,49380,0,171,49209
11/14/22,Seychelles,-4.6796,55.492,49380,0,171,49209
11/15/22,Seychelles,-4.6796,55.492,49380,0,171,49209
11/16/22,Seychelles,-4.6796,55.492,49380,0,171,49209
11/17/22,Seychelles,-4.6796,55.492,49380,0,171,49209
11/18/22,Seychelles,-4.6796,55.492,49380,0,171,49209
11/19/22,Seychelles,-4.6796,55.492,49380,0,171,49209
11/20/22,Seychelles,-4.6796,55.492,49380,0,171,49209
11/21/22,Seychelles,-4.6796,55.492,49380,0,171,49209
11/22/22,Seychelles,-4.6796,55.492,49380,0,171,49209
11/23/22,Seychelles,-4.6796,55.492,49862,0,171,49691
11/24/22,Seychelles,-4.6796,55.492,49862,0,171,49691
11/25/22,Seychelles,-4.6796,55.492,49862,0,171,49691
11/26/22,Seychelles,-4.6796,55.492,49862,0,171,49691
11/27/22,Seychelles,-4.6796,55.492,49862,0,171,49691
11/28/22,Seychelles,-4.6796,55.492,49862,0,171,49691
11/29/22,Seychelles,-4.6796,55.492,50068,0,171,49897
11/30/22,Seychelles,-4.6796,55.492,50068,0,171,49897
12/1/22,Seychelles,-4.6796,55.492,50068,0,171,49897
12/2/22,Seychelles,-4.6796,55.492,50068,0,171,49897
12/3/22,Seychelles,-4.6796,55.492,50068,0,171,49897
12/4/22,Seychelles,-4.6796,55.492,50068,0,171,49897
12/5/22,Seychelles,-4.6796,55.492,50068,0,171,49897
12/6/22,Seychelles,-4.6796,55.492,50068,0,171,49897
12/7/22,Seychelles,-4.6796,55.492,50068,0,171,49897
12/8/22,Seychelles,-4.6796,55.492,50068,0,171,49897
12/9/22,Seychelles,-4.6796,55.492,50068,0,171,49897
12/10/22,Seychelles,-4.6796,55.492,50068,0,171,49897
12/11/22,Seychelles,-4.6796,55.492,50068,0,171,49897
12/12/22,Seychelles,-4.6796,55.492,50068,0,171,49897
12/13/22,Seychelles,-4.6796,55.492,50068,0,171,49897
12/14/22,Seychelles,-4.6796,55.492,50355,0,172,50183
12/15/22,Seychelles,-4.6796,55.492,50355,0,172,50183
12/16/22,Seychelles,-4.6796,55.492,50355,0,172,50183
12/17/22,Seychelles,-4.6796,55.492,50355,0,172,50183
1/1/22,Sierra Leone,8.460555,-11.779889,7114,0,123,6991
1/2/22,Sierra Leone,8.460555,-11.779889,7179,0,123,7056
1/3/22,Sierra Leone,8.460555,-11.779889,7220,0,123,7097
1/4/22,Sierra Leone,8.460555,-11.779889,7268,0,123,7145
1/5/22,Sierra Leone,8.460555,-11.779889,7308,0,123,7185
1/6/22,Sierra Leone,8.460555,-11.779889,7352,0,123,7229
1/7/22,Sierra Leone,8.460555,-11.779889,7382,0,123,7259
1/8/22,Sierra Leone,8.460555,-11.779889,7405,0,124,7281
1/9/22,Sierra Leone,8.460555,-11.779889,7448,0,124,7324
1/10/22,Sierra Leone,8.460555,-11.779889,7454,0,125,7329
1/11/22,Sierra Leone,8.460555,-11.779889,7454,0,125,7329
1/12/22,Sierra Leone,8.460555,-11.779889,7493,0,125,7368
1/13/22,Sierra Leone,8.460555,-11.779889,7500,0,125,7375
1/14/22,Sierra Leone,8.460555,-11.779889,7500,0,125,7375
1/15/22,Sierra Leone,8.460555,-11.779889,7529,0,125,7404
1/16/22,Sierra Leone,8.460555,-11.779889,7542,0,125,7417
1/17/22,Sierra Leone,8.460555,-11.779889,7544,0,125,7419
1/18/22,Sierra Leone,8.460555,-11.779889,7558,0,125,7433
1/19/22,Sierra Leone,8.460555,-11.779889,7562,0,125,7437
1/20/22,Sierra Leone,8.460555,-11.779889,7567,0,125,7442
1/21/22,Sierra Leone,8.460555,-11.779889,7572,0,125,7447
1/22/22,Sierra Leone,8.460555,-11.779889,7584,0,125,7459
1/23/22,Sierra Leone,8.460555,-11.779889,7590,0,125,7465
1/24/22,Sierra Leone,8.460555,-11.779889,7593,0,125,7468
1/25/22,Sierra Leone,8.460555,-11.779889,7607,0,125,7482
1/26/22,Sierra Leone,8.460555,-11.779889,7608,0,125,7483
1/27/22,Sierra Leone,8.460555,-11.779889,7611,0,125,7486
1/28/22,Sierra Leone,8.460555,-11.779889,7612,0,125,7487
1/29/22,Sierra Leone,8.460555,-11.779889,7615,0,125,7490
1/30/22,Sierra Leone,8.460555,-11.779889,7622,0,125,7497
1/31/22,Sierra Leone,8.460555,-11.779889,7623,0,125,7498
2/1/22,Sierra Leone,8.460555,-11.779889,7623,0,125,7498
2/2/22,Sierra Leone,8.460555,-11.779889,7625,0,125,7500
2/3/22,Sierra Leone,8.460555,-11.779889,7625,0,125,7500
2/4/22,Sierra Leone,8.460555,-11.779889,7627,0,125,7502
2/5/22,Sierra Leone,8.460555,-11.779889,7627,0,125,7502
2/6/22,Sierra Leone,8.460555,-11.779889,7628,0,125,7503
2/7/22,Sierra Leone,8.460555,-11.779889,7628,0,125,7503
2/8/22,Sierra Leone,8.460555,-11.779889,7637,0,125,7512
2/9/22,Sierra Leone,8.460555,-11.779889,7638,0,125,7513
2/10/22,Sierra Leone,8.460555,-11.779889,7648,0,125,7523
2/11/22,Sierra Leone,8.460555,-11.779889,7648,0,125,7523
2/12/22,Sierra Leone,8.460555,-11.779889,7652,0,125,7527
2/13/22,Sierra Leone,8.460555,-11.779889,7652,0,125,7527
2/14/22,Sierra Leone,8.460555,-11.779889,7652,0,125,7527
2/15/22,Sierra Leone,8.460555,-11.779889,7659,0,125,7534
2/16/22,Sierra Leone,8.460555,-11.779889,7661,0,125,7536
2/17/22,Sierra Leone,8.460555,-11.779889,7661,0,125,7536
2/18/22,Sierra Leone,8.460555,-11.779889,7661,0,125,7536
2/19/22,Sierra Leone,8.460555,-11.779889,7663,0,125,7538
2/20/22,Sierra Leone,8.460555,-11.779889,7663,0,125,7538
2/21/22,Sierra Leone,8.460555,-11.779889,7663,0,125,7538
2/22/22,Sierra Leone,8.460555,-11.779889,7663,0,125,7538
2/23/22,Sierra Leone,8.460555,-11.779889,7663,0,125,7538
2/24/22,Sierra Leone,8.460555,-11.779889,7665,0,125,7540
2/25/22,Sierra Leone,8.460555,-11.779889,7665,0,125,7540
2/26/22,Sierra Leone,8.460555,-11.779889,7665,0,125,7540
2/27/22,Sierra Leone,8.460555,-11.779889,7665,0,125,7540
2/28/22,Sierra Leone,8.460555,-11.779889,7665,0,125,7540
3/1/22,Sierra Leone,8.460555,-11.779889,7665,0,125,7540
3/2/22,Sierra Leone,8.460555,-11.779889,7665,0,125,7540
3/3/22,Sierra Leone,8.460555,-11.779889,7665,0,125,7540
3/4/22,Sierra Leone,8.460555,-11.779889,7665,0,125,7540
3/5/22,Sierra Leone,8.460555,-11.779889,7665,0,125,7540
3/6/22,Sierra Leone,8.460555,-11.779889,7665,0,125,7540
3/7/22,Sierra Leone,8.460555,-11.779889,7666,0,125,7541
3/8/22,Sierra Leone,8.460555,-11.779889,7666,0,125,7541
3/9/22,Sierra Leone,8.460555,-11.779889,7666,0,125,7541
3/10/22,Sierra Leone,8.460555,-11.779889,7667,0,125,7542
3/11/22,Sierra Leone,8.460555,-11.779889,7667,0,125,7542
3/12/22,Sierra Leone,8.460555,-11.779889,7667,0,125,7542
3/13/22,Sierra Leone,8.460555,-11.779889,7667,0,125,7542
3/14/22,Sierra Leone,8.460555,-11.779889,7668,0,125,7543
3/15/22,Sierra Leone,8.460555,-11.779889,7670,0,125,7545
3/16/22,Sierra Leone,8.460555,-11.779889,7670,0,125,7545
3/17/22,Sierra Leone,8.460555,-11.779889,7670,0,125,7545
3/18/22,Sierra Leone,8.460555,-11.779889,7673,0,125,7548
3/19/22,Sierra Leone,8.460555,-11.779889,7673,0,125,7548
3/20/22,Sierra Leone,8.460555,-11.779889,7674,0,125,7549
3/21/22,Sierra Leone,8.460555,-11.779889,7674,0,125,7549
3/22/22,Sierra Leone,8.460555,-11.779889,7674,0,125,7549
3/23/22,Sierra Leone,8.460555,-11.779889,7674,0,125,7549
3/24/22,Sierra Leone,8.460555,-11.779889,7674,0,125,7549
3/25/22,Sierra Leone,8.460555,-11.779889,7674,0,125,7549
3/26/22,Sierra Leone,8.460555,-11.779889,7674,0,125,7549
3/27/22,Sierra Leone,8.460555,-11.779889,7674,0,125,7549
3/28/22,Sierra Leone,8.460555,-11.779889,7674,0,125,7549
3/29/22,Sierra Leone,8.460555,-11.779889,7674,0,125,7549
3/30/22,Sierra Leone,8.460555,-11.779889,7674,0,125,7549
3/31/22,Sierra Leone,8.460555,-11.779889,7674,0,125,7549
4/1/22,Sierra Leone,8.460555,-11.779889,7674,0,125,7549
4/2/22,Sierra Leone,8.460555,-11.779889,7674,0,125,7549
4/3/22,Sierra Leone,8.460555,-11.779889,7674,0,125,7549
4/4/22,Sierra Leone,8.460555,-11.779889,7675,0,125,7550
4/5/22,Sierra Leone,8.460555,-11.779889,7675,0,125,7550
4/6/22,Sierra Leone,8.460555,-11.779889,7675,0,125,7550
4/7/22,Sierra Leone,8.460555,-11.779889,7675,0,125,7550
4/8/22,Sierra Leone,8.460555,-11.779889,7675,0,125,7550
4/9/22,Sierra Leone,8.460555,-11.779889,7677,0,125,7552
4/10/22,Sierra Leone,8.460555,-11.779889,7677,0,125,7552
4/11/22,Sierra Leone,8.460555,-11.779889,7677,0,125,7552
4/12/22,Sierra Leone,8.460555,-11.779889,7677,0,125,7552
4/13/22,Sierra Leone,8.460555,-11.779889,7677,0,125,7552
4/14/22,Sierra Leone,8.460555,-11.779889,7681,0,125,7556
4/15/22,Sierra Leone,8.460555,-11.779889,7681,0,125,7556
4/16/22,Sierra Leone,8.460555,-11.779889,7681,0,125,7556
4/17/22,Sierra Leone,8.460555,-11.779889,7681,0,125,7556
4/18/22,Sierra Leone,8.460555,-11.779889,7681,0,125,7556
4/19/22,Sierra Leone,8.460555,-11.779889,7681,0,125,7556
4/20/22,Sierra Leone,8.460555,-11.779889,7681,0,125,7556
4/21/22,Sierra Leone,8.460555,-11.779889,7681,0,125,7556
4/22/22,Sierra Leone,8.460555,-11.779889,7681,0,125,7556
4/23/22,Sierra Leone,8.460555,-11.779889,7681,0,125,7556
4/24/22,Sierra Leone,8.460555,-11.779889,7681,0,125,7556
4/25/22,Sierra Leone,8.460555,-11.779889,7681,0,125,7556
4/26/22,Sierra Leone,8.460555,-11.779889,7681,0,125,7556
4/27/22,Sierra Leone,8.460555,-11.779889,7681,0,125,7556
4/28/22,Sierra Leone,8.460555,-11.779889,7681,0,125,7556
4/29/22,Sierra Leone,8.460555,-11.779889,7681,0,125,7556
4/30/22,Sierra Leone,8.460555,-11.779889,7681,0,125,7556
5/1/22,Sierra Leone,8.460555,-11.779889,7681,0,125,7556
5/2/22,Sierra Leone,8.460555,-11.779889,7681,0,125,7556
5/3/22,Sierra Leone,8.460555,-11.779889,7681,0,125,7556
5/4/22,Sierra Leone,8.460555,-11.779889,7681,0,125,7556
5/5/22,Sierra Leone,8.460555,-11.779889,7681,0,125,7556
5/6/22,Sierra Leone,8.460555,-11.779889,7682,0,125,7557
5/7/22,Sierra Leone,8.460555,-11.779889,7682,0,125,7557
5/8/22,Sierra Leone,8.460555,-11.779889,7682,0,125,7557
5/9/22,Sierra Leone,8.460555,-11.779889,7682,0,125,7557
5/10/22,Sierra Leone,8.460555,-11.779889,7682,0,125,7557
5/11/22,Sierra Leone,8.460555,-11.779889,7682,0,125,7557
5/12/22,Sierra Leone,8.460555,-11.779889,7682,0,125,7557
5/13/22,Sierra Leone,8.460555,-11.779889,7682,0,125,7557
5/14/22,Sierra Leone,8.460555,-11.779889,7682,0,125,7557
5/15/22,Sierra Leone,8.460555,-11.779889,7682,0,125,7557
5/16/22,Sierra Leone,8.460555,-11.779889,7682,0,125,7557
5/17/22,Sierra Leone,8.460555,-11.779889,7682,0,125,7557
5/18/22,Sierra Leone,8.460555,-11.779889,7682,0,125,7557
5/19/22,Sierra Leone,8.460555,-11.779889,7682,0,125,7557
5/20/22,Sierra Leone,8.460555,-11.779889,7682,0,125,7557
5/21/22,Sierra Leone,8.460555,-11.779889,7682,0,125,7557
5/22/22,Sierra Leone,8.460555,-11.779889,7682,0,125,7557
5/23/22,Sierra Leone,8.460555,-11.779889,7682,0,125,7557
5/24/22,Sierra Leone,8.460555,-11.779889,7682,0,125,7557
5/25/22,Sierra Leone,8.460555,-11.779889,7682,0,125,7557
5/26/22,Sierra Leone,8.460555,-11.779889,7682,0,125,7557
5/27/22,Sierra Leone,8.460555,-11.779889,7682,0,125,7557
5/28/22,Sierra Leone,8.460555,-11.779889,7682,0,125,7557
5/29/22,Sierra Leone,8.460555,-11.779889,7682,0,125,7557
5/30/22,Sierra Leone,8.460555,-11.779889,7682,0,125,7557
5/31/22,Sierra Leone,8.460555,-11.779889,7682,0,125,7557
6/1/22,Sierra Leone,8.460555,-11.779889,7682,0,125,7557
6/2/22,Sierra Leone,8.460555,-11.779889,7682,0,125,7557
6/3/22,Sierra Leone,8.460555,-11.779889,7682,0,125,7557
6/4/22,Sierra Leone,8.460555,-11.779889,7682,0,125,7557
6/5/22,Sierra Leone,8.460555,-11.779889,7682,0,125,7557
6/6/22,Sierra Leone,8.460555,-11.779889,7682,0,125,7557
6/7/22,Sierra Leone,8.460555,-11.779889,7682,0,125,7557
6/8/22,Sierra Leone,8.460555,-11.779889,7683,0,125,7558
6/9/22,Sierra Leone,8.460555,-11.779889,7683,0,125,7558
6/10/22,Sierra Leone,8.460555,-11.779889,7683,0,125,7558
6/11/22,Sierra Leone,8.460555,-11.779889,7683,0,125,7558
6/12/22,Sierra Leone,8.460555,-11.779889,7684,0,125,7559
6/13/22,Sierra Leone,8.460555,-11.779889,7685,0,125,7560
6/14/22,Sierra Leone,8.460555,-11.779889,7685,0,125,7560
6/15/22,Sierra Leone,8.460555,-11.779889,7685,0,125,7560
6/16/22,Sierra Leone,8.460555,-11.779889,7685,0,125,7560
6/17/22,Sierra Leone,8.460555,-11.779889,7688,0,125,7563
6/18/22,Sierra Leone,8.460555,-11.779889,7688,0,125,7563
6/19/22,Sierra Leone,8.460555,-11.779889,7688,0,125,7563
6/20/22,Sierra Leone,8.460555,-11.779889,7688,0,125,7563
6/21/22,Sierra Leone,8.460555,-11.779889,7688,0,125,7563
6/22/22,Sierra Leone,8.460555,-11.779889,7693,0,125,7568
6/23/22,Sierra Leone,8.460555,-11.779889,7693,0,125,7568
6/24/22,Sierra Leone,8.460555,-11.779889,7693,0,125,7568
6/25/22,Sierra Leone,8.460555,-11.779889,7693,0,125,7568
6/26/22,Sierra Leone,8.460555,-11.779889,7694,0,125,7569
6/27/22,Sierra Leone,8.460555,-11.779889,7694,0,125,7569
6/28/22,Sierra Leone,8.460555,-11.779889,7695,0,125,7570
6/29/22,Sierra Leone,8.460555,-11.779889,7695,0,125,7570
6/30/22,Sierra Leone,8.460555,-11.779889,7695,0,125,7570
7/1/22,Sierra Leone,8.460555,-11.779889,7697,0,125,7572
7/2/22,Sierra Leone,8.460555,-11.779889,7702,0,125,7577
7/3/22,Sierra Leone,8.460555,-11.779889,7702,0,125,7577
7/4/22,Sierra Leone,8.460555,-11.779889,7704,0,125,7579
7/5/22,Sierra Leone,8.460555,-11.779889,7704,0,125,7579
7/6/22,Sierra Leone,8.460555,-11.779889,7707,0,125,7582
7/7/22,Sierra Leone,8.460555,-11.779889,7713,0,125,7588
7/8/22,Sierra Leone,8.460555,-11.779889,7716,0,125,7591
7/9/22,Sierra Leone,8.460555,-11.779889,7718,0,125,7593
7/10/22,Sierra Leone,8.460555,-11.779889,7718,0,125,7593
7/11/22,Sierra Leone,8.460555,-11.779889,7718,0,125,7593
7/12/22,Sierra Leone,8.460555,-11.779889,7718,0,125,7593
7/13/22,Sierra Leone,8.460555,-11.779889,7718,0,125,7593
7/14/22,Sierra Leone,8.460555,-11.779889,7718,0,125,7593
7/15/22,Sierra Leone,8.460555,-11.779889,7721,0,125,7596
7/16/22,Sierra Leone,8.460555,-11.779889,7722,0,125,7597
7/17/22,Sierra Leone,8.460555,-11.779889,7722,0,125,7597
7/18/22,Sierra Leone,8.460555,-11.779889,7722,0,125,7597
7/19/22,Sierra Leone,8.460555,-11.779889,7725,0,125,7600
7/20/22,Sierra Leone,8.460555,-11.779889,7725,0,125,7600
7/21/22,Sierra Leone,8.460555,-11.779889,7725,0,125,7600
7/22/22,Sierra Leone,8.460555,-11.779889,7725,0,125,7600
7/23/22,Sierra Leone,8.460555,-11.779889,7728,0,125,7603
7/24/22,Sierra Leone,8.460555,-11.779889,7729,0,125,7604
7/25/22,Sierra Leone,8.460555,-11.779889,7729,0,125,7604
7/26/22,Sierra Leone,8.460555,-11.779889,7729,0,125,7604
7/27/22,Sierra Leone,8.460555,-11.779889,7731,0,125,7606
7/28/22,Sierra Leone,8.460555,-11.779889,7732,0,125,7607
7/29/22,Sierra Leone,8.460555,-11.779889,7732,0,125,7607
7/30/22,Sierra Leone,8.460555,-11.779889,7733,0,125,7608
7/31/22,Sierra Leone,8.460555,-11.779889,7734,0,125,7609
8/1/22,Sierra Leone,8.460555,-11.779889,7734,0,125,7609
8/2/22,Sierra Leone,8.460555,-11.779889,7734,0,125,7609
8/3/22,Sierra Leone,8.460555,-11.779889,7735,0,125,7610
8/4/22,Sierra Leone,8.460555,-11.779889,7736,0,125,7611
8/5/22,Sierra Leone,8.460555,-11.779889,7737,0,125,7612
8/6/22,Sierra Leone,8.460555,-11.779889,7737,0,125,7612
8/7/22,Sierra Leone,8.460555,-11.779889,7737,0,125,7612
8/8/22,Sierra Leone,8.460555,-11.779889,7738,0,125,7613
8/9/22,Sierra Leone,8.460555,-11.779889,7740,0,125,7615
8/10/22,Sierra Leone,8.460555,-11.779889,7740,0,125,7615
8/11/22,Sierra Leone,8.460555,-11.779889,7740,0,125,7615
8/12/22,Sierra Leone,8.460555,-11.779889,7740,0,126,7614
8/13/22,Sierra Leone,8.460555,-11.779889,7740,0,126,7614
8/14/22,Sierra Leone,8.460555,-11.779889,7741,0,126,7615
8/15/22,Sierra Leone,8.460555,-11.779889,7742,0,126,7616
8/16/22,Sierra Leone,8.460555,-11.779889,7742,0,126,7616
8/17/22,Sierra Leone,8.460555,-11.779889,7743,0,126,7617
8/18/22,Sierra Leone,8.460555,-11.779889,7743,0,126,7617
8/19/22,Sierra Leone,8.460555,-11.779889,7743,0,126,7617
8/20/22,Sierra Leone,8.460555,-11.779889,7744,0,126,7618
8/21/22,Sierra Leone,8.460555,-11.779889,7744,0,126,7618
8/22/22,Sierra Leone,8.460555,-11.779889,7744,0,126,7618
8/23/22,Sierra Leone,8.460555,-11.779889,7744,0,126,7618
8/24/22,Sierra Leone,8.460555,-11.779889,7744,0,126,7618
8/25/22,Sierra Leone,8.460555,-11.779889,7744,0,126,7618
8/26/22,Sierra Leone,8.460555,-11.779889,7744,0,126,7618
8/27/22,Sierra Leone,8.460555,-11.779889,7746,0,126,7620
8/28/22,Sierra Leone,8.460555,-11.779889,7747,0,126,7621
8/29/22,Sierra Leone,8.460555,-11.779889,7747,0,126,7621
8/30/22,Sierra Leone,8.460555,-11.779889,7747,0,126,7621
8/31/22,Sierra Leone,8.460555,-11.779889,7747,0,126,7621
9/1/22,Sierra Leone,8.460555,-11.779889,7747,0,126,7621
9/2/22,Sierra Leone,8.460555,-11.779889,7747,0,126,7621
9/3/22,Sierra Leone,8.460555,-11.779889,7747,0,126,7621
9/4/22,Sierra Leone,8.460555,-11.779889,7747,0,126,7621
9/5/22,Sierra Leone,8.460555,-11.779889,7747,0,126,7621
9/6/22,Sierra Leone,8.460555,-11.779889,7749,0,126,7623
9/7/22,Sierra Leone,8.460555,-11.779889,7749,0,126,7623
9/8/22,Sierra Leone,8.460555,-11.779889,7749,0,126,7623
9/9/22,Sierra Leone,8.460555,-11.779889,7749,0,126,7623
9/10/22,Sierra Leone,8.460555,-11.779889,7749,0,126,7623
9/11/22,Sierra Leone,8.460555,-11.779889,7749,0,126,7623
9/12/22,Sierra Leone,8.460555,-11.779889,7749,0,126,7623
9/13/22,Sierra Leone,8.460555,-11.779889,7749,0,126,7623
9/14/22,Sierra Leone,8.460555,-11.779889,7750,0,126,7624
9/15/22,Sierra Leone,8.460555,-11.779889,7750,0,126,7624
9/16/22,Sierra Leone,8.460555,-11.779889,7750,0,126,7624
9/17/22,Sierra Leone,8.460555,-11.779889,7750,0,126,7624
9/18/22,Sierra Leone,8.460555,-11.779889,7750,0,126,7624
9/19/22,Sierra Leone,8.460555,-11.779889,7750,0,126,7624
9/20/22,Sierra Leone,8.460555,-11.779889,7751,0,126,7625
9/21/22,Sierra Leone,8.460555,-11.779889,7751,0,126,7625
9/22/22,Sierra Leone,8.460555,-11.779889,7751,0,126,7625
9/23/22,Sierra Leone,8.460555,-11.779889,7751,0,126,7625
9/24/22,Sierra Leone,8.460555,-11.779889,7751,0,126,7625
9/25/22,Sierra Leone,8.460555,-11.779889,7751,0,126,7625
9/26/22,Sierra Leone,8.460555,-11.779889,7751,0,126,7625
9/27/22,Sierra Leone,8.460555,-11.779889,7751,0,126,7625
9/28/22,Sierra Leone,8.460555,-11.779889,7751,0,126,7625
9/29/22,Sierra Leone,8.460555,-11.779889,7751,0,126,7625
9/30/22,Sierra Leone,8.460555,-11.779889,7751,0,126,7625
10/1/22,Sierra Leone,8.460555,-11.779889,7751,0,126,7625
10/2/22,Sierra Leone,8.460555,-11.779889,7751,0,126,7625
10/3/22,Sierra Leone,8.460555,-11.779889,7751,0,126,7625
10/4/22,Sierra Leone,8.460555,-11.779889,7751,0,126,7625
10/5/22,Sierra Leone,8.460555,-11.779889,7751,0,126,7625
10/6/22,Sierra Leone,8.460555,-11.779889,7751,0,126,7625
10/7/22,Sierra Leone,8.460555,-11.779889,7751,0,126,7625
10/8/22,Sierra Leone,8.460555,-11.779889,7751,0,126,7625
10/9/22,Sierra Leone,8.460555,-11.779889,7751,0,126,7625
10/10/22,Sierra Leone,8.460555,-11.779889,7751,0,126,7625
10/11/22,Sierra Leone,8.460555,-11.779889,7752,0,126,7626
10/12/22,Sierra Leone,8.460555,-11.779889,7752,0,126,7626
10/13/22,Sierra Leone,8.460555,-11.779889,7752,0,126,7626
10/14/22,Sierra Leone,8.460555,-11.779889,7752,0,126,7626
10/15/22,Sierra Leone,8.460555,-11.779889,7752,0,126,7626
10/16/22,Sierra Leone,8.460555,-11.779889,7752,0,126,7626
10/17/22,Sierra Leone,8.460555,-11.779889,7752,0,126,7626
10/18/22,Sierra Leone,8.460555,-11.779889,7752,0,126,7626
10/19/22,Sierra Leone,8.460555,-11.779889,7752,0,126,7626
10/20/22,Sierra Leone,8.460555,-11.779889,7752,0,126,7626
10/21/22,Sierra Leone,8.460555,-11.779889,7752,0,126,7626
10/22/22,Sierra Leone,8.460555,-11.779889,7752,0,126,7626
10/23/22,Sierra Leone,8.460555,-11.779889,7752,0,126,7626
10/24/22,Sierra Leone,8.460555,-11.779889,7752,0,126,7626
10/25/22,Sierra Leone,8.460555,-11.779889,7752,0,126,7626
10/26/22,Sierra Leone,8.460555,-11.779889,7752,0,126,7626
10/27/22,Sierra Leone,8.460555,-11.779889,7754,0,126,7628
10/28/22,Sierra Leone,8.460555,-11.779889,7754,0,126,7628
10/29/22,Sierra Leone,8.460555,-11.779889,7754,0,126,7628
10/30/22,Sierra Leone,8.460555,-11.779889,7754,0,126,7628
10/31/22,Sierra Leone,8.460555,-11.779889,7754,0,126,7628
11/1/22,Sierra Leone,8.460555,-11.779889,7754,0,126,7628
11/2/22,Sierra Leone,8.460555,-11.779889,7754,0,126,7628
11/3/22,Sierra Leone,8.460555,-11.779889,7754,0,126,7628
11/4/22,Sierra Leone,8.460555,-11.779889,7754,0,126,7628
11/5/22,Sierra Leone,8.460555,-11.779889,7754,0,126,7628
11/6/22,Sierra Leone,8.460555,-11.779889,7754,0,126,7628
11/7/22,Sierra Leone,8.460555,-11.779889,7754,0,126,7628
11/8/22,Sierra Leone,8.460555,-11.779889,7754,0,126,7628
11/9/22,Sierra Leone,8.460555,-11.779889,7754,0,126,7628
11/10/22,Sierra Leone,8.460555,-11.779889,7758,0,126,7632
11/11/22,Sierra Leone,8.460555,-11.779889,7758,0,126,7632
11/12/22,Sierra Leone,8.460555,-11.779889,7758,0,126,7632
11/13/22,Sierra Leone,8.460555,-11.779889,7758,0,126,7632
11/14/22,Sierra Leone,8.460555,-11.779889,7758,0,126,7632
11/15/22,Sierra Leone,8.460555,-11.779889,7758,0,126,7632
11/16/22,Sierra Leone,8.460555,-11.779889,7758,0,126,7632
11/17/22,Sierra Leone,8.460555,-11.779889,7758,0,126,7632
11/18/22,Sierra Leone,8.460555,-11.779889,7758,0,126,7632
11/19/22,Sierra Leone,8.460555,-11.779889,7758,0,126,7632
11/20/22,Sierra Leone,8.460555,-11.779889,7758,0,126,7632
11/21/22,Sierra Leone,8.460555,-11.779889,7758,0,126,7632
11/22/22,Sierra Leone,8.460555,-11.779889,7758,0,126,7632
11/23/22,Sierra Leone,8.460555,-11.779889,7758,0,126,7632
11/24/22,Sierra Leone,8.460555,-11.779889,7758,0,126,7632
11/25/22,Sierra Leone,8.460555,-11.779889,7758,0,126,7632
11/26/22,Sierra Leone,8.460555,-11.779889,7758,0,126,7632
11/27/22,Sierra Leone,8.460555,-11.779889,7758,0,126,7632
11/28/22,Sierra Leone,8.460555,-11.779889,7758,0,126,7632
11/29/22,Sierra Leone,8.460555,-11.779889,7759,0,126,7633
11/30/22,Sierra Leone,8.460555,-11.779889,7759,0,126,7633
12/1/22,Sierra Leone,8.460555,-11.779889,7759,0,126,7633
12/2/22,Sierra Leone,8.460555,-11.779889,7759,0,126,7633
12/3/22,Sierra Leone,8.460555,-11.779889,7759,0,126,7633
12/4/22,Sierra Leone,8.460555,-11.779889,7759,0,126,7633
12/5/22,Sierra Leone,8.460555,-11.779889,7759,0,126,7633
12/6/22,Sierra Leone,8.460555,-11.779889,7760,0,126,7634
12/7/22,Sierra Leone,8.460555,-11.779889,7760,0,126,7634
12/8/22,Sierra Leone,8.460555,-11.779889,7760,0,126,7634
12/9/22,Sierra Leone,8.460555,-11.779889,7760,0,126,7634
12/10/22,Sierra Leone,8.460555,-11.779889,7760,0,126,7634
12/11/22,Sierra Leone,8.460555,-11.779889,7760,0,126,7634
12/12/22,Sierra Leone,8.460555,-11.779889,7760,0,126,7634
12/13/22,Sierra Leone,8.460555,-11.779889,7760,0,126,7634
12/14/22,Sierra Leone,8.460555,-11.779889,7760,0,126,7634
12/15/22,Sierra Leone,8.460555,-11.779889,7760,0,126,7634
12/16/22,Sierra Leone,8.460555,-11.779889,7760,0,126,7634
12/17/22,Sierra Leone,8.460555,-11.779889,7760,0,126,7634
1/1/22,Singapore,1.2833,103.8333,279861,0,829,279032
1/2/22,Singapore,1.2833,103.8333,280290,0,829,279461
1/3/22,Singapore,1.2833,103.8333,280754,0,829,279925
1/4/22,Singapore,1.2833,103.8333,281596,0,832,280764
1/5/22,Singapore,1.2833,103.8333,282401,0,834,281567
1/6/22,Singapore,1.2833,103.8333,283214,0,835,282379
1/7/22,Singapore,1.2833,103.8333,283214,0,835,282379
1/8/22,Singapore,1.2833,103.8333,284802,0,837,283965
1/9/22,Singapore,1.2833,103.8333,285647,0,838,284809
1/10/22,Singapore,1.2833,103.8333,286397,0,838,285559
1/11/22,Singapore,1.2833,103.8333,287243,0,838,286405
1/12/22,Singapore,1.2833,103.8333,288125,0,839,287286
1/13/22,Singapore,1.2833,103.8333,289085,0,839,288246
1/14/22,Singapore,1.2833,103.8333,290030,0,840,289190
1/15/22,Singapore,1.2833,103.8333,290986,0,843,290143
1/16/22,Singapore,1.2833,103.8333,291849,0,843,291006
1/17/22,Singapore,1.2833,103.8333,293014,0,843,292171
1/18/22,Singapore,1.2833,103.8333,294462,0,843,293619
1/19/22,Singapore,1.2833,103.8333,296077,0,844,295233
1/20/22,Singapore,1.2833,103.8333,297549,0,845,296704
1/21/22,Singapore,1.2833,103.8333,307813,0,846,306967
1/22/22,Singapore,1.2833,103.8333,310276,0,847,309429
1/23/22,Singapore,1.2833,103.8333,313772,0,848,312924
1/24/22,Singapore,1.2833,103.8333,316774,0,848,315926
1/25/22,Singapore,1.2833,103.8333,322770,0,850,321920
1/26/22,Singapore,1.2833,103.8333,327602,0,850,326752
1/27/22,Singapore,1.2833,103.8333,333071,0,850,332221
1/28/22,Singapore,1.2833,103.8333,338625,0,853,337772
1/29/22,Singapore,1.2833,103.8333,343832,0,854,342978
1/30/22,Singapore,1.2833,103.8333,348330,0,854,347476
1/31/22,Singapore,1.2833,103.8333,352811,0,855,351956
2/1/22,Singapore,1.2833,103.8333,359075,0,858,358217
2/2/22,Singapore,1.2833,103.8333,362176,0,859,361317
2/3/22,Singapore,1.2833,103.8333,366473,0,860,365613
2/4/22,Singapore,1.2833,103.8333,379681,0,866,378815
2/5/22,Singapore,1.2833,103.8333,379681,0,866,378815
2/6/22,Singapore,1.2833,103.8333,390071,0,868,389203
2/7/22,Singapore,1.2833,103.8333,405629,0,874,404755
2/8/22,Singapore,1.2833,103.8333,418640,0,877,417763
2/9/22,Singapore,1.2833,103.8333,428954,0,881,428073
2/10/22,Singapore,1.2833,103.8333,439640,0,882,438758
2/11/22,Singapore,1.2833,103.8333,449570,0,885,448685
2/12/22,Singapore,1.2833,103.8333,460075,0,893,459182
2/13/22,Singapore,1.2833,103.8333,469495,0,897,468598
2/14/22,Singapore,1.2833,103.8333,478577,0,906,477671
2/15/22,Singapore,1.2833,103.8333,497997,0,913,497084
2/16/22,Singapore,1.2833,103.8333,514880,0,926,513954
2/17/22,Singapore,1.2833,103.8333,533425,0,930,532495
2/18/22,Singapore,1.2833,103.8333,551519,0,937,550582
2/19/22,Singapore,1.2833,103.8333,576355,0,941,575414
2/20/22,Singapore,1.2833,103.8333,582638,0,945,581693
2/21/22,Singapore,1.2833,103.8333,596261,0,952,595309
2/22/22,Singapore,1.2833,103.8333,622293,0,956,621337
2/23/22,Singapore,1.2833,103.8333,642605,0,963,641642
2/24/22,Singapore,1.2833,103.8333,661198,0,975,660223
2/25/22,Singapore,1.2833,103.8333,679795,0,986,678809
2/26/22,Singapore,1.2833,103.8333,696652,0,999,695653
2/27/22,Singapore,1.2833,103.8333,710880,0,1007,709873
2/28/22,Singapore,1.2833,103.8333,724424,0,1019,723405
3/1/22,Singapore,1.2833,103.8333,748504,0,1030,747474
3/2/22,Singapore,1.2833,103.8333,767663,0,1040,766623
3/3/22,Singapore,1.2833,103.8333,785825,0,1049,784776
3/4/22,Singapore,1.2833,103.8333,803389,0,1067,802322
3/5/22,Singapore,1.2833,103.8333,819663,0,1073,818590
3/6/22,Singapore,1.2833,103.8333,832821,0,1078,831743
3/7/22,Singapore,1.2833,103.8333,846341,0,1084,845257
3/8/22,Singapore,1.2833,103.8333,846341,0,1099,845242
3/9/22,Singapore,1.2833,103.8333,885593,0,1110,884483
3/10/22,Singapore,1.2833,103.8333,901758,0,1116,900642
3/11/22,Singapore,1.2833,103.8333,917103,0,1129,915974
3/12/22,Singapore,1.2833,103.8333,929735,0,1139,928596
3/13/22,Singapore,1.2833,103.8333,939436,0,1145,938291
3/14/22,Singapore,1.2833,103.8333,948478,0,1153,947325
3/15/22,Singapore,1.2833,103.8333,964329,0,1159,963170
3/16/22,Singapore,1.2833,103.8333,975607,0,1170,974437
3/17/22,Singapore,1.2833,103.8333,986320,0,1182,985138
3/18/22,Singapore,1.2833,103.8333,996914,0,1191,995723
3/19/22,Singapore,1.2833,103.8333,1007158,0,1194,1005964
3/20/22,Singapore,1.2833,103.8333,1015017,0,1198,1013819
3/21/22,Singapore,1.2833,103.8333,1022555,0,1208,1021347
3/22/22,Singapore,1.2833,103.8333,1035721,0,1214,1034507
3/23/22,Singapore,1.2833,103.8333,1044661,0,1220,1043441
3/24/22,Singapore,1.2833,103.8333,1053139,0,1226,1051913
3/25/22,Singapore,1.2833,103.8333,1060723,0,1239,1059484
3/26/22,Singapore,1.2833,103.8333,1067157,0,1246,1065911
3/27/22,Singapore,1.2833,103.8333,1067157,0,1250,1065907
3/28/22,Singapore,1.2833,103.8333,1072005,0,1254,1070751
3/29/22,Singapore,1.2833,103.8333,1085094,0,1258,1083836
3/30/22,Singapore,1.2833,103.8333,1090823,0,1263,1089560
3/31/22,Singapore,1.2833,103.8333,1096428,0,1268,1095160
4/1/22,Singapore,1.2833,103.8333,1101438,0,1270,1100168
4/2/22,Singapore,1.2833,103.8333,1106001,0,1272,1104729
4/3/22,Singapore,1.2833,103.8333,1109744,0,1276,1108468
4/4/22,Singapore,1.2833,103.8333,1109744,0,1283,1108461
4/5/22,Singapore,1.2833,103.8333,1119419,0,1284,1118135
4/6/22,Singapore,1.2833,103.8333,1123886,0,1287,1122599
4/7/22,Singapore,1.2833,103.8333,1128155,0,1290,1126865
4/8/22,Singapore,1.2833,103.8333,1132169,0,1297,1130872
4/9/22,Singapore,1.2833,103.8333,1135428,0,1299,1134129
4/10/22,Singapore,1.2833,103.8333,1138001,0,1301,1136700
4/11/22,Singapore,1.2833,103.8333,1140569,0,1303,1139266
4/12/22,Singapore,1.2833,103.8333,1145121,0,1307,1143814
4/13/22,Singapore,1.2833,103.8333,1148656,0,1309,1147347
4/14/22,Singapore,1.2833,103.8333,1152177,0,1309,1150868
4/15/22,Singapore,1.2833,103.8333,1155581,0,1310,1154271
4/16/22,Singapore,1.2833,103.8333,1157251,0,1313,1155938
4/17/22,Singapore,1.2833,103.8333,1160300,0,1316,1158984
4/18/22,Singapore,1.2833,103.8333,1162780,0,1316,1161464
4/19/22,Singapore,1.2833,103.8333,1167498,0,1317,1166181
4/20/22,Singapore,1.2833,103.8333,1170970,0,1319,1169651
4/21/22,Singapore,1.2833,103.8333,1174390,0,1322,1173068
4/22/22,Singapore,1.2833,103.8333,1177415,0,1324,1176091
4/23/22,Singapore,1.2833,103.8333,1180124,0,1325,1178799
4/24/22,Singapore,1.2833,103.8333,1182168,0,1325,1180843
4/25/22,Singapore,1.2833,103.8333,1184226,0,1331,1182895
4/26/22,Singapore,1.2833,103.8333,1187914,0,1333,1186581
4/27/22,Singapore,1.2833,103.8333,1187914,0,1334,1186580
4/28/22,Singapore,1.2833,103.8333,1187914,0,1334,1186580
4/29/22,Singapore,1.2833,103.8333,1193250,0,1334,1191916
4/30/22,Singapore,1.2833,103.8333,1193250,0,1335,1191915
5/1/22,Singapore,1.2833,103.8333,1193250,0,1336,1191914
5/2/22,Singapore,1.2833,103.8333,1200976,0,1338,1199638
5/3/22,Singapore,1.2833,103.8333,1202546,0,1338,1201208
5/4/22,Singapore,1.2833,103.8333,1202546,0,1340,1201206
5/5/22,Singapore,1.2833,103.8333,1208917,0,1344,1207573
5/6/22,Singapore,1.2833,103.8333,1212337,0,1346,1210991
5/7/22,Singapore,1.2833,103.8333,1215499,0,1350,1214149
5/8/22,Singapore,1.2833,103.8333,1217922,0,1352,1216570
5/9/22,Singapore,1.2833,103.8333,1220193,0,1352,1218841
5/10/22,Singapore,1.2833,103.8333,1225024,0,1356,1223668
5/11/22,Singapore,1.2833,103.8333,1228914,0,1358,1227556
5/12/22,Singapore,1.2833,103.8333,1232559,0,1361,1231198
5/13/22,Singapore,1.2833,103.8333,1236850,0,1362,1235488
5/14/22,Singapore,1.2833,103.8333,1240233,0,1362,1238871
5/15/22,Singapore,1.2833,103.8333,1242884,0,1363,1241521
5/16/22,Singapore,1.2833,103.8333,1245007,0,1366,1243641
5/17/22,Singapore,1.2833,103.8333,1247671,0,1367,1246304
5/18/22,Singapore,1.2833,103.8333,1254113,0,1369,1252744
5/19/22,Singapore,1.2833,103.8333,1258691,0,1371,1257320
5/20/22,Singapore,1.2833,103.8333,1263033,0,1374,1261659
5/21/22,Singapore,1.2833,103.8333,1266808,0,1374,1265434
5/22/22,Singapore,1.2833,103.8333,1269635,0,1375,1268260
5/23/22,Singapore,1.2833,103.8333,1272386,0,1377,1271009
5/24/22,Singapore,1.2833,103.8333,1278113,0,1378,1276735
5/25/22,Singapore,1.2833,103.8333,1282280,0,1380,1280900
5/26/22,Singapore,1.2833,103.8333,1286216,0,1382,1284834
5/27/22,Singapore,1.2833,103.8333,1290046,0,1383,1288663
5/28/22,Singapore,1.2833,103.8333,1293369,0,1383,1291986
5/29/22,Singapore,1.2833,103.8333,1295920,0,1383,1294537
5/30/22,Singapore,1.2833,103.8333,1298309,0,1386,1296923
5/31/22,Singapore,1.2833,103.8333,1303294,0,1389,1301905
6/1/22,Singapore,1.2833,103.8333,1306871,0,1389,1305482
6/2/22,Singapore,1.2833,103.8333,1310616,0,1389,1309227
6/3/22,Singapore,1.2833,103.8333,1313849,0,1389,1312460
6/4/22,Singapore,1.2833,103.8333,1316728,0,1392,1315336
6/5/22,Singapore,1.2833,103.8333,1318984,0,1393,1317591
6/6/22,Singapore,1.2833,103.8333,1321146,0,1393,1319753
6/7/22,Singapore,1.2833,103.8333,1325623,0,1394,1324229
6/8/22,Singapore,1.2833,103.8333,1329225,0,1394,1327831
6/9/22,Singapore,1.2833,103.8333,1332656,0,1396,1331260
6/10/22,Singapore,1.2833,103.8333,1335625,0,1396,1334229
6/11/22,Singapore,1.2833,103.8333,1338753,0,1397,1337356
6/12/22,Singapore,1.2833,103.8333,1341256,0,1397,1339859
6/13/22,Singapore,1.2833,103.8333,1343645,0,1398,1342247
6/14/22,Singapore,1.2833,103.8333,1348775,0,1401,1347374
6/15/22,Singapore,1.2833,103.8333,1352681,0,1401,1351280
6/16/22,Singapore,1.2833,103.8333,1355801,0,1401,1354400
6/17/22,Singapore,1.2833,103.8333,1360780,0,1402,1359378
6/18/22,Singapore,1.2833,103.8333,1364562,0,1402,1363160
6/19/22,Singapore,1.2833,103.8333,1367761,0,1403,1366358
6/20/22,Singapore,1.2833,103.8333,1370981,0,1405,1369576
6/21/22,Singapore,1.2833,103.8333,1378090,0,1405,1376685
6/22/22,Singapore,1.2833,103.8333,1383952,0,1405,1382547
6/23/22,Singapore,1.2833,103.8333,1390558,0,1408,1389150
6/24/22,Singapore,1.2833,103.8333,1397074,0,1408,1395666
6/25/22,Singapore,1.2833,103.8333,1403242,0,1408,1401834
6/26/22,Singapore,1.2833,103.8333,1408358,0,1408,1406950
6/27/22,Singapore,1.2833,103.8333,1413667,0,1409,1412258
6/28/22,Singapore,1.2833,103.8333,1425171,0,1410,1423761
6/29/22,Singapore,1.2833,103.8333,1434563,0,1411,1433152
6/30/22,Singapore,1.2833,103.8333,1444068,0,1413,1442655
7/1/22,Singapore,1.2833,103.8333,1453155,0,1415,1451740
7/2/22,Singapore,1.2833,103.8333,1461107,0,1416,1459691
7/3/22,Singapore,1.2833,103.8333,1467234,0,1418,1465816
7/4/22,Singapore,1.2833,103.8333,1473180,0,1419,1471761
7/5/22,Singapore,1.2833,103.8333,1485964,0,1421,1484543
7/6/22,Singapore,1.2833,103.8333,1495953,0,1423,1494530
7/7/22,Singapore,1.2833,103.8333,1505938,0,1426,1504512
7/8/22,Singapore,1.2833,103.8333,1515222,0,1427,1513795
7/9/22,Singapore,1.2833,103.8333,1523881,0,1428,1522453
7/10/22,Singapore,1.2833,103.8333,1530304,0,1432,1528872
7/11/22,Singapore,1.2833,103.8333,1534799,0,1432,1533367
7/12/22,Singapore,1.2833,103.8333,1540778,0,1437,1539341
7/13/22,Singapore,1.2833,103.8333,1557648,0,1440,1556208
7/14/22,Singapore,1.2833,103.8333,1569420,0,1444,1567976
7/15/22,Singapore,1.2833,103.8333,1579946,0,1447,1578499
7/16/22,Singapore,1.2833,103.8333,1589099,0,1450,1587649
7/17/22,Singapore,1.2833,103.8333,1596046,0,1453,1594593
7/18/22,Singapore,1.2833,103.8333,1602273,0,1457,1600816
7/19/22,Singapore,1.2833,103.8333,1616067,0,1460,1614607
7/20/22,Singapore,1.2833,103.8333,1626360,0,1463,1624897
7/21/22,Singapore,1.2833,103.8333,1636109,0,1466,1634643
7/22/22,Singapore,1.2833,103.8333,1645092,0,1468,1643624
7/23/22,Singapore,1.2833,103.8333,1652981,0,1472,1651509
7/24/22,Singapore,1.2833,103.8333,1659156,0,1476,1657680
7/25/22,Singapore,1.2833,103.8333,1664707,0,1483,1663224
7/26/22,Singapore,1.2833,103.8333,1677126,0,1487,1675639
7/27/22,Singapore,1.2833,103.8333,1685889,0,1490,1684399
7/28/22,Singapore,1.2833,103.8333,1694454,0,1492,1692962
7/29/22,Singapore,1.2833,103.8333,1702392,0,1494,1700898
7/30/22,Singapore,1.2833,103.8333,1708950,0,1497,1707453
7/31/22,Singapore,1.2833,103.8333,1714056,0,1500,1712556
8/1/22,Singapore,1.2833,103.8333,1718765,0,1502,1717263
8/2/22,Singapore,1.2833,103.8333,1728995,0,1524,1727471
8/3/22,Singapore,1.2833,103.8333,1728995,0,1528,1727467
8/4/22,Singapore,1.2833,103.8333,1742874,0,1531,1741343
8/5/22,Singapore,1.2833,103.8333,1749144,0,1534,1747610
8/6/22,Singapore,1.2833,103.8333,1754777,0,1536,1753241
8/7/22,Singapore,1.2833,103.8333,1759575,0,1539,1758036
8/8/22,Singapore,1.2833,103.8333,1763116,0,1541,1761575
8/9/22,Singapore,1.2833,103.8333,1771081,0,1542,1769539
8/10/22,Singapore,1.2833,103.8333,1773386,0,1543,1771843
8/11/22,Singapore,1.2833,103.8333,1773386,0,1546,1771840
8/12/22,Singapore,1.2833,103.8333,1786643,0,1552,1785091
8/13/22,Singapore,1.2833,103.8333,1791046,0,1556,1789490
8/14/22,Singapore,1.2833,103.8333,1794069,0,1559,1792510
8/15/22,Singapore,1.2833,103.8333,1794069,0,1560,1792509
8/16/22,Singapore,1.2833,103.8333,1801936,0,1565,1800371
8/17/22,Singapore,1.2833,103.8333,1805698,0,1567,1804131
8/18/22,Singapore,1.2833,103.8333,1809251,0,1572,1807679
8/19/22,Singapore,1.2833,103.8333,1812255,0,1576,1810679
8/20/22,Singapore,1.2833,103.8333,1814915,0,1578,1813337
8/21/22,Singapore,1.2833,103.8333,1816866,0,1580,1815286
8/22/22,Singapore,1.2833,103.8333,1818560,0,1584,1816976
8/23/22,Singapore,1.2833,103.8333,1822187,0,1584,1820603
8/24/22,Singapore,1.2833,103.8333,1824832,0,1586,1823246
8/25/22,Singapore,1.2833,103.8333,1827229,0,1587,1825642
8/26/22,Singapore,1.2833,103.8333,1829361,0,1588,1827773
8/27/22,Singapore,1.2833,103.8333,1831332,0,1590,1829742
8/28/22,Singapore,1.2833,103.8333,1832780,0,1591,1831189
8/29/22,Singapore,1.2833,103.8333,1834190,0,1591,1832599
8/30/22,Singapore,1.2833,103.8333,1837090,0,1592,1835498
8/31/22,Singapore,1.2833,103.8333,1839244,0,1592,1837652
9/1/22,Singapore,1.2833,103.8333,1841288,0,1593,1839695
9/2/22,Singapore,1.2833,103.8333,1843236,0,1594,1841642
9/3/22,Singapore,1.2833,103.8333,1844785,0,1594,1843191
9/4/22,Singapore,1.2833,103.8333,1846094,0,1594,1844500
9/5/22,Singapore,1.2833,103.8333,1847270,0,1596,1845674
9/6/22,Singapore,1.2833,103.8333,1850015,0,1596,1848419
9/7/22,Singapore,1.2833,103.8333,1852286,0,1601,1850685
9/8/22,Singapore,1.2833,103.8333,1854455,0,1601,1852854
9/9/22,Singapore,1.2833,103.8333,1856673,0,1602,1855071
9/10/22,Singapore,1.2833,103.8333,1858497,0,1602,1856895
9/11/22,Singapore,1.2833,103.8333,1859937,0,1602,1858335
9/12/22,Singapore,1.2833,103.8333,1861390,0,1602,1859788
9/13/22,Singapore,1.2833,103.8333,1864742,0,1602,1863140
9/14/22,Singapore,1.2833,103.8333,1867168,0,1604,1865564
9/15/22,Singapore,1.2833,103.8333,1869591,0,1605,1867986
9/16/22,Singapore,1.2833,103.8333,1871900,0,1605,1870295
9/17/22,Singapore,1.2833,103.8333,1873747,0,1607,1872140
9/18/22,Singapore,1.2833,103.8333,1875275,0,1607,1873668
9/19/22,Singapore,1.2833,103.8333,1876584,0,1608,1874976
9/20/22,Singapore,1.2833,103.8333,1879806,0,1609,1878197
9/21/22,Singapore,1.2833,103.8333,1882314,0,1609,1880705
9/22/22,Singapore,1.2833,103.8333,1884859,0,1609,1883250
9/23/22,Singapore,1.2833,103.8333,1887202,0,1609,1885593
9/24/22,Singapore,1.2833,103.8333,1889544,0,1610,1887934
9/25/22,Singapore,1.2833,103.8333,1891341,0,1610,1889731
9/26/22,Singapore,1.2833,103.8333,1892947,0,1615,1891332
9/27/22,Singapore,1.2833,103.8333,1897307,0,1617,1895690
9/28/22,Singapore,1.2833,103.8333,1900761,0,1617,1899144
9/29/22,Singapore,1.2833,103.8333,1904192,0,1617,1902575
9/30/22,Singapore,1.2833,103.8333,1907907,0,1618,1906289
10/1/22,Singapore,1.2833,103.8333,1911417,0,1619,1909798
10/2/22,Singapore,1.2833,103.8333,1914280,0,1620,1912660
10/3/22,Singapore,1.2833,103.8333,1916993,0,1622,1915371
10/4/22,Singapore,1.2833,103.8333,1924139,0,1624,1922515
10/5/22,Singapore,1.2833,103.8333,1930062,0,1624,1928438
10/6/22,Singapore,1.2833,103.8333,1936270,0,1625,1934645
10/7/22,Singapore,1.2833,103.8333,1942204,0,1628,1940576
10/8/22,Singapore,1.2833,103.8333,1948402,0,1629,1946773
10/9/22,Singapore,1.2833,103.8333,1953197,0,1629,1951568
10/10/22,Singapore,1.2833,103.8333,1957916,0,1632,1956284
10/11/22,Singapore,1.2833,103.8333,1969648,0,1634,1968014
10/12/22,Singapore,1.2833,103.8333,1979259,0,1636,1977623
10/13/22,Singapore,1.2833,103.8333,1988760,0,1639,1987121
10/14/22,Singapore,1.2833,103.8333,1997847,0,1641,1996206
10/15/22,Singapore,1.2833,103.8333,2005884,0,1641,2004243
10/16/22,Singapore,1.2833,103.8333,2012065,0,1644,2010421
10/17/22,Singapore,1.2833,103.8333,2017261,0,1646,2015615
10/18/22,Singapore,1.2833,103.8333,2029195,0,1651,2027544
10/19/22,Singapore,1.2833,103.8333,2037947,0,1654,2036293
10/20/22,Singapore,1.2833,103.8333,2046123,0,1659,2044464
10/21/22,Singapore,1.2833,103.8333,2053370,0,1660,2051710
10/22/22,Singapore,1.2833,103.8333,2059709,0,1660,2058049
10/23/22,Singapore,1.2833,103.8333,2064163,0,1662,2062501
10/24/22,Singapore,1.2833,103.8333,2067790,0,1663,2066127
10/25/22,Singapore,1.2833,103.8333,2070784,0,1666,2069118
10/26/22,Singapore,1.2833,103.8333,2080341,0,1668,2078673
10/27/22,Singapore,1.2833,103.8333,2086588,0,1670,2084918
10/28/22,Singapore,1.2833,103.8333,2091889,0,1672,2090217
10/29/22,Singapore,1.2833,103.8333,2096520,0,1674,2094846
10/30/22,Singapore,1.2833,103.8333,2099760,0,1676,2098084
10/31/22,Singapore,1.2833,103.8333,2102372,0,1680,2100692
11/1/22,Singapore,1.2833,103.8333,2108024,0,1680,2106344
11/2/22,Singapore,1.2833,103.8333,2112110,0,1682,2110428
11/3/22,Singapore,1.2833,103.8333,2115621,0,1683,2113938
11/4/22,Singapore,1.2833,103.8333,2118749,0,1685,2117064
11/5/22,Singapore,1.2833,103.8333,2121435,0,1686,2119749
11/6/22,Singapore,1.2833,103.8333,2123328,0,1687,2121641
11/7/22,Singapore,1.2833,103.8333,2125004,0,1690,2123314
11/8/22,Singapore,1.2833,103.8333,2128572,0,1691,2126881
11/9/22,Singapore,1.2833,103.8333,2131554,0,1693,2129861
11/10/22,Singapore,1.2833,103.8333,2134319,0,1693,2132626
11/11/22,Singapore,1.2833,103.8333,2136658,0,1693,2134965
11/12/22,Singapore,1.2833,103.8333,2138598,0,1694,2136904
11/13/22,Singapore,1.2833,103.8333,2140099,0,1695,2138404
11/14/22,Singapore,1.2833,103.8333,2141411,0,1697,2139714
11/15/22,Singapore,1.2833,103.8333,2144522,0,1697,2142825
11/16/22,Singapore,1.2833,103.8333,2146706,0,1698,2145008
11/17/22,Singapore,1.2833,103.8333,2148794,0,1699,2147095
11/18/22,Singapore,1.2833,103.8333,2150702,0,1699,2149003
11/19/22,Singapore,1.2833,103.8333,2152368,0,1699,2150669
11/20/22,Singapore,1.2833,103.8333,2153535,0,1700,2151835
11/21/22,Singapore,1.2833,103.8333,2154633,0,1700,2152933
11/22/22,Singapore,1.2833,103.8333,2157021,0,1701,2155320
11/23/22,Singapore,1.2833,103.8333,2158709,0,1701,2157008
11/24/22,Singapore,1.2833,103.8333,2160324,0,1701,2158623
11/25/22,Singapore,1.2833,103.8333,2161673,0,1702,2159971
11/26/22,Singapore,1.2833,103.8333,2162963,0,1702,2161261
11/27/22,Singapore,1.2833,103.8333,2163872,0,1702,2162170
11/28/22,Singapore,1.2833,103.8333,2164689,0,1702,2162987
11/29/22,Singapore,1.2833,103.8333,2166527,0,1703,2164824
11/30/22,Singapore,1.2833,103.8333,2167897,0,1703,2166194
12/1/22,Singapore,1.2833,103.8333,2169201,0,1703,2167498
12/2/22,Singapore,1.2833,103.8333,2170498,0,1705,2168793
12/3/22,Singapore,1.2833,103.8333,2171550,0,1705,2169845
12/4/22,Singapore,1.2833,103.8333,2172396,0,1705,2170691
12/5/22,Singapore,1.2833,103.8333,2173172,0,1706,2171466
12/6/22,Singapore,1.2833,103.8333,2174989,0,1706,2173283
12/7/22,Singapore,1.2833,103.8333,2176338,0,1707,2174631
12/8/22,Singapore,1.2833,103.8333,2177701,0,1707,2175994
12/9/22,Singapore,1.2833,103.8333,2179044,0,1707,2177337
12/10/22,Singapore,1.2833,103.8333,2180146,0,1707,2178439
12/11/22,Singapore,1.2833,103.8333,2181048,0,1707,2179341
12/12/22,Singapore,1.2833,103.8333,2181788,0,1707,2180081
12/13/22,Singapore,1.2833,103.8333,2183605,0,1708,2181897
12/14/22,Singapore,1.2833,103.8333,2184952,0,1708,2183244
12/15/22,Singapore,1.2833,103.8333,2186214,0,1709,2184505
12/16/22,Singapore,1.2833,103.8333,2187459,0,1709,2185750
12/17/22,Singapore,1.2833,103.8333,2188511,0,1709,2186802
1/1/22,Slovakia,48.669,19.699,1374354,0,16665,1357689
1/2/22,Slovakia,48.669,19.699,1374850,0,16701,1358149
1/3/22,Slovakia,48.669,19.699,1376559,0,16740,1359819
1/4/22,Slovakia,48.669,19.699,1381175,0,16788,1364387
1/5/22,Slovakia,48.669,19.699,1385760,0,16824,1368936
1/6/22,Slovakia,48.669,19.699,1389546,0,16871,1372675
1/7/22,Slovakia,48.669,19.699,1391061,0,16896,1374165
1/8/22,Slovakia,48.669,19.699,1394685,0,16933,1377752
1/9/22,Slovakia,48.669,19.699,1397257,0,16962,1380295
1/10/22,Slovakia,48.669,19.699,1398557,0,16989,1381568
1/11/22,Slovakia,48.669,19.699,1401959,0,17039,1384920
1/12/22,Slovakia,48.669,19.699,1405854,0,17081,1388773
1/13/22,Slovakia,48.669,19.699,1409365,0,17128,1392237
1/14/22,Slovakia,48.669,19.699,1411568,0,17188,1394380
1/15/22,Slovakia,48.669,19.699,1414154,0,17252,1396902
1/16/22,Slovakia,48.669,19.699,1417687,0,17300,1400387
1/17/22,Slovakia,48.669,19.699,1419379,0,17352,1402027
1/18/22,Slovakia,48.669,19.699,1421125,0,17398,1403727
1/19/22,Slovakia,48.669,19.699,1431770,0,17459,1414311
1/20/22,Slovakia,48.669,19.699,1438877,0,17520,1421357
1/21/22,Slovakia,48.669,19.699,1447067,0,17577,1429490
1/22/22,Slovakia,48.669,19.699,1454621,0,17612,1437009
1/23/22,Slovakia,48.669,19.699,1462998,0,17643,1445355
1/24/22,Slovakia,48.669,19.699,1464277,0,17675,1446602
1/25/22,Slovakia,48.669,19.699,1478543,0,17698,1460845
1/26/22,Slovakia,48.669,19.699,1494945,0,17725,1477220
1/27/22,Slovakia,48.669,19.699,1512072,0,17755,1494317
1/28/22,Slovakia,48.669,19.699,1529099,0,17779,1511320
1/29/22,Slovakia,48.669,19.699,1546907,0,17796,1529111
1/30/22,Slovakia,48.669,19.699,1562107,0,17817,1544290
1/31/22,Slovakia,48.669,19.699,1569299,0,17830,1551469
2/1/22,Slovakia,48.669,19.699,1593001,0,17850,1575151
2/2/22,Slovakia,48.669,19.699,1617288,0,17877,1599411
2/3/22,Slovakia,48.669,19.699,1639953,0,17896,1622057
2/4/22,Slovakia,48.669,19.699,1660336,0,17921,1642415
2/5/22,Slovakia,48.669,19.699,1686936,0,17938,1668998
2/6/22,Slovakia,48.669,19.699,1705482,0,17958,1687524
2/7/22,Slovakia,48.669,19.699,1718369,0,17973,1700396
2/8/22,Slovakia,48.669,19.699,1743941,0,17995,1725946
2/9/22,Slovakia,48.669,19.699,1765914,0,18014,1747900
2/10/22,Slovakia,48.669,19.699,1794150,0,18040,1776110
2/11/22,Slovakia,48.669,19.699,1818532,0,18064,1800468
2/12/22,Slovakia,48.669,19.699,1841934,0,18081,1823853
2/13/22,Slovakia,48.669,19.699,1858190,0,18095,1840095
2/14/22,Slovakia,48.669,19.699,1870119,0,18105,1852014
2/15/22,Slovakia,48.669,19.699,1891646,0,18123,1873523
2/16/22,Slovakia,48.669,19.699,1920150,0,18145,1902005
2/17/22,Slovakia,48.669,19.699,1943101,0,18179,1924922
2/18/22,Slovakia,48.669,19.699,1964411,0,18201,1946210
2/19/22,Slovakia,48.669,19.699,1985859,0,18225,1967634
2/20/22,Slovakia,48.669,19.699,2000643,0,18240,1982403
2/21/22,Slovakia,48.669,19.699,2010065,0,18252,1991813
2/22/22,Slovakia,48.669,19.699,2025646,0,18279,2007367
2/23/22,Slovakia,48.669,19.699,2052260,0,18314,2033946
2/24/22,Slovakia,48.669,19.699,2071372,0,18338,2053034
2/25/22,Slovakia,48.669,19.699,2083963,0,18375,2065588
2/26/22,Slovakia,48.669,19.699,2102420,0,18413,2084007
2/27/22,Slovakia,48.669,19.699,2112272,0,18453,2093819
2/28/22,Slovakia,48.669,19.699,2119358,0,18485,2100873
3/1/22,Slovakia,48.669,19.699,2134795,0,18530,2116265
3/2/22,Slovakia,48.669,19.699,2150666,0,18567,2132099
3/3/22,Slovakia,48.669,19.699,2164751,0,18611,2146140
3/4/22,Slovakia,48.669,19.699,2178234,0,18631,2159603
3/5/22,Slovakia,48.669,19.699,2190599,0,18663,2171936
3/6/22,Slovakia,48.669,19.699,2197979,0,18687,2179292
3/7/22,Slovakia,48.669,19.699,2203141,0,18704,2184437
3/8/22,Slovakia,48.669,19.699,2216994,0,18750,2198244
3/9/22,Slovakia,48.669,19.699,2231352,0,18786,2212566
3/10/22,Slovakia,48.669,19.699,2246029,0,18817,2227212
3/11/22,Slovakia,48.669,19.699,2258399,0,18847,2239552
3/12/22,Slovakia,48.669,19.699,2269610,0,18881,2250729
3/13/22,Slovakia,48.669,19.699,2278164,0,18918,2259246
3/14/22,Slovakia,48.669,19.699,2282747,0,18950,2263797
3/15/22,Slovakia,48.669,19.699,2295377,0,18979,2276398
3/16/22,Slovakia,48.669,19.699,2309029,0,19009,2290020
3/17/22,Slovakia,48.669,19.699,2322231,0,19040,2303191
3/18/22,Slovakia,48.669,19.699,2333162,0,19073,2314089
3/19/22,Slovakia,48.669,19.699,2344057,0,19093,2324964
3/20/22,Slovakia,48.669,19.699,2351701,0,19110,2332591
3/21/22,Slovakia,48.669,19.699,2355564,0,19133,2336431
3/22/22,Slovakia,48.669,19.699,2366902,0,19161,2347741
3/23/22,Slovakia,48.669,19.699,2379094,0,19185,2359909
3/24/22,Slovakia,48.669,19.699,2390390,0,19209,2371181
3/25/22,Slovakia,48.669,19.699,2399832,0,19229,2380603
3/26/22,Slovakia,48.669,19.699,2408571,0,19251,2389320
3/27/22,Slovakia,48.669,19.699,2414805,0,19270,2395535
3/28/22,Slovakia,48.669,19.699,2418385,0,19292,2399093
3/29/22,Slovakia,48.669,19.699,2426662,0,19311,2407351
3/30/22,Slovakia,48.669,19.699,2434708,0,19334,2415374
3/31/22,Slovakia,48.669,19.699,2443137,0,19352,2423785
4/1/22,Slovakia,48.669,19.699,2450101,0,19368,2430733
4/2/22,Slovakia,48.669,19.699,2456636,0,19392,2437244
4/3/22,Slovakia,48.669,19.699,2460197,0,19417,2440780
4/4/22,Slovakia,48.669,19.699,2462300,0,19440,2442860
4/5/22,Slovakia,48.669,19.699,2468812,0,19462,2449350
4/6/22,Slovakia,48.669,19.699,2474869,0,19482,2455387
4/7/22,Slovakia,48.669,19.699,2480132,0,19500,2460632
4/8/22,Slovakia,48.669,19.699,2484354,0,19523,2464831
4/9/22,Slovakia,48.669,19.699,2488243,0,19549,2468694
4/10/22,Slovakia,48.669,19.699,2490661,0,19573,2471088
4/11/22,Slovakia,48.669,19.699,2491957,0,19595,2472362
4/12/22,Slovakia,48.669,19.699,2495855,0,19618,2476237
4/13/22,Slovakia,48.669,19.699,2498938,0,19643,2479295
4/14/22,Slovakia,48.669,19.699,2498938,0,19643,2479295
4/15/22,Slovakia,48.669,19.699,2504931,0,19697,2485234
4/16/22,Slovakia,48.669,19.699,2505968,0,19721,2486247
4/17/22,Slovakia,48.669,19.699,2506879,0,19741,2487138
4/18/22,Slovakia,48.669,19.699,2506879,0,19741,2487138
4/19/22,Slovakia,48.669,19.699,2509184,0,19773,2489411
4/20/22,Slovakia,48.669,19.699,2508400,0,19790,2488610
4/21/22,Slovakia,48.669,19.699,2514884,0,19803,2495081
4/22/22,Slovakia,48.669,19.699,2517571,0,19817,2497754
4/23/22,Slovakia,48.669,19.699,2519448,0,19829,2499619
4/24/22,Slovakia,48.669,19.699,2520706,0,19839,2500867
4/25/22,Slovakia,48.669,19.699,2521279,0,19852,2501427
4/26/22,Slovakia,48.669,19.699,2523096,0,19862,2503234
4/27/22,Slovakia,48.669,19.699,2526855,0,19873,2506982
4/28/22,Slovakia,48.669,19.699,2528216,0,19879,2508337
4/29/22,Slovakia,48.669,19.699,2528216,0,19879,2508337
4/30/22,Slovakia,48.669,19.699,2528216,0,19879,2508337
5/1/22,Slovakia,48.669,19.699,2528216,0,19879,2508337
5/2/22,Slovakia,48.669,19.699,2528216,0,19879,2508337
5/3/22,Slovakia,48.669,19.699,2528216,0,19879,2508337
5/4/22,Slovakia,48.669,19.699,2533654,0,19943,2513711
5/5/22,Slovakia,48.669,19.699,2534433,0,19952,2514481
5/6/22,Slovakia,48.669,19.699,2535084,0,19961,2515123
5/7/22,Slovakia,48.669,19.699,2535706,0,19968,2515738
5/8/22,Slovakia,48.669,19.699,2536000,0,19978,2516022
5/9/22,Slovakia,48.669,19.699,2536111,0,19984,2516127
5/10/22,Slovakia,48.669,19.699,2536743,0,19994,2516749
5/11/22,Slovakia,48.669,19.699,2537377,0,20002,2517375
5/12/22,Slovakia,48.669,19.699,2537896,0,20011,2517885
5/13/22,Slovakia,48.669,19.699,2538274,0,20018,2518256
5/14/22,Slovakia,48.669,19.699,2538274,0,20018,2518256
5/15/22,Slovakia,48.669,19.699,2538964,0,20041,2518923
5/16/22,Slovakia,48.669,19.699,2539041,0,20050,2518991
5/17/22,Slovakia,48.669,19.699,2539498,0,20062,2519436
5/18/22,Slovakia,48.669,19.699,2539862,0,20069,2519793
5/19/22,Slovakia,48.669,19.699,2539862,0,20069,2519793
5/20/22,Slovakia,48.669,19.699,2540471,0,20075,2520396
5/21/22,Slovakia,48.669,19.699,2540471,0,20075,2520396
5/22/22,Slovakia,48.669,19.699,2540471,0,20075,2520396
5/23/22,Slovakia,48.669,19.699,2540935,0,20081,2520854
5/24/22,Slovakia,48.669,19.699,2541256,0,20083,2521173
5/25/22,Slovakia,48.669,19.699,2541509,0,20088,2521421
5/26/22,Slovakia,48.669,19.699,2541509,0,20088,2521421
5/27/22,Slovakia,48.669,19.699,2541986,0,20093,2521893
5/28/22,Slovakia,48.669,19.699,2542191,0,20096,2522095
5/29/22,Slovakia,48.669,19.699,2542299,0,20097,2522202
5/30/22,Slovakia,48.669,19.699,2542345,0,20098,2522247
5/31/22,Slovakia,48.669,19.699,2542564,0,20100,2522464
6/1/22,Slovakia,48.669,19.699,2542773,0,20100,2522673
6/2/22,Slovakia,48.669,19.699,2542970,0,20101,2522869
6/3/22,Slovakia,48.669,19.699,2543160,0,20103,2523057
6/4/22,Slovakia,48.669,19.699,2543341,0,20104,2523237
6/5/22,Slovakia,48.669,19.699,2543439,0,20104,2523335
6/6/22,Slovakia,48.669,19.699,2543503,0,20104,2523399
6/7/22,Slovakia,48.669,19.699,2543763,0,20105,2523658
6/8/22,Slovakia,48.669,19.699,2543993,0,20107,2523886
6/9/22,Slovakia,48.669,19.699,2544255,0,20109,2524146
6/10/22,Slovakia,48.669,19.699,2544473,0,20112,2524361
6/11/22,Slovakia,48.669,19.699,2544678,0,20114,2524564
6/12/22,Slovakia,48.669,19.699,2544678,0,20114,2524564
6/13/22,Slovakia,48.669,19.699,2544823,0,20116,2524707
6/14/22,Slovakia,48.669,19.699,2545137,0,20119,2525018
6/15/22,Slovakia,48.669,19.699,2545409,0,20119,2525290
6/16/22,Slovakia,48.669,19.699,2545651,0,20122,2525529
6/17/22,Slovakia,48.669,19.699,2545879,0,20126,2525753
6/18/22,Slovakia,48.669,19.699,2546134,0,20130,2526004
6/19/22,Slovakia,48.669,19.699,2546134,0,20130,2526004
6/20/22,Slovakia,48.669,19.699,2546346,0,20137,2526209
6/21/22,Slovakia,48.669,19.699,2546800,0,20137,2526663
6/22/22,Slovakia,48.669,19.699,2547229,0,20140,2527089
6/23/22,Slovakia,48.669,19.699,2547645,0,20142,2527503
6/24/22,Slovakia,48.669,19.699,2548069,0,20142,2527927
6/25/22,Slovakia,48.669,19.699,2548586,0,20142,2528444
6/26/22,Slovakia,48.669,19.699,2548819,0,20142,2528677
6/27/22,Slovakia,48.669,19.699,2548964,0,20142,2528822
6/28/22,Slovakia,48.669,19.699,2549692,0,20144,2529548
6/29/22,Slovakia,48.669,19.699,2550368,0,20146,2530222
6/30/22,Slovakia,48.669,19.699,2551116,0,20147,2530969
7/1/22,Slovakia,48.669,19.699,2551116,0,20147,2530969
7/2/22,Slovakia,48.669,19.699,2551116,0,20147,2530969
7/3/22,Slovakia,48.669,19.699,2551116,0,20147,2530969
7/4/22,Slovakia,48.669,19.699,2551116,0,20147,2530969
7/5/22,Slovakia,48.669,19.699,2551116,0,20147,2530969
7/6/22,Slovakia,48.669,19.699,2554112,0,20152,2533960
7/7/22,Slovakia,48.669,19.699,2555080,0,20154,2534926
7/8/22,Slovakia,48.669,19.699,2556052,0,20157,2535895
7/9/22,Slovakia,48.669,19.699,2557202,0,20159,2537043
7/10/22,Slovakia,48.669,19.699,2557640,0,20160,2537480
7/11/22,Slovakia,48.669,19.699,2557839,0,20160,2537679
7/12/22,Slovakia,48.669,19.699,2559088,0,20163,2538925
7/13/22,Slovakia,48.669,19.699,2560261,0,20166,2540095
7/14/22,Slovakia,48.669,19.699,2561338,0,20168,2541170
7/15/22,Slovakia,48.669,19.699,2562431,0,20169,2542262
7/16/22,Slovakia,48.669,19.699,2563799,0,20171,2543628
7/17/22,Slovakia,48.669,19.699,2564393,0,20172,2544221
7/18/22,Slovakia,48.669,19.699,2564633,0,20172,2544461
7/19/22,Slovakia,48.669,19.699,2566215,0,20176,2546039
7/20/22,Slovakia,48.669,19.699,2567776,0,20183,2547593
7/21/22,Slovakia,48.669,19.699,2569210,0,20188,2549022
7/22/22,Slovakia,48.669,19.699,2570582,0,20193,2550389
7/23/22,Slovakia,48.669,19.699,2571985,0,20195,2551790
7/24/22,Slovakia,48.669,19.699,2572792,0,20197,2552595
7/25/22,Slovakia,48.669,19.699,2573084,0,20198,2552886
7/26/22,Slovakia,48.669,19.699,2574932,0,20201,2554731
7/27/22,Slovakia,48.669,19.699,2576509,0,20206,2556303
7/28/22,Slovakia,48.669,19.699,2577417,0,20212,2557205
7/29/22,Slovakia,48.669,19.699,2578855,0,20216,2558639
7/30/22,Slovakia,48.669,19.699,2580451,0,20219,2560232
7/31/22,Slovakia,48.669,19.699,2581047,0,20223,2560824
8/1/22,Slovakia,48.669,19.699,2581323,0,20227,2561096
8/2/22,Slovakia,48.669,19.699,2582793,0,20232,2562561
8/3/22,Slovakia,48.669,19.699,2584276,0,20236,2564040
8/4/22,Slovakia,48.669,19.699,2580748,0,20236,2560512
8/5/22,Slovakia,48.669,19.699,2580748,0,20236,2560512
8/6/22,Slovakia,48.669,19.699,2580748,0,20236,2560512
8/7/22,Slovakia,48.669,19.699,2580748,0,20236,2560512
8/8/22,Slovakia,48.669,19.699,2580748,0,20236,2560512
8/9/22,Slovakia,48.669,19.699,2580748,0,20236,2560512
8/10/22,Slovakia,48.669,19.699,2580748,0,20236,2560512
8/11/22,Slovakia,48.669,19.699,2580748,0,20236,2560512
8/12/22,Slovakia,48.669,19.699,2580748,0,20236,2560512
8/13/22,Slovakia,48.669,19.699,2580748,0,20236,2560512
8/14/22,Slovakia,48.669,19.699,2580748,0,20236,2560512
8/15/22,Slovakia,48.669,19.699,2580748,0,20236,2560512
8/16/22,Slovakia,48.669,19.699,2580748,0,20236,2560512
8/17/22,Slovakia,48.669,19.699,2580748,0,20236,2560512
8/18/22,Slovakia,48.669,19.699,2580748,0,20236,2560512
8/19/22,Slovakia,48.669,19.699,2580748,0,20236,2560512
8/20/22,Slovakia,48.669,19.699,2580748,0,20236,2560512
8/21/22,Slovakia,48.669,19.699,2580748,0,20236,2560512
8/22/22,Slovakia,48.669,19.699,2580748,0,20236,2560512
8/23/22,Slovakia,48.669,19.699,2580748,0,20236,2560512
8/24/22,Slovakia,48.669,19.699,2580748,0,20236,2560512
8/25/22,Slovakia,48.669,19.699,2580748,0,20236,2560512
8/26/22,Slovakia,48.669,19.699,2580748,0,20236,2560512
8/27/22,Slovakia,48.669,19.699,2580748,0,20236,2560512
8/28/22,Slovakia,48.669,19.699,2580748,0,20236,2560512
8/29/22,Slovakia,48.669,19.699,2580748,0,20236,2560512
8/30/22,Slovakia,48.669,19.699,2580748,0,20236,2560512
8/31/22,Slovakia,48.669,19.699,2580748,0,20236,2560512
9/1/22,Slovakia,48.669,19.699,2580748,0,20236,2560512
9/2/22,Slovakia,48.669,19.699,2580748,0,20236,2560512
9/3/22,Slovakia,48.669,19.699,2580748,0,20236,2560512
9/4/22,Slovakia,48.669,19.699,2580748,0,20236,2560512
9/5/22,Slovakia,48.669,19.699,2580748,0,20236,2560512
9/6/22,Slovakia,48.669,19.699,2580748,0,20236,2560512
9/7/22,Slovakia,48.669,19.699,2580748,0,20236,2560512
9/8/22,Slovakia,48.669,19.699,2580748,0,20236,2560512
9/9/22,Slovakia,48.669,19.699,2580748,0,20236,2560512
9/10/22,Slovakia,48.669,19.699,2580748,0,20236,2560512
9/11/22,Slovakia,48.669,19.699,2580748,0,20236,2560512
9/12/22,Slovakia,48.669,19.699,2580748,0,20236,2560512
9/13/22,Slovakia,48.669,19.699,2580748,0,20236,2560512
9/14/22,Slovakia,48.669,19.699,2614381,0,20421,2593960
9/15/22,Slovakia,48.669,19.699,2614850,0,20426,2594424
9/16/22,Slovakia,48.669,19.699,2614999,0,20429,2594570
9/17/22,Slovakia,48.669,19.699,2615778,0,20433,2595345
9/18/22,Slovakia,48.669,19.699,2616071,0,20436,2595635
9/19/22,Slovakia,48.669,19.699,2616213,0,20436,2595777
9/20/22,Slovakia,48.669,19.699,2617274,0,20439,2596835
9/21/22,Slovakia,48.669,19.699,2618312,0,20439,2597873
9/22/22,Slovakia,48.669,19.699,2619156,0,20441,2598715
9/23/22,Slovakia,48.669,19.699,2619905,0,20443,2599462
9/24/22,Slovakia,48.669,19.699,2620636,0,20446,2600190
9/25/22,Slovakia,48.669,19.699,2620982,0,20448,2600534
9/26/22,Slovakia,48.669,19.699,2621147,0,20450,2600697
9/27/22,Slovakia,48.669,19.699,2622211,0,20453,2601758
9/28/22,Slovakia,48.669,19.699,2623345,0,20454,2602891
9/29/22,Slovakia,48.669,19.699,2624386,0,20455,2603931
9/30/22,Slovakia,48.669,19.699,2625317,0,20457,2604860
10/1/22,Slovakia,48.669,19.699,2626218,0,20459,2605759
10/2/22,Slovakia,48.669,19.699,2626595,0,20461,2606134
10/3/22,Slovakia,48.669,19.699,2626750,0,20462,2606288
10/4/22,Slovakia,48.669,19.699,2627964,0,20465,2607499
10/5/22,Slovakia,48.669,19.699,2629146,0,20467,2608679
10/6/22,Slovakia,48.669,19.699,2630134,0,20470,2609664
10/7/22,Slovakia,48.669,19.699,2631043,0,20472,2610571
10/8/22,Slovakia,48.669,19.699,2631965,0,20475,2611490
10/9/22,Slovakia,48.669,19.699,2632299,0,20478,2611821
10/10/22,Slovakia,48.669,19.699,2632434,0,20481,2611953
10/11/22,Slovakia,48.669,19.699,2633464,0,20485,2612979
10/12/22,Slovakia,48.669,19.699,2634435,0,20491,2613944
10/13/22,Slovakia,48.669,19.699,2635303,0,20496,2614807
10/14/22,Slovakia,48.669,19.699,2635955,0,20501,2615454
10/15/22,Slovakia,48.669,19.699,2636652,0,20507,2616145
10/16/22,Slovakia,48.669,19.699,2636880,0,20511,2616369
10/17/22,Slovakia,48.669,19.699,2637041,0,20518,2616523
10/18/22,Slovakia,48.669,19.699,2637967,0,20523,2617444
10/19/22,Slovakia,48.669,19.699,2638637,0,20530,2618107
10/20/22,Slovakia,48.669,19.699,2639268,0,20538,2618730
10/21/22,Slovakia,48.669,19.699,2639764,0,20543,2619221
10/22/22,Slovakia,48.669,19.699,2640305,0,20551,2619754
10/23/22,Slovakia,48.669,19.699,2640491,0,20557,2619934
10/24/22,Slovakia,48.669,19.699,2640612,0,20564,2620048
10/25/22,Slovakia,48.669,19.699,2641225,0,20573,2620652
10/26/22,Slovakia,48.669,19.699,2641696,0,20579,2621117
10/27/22,Slovakia,48.669,19.699,2642129,0,20586,2621543
10/28/22,Slovakia,48.669,19.699,2642518,0,20592,2621926
10/29/22,Slovakia,48.669,19.699,2642968,0,20597,2622371
10/30/22,Slovakia,48.669,19.699,2643113,0,20601,2622512
10/31/22,Slovakia,48.669,19.699,2643182,0,20606,2622576
11/1/22,Slovakia,48.669,19.699,2643658,0,20609,2623049
11/2/22,Slovakia,48.669,19.699,2643774,0,20614,2623160
11/3/22,Slovakia,48.669,19.699,2644213,0,20620,2623593
11/4/22,Slovakia,48.669,19.699,2644627,0,20624,2624003
11/5/22,Slovakia,48.669,19.699,2644984,0,20629,2624355
11/6/22,Slovakia,48.669,19.699,2645118,0,20635,2624483
11/7/22,Slovakia,48.669,19.699,2645192,0,20641,2624551
11/8/22,Slovakia,48.669,19.699,2645588,0,20645,2624943
11/9/22,Slovakia,48.669,19.699,2645927,0,20651,2625276
11/10/22,Slovakia,48.669,19.699,2646203,0,20656,2625547
11/11/22,Slovakia,48.669,19.699,2646511,0,20663,2625848
11/12/22,Slovakia,48.669,19.699,2646740,0,20670,2626070
11/13/22,Slovakia,48.669,19.699,2646860,0,20676,2626184
11/14/22,Slovakia,48.669,19.699,2646893,0,20684,2626209
11/15/22,Slovakia,48.669,19.699,2647233,0,20689,2626544
11/16/22,Slovakia,48.669,19.699,2647488,0,20696,2626792
11/17/22,Slovakia,48.669,19.699,2647741,0,20700,2627041
11/18/22,Slovakia,48.669,19.699,2647809,0,20705,2627104
11/19/22,Slovakia,48.669,19.699,2647985,0,20709,2627276
11/20/22,Slovakia,48.669,19.699,2648095,0,20711,2627384
11/21/22,Slovakia,48.669,19.699,2648151,0,20712,2627439
11/22/22,Slovakia,48.669,19.699,2648456,0,20715,2627741
11/23/22,Slovakia,48.669,19.699,2648680,0,20719,2627961
11/24/22,Slovakia,48.669,19.699,2648927,0,20722,2628205
11/25/22,Slovakia,48.669,19.699,2649166,0,20725,2628441
11/26/22,Slovakia,48.669,19.699,2649432,0,20727,2628705
11/27/22,Slovakia,48.669,19.699,2649520,0,20729,2628791
11/28/22,Slovakia,48.669,19.699,2649580,0,20729,2628851
11/29/22,Slovakia,48.669,19.699,2649967,0,20732,2629235
11/30/22,Slovakia,48.669,19.699,2650230,0,20733,2629497
12/1/22,Slovakia,48.669,19.699,2650472,0,20734,2629738
12/2/22,Slovakia,48.669,19.699,2650690,0,20737,2629953
12/3/22,Slovakia,48.669,19.699,2650937,0,20740,2630197
12/4/22,Slovakia,48.669,19.699,2651038,0,20741,2630297
12/5/22,Slovakia,48.669,19.699,2651069,0,20742,2630327
12/6/22,Slovakia,48.669,19.699,2651459,0,20745,2630714
12/7/22,Slovakia,48.669,19.699,2651788,0,20747,2631041
12/8/22,Slovakia,48.669,19.699,2652086,0,20750,2631336
12/9/22,Slovakia,48.669,19.699,2652388,0,20752,2631636
12/10/22,Slovakia,48.669,19.699,2652676,0,20756,2631920
12/11/22,Slovakia,48.669,19.699,2652759,0,20761,2631998
12/12/22,Slovakia,48.669,19.699,2652801,0,20764,2632037
12/13/22,Slovakia,48.669,19.699,2653246,0,20770,2632476
12/14/22,Slovakia,48.669,19.699,2653639,0,20773,2632866
12/15/22,Slovakia,48.669,19.699,2653925,0,20776,2633149
12/16/22,Slovakia,48.669,19.699,2654148,0,20778,2633370
12/17/22,Slovakia,48.669,19.699,2654422,0,20781,2633641
1/1/22,Slovenia,46.1512,14.9955,465711,0,5597,460114
1/2/22,Slovenia,46.1512,14.9955,466554,0,5603,460951
1/3/22,Slovenia,46.1512,14.9955,467565,0,5614,461951
1/4/22,Slovenia,46.1512,14.9955,470960,0,5623,465337
1/5/22,Slovenia,46.1512,14.9955,475027,0,5629,469398
1/6/22,Slovenia,46.1512,14.9955,478860,0,5634,473226
1/7/22,Slovenia,46.1512,14.9955,482927,0,5644,477283
1/8/22,Slovenia,46.1512,14.9955,487437,0,5650,481787
1/9/22,Slovenia,46.1512,14.9955,490784,0,5655,485129
1/10/22,Slovenia,46.1512,14.9955,493289,0,5662,487627
1/11/22,Slovenia,46.1512,14.9955,498506,0,5666,492840
1/12/22,Slovenia,46.1512,14.9955,505929,0,5678,500251
1/13/22,Slovenia,46.1512,14.9955,512793,0,5685,507108
1/14/22,Slovenia,46.1512,14.9955,519714,0,5691,514023
1/15/22,Slovenia,46.1512,14.9955,527311,0,5696,521615
1/16/22,Slovenia,46.1512,14.9955,533334,0,5698,527636
1/17/22,Slovenia,46.1512,14.9955,538325,0,5705,532620
1/18/22,Slovenia,46.1512,14.9955,547013,0,5715,541298
1/19/22,Slovenia,46.1512,14.9955,559312,0,5722,553590
1/20/22,Slovenia,46.1512,14.9955,569620,0,5732,563888
1/21/22,Slovenia,46.1512,14.9955,579480,0,5743,573737
1/22/22,Slovenia,46.1512,14.9955,589458,0,5751,583707
1/23/22,Slovenia,46.1512,14.9955,603341,0,5772,597569
1/24/22,Slovenia,46.1512,14.9955,612017,0,5787,606230
1/25/22,Slovenia,46.1512,14.9955,624851,0,5798,619053
1/26/22,Slovenia,46.1512,14.9955,642342,0,5813,636529
1/27/22,Slovenia,46.1512,14.9955,656569,0,5827,650742
1/28/22,Slovenia,46.1512,14.9955,673154,0,5835,667319
1/29/22,Slovenia,46.1512,14.9955,688336,0,5846,682490
1/30/22,Slovenia,46.1512,14.9955,702201,0,5857,696344
1/31/22,Slovenia,46.1512,14.9955,710821,0,5866,704955
2/1/22,Slovenia,46.1512,14.9955,722648,0,5880,716768
2/2/22,Slovenia,46.1512,14.9955,745980,0,5893,740087
2/3/22,Slovenia,46.1512,14.9955,762840,0,5912,756928
2/4/22,Slovenia,46.1512,14.9955,774584,0,5933,768651
2/5/22,Slovenia,46.1512,14.9955,786957,0,5959,780998
2/6/22,Slovenia,46.1512,14.9955,794443,0,5975,788468
2/7/22,Slovenia,46.1512,14.9955,800012,0,5990,794022
2/8/22,Slovenia,46.1512,14.9955,811174,0,6012,805162
2/9/22,Slovenia,46.1512,14.9955,816299,0,6028,810271
2/10/22,Slovenia,46.1512,14.9955,828508,0,6049,822459
2/11/22,Slovenia,46.1512,14.9955,836088,0,6059,830029
2/12/22,Slovenia,46.1512,14.9955,843495,0,6074,837421
2/13/22,Slovenia,46.1512,14.9955,847777,0,6081,841696
2/14/22,Slovenia,46.1512,14.9955,851416,0,6099,845317
2/15/22,Slovenia,46.1512,14.9955,858670,0,6122,852548
2/16/22,Slovenia,46.1512,14.9955,863461,0,6137,857324
2/17/22,Slovenia,46.1512,14.9955,868142,0,6152,861990
2/18/22,Slovenia,46.1512,14.9955,871951,0,6174,865777
2/19/22,Slovenia,46.1512,14.9955,875747,0,6184,869563
2/20/22,Slovenia,46.1512,14.9955,878036,0,6203,871833
2/21/22,Slovenia,46.1512,14.9955,880073,0,6222,873851
2/22/22,Slovenia,46.1512,14.9955,882364,0,6236,876128
2/23/22,Slovenia,46.1512,14.9955,884830,0,6246,878584
2/24/22,Slovenia,46.1512,14.9955,887224,0,6257,880967
2/25/22,Slovenia,46.1512,14.9955,889202,0,6264,882938
2/26/22,Slovenia,46.1512,14.9955,891041,0,6276,884765
2/27/22,Slovenia,46.1512,14.9955,891950,0,6292,885658
2/28/22,Slovenia,46.1512,14.9955,892620,0,6307,886313
3/1/22,Slovenia,46.1512,14.9955,895174,0,6318,888856
3/2/22,Slovenia,46.1512,14.9955,897040,0,6327,890713
3/3/22,Slovenia,46.1512,14.9955,898947,0,6337,892610
3/4/22,Slovenia,46.1512,14.9955,900857,0,6341,894516
3/5/22,Slovenia,46.1512,14.9955,902744,0,6351,896393
3/6/22,Slovenia,46.1512,14.9955,903686,0,6363,897323
3/7/22,Slovenia,46.1512,14.9955,904459,0,6367,898092
3/8/22,Slovenia,46.1512,14.9955,907630,0,6374,901256
3/9/22,Slovenia,46.1512,14.9955,909863,0,6382,903481
3/10/22,Slovenia,46.1512,14.9955,912193,0,6388,905805
3/11/22,Slovenia,46.1512,14.9955,914427,0,6396,908031
3/12/22,Slovenia,46.1512,14.9955,916712,0,6404,910308
3/13/22,Slovenia,46.1512,14.9955,917820,0,6410,911410
3/14/22,Slovenia,46.1512,14.9955,918762,0,6415,912347
3/15/22,Slovenia,46.1512,14.9955,923011,0,6419,916592
3/16/22,Slovenia,46.1512,14.9955,925939,0,6424,919515
3/17/22,Slovenia,46.1512,14.9955,929013,0,6428,922585
3/18/22,Slovenia,46.1512,14.9955,932155,0,6429,925726
3/19/22,Slovenia,46.1512,14.9955,935373,0,6435,928938
3/20/22,Slovenia,46.1512,14.9955,936847,0,6442,930405
3/21/22,Slovenia,46.1512,14.9955,937936,0,6449,931487
3/22/22,Slovenia,46.1512,14.9955,942954,0,6451,936503
3/23/22,Slovenia,46.1512,14.9955,946340,0,6454,939886
3/24/22,Slovenia,46.1512,14.9955,949640,0,6461,943179
3/25/22,Slovenia,46.1512,14.9955,952479,0,6469,946010
3/26/22,Slovenia,46.1512,14.9955,955473,0,6471,949002
3/27/22,Slovenia,46.1512,14.9955,956742,0,6475,950267
3/28/22,Slovenia,46.1512,14.9955,957720,0,6479,951241
3/29/22,Slovenia,46.1512,14.9955,962199,0,6480,955719
3/30/22,Slovenia,46.1512,14.9955,965295,0,6482,958813
3/31/22,Slovenia,46.1512,14.9955,968109,0,6487,961622
4/1/22,Slovenia,46.1512,14.9955,970541,0,6493,964048
4/2/22,Slovenia,46.1512,14.9955,972899,0,6498,966401
4/3/22,Slovenia,46.1512,14.9955,973876,0,6501,967375
4/4/22,Slovenia,46.1512,14.9955,974694,0,6505,968189
4/5/22,Slovenia,46.1512,14.9955,978134,0,6512,971622
4/6/22,Slovenia,46.1512,14.9955,980451,0,6517,973934
4/7/22,Slovenia,46.1512,14.9955,982784,0,6523,976261
4/8/22,Slovenia,46.1512,14.9955,984838,0,6527,978311
4/9/22,Slovenia,46.1512,14.9955,986719,0,6531,980188
4/10/22,Slovenia,46.1512,14.9955,987527,0,6535,980992
4/11/22,Slovenia,46.1512,14.9955,988066,0,6538,981528
4/12/22,Slovenia,46.1512,14.9955,990788,0,6541,984247
4/13/22,Slovenia,46.1512,14.9955,992497,0,6545,985952
4/14/22,Slovenia,46.1512,14.9955,994164,0,6552,987612
4/15/22,Slovenia,46.1512,14.9955,995515,0,6555,988960
4/16/22,Slovenia,46.1512,14.9955,996832,0,6556,990276
4/17/22,Slovenia,46.1512,14.9955,997395,0,6557,990838
4/18/22,Slovenia,46.1512,14.9955,997766,0,6560,991206
4/19/22,Slovenia,46.1512,14.9955,998247,0,6564,991683
4/20/22,Slovenia,46.1512,14.9955,1000432,0,6567,993865
4/21/22,Slovenia,46.1512,14.9955,1001713,0,6568,995145
4/22/22,Slovenia,46.1512,14.9955,1002908,0,6569,996339
4/23/22,Slovenia,46.1512,14.9955,1003970,0,6576,997394
4/24/22,Slovenia,46.1512,14.9955,1004466,0,6578,997888
4/25/22,Slovenia,46.1512,14.9955,1004798,0,6582,998216
4/26/22,Slovenia,46.1512,14.9955,1006377,0,6585,999792
4/27/22,Slovenia,46.1512,14.9955,1007538,0,6586,1000952
4/28/22,Slovenia,46.1512,14.9955,1007821,0,6588,1001233
4/29/22,Slovenia,46.1512,14.9955,1009085,0,6592,1002493
4/30/22,Slovenia,46.1512,14.9955,1010058,0,6592,1003466
5/1/22,Slovenia,46.1512,14.9955,1010555,0,6593,1003962
5/2/22,Slovenia,46.1512,14.9955,1010785,0,6595,1004190
5/3/22,Slovenia,46.1512,14.9955,1011253,0,6598,1004655
5/4/22,Slovenia,46.1512,14.9955,1012915,0,6602,1006313
5/5/22,Slovenia,46.1512,14.9955,1013935,0,6605,1007330
5/6/22,Slovenia,46.1512,14.9955,1014699,0,6608,1008091
5/7/22,Slovenia,46.1512,14.9955,1015456,0,6611,1008845
5/8/22,Slovenia,46.1512,14.9955,1015779,0,6611,1009168
5/9/22,Slovenia,46.1512,14.9955,1015982,0,6613,1009369
5/10/22,Slovenia,46.1512,14.9955,1016993,0,6613,1010380
5/11/22,Slovenia,46.1512,14.9955,1017676,0,6616,1011060
5/12/22,Slovenia,46.1512,14.9955,1018298,0,6617,1011681
5/13/22,Slovenia,46.1512,14.9955,1018900,0,6619,1012281
5/14/22,Slovenia,46.1512,14.9955,1019468,0,6622,1012846
5/15/22,Slovenia,46.1512,14.9955,1019468,0,6622,1012846
5/16/22,Slovenia,46.1512,14.9955,1019834,0,6625,1013209
5/17/22,Slovenia,46.1512,14.9955,1020580,0,6626,1013954
5/18/22,Slovenia,46.1512,14.9955,1021136,0,6627,1014509
5/19/22,Slovenia,46.1512,14.9955,1021550,0,6628,1014922
5/20/22,Slovenia,46.1512,14.9955,1021965,0,6628,1015337
5/21/22,Slovenia,46.1512,14.9955,1021965,0,6628,1015337
5/22/22,Slovenia,46.1512,14.9955,1022514,0,6629,1015885
5/23/22,Slovenia,46.1512,14.9955,1022600,0,6630,1015970
5/24/22,Slovenia,46.1512,14.9955,1023191,0,6631,1016560
5/25/22,Slovenia,46.1512,14.9955,1023588,0,6631,1016957
5/26/22,Slovenia,46.1512,14.9955,1023922,0,6634,1017288
5/27/22,Slovenia,46.1512,14.9955,1024219,0,6634,1017585
5/28/22,Slovenia,46.1512,14.9955,1024482,0,6636,1017846
5/29/22,Slovenia,46.1512,14.9955,1024482,0,6636,1017846
5/30/22,Slovenia,46.1512,14.9955,1024643,0,6637,1018006
5/31/22,Slovenia,46.1512,14.9955,1025030,0,6637,1018393
6/1/22,Slovenia,46.1512,14.9955,1025367,0,6640,1018727
6/2/22,Slovenia,46.1512,14.9955,1025656,0,6640,1019016
6/3/22,Slovenia,46.1512,14.9955,1025913,0,6640,1019273
6/4/22,Slovenia,46.1512,14.9955,1025913,0,6640,1019273
6/5/22,Slovenia,46.1512,14.9955,1026292,0,6642,1019650
6/6/22,Slovenia,46.1512,14.9955,1026372,0,6642,1019730
6/7/22,Slovenia,46.1512,14.9955,1026834,0,6642,1020192
6/8/22,Slovenia,46.1512,14.9955,1026834,0,6642,1020192
6/9/22,Slovenia,46.1512,14.9955,1027524,0,6643,1020881
6/10/22,Slovenia,46.1512,14.9955,1027821,0,6644,1021177
6/11/22,Slovenia,46.1512,14.9955,1027821,0,6644,1021177
6/12/22,Slovenia,46.1512,14.9955,1027821,0,6644,1021177
6/13/22,Slovenia,46.1512,14.9955,1028376,0,6644,1021732
6/14/22,Slovenia,46.1512,14.9955,1028943,0,6645,1022298
6/15/22,Slovenia,46.1512,14.9955,1029415,0,6645,1022770
6/16/22,Slovenia,46.1512,14.9955,1029887,0,6645,1023242
6/17/22,Slovenia,46.1512,14.9955,1030354,0,6646,1023708
6/18/22,Slovenia,46.1512,14.9955,1030354,0,6646,1023708
6/19/22,Slovenia,46.1512,14.9955,1030354,0,6646,1023708
6/20/22,Slovenia,46.1512,14.9955,1031216,0,6646,1024570
6/21/22,Slovenia,46.1512,14.9955,1032072,0,6646,1025426
6/22/22,Slovenia,46.1512,14.9955,1032748,0,6647,1026101
6/23/22,Slovenia,46.1512,14.9955,1033524,0,6647,1026877
6/24/22,Slovenia,46.1512,14.9955,1034172,0,6648,1027524
6/25/22,Slovenia,46.1512,14.9955,1034172,0,6648,1027524
6/26/22,Slovenia,46.1512,14.9955,1034172,0,6648,1027524
6/27/22,Slovenia,46.1512,14.9955,1035420,0,6649,1028771
6/28/22,Slovenia,46.1512,14.9955,1036653,0,6651,1030002
6/29/22,Slovenia,46.1512,14.9955,1037714,0,6651,1031063
6/30/22,Slovenia,46.1512,14.9955,1038716,0,6651,1032065
7/1/22,Slovenia,46.1512,14.9955,1039632,0,6652,1032980
7/2/22,Slovenia,46.1512,14.9955,1039632,0,6652,1032980
7/3/22,Slovenia,46.1512,14.9955,1039632,0,6652,1032980
7/4/22,Slovenia,46.1512,14.9955,1041426,0,6655,1034771
7/5/22,Slovenia,46.1512,14.9955,1043268,0,6657,1036611
7/6/22,Slovenia,46.1512,14.9955,1044765,0,6657,1038108
7/7/22,Slovenia,46.1512,14.9955,1046425,0,6657,1039768
7/8/22,Slovenia,46.1512,14.9955,1047765,0,6659,1041106
7/9/22,Slovenia,46.1512,14.9955,1049215,0,6659,1042556
7/10/22,Slovenia,46.1512,14.9955,1049710,0,6660,1043050
7/11/22,Slovenia,46.1512,14.9955,1050175,0,6660,1043515
7/12/22,Slovenia,46.1512,14.9955,1052574,0,6661,1045913
7/13/22,Slovenia,46.1512,14.9955,1054441,0,6662,1047779
7/14/22,Slovenia,46.1512,14.9955,1056201,0,6665,1049536
7/15/22,Slovenia,46.1512,14.9955,1057817,0,6666,1051151
7/16/22,Slovenia,46.1512,14.9955,1059682,0,6667,1053015
7/17/22,Slovenia,46.1512,14.9955,1060248,0,6667,1053581
7/18/22,Slovenia,46.1512,14.9955,1060808,0,6668,1054140
7/19/22,Slovenia,46.1512,14.9955,1063613,0,6668,1056945
7/20/22,Slovenia,46.1512,14.9955,1065473,0,6670,1058803
7/21/22,Slovenia,46.1512,14.9955,1067317,0,6673,1060644
7/22/22,Slovenia,46.1512,14.9955,1068962,0,6678,1062284
7/23/22,Slovenia,46.1512,14.9955,1070874,0,6681,1064193
7/24/22,Slovenia,46.1512,14.9955,1071573,0,6681,1064892
7/25/22,Slovenia,46.1512,14.9955,1072182,0,6686,1065496
7/26/22,Slovenia,46.1512,14.9955,1075196,0,6686,1068510
7/27/22,Slovenia,46.1512,14.9955,1077189,0,6688,1070501
7/28/22,Slovenia,46.1512,14.9955,1079192,0,6690,1072502
7/29/22,Slovenia,46.1512,14.9955,1080710,0,6691,1074019
7/30/22,Slovenia,46.1512,14.9955,1082492,0,6694,1075798
7/31/22,Slovenia,46.1512,14.9955,1083067,0,6698,1076369
8/1/22,Slovenia,46.1512,14.9955,1083661,0,6700,1076961
8/2/22,Slovenia,46.1512,14.9955,1086337,0,6702,1079635
8/3/22,Slovenia,46.1512,14.9955,1088205,0,6705,1081500
8/4/22,Slovenia,46.1512,14.9955,1089921,0,6707,1083214
8/5/22,Slovenia,46.1512,14.9955,1091420,0,6720,1084700
8/6/22,Slovenia,46.1512,14.9955,1093023,0,6721,1086302
8/7/22,Slovenia,46.1512,14.9955,1093584,0,6721,1086863
8/8/22,Slovenia,46.1512,14.9955,1094104,0,6726,1087378
8/9/22,Slovenia,46.1512,14.9955,1096506,0,6732,1089774
8/10/22,Slovenia,46.1512,14.9955,1098327,0,6738,1091589
8/11/22,Slovenia,46.1512,14.9955,1099952,0,6741,1093211
8/12/22,Slovenia,46.1512,14.9955,1101368,0,6743,1094625
8/13/22,Slovenia,46.1512,14.9955,1102935,0,6745,1096190
8/14/22,Slovenia,46.1512,14.9955,1103466,0,6747,1096719
8/15/22,Slovenia,46.1512,14.9955,1103963,0,6750,1097213
8/16/22,Slovenia,46.1512,14.9955,1104546,0,6752,1097794
8/17/22,Slovenia,46.1512,14.9955,1107198,0,6753,1100445
8/18/22,Slovenia,46.1512,14.9955,1108454,0,6753,1101701
8/19/22,Slovenia,46.1512,14.9955,1110255,0,6755,1103500
8/20/22,Slovenia,46.1512,14.9955,1111936,0,6756,1105180
8/21/22,Slovenia,46.1512,14.9955,1112481,0,6757,1105724
8/22/22,Slovenia,46.1512,14.9955,1112949,0,6758,1106191
8/23/22,Slovenia,46.1512,14.9955,1115286,0,6761,1108525
8/24/22,Slovenia,46.1512,14.9955,1116916,0,6765,1110151
8/25/22,Slovenia,46.1512,14.9955,1118541,0,6767,1111774
8/26/22,Slovenia,46.1512,14.9955,1120443,0,6771,1113672
8/27/22,Slovenia,46.1512,14.9955,1121965,0,6774,1115191
8/28/22,Slovenia,46.1512,14.9955,1122495,0,6777,1115718
8/29/22,Slovenia,46.1512,14.9955,1122961,0,6782,1116179
8/30/22,Slovenia,46.1512,14.9955,1125145,0,6782,1118363
8/31/22,Slovenia,46.1512,14.9955,1126715,0,6783,1119932
9/1/22,Slovenia,46.1512,14.9955,1128269,0,6784,1121485
9/2/22,Slovenia,46.1512,14.9955,1129551,0,6786,1122765
9/3/22,Slovenia,46.1512,14.9955,1130856,0,6787,1124069
9/4/22,Slovenia,46.1512,14.9955,1131342,0,6787,1124555
9/5/22,Slovenia,46.1512,14.9955,1131747,0,6787,1124960
9/6/22,Slovenia,46.1512,14.9955,1134394,0,6787,1127607
9/7/22,Slovenia,46.1512,14.9955,1136236,0,6789,1129447
9/8/22,Slovenia,46.1512,14.9955,1138346,0,6789,1131557
9/9/22,Slovenia,46.1512,14.9955,1139987,0,6791,1133196
9/10/22,Slovenia,46.1512,14.9955,1142042,0,6792,1135250
9/11/22,Slovenia,46.1512,14.9955,1142670,0,6793,1135877
9/12/22,Slovenia,46.1512,14.9955,1143235,0,6794,1136441
9/13/22,Slovenia,46.1512,14.9955,1146802,0,6795,1140007
9/14/22,Slovenia,46.1512,14.9955,1149364,0,6799,1142565
9/15/22,Slovenia,46.1512,14.9955,1151774,0,6802,1144972
9/16/22,Slovenia,46.1512,14.9955,1153964,0,6802,1147162
9/17/22,Slovenia,46.1512,14.9955,1156307,0,6803,1149504
9/18/22,Slovenia,46.1512,14.9955,1157071,0,6803,1150268
9/19/22,Slovenia,46.1512,14.9955,1157703,0,6805,1150898
9/20/22,Slovenia,46.1512,14.9955,1161178,0,6808,1154370
9/21/22,Slovenia,46.1512,14.9955,1163631,0,6808,1156823
9/22/22,Slovenia,46.1512,14.9955,1166064,0,6809,1159255
9/23/22,Slovenia,46.1512,14.9955,1168036,0,6809,1161227
9/24/22,Slovenia,46.1512,14.9955,1170202,0,6810,1163392
9/25/22,Slovenia,46.1512,14.9955,1170936,0,6812,1164124
9/26/22,Slovenia,46.1512,14.9955,1171695,0,6814,1164881
9/27/22,Slovenia,46.1512,14.9955,1175643,0,6815,1168828
9/28/22,Slovenia,46.1512,14.9955,1178415,0,6816,1171599
9/29/22,Slovenia,46.1512,14.9955,1181073,0,6821,1174252
9/30/22,Slovenia,46.1512,14.9955,1183392,0,6822,1176570
10/1/22,Slovenia,46.1512,14.9955,1185918,0,6825,1179093
10/2/22,Slovenia,46.1512,14.9955,1186809,0,6826,1179983
10/3/22,Slovenia,46.1512,14.9955,1187592,0,6826,1180766
10/4/22,Slovenia,46.1512,14.9955,1191573,0,6827,1184746
10/5/22,Slovenia,46.1512,14.9955,1194561,0,6829,1187732
10/6/22,Slovenia,46.1512,14.9955,1197150,0,6832,1190318
10/7/22,Slovenia,46.1512,14.9955,1199381,0,6833,1192548
10/8/22,Slovenia,46.1512,14.9955,1201767,0,6836,1194931
10/9/22,Slovenia,46.1512,14.9955,1202548,0,6836,1195712
10/10/22,Slovenia,46.1512,14.9955,1203345,0,6842,1196503
10/11/22,Slovenia,46.1512,14.9955,1207041,0,6845,1200196
10/12/22,Slovenia,46.1512,14.9955,1209326,0,6847,1202479
10/13/22,Slovenia,46.1512,14.9955,1211499,0,6848,1204651
10/14/22,Slovenia,46.1512,14.9955,1213305,0,6848,1206457
10/15/22,Slovenia,46.1512,14.9955,1215166,0,6849,1208317
10/16/22,Slovenia,46.1512,14.9955,1215720,0,6852,1208868
10/17/22,Slovenia,46.1512,14.9955,1216276,0,6855,1209421
10/18/22,Slovenia,46.1512,14.9955,1219095,0,6858,1212237
10/19/22,Slovenia,46.1512,14.9955,1220889,0,6864,1214025
10/20/22,Slovenia,46.1512,14.9955,1222557,0,6865,1215692
10/21/22,Slovenia,46.1512,14.9955,1223928,0,6868,1217060
10/22/22,Slovenia,46.1512,14.9955,1225251,0,6870,1218381
10/23/22,Slovenia,46.1512,14.9955,1225660,0,6872,1218788
10/24/22,Slovenia,46.1512,14.9955,1226109,0,6875,1219234
10/25/22,Slovenia,46.1512,14.9955,1228217,0,6876,1221341
10/26/22,Slovenia,46.1512,14.9955,1229711,0,6877,1222834
10/27/22,Slovenia,46.1512,14.9955,1230970,0,6878,1224092
10/28/22,Slovenia,46.1512,14.9955,1231922,0,6882,1225040
10/29/22,Slovenia,46.1512,14.9955,1232864,0,6885,1225979
10/30/22,Slovenia,46.1512,14.9955,1233155,0,6887,1226268
10/31/22,Slovenia,46.1512,14.9955,1233482,0,6889,1226593
11/1/22,Slovenia,46.1512,14.9955,1233870,0,6889,1226981
11/2/22,Slovenia,46.1512,14.9955,1234223,0,6890,1227333
11/3/22,Slovenia,46.1512,14.9955,1235756,0,6891,1228865
11/4/22,Slovenia,46.1512,14.9955,1236787,0,6892,1229895
11/5/22,Slovenia,46.1512,14.9955,1237624,0,6893,1230731
11/6/22,Slovenia,46.1512,14.9955,1237884,0,6895,1230989
11/7/22,Slovenia,46.1512,14.9955,1238191,0,6900,1231291
11/8/22,Slovenia,46.1512,14.9955,1239383,0,6903,1232480
11/9/22,Slovenia,46.1512,14.9955,1240194,0,6906,1233288
11/10/22,Slovenia,46.1512,14.9955,1240891,0,6908,1233983
11/11/22,Slovenia,46.1512,14.9955,1241455,0,6909,1234546
11/12/22,Slovenia,46.1512,14.9955,1242130,0,6899,1235231
11/13/22,Slovenia,46.1512,14.9955,1242314,0,6899,1235415
11/14/22,Slovenia,46.1512,14.9955,1242573,0,6901,1235672
11/15/22,Slovenia,46.1512,14.9955,1243778,0,6903,1236875
11/16/22,Slovenia,46.1512,14.9955,1244721,0,6903,1237818
11/17/22,Slovenia,46.1512,14.9955,1245626,0,6905,1238721
11/18/22,Slovenia,46.1512,14.9955,1246440,0,6905,1239535
11/19/22,Slovenia,46.1512,14.9955,1247372,0,6907,1240465
11/20/22,Slovenia,46.1512,14.9955,1247664,0,6909,1240755
11/21/22,Slovenia,46.1512,14.9955,1247979,0,6911,1241068
11/22/22,Slovenia,46.1512,14.9955,1249572,0,6915,1242657
11/23/22,Slovenia,46.1512,14.9955,1250731,0,6917,1243814
11/24/22,Slovenia,46.1512,14.9955,1251867,0,6923,1244944
11/25/22,Slovenia,46.1512,14.9955,1252901,0,6928,1245973
11/26/22,Slovenia,46.1512,14.9955,1253991,0,6928,1247063
11/27/22,Slovenia,46.1512,14.9955,1254384,0,6928,1247456
11/28/22,Slovenia,46.1512,14.9955,1254808,0,6930,1247878
11/29/22,Slovenia,46.1512,14.9955,1256814,0,6932,1249882
11/30/22,Slovenia,46.1512,14.9955,1258446,0,6933,1251513
12/1/22,Slovenia,46.1512,14.9955,1260071,0,6936,1253135
12/2/22,Slovenia,46.1512,14.9955,1261489,0,6938,1254551
12/3/22,Slovenia,46.1512,14.9955,1262996,0,6939,1256057
12/4/22,Slovenia,46.1512,14.9955,1263487,0,6940,1256547
12/5/22,Slovenia,46.1512,14.9955,1264000,0,6943,1257057
12/6/22,Slovenia,46.1512,14.9955,1266751,0,6944,1259807
12/7/22,Slovenia,46.1512,14.9955,1269058,0,6945,1262113
12/8/22,Slovenia,46.1512,14.9955,1271249,0,6946,1264303
12/9/22,Slovenia,46.1512,14.9955,1273067,0,6947,1266120
12/10/22,Slovenia,46.1512,14.9955,1274949,0,6949,1268000
12/11/22,Slovenia,46.1512,14.9955,1275513,0,6952,1268561
12/12/22,Slovenia,46.1512,14.9955,1276150,0,6955,1269195
12/13/22,Slovenia,46.1512,14.9955,1279297,0,6958,1272339
12/14/22,Slovenia,46.1512,14.9955,1281705,0,6962,1274743
12/15/22,Slovenia,46.1512,14.9955,1283998,0,6964,1277034
12/16/22,Slovenia,46.1512,14.9955,1285920,0,6966,1278954
12/17/22,Slovenia,46.1512,14.9955,1287781,0,6968,1280813
1/1/22,Solomon Islands,-9.6457,160.1562,24,0,0,24
1/2/22,Solomon Islands,-9.6457,160.1562,24,0,0,24
1/3/22,Solomon Islands,-9.6457,160.1562,24,0,0,24
1/4/22,Solomon Islands,-9.6457,160.1562,24,0,0,24
1/5/22,Solomon Islands,-9.6457,160.1562,24,0,0,24
1/6/22,Solomon Islands,-9.6457,160.1562,28,0,0,28
1/7/22,Solomon Islands,-9.6457,160.1562,28,0,0,28
1/8/22,Solomon Islands,-9.6457,160.1562,28,0,0,28
1/9/22,Solomon Islands,-9.6457,160.1562,28,0,0,28
1/10/22,Solomon Islands,-9.6457,160.1562,28,0,0,28
1/11/22,Solomon Islands,-9.6457,160.1562,25,0,0,25
1/12/22,Solomon Islands,-9.6457,160.1562,25,0,0,25
1/13/22,Solomon Islands,-9.6457,160.1562,25,0,0,25
1/14/22,Solomon Islands,-9.6457,160.1562,25,0,0,25
1/15/22,Solomon Islands,-9.6457,160.1562,25,0,0,25
1/16/22,Solomon Islands,-9.6457,160.1562,25,0,0,25
1/17/22,Solomon Islands,-9.6457,160.1562,25,0,0,25
1/18/22,Solomon Islands,-9.6457,160.1562,32,0,0,32
1/19/22,Solomon Islands,-9.6457,160.1562,33,0,0,33
1/20/22,Solomon Islands,-9.6457,160.1562,81,0,0,81
1/21/22,Solomon Islands,-9.6457,160.1562,81,0,0,81
1/22/22,Solomon Islands,-9.6457,160.1562,289,0,0,289
1/23/22,Solomon Islands,-9.6457,160.1562,289,0,0,289
1/24/22,Solomon Islands,-9.6457,160.1562,289,0,0,289
1/25/22,Solomon Islands,-9.6457,160.1562,650,0,2,648
1/26/22,Solomon Islands,-9.6457,160.1562,676,0,2,674
1/27/22,Solomon Islands,-9.6457,160.1562,755,0,5,750
1/28/22,Solomon Islands,-9.6457,160.1562,898,0,5,893
1/29/22,Solomon Islands,-9.6457,160.1562,898,0,5,893
1/30/22,Solomon Islands,-9.6457,160.1562,898,0,5,893
1/31/22,Solomon Islands,-9.6457,160.1562,1183,0,9,1174
2/1/22,Solomon Islands,-9.6457,160.1562,1486,0,12,1474
2/2/22,Solomon Islands,-9.6457,160.1562,2167,0,15,2152
2/3/22,Solomon Islands,-9.6457,160.1562,2357,0,21,2336
2/4/22,Solomon Islands,-9.6457,160.1562,2357,0,21,2336
2/5/22,Solomon Islands,-9.6457,160.1562,2790,0,25,2765
2/6/22,Solomon Islands,-9.6457,160.1562,2790,0,25,2765
2/7/22,Solomon Islands,-9.6457,160.1562,3319,0,37,3282
2/8/22,Solomon Islands,-9.6457,160.1562,3319,0,37,3282
2/9/22,Solomon Islands,-9.6457,160.1562,3795,0,40,3755
2/10/22,Solomon Islands,-9.6457,160.1562,4203,0,50,4153
2/11/22,Solomon Islands,-9.6457,160.1562,4302,0,53,4249
2/12/22,Solomon Islands,-9.6457,160.1562,4302,0,53,4249
2/13/22,Solomon Islands,-9.6457,160.1562,4489,0,58,4431
2/14/22,Solomon Islands,-9.6457,160.1562,4827,0,61,4766
2/15/22,Solomon Islands,-9.6457,160.1562,4910,0,65,4845
2/16/22,Solomon Islands,-9.6457,160.1562,5043,0,68,4975
2/17/22,Solomon Islands,-9.6457,160.1562,5565,0,74,5491
2/18/22,Solomon Islands,-9.6457,160.1562,5565,0,74,5491
2/19/22,Solomon Islands,-9.6457,160.1562,5684,0,77,5607
2/20/22,Solomon Islands,-9.6457,160.1562,5790,0,83,5707
2/21/22,Solomon Islands,-9.6457,160.1562,5891,0,83,5808
2/22/22,Solomon Islands,-9.6457,160.1562,5968,0,85,5883
2/23/22,Solomon Islands,-9.6457,160.1562,6348,0,87,6261
2/24/22,Solomon Islands,-9.6457,160.1562,6654,0,92,6562
2/25/22,Solomon Islands,-9.6457,160.1562,6654,0,92,6562
2/26/22,Solomon Islands,-9.6457,160.1562,6813,0,93,6720
2/27/22,Solomon Islands,-9.6457,160.1562,6937,0,96,6841
2/28/22,Solomon Islands,-9.6457,160.1562,7049,0,99,6950
3/1/22,Solomon Islands,-9.6457,160.1562,7258,0,106,7152
3/2/22,Solomon Islands,-9.6457,160.1562,7258,0,106,7152
3/3/22,Solomon Islands,-9.6457,160.1562,7258,0,111,7147
3/4/22,Solomon Islands,-9.6457,160.1562,7326,0,111,7215
3/5/22,Solomon Islands,-9.6457,160.1562,7940,0,115,7825
3/6/22,Solomon Islands,-9.6457,160.1562,8026,0,116,7910
3/7/22,Solomon Islands,-9.6457,160.1562,8150,0,118,8032
3/8/22,Solomon Islands,-9.6457,160.1562,8150,0,118,8032
3/9/22,Solomon Islands,-9.6457,160.1562,8491,0,118,8373
3/10/22,Solomon Islands,-9.6457,160.1562,8491,0,118,8373
3/11/22,Solomon Islands,-9.6457,160.1562,8491,0,118,8373
3/12/22,Solomon Islands,-9.6457,160.1562,8491,0,118,8373
3/13/22,Solomon Islands,-9.6457,160.1562,9124,0,120,9004
3/14/22,Solomon Islands,-9.6457,160.1562,9124,0,120,9004
3/15/22,Solomon Islands,-9.6457,160.1562,9412,0,125,9287
3/16/22,Solomon Islands,-9.6457,160.1562,9412,0,125,9287
3/17/22,Solomon Islands,-9.6457,160.1562,9758,0,127,9631
3/18/22,Solomon Islands,-9.6457,160.1562,9758,0,127,9631
3/19/22,Solomon Islands,-9.6457,160.1562,9851,0,127,9724
3/20/22,Solomon Islands,-9.6457,160.1562,9851,0,127,9724
3/21/22,Solomon Islands,-9.6457,160.1562,9851,0,127,9724
3/22/22,Solomon Islands,-9.6457,160.1562,10204,0,128,10076
3/23/22,Solomon Islands,-9.6457,160.1562,10204,0,128,10076
3/24/22,Solomon Islands,-9.6457,160.1562,10426,0,129,10297
3/25/22,Solomon Islands,-9.6457,160.1562,10426,0,129,10297
3/26/22,Solomon Islands,-9.6457,160.1562,10426,0,129,10297
3/27/22,Solomon Islands,-9.6457,160.1562,10778,0,133,10645
3/28/22,Solomon Islands,-9.6457,160.1562,10778,0,133,10645
3/29/22,Solomon Islands,-9.6457,160.1562,10778,0,133,10645
3/30/22,Solomon Islands,-9.6457,160.1562,11174,0,133,11041
3/31/22,Solomon Islands,-9.6457,160.1562,11470,0,133,11337
4/1/22,Solomon Islands,-9.6457,160.1562,11470,0,133,11337
4/2/22,Solomon Islands,-9.6457,160.1562,11470,0,133,11337
4/3/22,Solomon Islands,-9.6457,160.1562,11470,0,133,11337
4/4/22,Solomon Islands,-9.6457,160.1562,11470,0,137,11333
4/5/22,Solomon Islands,-9.6457,160.1562,11856,0,136,11720
4/6/22,Solomon Islands,-9.6457,160.1562,11856,0,136,11720
4/7/22,Solomon Islands,-9.6457,160.1562,12005,0,137,11868
4/8/22,Solomon Islands,-9.6457,160.1562,12005,0,137,11868
4/9/22,Solomon Islands,-9.6457,160.1562,12005,0,137,11868
4/10/22,Solomon Islands,-9.6457,160.1562,12005,0,137,11868
4/11/22,Solomon Islands,-9.6457,160.1562,12005,0,137,11868
4/12/22,Solomon Islands,-9.6457,160.1562,12285,0,139,12146
4/13/22,Solomon Islands,-9.6457,160.1562,12285,0,139,12146
4/14/22,Solomon Islands,-9.6457,160.1562,12437,0,139,12298
4/15/22,Solomon Islands,-9.6457,160.1562,12437,0,139,12298
4/16/22,Solomon Islands,-9.6457,160.1562,12437,0,139,12298
4/17/22,Solomon Islands,-9.6457,160.1562,12437,0,139,12298
4/18/22,Solomon Islands,-9.6457,160.1562,12437,0,139,12298
4/19/22,Solomon Islands,-9.6457,160.1562,12437,0,139,12298
4/20/22,Solomon Islands,-9.6457,160.1562,12437,0,139,12298
4/21/22,Solomon Islands,-9.6457,160.1562,12437,0,139,12298
4/22/22,Solomon Islands,-9.6457,160.1562,12437,0,139,12298
4/23/22,Solomon Islands,-9.6457,160.1562,12437,0,139,12298
4/24/22,Solomon Islands,-9.6457,160.1562,12437,0,139,12298
4/25/22,Solomon Islands,-9.6457,160.1562,14182,0,140,14042
4/26/22,Solomon Islands,-9.6457,160.1562,14786,0,141,14645
4/27/22,Solomon Islands,-9.6457,160.1562,14786,0,141,14645
4/28/22,Solomon Islands,-9.6457,160.1562,14786,0,141,14645
4/29/22,Solomon Islands,-9.6457,160.1562,14786,0,141,14645
4/30/22,Solomon Islands,-9.6457,160.1562,14786,0,141,14645
5/1/22,Solomon Islands,-9.6457,160.1562,15677,0,141,15536
5/2/22,Solomon Islands,-9.6457,160.1562,15677,0,141,15536
5/3/22,Solomon Islands,-9.6457,160.1562,15677,0,141,15536
5/4/22,Solomon Islands,-9.6457,160.1562,15881,0,141,15740
5/5/22,Solomon Islands,-9.6457,160.1562,16441,0,144,16297
5/6/22,Solomon Islands,-9.6457,160.1562,16441,0,144,16297
5/7/22,Solomon Islands,-9.6457,160.1562,16441,0,144,16297
5/8/22,Solomon Islands,-9.6457,160.1562,16441,0,144,16297
5/9/22,Solomon Islands,-9.6457,160.1562,16441,0,144,16297
5/10/22,Solomon Islands,-9.6457,160.1562,18174,0,146,18028
5/11/22,Solomon Islands,-9.6457,160.1562,18174,0,146,18028
5/12/22,Solomon Islands,-9.6457,160.1562,18174,0,146,18028
5/13/22,Solomon Islands,-9.6457,160.1562,18174,0,146,18028
5/14/22,Solomon Islands,-9.6457,160.1562,18174,0,146,18028
5/15/22,Solomon Islands,-9.6457,160.1562,18174,0,146,18028
5/16/22,Solomon Islands,-9.6457,160.1562,18174,0,146,18028
5/17/22,Solomon Islands,-9.6457,160.1562,18174,0,146,18028
5/18/22,Solomon Islands,-9.6457,160.1562,18174,0,146,18028
5/19/22,Solomon Islands,-9.6457,160.1562,18174,0,146,18028
5/20/22,Solomon Islands,-9.6457,160.1562,18174,0,146,18028
5/21/22,Solomon Islands,-9.6457,160.1562,18174,0,146,18028
5/22/22,Solomon Islands,-9.6457,160.1562,18174,0,146,18028
5/23/22,Solomon Islands,-9.6457,160.1562,18174,0,146,18028
5/24/22,Solomon Islands,-9.6457,160.1562,18174,0,146,18028
5/25/22,Solomon Islands,-9.6457,160.1562,18174,0,146,18028
5/26/22,Solomon Islands,-9.6457,160.1562,18174,0,146,18028
5/27/22,Solomon Islands,-9.6457,160.1562,18174,0,146,18028
5/28/22,Solomon Islands,-9.6457,160.1562,18174,0,146,18028
5/29/22,Solomon Islands,-9.6457,160.1562,18174,0,146,18028
5/30/22,Solomon Islands,-9.6457,160.1562,18174,0,146,18028
5/31/22,Solomon Islands,-9.6457,160.1562,18174,0,146,18028
6/1/22,Solomon Islands,-9.6457,160.1562,21237,0,149,21088
6/2/22,Solomon Islands,-9.6457,160.1562,21237,0,149,21088
6/3/22,Solomon Islands,-9.6457,160.1562,21237,0,149,21088
6/4/22,Solomon Islands,-9.6457,160.1562,21237,0,149,21088
6/5/22,Solomon Islands,-9.6457,160.1562,21237,0,149,21088
6/6/22,Solomon Islands,-9.6457,160.1562,21237,0,149,21088
6/7/22,Solomon Islands,-9.6457,160.1562,21237,0,149,21088
6/8/22,Solomon Islands,-9.6457,160.1562,21237,0,149,21088
6/9/22,Solomon Islands,-9.6457,160.1562,21237,0,149,21088
6/10/22,Solomon Islands,-9.6457,160.1562,21237,0,149,21088
6/11/22,Solomon Islands,-9.6457,160.1562,21237,0,149,21088
6/12/22,Solomon Islands,-9.6457,160.1562,21237,0,149,21088
6/13/22,Solomon Islands,-9.6457,160.1562,21237,0,149,21088
6/14/22,Solomon Islands,-9.6457,160.1562,21237,0,149,21088
6/15/22,Solomon Islands,-9.6457,160.1562,21237,0,149,21088
6/16/22,Solomon Islands,-9.6457,160.1562,21237,0,149,21088
6/17/22,Solomon Islands,-9.6457,160.1562,21544,0,153,21391
6/18/22,Solomon Islands,-9.6457,160.1562,21544,0,153,21391
6/19/22,Solomon Islands,-9.6457,160.1562,21544,0,153,21391
6/20/22,Solomon Islands,-9.6457,160.1562,21544,0,153,21391
6/21/22,Solomon Islands,-9.6457,160.1562,21544,0,153,21391
6/22/22,Solomon Islands,-9.6457,160.1562,21544,0,153,21391
6/23/22,Solomon Islands,-9.6457,160.1562,21544,0,153,21391
6/24/22,Solomon Islands,-9.6457,160.1562,21544,0,153,21391
6/25/22,Solomon Islands,-9.6457,160.1562,21544,0,153,21391
6/26/22,Solomon Islands,-9.6457,160.1562,21544,0,153,21391
6/27/22,Solomon Islands,-9.6457,160.1562,21544,0,153,21391
6/28/22,Solomon Islands,-9.6457,160.1562,21544,0,153,21391
6/29/22,Solomon Islands,-9.6457,160.1562,21544,0,153,21391
6/30/22,Solomon Islands,-9.6457,160.1562,21544,0,153,21391
7/1/22,Solomon Islands,-9.6457,160.1562,21544,0,153,21391
7/2/22,Solomon Islands,-9.6457,160.1562,21544,0,153,21391
7/3/22,Solomon Islands,-9.6457,160.1562,21544,0,153,21391
7/4/22,Solomon Islands,-9.6457,160.1562,21544,0,153,21391
7/5/22,Solomon Islands,-9.6457,160.1562,21544,0,153,21391
7/6/22,Solomon Islands,-9.6457,160.1562,21544,0,153,21391
7/7/22,Solomon Islands,-9.6457,160.1562,21544,0,153,21391
7/8/22,Solomon Islands,-9.6457,160.1562,21544,0,153,21391
7/9/22,Solomon Islands,-9.6457,160.1562,21544,0,153,21391
7/10/22,Solomon Islands,-9.6457,160.1562,21544,0,153,21391
7/11/22,Solomon Islands,-9.6457,160.1562,21544,0,153,21391
7/12/22,Solomon Islands,-9.6457,160.1562,21544,0,153,21391
7/13/22,Solomon Islands,-9.6457,160.1562,21544,0,153,21391
7/14/22,Solomon Islands,-9.6457,160.1562,21544,0,153,21391
7/15/22,Solomon Islands,-9.6457,160.1562,21544,0,153,21391
7/16/22,Solomon Islands,-9.6457,160.1562,21544,0,153,21391
7/17/22,Solomon Islands,-9.6457,160.1562,21544,0,153,21391
7/18/22,Solomon Islands,-9.6457,160.1562,21544,0,153,21391
7/19/22,Solomon Islands,-9.6457,160.1562,21544,0,153,21391
7/20/22,Solomon Islands,-9.6457,160.1562,21544,0,153,21391
7/21/22,Solomon Islands,-9.6457,160.1562,21544,0,153,21391
7/22/22,Solomon Islands,-9.6457,160.1562,21544,0,153,21391
7/23/22,Solomon Islands,-9.6457,160.1562,21544,0,153,21391
7/24/22,Solomon Islands,-9.6457,160.1562,21544,0,153,21391
7/25/22,Solomon Islands,-9.6457,160.1562,21544,0,153,21391
7/26/22,Solomon Islands,-9.6457,160.1562,21544,0,153,21391
7/27/22,Solomon Islands,-9.6457,160.1562,21544,0,153,21391
7/28/22,Solomon Islands,-9.6457,160.1562,21544,0,153,21391
7/29/22,Solomon Islands,-9.6457,160.1562,21544,0,153,21391
7/30/22,Solomon Islands,-9.6457,160.1562,21544,0,153,21391
7/31/22,Solomon Islands,-9.6457,160.1562,21544,0,153,21391
8/1/22,Solomon Islands,-9.6457,160.1562,21544,0,153,21391
8/2/22,Solomon Islands,-9.6457,160.1562,21544,0,153,21391
8/3/22,Solomon Islands,-9.6457,160.1562,21544,0,153,21391
8/4/22,Solomon Islands,-9.6457,160.1562,21544,0,153,21391
8/5/22,Solomon Islands,-9.6457,160.1562,21544,0,153,21391
8/6/22,Solomon Islands,-9.6457,160.1562,21544,0,153,21391
8/7/22,Solomon Islands,-9.6457,160.1562,21544,0,153,21391
8/8/22,Solomon Islands,-9.6457,160.1562,21544,0,153,21391
8/9/22,Solomon Islands,-9.6457,160.1562,21544,0,153,21391
8/10/22,Solomon Islands,-9.6457,160.1562,21544,0,153,21391
8/11/22,Solomon Islands,-9.6457,160.1562,21544,0,153,21391
8/12/22,Solomon Islands,-9.6457,160.1562,21544,0,153,21391
8/13/22,Solomon Islands,-9.6457,160.1562,21544,0,153,21391
8/14/22,Solomon Islands,-9.6457,160.1562,21544,0,153,21391
8/15/22,Solomon Islands,-9.6457,160.1562,21544,0,153,21391
8/16/22,Solomon Islands,-9.6457,160.1562,21544,0,153,21391
8/17/22,Solomon Islands,-9.6457,160.1562,21544,0,153,21391
8/18/22,Solomon Islands,-9.6457,160.1562,21544,0,153,21391
8/19/22,Solomon Islands,-9.6457,160.1562,21544,0,153,21391
8/20/22,Solomon Islands,-9.6457,160.1562,21544,0,153,21391
8/21/22,Solomon Islands,-9.6457,160.1562,21544,0,153,21391
8/22/22,Solomon Islands,-9.6457,160.1562,21544,0,153,21391
8/23/22,Solomon Islands,-9.6457,160.1562,21544,0,153,21391
8/24/22,Solomon Islands,-9.6457,160.1562,21544,0,153,21391
8/25/22,Solomon Islands,-9.6457,160.1562,21544,0,153,21391
8/26/22,Solomon Islands,-9.6457,160.1562,21544,0,153,21391
8/27/22,Solomon Islands,-9.6457,160.1562,21544,0,153,21391
8/28/22,Solomon Islands,-9.6457,160.1562,21544,0,153,21391
8/29/22,Solomon Islands,-9.6457,160.1562,21544,0,153,21391
8/30/22,Solomon Islands,-9.6457,160.1562,21544,0,153,21391
8/31/22,Solomon Islands,-9.6457,160.1562,21544,0,153,21391
9/1/22,Solomon Islands,-9.6457,160.1562,21544,0,153,21391
9/2/22,Solomon Islands,-9.6457,160.1562,21544,0,153,21391
9/3/22,Solomon Islands,-9.6457,160.1562,21544,0,153,21391
9/4/22,Solomon Islands,-9.6457,160.1562,21544,0,153,21391
9/5/22,Solomon Islands,-9.6457,160.1562,21544,0,153,21391
9/6/22,Solomon Islands,-9.6457,160.1562,21544,0,153,21391
9/7/22,Solomon Islands,-9.6457,160.1562,21544,0,153,21391
9/8/22,Solomon Islands,-9.6457,160.1562,21544,0,153,21391
9/9/22,Solomon Islands,-9.6457,160.1562,21544,0,153,21391
9/10/22,Solomon Islands,-9.6457,160.1562,21544,0,153,21391
9/11/22,Solomon Islands,-9.6457,160.1562,21544,0,153,21391
9/12/22,Solomon Islands,-9.6457,160.1562,21544,0,153,21391
9/13/22,Solomon Islands,-9.6457,160.1562,21544,0,153,21391
9/14/22,Solomon Islands,-9.6457,160.1562,21544,0,153,21391
9/15/22,Solomon Islands,-9.6457,160.1562,21544,0,153,21391
9/16/22,Solomon Islands,-9.6457,160.1562,21544,0,153,21391
9/17/22,Solomon Islands,-9.6457,160.1562,21544,0,153,21391
9/18/22,Solomon Islands,-9.6457,160.1562,21544,0,153,21391
9/19/22,Solomon Islands,-9.6457,160.1562,21544,0,153,21391
9/20/22,Solomon Islands,-9.6457,160.1562,21544,0,153,21391
9/21/22,Solomon Islands,-9.6457,160.1562,21544,0,153,21391
9/22/22,Solomon Islands,-9.6457,160.1562,21544,0,153,21391
9/23/22,Solomon Islands,-9.6457,160.1562,21544,0,153,21391
9/24/22,Solomon Islands,-9.6457,160.1562,21544,0,153,21391
9/25/22,Solomon Islands,-9.6457,160.1562,21544,0,153,21391
9/26/22,Solomon Islands,-9.6457,160.1562,21544,0,153,21391
9/27/22,Solomon Islands,-9.6457,160.1562,21544,0,153,21391
9/28/22,Solomon Islands,-9.6457,160.1562,21544,0,153,21391
9/29/22,Solomon Islands,-9.6457,160.1562,21544,0,153,21391
9/30/22,Solomon Islands,-9.6457,160.1562,21544,0,153,21391
10/1/22,Solomon Islands,-9.6457,160.1562,21544,0,153,21391
10/2/22,Solomon Islands,-9.6457,160.1562,21544,0,153,21391
10/3/22,Solomon Islands,-9.6457,160.1562,21544,0,153,21391
10/4/22,Solomon Islands,-9.6457,160.1562,21544,0,153,21391
10/5/22,Solomon Islands,-9.6457,160.1562,21544,0,153,21391
10/6/22,Solomon Islands,-9.6457,160.1562,21544,0,153,21391
10/7/22,Solomon Islands,-9.6457,160.1562,21544,0,153,21391
10/8/22,Solomon Islands,-9.6457,160.1562,21544,0,153,21391
10/9/22,Solomon Islands,-9.6457,160.1562,21544,0,153,21391
10/10/22,Solomon Islands,-9.6457,160.1562,21544,0,153,21391
10/11/22,Solomon Islands,-9.6457,160.1562,21544,0,153,21391
10/12/22,Solomon Islands,-9.6457,160.1562,21544,0,153,21391
10/13/22,Solomon Islands,-9.6457,160.1562,21544,0,153,21391
10/14/22,Solomon Islands,-9.6457,160.1562,21544,0,153,21391
10/15/22,Solomon Islands,-9.6457,160.1562,21544,0,153,21391
10/16/22,Solomon Islands,-9.6457,160.1562,21544,0,153,21391
10/17/22,Solomon Islands,-9.6457,160.1562,21544,0,153,21391
10/18/22,Solomon Islands,-9.6457,160.1562,21544,0,153,21391
10/19/22,Solomon Islands,-9.6457,160.1562,21544,0,153,21391
10/20/22,Solomon Islands,-9.6457,160.1562,21544,0,153,21391
10/21/22,Solomon Islands,-9.6457,160.1562,21544,0,153,21391
10/22/22,Solomon Islands,-9.6457,160.1562,21544,0,153,21391
10/23/22,Solomon Islands,-9.6457,160.1562,21544,0,153,21391
10/24/22,Solomon Islands,-9.6457,160.1562,21544,0,153,21391
10/25/22,Solomon Islands,-9.6457,160.1562,21544,0,153,21391
10/26/22,Solomon Islands,-9.6457,160.1562,21544,0,153,21391
10/27/22,Solomon Islands,-9.6457,160.1562,21544,0,153,21391
10/28/22,Solomon Islands,-9.6457,160.1562,21544,0,153,21391
10/29/22,Solomon Islands,-9.6457,160.1562,21544,0,153,21391
10/30/22,Solomon Islands,-9.6457,160.1562,21544,0,153,21391
10/31/22,Solomon Islands,-9.6457,160.1562,21544,0,153,21391
11/1/22,Solomon Islands,-9.6457,160.1562,21544,0,153,21391
11/2/22,Solomon Islands,-9.6457,160.1562,21544,0,153,21391
11/3/22,Solomon Islands,-9.6457,160.1562,21544,0,153,21391
11/4/22,Solomon Islands,-9.6457,160.1562,21544,0,153,21391
11/5/22,Solomon Islands,-9.6457,160.1562,21544,0,153,21391
11/6/22,Solomon Islands,-9.6457,160.1562,21544,0,153,21391
11/7/22,Solomon Islands,-9.6457,160.1562,21544,0,153,21391
11/8/22,Solomon Islands,-9.6457,160.1562,21544,0,153,21391
11/9/22,Solomon Islands,-9.6457,160.1562,21544,0,153,21391
11/10/22,Solomon Islands,-9.6457,160.1562,21544,0,153,21391
11/11/22,Solomon Islands,-9.6457,160.1562,21544,0,153,21391
11/12/22,Solomon Islands,-9.6457,160.1562,21544,0,153,21391
11/13/22,Solomon Islands,-9.6457,160.1562,21544,0,153,21391
11/14/22,Solomon Islands,-9.6457,160.1562,21563,0,153,21410
11/15/22,Solomon Islands,-9.6457,160.1562,21884,0,153,21731
11/16/22,Solomon Islands,-9.6457,160.1562,21884,0,153,21731
11/17/22,Solomon Islands,-9.6457,160.1562,21884,0,153,21731
11/18/22,Solomon Islands,-9.6457,160.1562,24575,0,153,24422
11/19/22,Solomon Islands,-9.6457,160.1562,24575,0,153,24422
11/20/22,Solomon Islands,-9.6457,160.1562,24575,0,153,24422
11/21/22,Solomon Islands,-9.6457,160.1562,24575,0,153,24422
11/22/22,Solomon Islands,-9.6457,160.1562,24575,0,153,24422
11/23/22,Solomon Islands,-9.6457,160.1562,24575,0,153,24422
11/24/22,Solomon Islands,-9.6457,160.1562,24575,0,153,24422
11/25/22,Solomon Islands,-9.6457,160.1562,24575,0,153,24422
11/26/22,Solomon Islands,-9.6457,160.1562,24575,0,153,24422
11/27/22,Solomon Islands,-9.6457,160.1562,24575,0,153,24422
11/28/22,Solomon Islands,-9.6457,160.1562,24575,0,153,24422
11/29/22,Solomon Islands,-9.6457,160.1562,24575,0,153,24422
11/30/22,Solomon Islands,-9.6457,160.1562,24575,0,153,24422
12/1/22,Solomon Islands,-9.6457,160.1562,24575,0,153,24422
12/2/22,Solomon Islands,-9.6457,160.1562,24575,0,153,24422
12/3/22,Solomon Islands,-9.6457,160.1562,24575,0,153,24422
12/4/22,Solomon Islands,-9.6457,160.1562,24575,0,153,24422
12/5/22,Solomon Islands,-9.6457,160.1562,24575,0,153,24422
12/6/22,Solomon Islands,-9.6457,160.1562,24575,0,153,24422
12/7/22,Solomon Islands,-9.6457,160.1562,24575,0,153,24422
12/8/22,Solomon Islands,-9.6457,160.1562,24575,0,153,24422
12/9/22,Solomon Islands,-9.6457,160.1562,24575,0,153,24422
12/10/22,Solomon Islands,-9.6457,160.1562,24575,0,153,24422
12/11/22,Solomon Islands,-9.6457,160.1562,24575,0,153,24422
12/12/22,Solomon Islands,-9.6457,160.1562,24575,0,153,24422
12/13/22,Solomon Islands,-9.6457,160.1562,24575,0,153,24422
12/14/22,Solomon Islands,-9.6457,160.1562,24575,0,153,24422
12/15/22,Solomon Islands,-9.6457,160.1562,24575,0,153,24422
12/16/22,Solomon Islands,-9.6457,160.1562,24575,0,153,24422
12/17/22,Solomon Islands,-9.6457,160.1562,24575,0,153,24422
1/1/22,Somalia,5.152149,46.199616,23532,0,1333,22199
1/2/22,Somalia,5.152149,46.199616,23532,0,1333,22199
1/3/22,Somalia,5.152149,46.199616,23532,0,1333,22199
1/4/22,Somalia,5.152149,46.199616,23532,0,1333,22199
1/5/22,Somalia,5.152149,46.199616,24261,0,1335,22926
1/6/22,Somalia,5.152149,46.199616,24261,0,1335,22926
1/7/22,Somalia,5.152149,46.199616,24261,0,1335,22926
1/8/22,Somalia,5.152149,46.199616,24261,0,1335,22926
1/9/22,Somalia,5.152149,46.199616,24261,0,1335,22926
1/10/22,Somalia,5.152149,46.199616,24261,0,1335,22926
1/11/22,Somalia,5.152149,46.199616,24261,0,1335,22926
1/12/22,Somalia,5.152149,46.199616,24261,0,1335,22926
1/13/22,Somalia,5.152149,46.199616,24261,0,1335,22926
1/14/22,Somalia,5.152149,46.199616,24261,0,1335,22926
1/15/22,Somalia,5.152149,46.199616,24261,0,1335,22926
1/16/22,Somalia,5.152149,46.199616,24261,0,1335,22926
1/17/22,Somalia,5.152149,46.199616,24261,0,1335,22926
1/18/22,Somalia,5.152149,46.199616,24261,0,1335,22926
1/19/22,Somalia,5.152149,46.199616,24261,0,1335,22926
1/20/22,Somalia,5.152149,46.199616,24322,0,1335,22987
1/21/22,Somalia,5.152149,46.199616,24322,0,1335,22987
1/22/22,Somalia,5.152149,46.199616,24322,0,1335,22987
1/23/22,Somalia,5.152149,46.199616,24322,0,1335,22987
1/24/22,Somalia,5.152149,46.199616,25388,0,1335,24053
1/25/22,Somalia,5.152149,46.199616,25388,0,1335,24053
1/26/22,Somalia,5.152149,46.199616,25388,0,1335,24053
1/27/22,Somalia,5.152149,46.199616,25388,0,1335,24053
1/28/22,Somalia,5.152149,46.199616,25388,0,1335,24053
1/29/22,Somalia,5.152149,46.199616,25388,0,1335,24053
1/30/22,Somalia,5.152149,46.199616,25388,0,1335,24053
1/31/22,Somalia,5.152149,46.199616,25388,0,1335,24053
2/1/22,Somalia,5.152149,46.199616,26067,0,1335,24732
2/2/22,Somalia,5.152149,46.199616,26067,0,1335,24732
2/3/22,Somalia,5.152149,46.199616,26067,0,1335,24732
2/4/22,Somalia,5.152149,46.199616,26067,0,1335,24732
2/5/22,Somalia,5.152149,46.199616,26067,0,1335,24732
2/6/22,Somalia,5.152149,46.199616,26067,0,1335,24732
2/7/22,Somalia,5.152149,46.199616,26203,0,1340,24863
2/8/22,Somalia,5.152149,46.199616,26203,0,1340,24863
2/9/22,Somalia,5.152149,46.199616,26203,0,1340,24863
2/10/22,Somalia,5.152149,46.199616,26203,0,1340,24863
2/11/22,Somalia,5.152149,46.199616,26203,0,1340,24863
2/12/22,Somalia,5.152149,46.199616,26203,0,1340,24863
2/13/22,Somalia,5.152149,46.199616,26203,0,1340,24863
2/14/22,Somalia,5.152149,46.199616,26203,0,1340,24863
2/15/22,Somalia,5.152149,46.199616,26260,0,1345,24915
2/16/22,Somalia,5.152149,46.199616,26260,0,1345,24915
2/17/22,Somalia,5.152149,46.199616,26260,0,1345,24915
2/18/22,Somalia,5.152149,46.199616,26260,0,1345,24915
2/19/22,Somalia,5.152149,46.199616,26260,0,1345,24915
2/20/22,Somalia,5.152149,46.199616,26260,0,1345,24915
2/21/22,Somalia,5.152149,46.199616,26313,0,1348,24965
2/22/22,Somalia,5.152149,46.199616,26313,0,1348,24965
2/23/22,Somalia,5.152149,46.199616,26313,0,1348,24965
2/24/22,Somalia,5.152149,46.199616,26313,0,1348,24965
2/25/22,Somalia,5.152149,46.199616,26313,0,1348,24965
2/26/22,Somalia,5.152149,46.199616,26313,0,1348,24965
2/27/22,Somalia,5.152149,46.199616,26313,0,1348,24965
2/28/22,Somalia,5.152149,46.199616,26313,0,1348,24965
3/1/22,Somalia,5.152149,46.199616,26351,0,1348,25003
3/2/22,Somalia,5.152149,46.199616,26351,0,1348,25003
3/3/22,Somalia,5.152149,46.199616,26351,0,1348,25003
3/4/22,Somalia,5.152149,46.199616,26351,0,1348,25003
3/5/22,Somalia,5.152149,46.199616,26351,0,1348,25003
3/6/22,Somalia,5.152149,46.199616,26351,0,1348,25003
3/7/22,Somalia,5.152149,46.199616,26400,0,1359,25041
3/8/22,Somalia,5.152149,46.199616,26400,0,1359,25041
3/9/22,Somalia,5.152149,46.199616,26400,0,1359,25041
3/10/22,Somalia,5.152149,46.199616,26400,0,1359,25041
3/11/22,Somalia,5.152149,46.199616,26400,0,1359,25041
3/12/22,Somalia,5.152149,46.199616,26400,0,1359,25041
3/13/22,Somalia,5.152149,46.199616,26400,0,1359,25041
3/14/22,Somalia,5.152149,46.199616,26410,0,1361,25049
3/15/22,Somalia,5.152149,46.199616,26410,0,1361,25049
3/16/22,Somalia,5.152149,46.199616,26410,0,1361,25049
3/17/22,Somalia,5.152149,46.199616,26410,0,1361,25049
3/18/22,Somalia,5.152149,46.199616,26410,0,1361,25049
3/19/22,Somalia,5.152149,46.199616,26410,0,1361,25049
3/20/22,Somalia,5.152149,46.199616,26410,0,1361,25049
3/21/22,Somalia,5.152149,46.199616,26410,0,1361,25049
3/22/22,Somalia,5.152149,46.199616,26410,0,1361,25049
3/23/22,Somalia,5.152149,46.199616,26410,0,1361,25049
3/24/22,Somalia,5.152149,46.199616,26410,0,1361,25049
3/25/22,Somalia,5.152149,46.199616,26410,0,1361,25049
3/26/22,Somalia,5.152149,46.199616,26410,0,1361,25049
3/27/22,Somalia,5.152149,46.199616,26410,0,1361,25049
3/28/22,Somalia,5.152149,46.199616,26410,0,1361,25049
3/29/22,Somalia,5.152149,46.199616,26410,0,1361,25049
3/30/22,Somalia,5.152149,46.199616,26410,0,1361,25049
3/31/22,Somalia,5.152149,46.199616,26410,0,1361,25049
4/1/22,Somalia,5.152149,46.199616,26410,0,1361,25049
4/2/22,Somalia,5.152149,46.199616,26410,0,1361,25049
4/3/22,Somalia,5.152149,46.199616,26410,0,1361,25049
4/4/22,Somalia,5.152149,46.199616,26410,0,1361,25049
4/5/22,Somalia,5.152149,46.199616,26471,0,1361,25110
4/6/22,Somalia,5.152149,46.199616,26471,0,1361,25110
4/7/22,Somalia,5.152149,46.199616,26471,0,1361,25110
4/8/22,Somalia,5.152149,46.199616,26471,0,1361,25110
4/9/22,Somalia,5.152149,46.199616,26471,0,1361,25110
4/10/22,Somalia,5.152149,46.199616,26471,0,1361,25110
4/11/22,Somalia,5.152149,46.199616,26471,0,1361,25110
4/12/22,Somalia,5.152149,46.199616,26471,0,1361,25110
4/13/22,Somalia,5.152149,46.199616,26471,0,1361,25110
4/14/22,Somalia,5.152149,46.199616,26471,0,1361,25110
4/15/22,Somalia,5.152149,46.199616,26471,0,1361,25110
4/16/22,Somalia,5.152149,46.199616,26471,0,1361,25110
4/17/22,Somalia,5.152149,46.199616,26471,0,1361,25110
4/18/22,Somalia,5.152149,46.199616,26485,0,1361,25124
4/19/22,Somalia,5.152149,46.199616,26485,0,1361,25124
4/20/22,Somalia,5.152149,46.199616,26485,0,1361,25124
4/21/22,Somalia,5.152149,46.199616,26485,0,1361,25124
4/22/22,Somalia,5.152149,46.199616,26485,0,1361,25124
4/23/22,Somalia,5.152149,46.199616,26485,0,1361,25124
4/24/22,Somalia,5.152149,46.199616,26485,0,1361,25124
4/25/22,Somalia,5.152149,46.199616,26485,0,1361,25124
4/26/22,Somalia,5.152149,46.199616,26485,0,1361,25124
4/27/22,Somalia,5.152149,46.199616,26485,0,1361,25124
4/28/22,Somalia,5.152149,46.199616,26485,0,1361,25124
4/29/22,Somalia,5.152149,46.199616,26485,0,1361,25124
4/30/22,Somalia,5.152149,46.199616,26485,0,1361,25124
5/1/22,Somalia,5.152149,46.199616,26485,0,1361,25124
5/2/22,Somalia,5.152149,46.199616,26485,0,1361,25124
5/3/22,Somalia,5.152149,46.199616,26485,0,1361,25124
5/4/22,Somalia,5.152149,46.199616,26485,0,1361,25124
5/5/22,Somalia,5.152149,46.199616,26485,0,1361,25124
5/6/22,Somalia,5.152149,46.199616,26485,0,1361,25124
5/7/22,Somalia,5.152149,46.199616,26485,0,1361,25124
5/8/22,Somalia,5.152149,46.199616,26485,0,1361,25124
5/9/22,Somalia,5.152149,46.199616,26485,0,1361,25124
5/10/22,Somalia,5.152149,46.199616,26499,0,1361,25138
5/11/22,Somalia,5.152149,46.199616,26518,0,1361,25157
5/12/22,Somalia,5.152149,46.199616,26518,0,1361,25157
5/13/22,Somalia,5.152149,46.199616,26518,0,1361,25157
5/14/22,Somalia,5.152149,46.199616,26518,0,1361,25157
5/15/22,Somalia,5.152149,46.199616,26518,0,1361,25157
5/16/22,Somalia,5.152149,46.199616,26518,0,1361,25157
5/17/22,Somalia,5.152149,46.199616,26518,0,1361,25157
5/18/22,Somalia,5.152149,46.199616,26521,0,1361,25160
5/19/22,Somalia,5.152149,46.199616,26521,0,1361,25160
5/20/22,Somalia,5.152149,46.199616,26521,0,1361,25160
5/21/22,Somalia,5.152149,46.199616,26521,0,1361,25160
5/22/22,Somalia,5.152149,46.199616,26521,0,1361,25160
5/23/22,Somalia,5.152149,46.199616,26521,0,1361,25160
5/24/22,Somalia,5.152149,46.199616,26535,0,1361,25174
5/25/22,Somalia,5.152149,46.199616,26535,0,1361,25174
5/26/22,Somalia,5.152149,46.199616,26535,0,1361,25174
5/27/22,Somalia,5.152149,46.199616,26535,0,1361,25174
5/28/22,Somalia,5.152149,46.199616,26535,0,1361,25174
5/29/22,Somalia,5.152149,46.199616,26535,0,1361,25174
5/30/22,Somalia,5.152149,46.199616,26565,0,1361,25204
5/31/22,Somalia,5.152149,46.199616,26565,0,1361,25204
6/1/22,Somalia,5.152149,46.199616,26565,0,1361,25204
6/2/22,Somalia,5.152149,46.199616,26565,0,1361,25204
6/3/22,Somalia,5.152149,46.199616,26565,0,1361,25204
6/4/22,Somalia,5.152149,46.199616,26565,0,1361,25204
6/5/22,Somalia,5.152149,46.199616,26565,0,1361,25204
6/6/22,Somalia,5.152149,46.199616,26565,0,1361,25204
6/7/22,Somalia,5.152149,46.199616,26565,0,1361,25204
6/8/22,Somalia,5.152149,46.199616,26565,0,1361,25204
6/9/22,Somalia,5.152149,46.199616,26565,0,1361,25204
6/10/22,Somalia,5.152149,46.199616,26565,0,1361,25204
6/11/22,Somalia,5.152149,46.199616,26565,0,1361,25204
6/12/22,Somalia,5.152149,46.199616,26565,0,1361,25204
6/13/22,Somalia,5.152149,46.199616,26675,0,1361,25314
6/14/22,Somalia,5.152149,46.199616,26675,0,1361,25314
6/15/22,Somalia,5.152149,46.199616,26675,0,1361,25314
6/16/22,Somalia,5.152149,46.199616,26675,0,1361,25314
6/17/22,Somalia,5.152149,46.199616,26675,0,1361,25314
6/18/22,Somalia,5.152149,46.199616,26675,0,1361,25314
6/19/22,Somalia,5.152149,46.199616,26675,0,1361,25314
6/20/22,Somalia,5.152149,46.199616,26748,0,1361,25387
6/21/22,Somalia,5.152149,46.199616,26748,0,1361,25387
6/22/22,Somalia,5.152149,46.199616,26748,0,1361,25387
6/23/22,Somalia,5.152149,46.199616,26748,0,1361,25387
6/24/22,Somalia,5.152149,46.199616,26748,0,1361,25387
6/25/22,Somalia,5.152149,46.199616,26748,0,1361,25387
6/26/22,Somalia,5.152149,46.199616,26748,0,1361,25387
6/27/22,Somalia,5.152149,46.199616,26803,0,1361,25442
6/28/22,Somalia,5.152149,46.199616,26803,0,1361,25442
6/29/22,Somalia,5.152149,46.199616,26803,0,1361,25442
6/30/22,Somalia,5.152149,46.199616,26803,0,1361,25442
7/1/22,Somalia,5.152149,46.199616,26803,0,1361,25442
7/2/22,Somalia,5.152149,46.199616,26803,0,1361,25442
7/3/22,Somalia,5.152149,46.199616,26803,0,1361,25442
7/4/22,Somalia,5.152149,46.199616,26803,0,1361,25442
7/5/22,Somalia,5.152149,46.199616,26803,0,1361,25442
7/6/22,Somalia,5.152149,46.199616,26803,0,1361,25442
7/7/22,Somalia,5.152149,46.199616,26803,0,1361,25442
7/8/22,Somalia,5.152149,46.199616,26865,0,1361,25504
7/9/22,Somalia,5.152149,46.199616,26865,0,1361,25504
7/10/22,Somalia,5.152149,46.199616,26865,0,1361,25504
7/11/22,Somalia,5.152149,46.199616,26900,0,1361,25539
7/12/22,Somalia,5.152149,46.199616,26900,0,1361,25539
7/13/22,Somalia,5.152149,46.199616,26900,0,1361,25539
7/14/22,Somalia,5.152149,46.199616,26900,0,1361,25539
7/15/22,Somalia,5.152149,46.199616,26900,0,1361,25539
7/16/22,Somalia,5.152149,46.199616,26900,0,1361,25539
7/17/22,Somalia,5.152149,46.199616,26900,0,1361,25539
7/18/22,Somalia,5.152149,46.199616,26912,0,1361,25551
7/19/22,Somalia,5.152149,46.199616,26912,0,1361,25551
7/20/22,Somalia,5.152149,46.199616,26912,0,1361,25551
7/21/22,Somalia,5.152149,46.199616,26912,0,1361,25551
7/22/22,Somalia,5.152149,46.199616,26912,0,1361,25551
7/23/22,Somalia,5.152149,46.199616,26912,0,1361,25551
7/24/22,Somalia,5.152149,46.199616,26912,0,1361,25551
7/25/22,Somalia,5.152149,46.199616,26957,0,1361,25596
7/26/22,Somalia,5.152149,46.199616,26957,0,1361,25596
7/27/22,Somalia,5.152149,46.199616,26957,0,1361,25596
7/28/22,Somalia,5.152149,46.199616,26957,0,1361,25596
7/29/22,Somalia,5.152149,46.199616,26957,0,1361,25596
7/30/22,Somalia,5.152149,46.199616,26957,0,1361,25596
7/31/22,Somalia,5.152149,46.199616,26957,0,1361,25596
8/1/22,Somalia,5.152149,46.199616,27020,0,1361,25659
8/2/22,Somalia,5.152149,46.199616,27020,0,1361,25659
8/3/22,Somalia,5.152149,46.199616,27020,0,1361,25659
8/4/22,Somalia,5.152149,46.199616,27020,0,1361,25659
8/5/22,Somalia,5.152149,46.199616,27020,0,1361,25659
8/6/22,Somalia,5.152149,46.199616,27020,0,1361,25659
8/7/22,Somalia,5.152149,46.199616,27020,0,1361,25659
8/8/22,Somalia,5.152149,46.199616,27020,0,1361,25659
8/9/22,Somalia,5.152149,46.199616,27020,0,1361,25659
8/10/22,Somalia,5.152149,46.199616,27020,0,1361,25659
8/11/22,Somalia,5.152149,46.199616,27020,0,1361,25659
8/12/22,Somalia,5.152149,46.199616,27020,0,1361,25659
8/13/22,Somalia,5.152149,46.199616,27020,0,1361,25659
8/14/22,Somalia,5.152149,46.199616,27020,0,1361,25659
8/15/22,Somalia,5.152149,46.199616,27020,0,1361,25659
8/16/22,Somalia,5.152149,46.199616,27020,0,1361,25659
8/17/22,Somalia,5.152149,46.199616,27020,0,1361,25659
8/18/22,Somalia,5.152149,46.199616,27020,0,1361,25659
8/19/22,Somalia,5.152149,46.199616,27020,0,1361,25659
8/20/22,Somalia,5.152149,46.199616,27020,0,1361,25659
8/21/22,Somalia,5.152149,46.199616,27020,0,1361,25659
8/22/22,Somalia,5.152149,46.199616,27020,0,1361,25659
8/23/22,Somalia,5.152149,46.199616,27020,0,1361,25659
8/24/22,Somalia,5.152149,46.199616,27020,0,1361,25659
8/25/22,Somalia,5.152149,46.199616,27020,0,1361,25659
8/26/22,Somalia,5.152149,46.199616,27020,0,1361,25659
8/27/22,Somalia,5.152149,46.199616,27020,0,1361,25659
8/28/22,Somalia,5.152149,46.199616,27020,0,1361,25659
8/29/22,Somalia,5.152149,46.199616,27020,0,1361,25659
8/30/22,Somalia,5.152149,46.199616,27020,0,1361,25659
8/31/22,Somalia,5.152149,46.199616,27020,0,1361,25659
9/1/22,Somalia,5.152149,46.199616,27020,0,1361,25659
9/2/22,Somalia,5.152149,46.199616,27020,0,1361,25659
9/3/22,Somalia,5.152149,46.199616,27020,0,1361,25659
9/4/22,Somalia,5.152149,46.199616,27020,0,1361,25659
9/5/22,Somalia,5.152149,46.199616,27020,0,1361,25659
9/6/22,Somalia,5.152149,46.199616,27020,0,1361,25659
9/7/22,Somalia,5.152149,46.199616,27020,0,1361,25659
9/8/22,Somalia,5.152149,46.199616,27020,0,1361,25659
9/9/22,Somalia,5.152149,46.199616,27020,0,1361,25659
9/10/22,Somalia,5.152149,46.199616,27020,0,1361,25659
9/11/22,Somalia,5.152149,46.199616,27020,0,1361,25659
9/12/22,Somalia,5.152149,46.199616,27020,0,1361,25659
9/13/22,Somalia,5.152149,46.199616,27197,0,1361,25836
9/14/22,Somalia,5.152149,46.199616,27197,0,1361,25836
9/15/22,Somalia,5.152149,46.199616,27197,0,1361,25836
9/16/22,Somalia,5.152149,46.199616,27197,0,1361,25836
9/17/22,Somalia,5.152149,46.199616,27197,0,1361,25836
9/18/22,Somalia,5.152149,46.199616,27197,0,1361,25836
9/19/22,Somalia,5.152149,46.199616,27207,0,1361,25846
9/20/22,Somalia,5.152149,46.199616,27207,0,1361,25846
9/21/22,Somalia,5.152149,46.199616,27207,0,1361,25846
9/22/22,Somalia,5.152149,46.199616,27207,0,1361,25846
9/23/22,Somalia,5.152149,46.199616,27207,0,1361,25846
9/24/22,Somalia,5.152149,46.199616,27207,0,1361,25846
9/25/22,Somalia,5.152149,46.199616,27207,0,1361,25846
9/26/22,Somalia,5.152149,46.199616,27207,0,1361,25846
9/27/22,Somalia,5.152149,46.199616,27214,0,1361,25853
9/28/22,Somalia,5.152149,46.199616,27214,0,1361,25853
9/29/22,Somalia,5.152149,46.199616,27214,0,1361,25853
9/30/22,Somalia,5.152149,46.199616,27214,0,1361,25853
10/1/22,Somalia,5.152149,46.199616,27214,0,1361,25853
10/2/22,Somalia,5.152149,46.199616,27214,0,1361,25853
10/3/22,Somalia,5.152149,46.199616,27216,0,1361,25855
10/4/22,Somalia,5.152149,46.199616,27216,0,1361,25855
10/5/22,Somalia,5.152149,46.199616,27216,0,1361,25855
10/6/22,Somalia,5.152149,46.199616,27216,0,1361,25855
10/7/22,Somalia,5.152149,46.199616,27216,0,1361,25855
10/8/22,Somalia,5.152149,46.199616,27216,0,1361,25855
10/9/22,Somalia,5.152149,46.199616,27216,0,1361,25855
10/10/22,Somalia,5.152149,46.199616,27223,0,1361,25862
10/11/22,Somalia,5.152149,46.199616,27223,0,1361,25862
10/12/22,Somalia,5.152149,46.199616,27223,0,1361,25862
10/13/22,Somalia,5.152149,46.199616,27223,0,1361,25862
10/14/22,Somalia,5.152149,46.199616,27223,0,1361,25862
10/15/22,Somalia,5.152149,46.199616,27223,0,1361,25862
10/16/22,Somalia,5.152149,46.199616,27223,0,1361,25862
10/17/22,Somalia,5.152149,46.199616,27223,0,1361,25862
10/18/22,Somalia,5.152149,46.199616,27223,0,1361,25862
10/19/22,Somalia,5.152149,46.199616,27223,0,1361,25862
10/20/22,Somalia,5.152149,46.199616,27225,0,1361,25864
10/21/22,Somalia,5.152149,46.199616,27225,0,1361,25864
10/22/22,Somalia,5.152149,46.199616,27225,0,1361,25864
10/23/22,Somalia,5.152149,46.199616,27225,0,1361,25864
10/24/22,Somalia,5.152149,46.199616,27225,0,1361,25864
10/25/22,Somalia,5.152149,46.199616,27225,0,1361,25864
10/26/22,Somalia,5.152149,46.199616,27237,0,1361,25876
10/27/22,Somalia,5.152149,46.199616,27237,0,1361,25876
10/28/22,Somalia,5.152149,46.199616,27237,0,1361,25876
10/29/22,Somalia,5.152149,46.199616,27237,0,1361,25876
10/30/22,Somalia,5.152149,46.199616,27237,0,1361,25876
10/31/22,Somalia,5.152149,46.199616,27237,0,1361,25876
11/1/22,Somalia,5.152149,46.199616,27237,0,1361,25876
11/2/22,Somalia,5.152149,46.199616,27243,0,1361,25882
11/3/22,Somalia,5.152149,46.199616,27243,0,1361,25882
11/4/22,Somalia,5.152149,46.199616,27243,0,1361,25882
11/5/22,Somalia,5.152149,46.199616,27243,0,1361,25882
11/6/22,Somalia,5.152149,46.199616,27243,0,1361,25882
11/7/22,Somalia,5.152149,46.199616,27254,0,1361,25893
11/8/22,Somalia,5.152149,46.199616,27254,0,1361,25893
11/9/22,Somalia,5.152149,46.199616,27254,0,1361,25893
11/10/22,Somalia,5.152149,46.199616,27254,0,1361,25893
11/11/22,Somalia,5.152149,46.199616,27254,0,1361,25893
11/12/22,Somalia,5.152149,46.199616,27254,0,1361,25893
11/13/22,Somalia,5.152149,46.199616,27254,0,1361,25893
11/14/22,Somalia,5.152149,46.199616,27254,0,1361,25893
11/15/22,Somalia,5.152149,46.199616,27254,0,1361,25893
11/16/22,Somalia,5.152149,46.199616,27254,0,1361,25893
11/17/22,Somalia,5.152149,46.199616,27254,0,1361,25893
11/18/22,Somalia,5.152149,46.199616,27254,0,1361,25893
11/19/22,Somalia,5.152149,46.199616,27254,0,1361,25893
11/20/22,Somalia,5.152149,46.199616,27254,0,1361,25893
11/21/22,Somalia,5.152149,46.199616,27254,0,1361,25893
11/22/22,Somalia,5.152149,46.199616,27254,0,1361,25893
11/23/22,Somalia,5.152149,46.199616,27254,0,1361,25893
11/24/22,Somalia,5.152149,46.199616,27286,0,1361,25925
11/25/22,Somalia,5.152149,46.199616,27286,0,1361,25925
11/26/22,Somalia,5.152149,46.199616,27286,0,1361,25925
11/27/22,Somalia,5.152149,46.199616,27286,0,1361,25925
11/28/22,Somalia,5.152149,46.199616,27286,0,1361,25925
11/29/22,Somalia,5.152149,46.199616,27286,0,1361,25925
11/30/22,Somalia,5.152149,46.199616,27286,0,1361,25925
12/1/22,Somalia,5.152149,46.199616,27286,0,1361,25925
12/2/22,Somalia,5.152149,46.199616,27286,0,1361,25925
12/3/22,Somalia,5.152149,46.199616,27286,0,1361,25925
12/4/22,Somalia,5.152149,46.199616,27286,0,1361,25925
12/5/22,Somalia,5.152149,46.199616,27286,0,1361,25925
12/6/22,Somalia,5.152149,46.199616,27286,0,1361,25925
12/7/22,Somalia,5.152149,46.199616,27286,0,1361,25925
12/8/22,Somalia,5.152149,46.199616,27300,0,1361,25939
12/9/22,Somalia,5.152149,46.199616,27300,0,1361,25939
12/10/22,Somalia,5.152149,46.199616,27300,0,1361,25939
12/11/22,Somalia,5.152149,46.199616,27300,0,1361,25939
12/12/22,Somalia,5.152149,46.199616,27300,0,1361,25939
12/13/22,Somalia,5.152149,46.199616,27300,0,1361,25939
12/14/22,Somalia,5.152149,46.199616,27300,0,1361,25939
12/15/22,Somalia,5.152149,46.199616,27300,0,1361,25939
12/16/22,Somalia,5.152149,46.199616,27300,0,1361,25939
12/17/22,Somalia,5.152149,46.199616,27300,0,1361,25939
1/1/22,South Africa,-30.5595,22.9375,3468079,0,91198,3376881
1/2/22,South Africa,-30.5595,22.9375,3472436,0,91228,3381208
1/3/22,South Africa,-30.5595,22.9375,3475512,0,91312,3384200
1/4/22,South Africa,-30.5595,22.9375,3483590,0,91451,3392139
1/5/22,South Africa,-30.5595,22.9375,3494696,0,91561,3403135
1/6/22,South Africa,-30.5595,22.9375,3504554,0,92112,3412442
1/7/22,South Africa,-30.5595,22.9375,3513813,0,92252,3421561
1/8/22,South Africa,-30.5595,22.9375,3521572,0,92371,3429201
1/9/22,South Africa,-30.5595,22.9375,3526054,0,92453,3433601
1/10/22,South Africa,-30.5595,22.9375,3528463,0,92530,3435933
1/11/22,South Africa,-30.5595,22.9375,3534131,0,92649,3441482
1/12/22,South Africa,-30.5595,22.9375,3540891,0,92830,3448061
1/13/22,South Africa,-30.5595,22.9375,3546808,0,92989,3453819
1/14/22,South Africa,-30.5595,22.9375,3552043,0,93117,3458926
1/15/22,South Africa,-30.5595,22.9375,3556633,0,93278,3463355
1/16/22,South Africa,-30.5595,22.9375,3559292,0,93364,3465928
1/17/22,South Africa,-30.5595,22.9375,3560921,0,93451,3467470
1/18/22,South Africa,-30.5595,22.9375,3564578,0,93571,3471007
1/19/22,South Africa,-30.5595,22.9375,3564578,0,93571,3471007
1/20/22,South Africa,-30.5595,22.9375,3572860,0,93846,3479014
1/21/22,South Africa,-30.5595,22.9375,3576379,0,93949,3482430
1/22/22,South Africa,-30.5595,22.9375,3579428,0,94063,3485365
1/23/22,South Africa,-30.5595,22.9375,3581359,0,94177,3487182
1/24/22,South Africa,-30.5595,22.9375,3582691,0,94625,3488066
1/25/22,South Africa,-30.5595,22.9375,3585888,0,94397,3491491
1/26/22,South Africa,-30.5595,22.9375,3590399,0,94491,3495908
1/27/22,South Africa,-30.5595,22.9375,3594499,0,94651,3499848
1/28/22,South Africa,-30.5595,22.9375,3598288,0,94784,3503504
1/29/22,South Africa,-30.5595,22.9375,3601630,0,94905,3506725
1/30/22,South Africa,-30.5595,22.9375,3603856,0,95022,3508834
1/31/22,South Africa,-30.5595,22.9375,3605222,0,95093,3510129
2/1/22,South Africa,-30.5595,22.9375,3608307,0,95288,3513019
2/2/22,South Africa,-30.5595,22.9375,3612809,0,95463,3517346
2/3/22,South Africa,-30.5595,22.9375,3616075,0,95545,3520530
2/4/22,South Africa,-30.5595,22.9375,3616075,0,95545,3520530
2/5/22,South Africa,-30.5595,22.9375,3622210,0,95817,3526393
2/6/22,South Africa,-30.5595,22.9375,3623962,0,95835,3528127
2/7/22,South Africa,-30.5595,22.9375,3625190,0,96021,3529169
2/8/22,South Africa,-30.5595,22.9375,3626014,0,96289,3529725
2/9/22,South Africa,-30.5595,22.9375,3631642,0,96502,3535140
2/10/22,South Africa,-30.5595,22.9375,3634811,0,96705,3538106
2/11/22,South Africa,-30.5595,22.9375,3637673,0,96851,3540822
2/12/22,South Africa,-30.5595,22.9375,3640162,0,96985,3543177
2/13/22,South Africa,-30.5595,22.9375,3641811,0,96993,3544818
2/14/22,South Africa,-30.5595,22.9375,3642905,0,97250,3545655
2/15/22,South Africa,-30.5595,22.9375,3645269,0,97431,3547838
2/16/22,South Africa,-30.5595,22.9375,3648968,0,97520,3551448
2/17/22,South Africa,-30.5595,22.9375,3652024,0,97955,3554069
2/18/22,South Africa,-30.5595,22.9375,3654824,0,98298,3556526
2/19/22,South Africa,-30.5595,22.9375,3657091,0,98617,3558474
2/20/22,South Africa,-30.5595,22.9375,3658547,0,98667,3559880
2/21/22,South Africa,-30.5595,22.9375,3659698,0,98804,3560894
2/22/22,South Africa,-30.5595,22.9375,3662032,0,98868,3563164
2/23/22,South Africa,-30.5595,22.9375,3665149,0,98978,3566171
2/24/22,South Africa,-30.5595,22.9375,3667560,0,99018,3568542
2/25/22,South Africa,-30.5595,22.9375,3669671,0,99145,3570526
2/26/22,South Africa,-30.5595,22.9375,3671991,0,99191,3572800
2/27/22,South Africa,-30.5595,22.9375,3673257,0,99229,3574028
2/28/22,South Africa,-30.5595,22.9375,3674042,0,99412,3574630
3/1/22,South Africa,-30.5595,22.9375,3675691,0,99430,3576261
3/2/22,South Africa,-30.5595,22.9375,3677686,0,99458,3578228
3/3/22,South Africa,-30.5595,22.9375,3679539,0,99499,3580040
3/4/22,South Africa,-30.5595,22.9375,3681437,0,99517,3581920
3/5/22,South Africa,-30.5595,22.9375,3683172,0,99543,3583629
3/6/22,South Africa,-30.5595,22.9375,3684319,0,99543,3584776
3/7/22,South Africa,-30.5595,22.9375,3685120,0,99609,3585511
3/8/22,South Africa,-30.5595,22.9375,3686556,0,99625,3586931
3/9/22,South Africa,-30.5595,22.9375,3688423,0,99656,3588767
3/10/22,South Africa,-30.5595,22.9375,3690291,0,99681,3590610
3/11/22,South Africa,-30.5595,22.9375,3691962,0,99709,3592253
3/12/22,South Africa,-30.5595,22.9375,3693532,0,99712,3593820
3/13/22,South Africa,-30.5595,22.9375,3694504,0,99725,3594779
3/14/22,South Africa,-30.5595,22.9375,3695175,0,99725,3595450
3/15/22,South Africa,-30.5595,22.9375,3696823,0,99727,3597096
3/16/22,South Africa,-30.5595,22.9375,3698803,0,99767,3599036
3/17/22,South Africa,-30.5595,22.9375,3700484,0,99829,3600655
3/18/22,South Africa,-30.5595,22.9375,3702042,0,99868,3602174
3/19/22,South Africa,-30.5595,22.9375,3703329,0,99879,3603450
3/20/22,South Africa,-30.5595,22.9375,3704218,0,99881,3604337
3/21/22,South Africa,-30.5595,22.9375,3704784,0,99890,3604894
3/22/22,South Africa,-30.5595,22.9375,3705696,0,99893,3605803
3/23/22,South Africa,-30.5595,22.9375,3707089,0,99899,3607190
3/24/22,South Africa,-30.5595,22.9375,3709209,0,99932,3609277
3/25/22,South Africa,-30.5595,22.9375,3710766,0,99939,3610827
3/26/22,South Africa,-30.5595,22.9375,3712263,0,99965,3612298
3/27/22,South Africa,-30.5595,22.9375,3713252,0,99966,3613286
3/28/22,South Africa,-30.5595,22.9375,3713833,0,99970,3613863
3/29/22,South Africa,-30.5595,22.9375,3715390,0,99976,3615414
3/30/22,South Africa,-30.5595,22.9375,3717067,0,100020,3617047
3/31/22,South Africa,-30.5595,22.9375,3718953,0,100032,3618921
4/1/22,South Africa,-30.5595,22.9375,3718953,0,100032,3618921
4/2/22,South Africa,-30.5595,22.9375,3718953,0,100032,3618921
4/3/22,South Africa,-30.5595,22.9375,3722954,0,100050,3622904
4/4/22,South Africa,-30.5595,22.9375,3722954,0,100050,3622904
4/5/22,South Africa,-30.5595,22.9375,3725177,0,100067,3625110
4/6/22,South Africa,-30.5595,22.9375,3727208,0,100070,3627138
4/7/22,South Africa,-30.5595,22.9375,3728689,0,100075,3628614
4/8/22,South Africa,-30.5595,22.9375,3730066,0,100084,3629982
4/9/22,South Africa,-30.5595,22.9375,3731247,0,100096,3631151
4/10/22,South Africa,-30.5595,22.9375,3732075,0,100096,3631979
4/11/22,South Africa,-30.5595,22.9375,3732628,0,100098,3632530
4/12/22,South Africa,-30.5595,22.9375,3733919,0,100116,3633803
4/13/22,South Africa,-30.5595,22.9375,3735578,0,100132,3635446
4/14/22,South Africa,-30.5595,22.9375,3737346,0,100138,3637208
4/15/22,South Africa,-30.5595,22.9375,3739192,0,100142,3639050
4/16/22,South Africa,-30.5595,22.9375,3740398,0,100144,3640254
4/17/22,South Africa,-30.5595,22.9375,3741230,0,100147,3641083
4/18/22,South Africa,-30.5595,22.9375,3742107,0,100181,3641926
4/19/22,South Africa,-30.5595,22.9375,3743582,0,100195,3643387
4/20/22,South Africa,-30.5595,22.9375,3746424,0,100211,3646213
4/21/22,South Africa,-30.5595,22.9375,3750830,0,100276,3650554
4/22/22,South Africa,-30.5595,22.9375,3755459,0,100286,3655173
4/23/22,South Africa,-30.5595,22.9375,3759689,0,100298,3659391
4/24/22,South Africa,-30.5595,22.9375,3762911,0,100303,3662608
4/25/22,South Africa,-30.5595,22.9375,3764865,0,100333,3664532
4/26/22,South Africa,-30.5595,22.9375,3769927,0,100348,3669579
4/27/22,South Africa,-30.5595,22.9375,3776298,0,100351,3675947
4/28/22,South Africa,-30.5595,22.9375,3780444,0,100355,3680089
4/29/22,South Africa,-30.5595,22.9375,3785398,0,100360,3685038
4/30/22,South Africa,-30.5595,22.9375,3791125,0,100363,3690762
5/1/22,South Africa,-30.5595,22.9375,3795763,0,100363,3695400
5/2/22,South Africa,-30.5595,22.9375,3798413,0,100370,3698043
5/3/22,South Africa,-30.5595,22.9375,3802198,0,100377,3701821
5/4/22,South Africa,-30.5595,22.9375,3808368,0,100407,3707961
5/5/22,South Africa,-30.5595,22.9375,3818125,0,100471,3717654
5/6/22,South Africa,-30.5595,22.9375,3827378,0,100505,3726873
5/7/22,South Africa,-30.5595,22.9375,3835902,0,100516,3735386
5/8/22,South Africa,-30.5595,22.9375,3841388,0,100523,3740865
5/9/22,South Africa,-30.5595,22.9375,3844625,0,100533,3744092
5/10/22,South Africa,-30.5595,22.9375,3852148,0,100559,3751589
5/11/22,South Africa,-30.5595,22.9375,3862165,0,100609,3761556
5/12/22,South Africa,-30.5595,22.9375,3871085,0,100630,3770455
5/13/22,South Africa,-30.5595,22.9375,3879434,0,100744,3778690
5/14/22,South Africa,-30.5595,22.9375,3887449,0,100753,3786696
5/15/22,South Africa,-30.5595,22.9375,3891793,0,100755,3791038
5/16/22,South Africa,-30.5595,22.9375,3894745,0,100771,3793974
5/17/22,South Africa,-30.5595,22.9375,3899841,0,100812,3799029
5/18/22,South Africa,-30.5595,22.9375,3908020,0,100867,3807153
5/19/22,South Africa,-30.5595,22.9375,3908020,0,100867,3807153
5/20/22,South Africa,-30.5595,22.9375,3921633,0,100916,3820717
5/21/22,South Africa,-30.5595,22.9375,3926652,0,100931,3825721
5/22/22,South Africa,-30.5595,22.9375,3929872,0,100933,3828939
5/23/22,South Africa,-30.5595,22.9375,3931534,0,100952,3830582
5/24/22,South Africa,-30.5595,22.9375,3935761,0,101002,3834759
5/25/22,South Africa,-30.5595,22.9375,3941045,0,101043,3840002
5/26/22,South Africa,-30.5595,22.9375,3944845,0,101092,3843753
5/27/22,South Africa,-30.5595,22.9375,3948119,0,101128,3846991
5/28/22,South Africa,-30.5595,22.9375,3952193,0,101142,3851051
5/29/22,South Africa,-30.5595,22.9375,3953967,0,101146,3852821
5/30/22,South Africa,-30.5595,22.9375,3954971,0,101162,3853809
5/31/22,South Africa,-30.5595,22.9375,3957777,0,101190,3856587
6/1/22,South Africa,-30.5595,22.9375,3960424,0,101219,3859205
6/2/22,South Africa,-30.5595,22.9375,3963394,0,101250,3862144
6/3/22,South Africa,-30.5595,22.9375,3965422,0,101285,3864137
6/4/22,South Africa,-30.5595,22.9375,3967078,0,101313,3865765
6/5/22,South Africa,-30.5595,22.9375,3968205,0,101317,3866888
6/6/22,South Africa,-30.5595,22.9375,3968205,0,101317,3866888
6/7/22,South Africa,-30.5595,22.9375,3970993,0,101397,3869596
6/8/22,South Africa,-30.5595,22.9375,3973086,0,101424,3871662
6/9/22,South Africa,-30.5595,22.9375,3975062,0,101448,3873614
6/10/22,South Africa,-30.5595,22.9375,3976653,0,101468,3875185
6/11/22,South Africa,-30.5595,22.9375,3977628,0,101477,3876151
6/12/22,South Africa,-30.5595,22.9375,3978590,0,101484,3877106
6/13/22,South Africa,-30.5595,22.9375,3979126,0,101509,3877617
6/14/22,South Africa,-30.5595,22.9375,3979836,0,101550,3878286
6/15/22,South Africa,-30.5595,22.9375,3981739,0,101576,3880163
6/16/22,South Africa,-30.5595,22.9375,3983675,0,101584,3882091
6/17/22,South Africa,-30.5595,22.9375,3984646,0,101589,3883057
6/18/22,South Africa,-30.5595,22.9375,3984646,0,101589,3883057
6/19/22,South Africa,-30.5595,22.9375,3986601,0,101604,3884997
6/20/22,South Africa,-30.5595,22.9375,3986892,0,101620,3885272
6/21/22,South Africa,-30.5595,22.9375,3986892,0,101640,3885252
6/22/22,South Africa,-30.5595,22.9375,3989007,0,101697,3887310
6/23/22,South Africa,-30.5595,22.9375,3990057,0,101704,3888353
6/24/22,South Africa,-30.5595,22.9375,3991003,0,101717,3889286
6/25/22,South Africa,-30.5595,22.9375,3991944,0,101727,3890217
6/26/22,South Africa,-30.5595,22.9375,3992449,0,101731,3890718
6/27/22,South Africa,-30.5595,22.9375,3992661,0,101740,3890921
6/28/22,South Africa,-30.5595,22.9375,3993004,0,101745,3891259
6/29/22,South Africa,-30.5595,22.9375,3993444,0,101764,3891680
6/30/22,South Africa,-30.5595,22.9375,3993444,0,101764,3891680
7/1/22,South Africa,-30.5595,22.9375,3993843,0,101793,3892050
7/2/22,South Africa,-30.5595,22.9375,3994223,0,101809,3892414
7/3/22,South Africa,-30.5595,22.9375,3995291,0,101812,3893479
7/4/22,South Africa,-30.5595,22.9375,3995291,0,101812,3893479
7/5/22,South Africa,-30.5595,22.9375,3995784,0,101847,3893937
7/6/22,South Africa,-30.5595,22.9375,3995784,0,101847,3893937
7/7/22,South Africa,-30.5595,22.9375,3996904,0,101868,3895036
7/8/22,South Africa,-30.5595,22.9375,3997269,0,101876,3895393
7/9/22,South Africa,-30.5595,22.9375,3997269,0,101876,3895393
7/10/22,South Africa,-30.5595,22.9375,3997269,0,101876,3895393
7/11/22,South Africa,-30.5595,22.9375,3997975,0,101880,3896095
7/12/22,South Africa,-30.5595,22.9375,3997975,0,101880,3896095
7/13/22,South Africa,-30.5595,22.9375,3998466,0,101895,3896571
7/14/22,South Africa,-30.5595,22.9375,3998466,0,101895,3896571
7/15/22,South Africa,-30.5595,22.9375,3998466,0,101895,3896571
7/16/22,South Africa,-30.5595,22.9375,3999751,0,101918,3897833
7/17/22,South Africa,-30.5595,22.9375,3999751,0,101918,3897833
7/18/22,South Africa,-30.5595,22.9375,3999751,0,101918,3897833
7/19/22,South Africa,-30.5595,22.9375,4000894,0,101935,3898959
7/20/22,South Africa,-30.5595,22.9375,4001444,0,101939,3899505
7/21/22,South Africa,-30.5595,22.9375,4001816,0,101942,3899874
7/22/22,South Africa,-30.5595,22.9375,4002133,0,101943,3900190
7/23/22,South Africa,-30.5595,22.9375,4002133,0,101943,3900190
7/24/22,South Africa,-30.5595,22.9375,4002133,0,101943,3900190
7/25/22,South Africa,-30.5595,22.9375,4002981,0,101955,3901026
7/26/22,South Africa,-30.5595,22.9375,4002981,0,101955,3901026
7/27/22,South Africa,-30.5595,22.9375,4002981,0,101955,3901026
7/28/22,South Africa,-30.5595,22.9375,4004201,0,101977,3902224
7/29/22,South Africa,-30.5595,22.9375,4004555,0,101982,3902573
7/30/22,South Africa,-30.5595,22.9375,4004555,0,101982,3902573
7/31/22,South Africa,-30.5595,22.9375,4005124,0,101982,3903142
8/1/22,South Africa,-30.5595,22.9375,4005124,0,101982,3903142
8/2/22,South Africa,-30.5595,22.9375,4005124,0,101982,3903142
8/3/22,South Africa,-30.5595,22.9375,4005124,0,101982,3903142
8/4/22,South Africa,-30.5595,22.9375,4005124,0,101982,3903142
8/5/22,South Africa,-30.5595,22.9375,4005124,0,101982,3903142
8/6/22,South Africa,-30.5595,22.9375,4005124,0,101982,3903142
8/7/22,South Africa,-30.5595,22.9375,4006871,0,101982,3904889
8/8/22,South Africa,-30.5595,22.9375,4006871,0,101982,3904889
8/9/22,South Africa,-30.5595,22.9375,4006916,0,101982,3904934
8/10/22,South Africa,-30.5595,22.9375,4006916,0,101982,3904934
8/11/22,South Africa,-30.5595,22.9375,4007080,0,101982,3905098
8/12/22,South Africa,-30.5595,22.9375,4007080,0,101982,3905098
8/13/22,South Africa,-30.5595,22.9375,4007925,0,101982,3905943
8/14/22,South Africa,-30.5595,22.9375,4008164,0,101982,3906182
8/15/22,South Africa,-30.5595,22.9375,4008443,0,101982,3906461
8/16/22,South Africa,-30.5595,22.9375,4008696,0,101982,3906714
8/17/22,South Africa,-30.5595,22.9375,4008988,0,102066,3906922
8/18/22,South Africa,-30.5595,22.9375,4009243,0,102066,3907177
8/19/22,South Africa,-30.5595,22.9375,4009509,0,102066,3907443
8/20/22,South Africa,-30.5595,22.9375,4009730,0,102066,3907664
8/21/22,South Africa,-30.5595,22.9375,4009730,0,102066,3907664
8/22/22,South Africa,-30.5595,22.9375,4010000,0,102066,3907934
8/23/22,South Africa,-30.5595,22.9375,4010207,0,102066,3908141
8/24/22,South Africa,-30.5595,22.9375,4010453,0,102084,3908369
8/25/22,South Africa,-30.5595,22.9375,4010752,0,102084,3908668
8/26/22,South Africa,-30.5595,22.9375,4010999,0,102084,3908915
8/27/22,South Africa,-30.5595,22.9375,4011210,0,102084,3909126
8/28/22,South Africa,-30.5595,22.9375,4011357,0,102084,3909273
8/29/22,South Africa,-30.5595,22.9375,4011431,0,102084,3909347
8/30/22,South Africa,-30.5595,22.9375,4011657,0,102084,3909573
8/31/22,South Africa,-30.5595,22.9375,4011937,0,102084,3909853
9/1/22,South Africa,-30.5595,22.9375,4012239,0,102108,3910131
9/2/22,South Africa,-30.5595,22.9375,4012485,0,102108,3910377
9/3/22,South Africa,-30.5595,22.9375,4012653,0,102108,3910545
9/4/22,South Africa,-30.5595,22.9375,4012812,0,102108,3910704
9/5/22,South Africa,-30.5595,22.9375,4012920,0,102108,3910812
9/6/22,South Africa,-30.5595,22.9375,4012920,0,102108,3910812
9/7/22,South Africa,-30.5595,22.9375,4013446,0,102129,3911317
9/8/22,South Africa,-30.5595,22.9375,4013721,0,102129,3911592
9/9/22,South Africa,-30.5595,22.9375,4014050,0,102129,3911921
9/10/22,South Africa,-30.5595,22.9375,4014277,0,102129,3912148
9/11/22,South Africa,-30.5595,22.9375,4014405,0,102129,3912276
9/12/22,South Africa,-30.5595,22.9375,4014485,0,102129,3912356
9/13/22,South Africa,-30.5595,22.9375,4014724,0,102129,3912595
9/14/22,South Africa,-30.5595,22.9375,4014986,0,102129,3912857
9/15/22,South Africa,-30.5595,22.9375,4015347,0,102146,3913201
9/16/22,South Africa,-30.5595,22.9375,4015626,0,102146,3913480
9/17/22,South Africa,-30.5595,22.9375,4015880,0,102146,3913734
9/18/22,South Africa,-30.5595,22.9375,4015880,0,102146,3913734
9/19/22,South Africa,-30.5595,22.9375,4016157,0,102146,3914011
9/20/22,South Africa,-30.5595,22.9375,4016157,0,102146,3914011
9/21/22,South Africa,-30.5595,22.9375,4016460,0,102169,3914291
9/22/22,South Africa,-30.5595,22.9375,4017011,0,102169,3914842
9/23/22,South Africa,-30.5595,22.9375,4017163,0,102169,3914994
9/24/22,South Africa,-30.5595,22.9375,4017163,0,102169,3914994
9/25/22,South Africa,-30.5595,22.9375,4017552,0,102169,3915383
9/26/22,South Africa,-30.5595,22.9375,4017788,0,102169,3915619
9/27/22,South Africa,-30.5595,22.9375,4018102,0,102169,3915933
9/28/22,South Africa,-30.5595,22.9375,4018102,0,102169,3915933
9/29/22,South Africa,-30.5595,22.9375,4018769,0,102185,3916584
9/30/22,South Africa,-30.5595,22.9375,4019077,0,102185,3916892
10/1/22,South Africa,-30.5595,22.9375,4019077,0,102185,3916892
10/2/22,South Africa,-30.5595,22.9375,4019077,0,102185,3916892
10/3/22,South Africa,-30.5595,22.9375,4019077,0,102185,3916892
10/4/22,South Africa,-30.5595,22.9375,4019800,0,102185,3917615
10/5/22,South Africa,-30.5595,22.9375,4020142,0,102194,3917948
10/6/22,South Africa,-30.5595,22.9375,4020429,0,102194,3918235
10/7/22,South Africa,-30.5595,22.9375,4020788,0,102194,3918594
10/8/22,South Africa,-30.5595,22.9375,4020788,0,102194,3918594
10/9/22,South Africa,-30.5595,22.9375,4021252,0,102194,3919058
10/10/22,South Africa,-30.5595,22.9375,4021386,0,102194,3919192
10/11/22,South Africa,-30.5595,22.9375,4021746,0,102194,3919552
10/12/22,South Africa,-30.5595,22.9375,4022107,0,102194,3919913
10/13/22,South Africa,-30.5595,22.9375,4022577,0,102246,3920331
10/14/22,South Africa,-30.5595,22.9375,4022973,0,102246,3920727
10/15/22,South Africa,-30.5595,22.9375,4023358,0,102246,3921112
10/16/22,South Africa,-30.5595,22.9375,4023358,0,102246,3921112
10/17/22,South Africa,-30.5595,22.9375,4023732,0,102246,3921486
10/18/22,South Africa,-30.5595,22.9375,4024129,0,102246,3921883
10/19/22,South Africa,-30.5595,22.9375,4024553,0,102246,3922307
10/20/22,South Africa,-30.5595,22.9375,4024959,0,102246,3922713
10/21/22,South Africa,-30.5595,22.9375,4025375,0,102257,3923118
10/22/22,South Africa,-30.5595,22.9375,4025375,0,102257,3923118
10/23/22,South Africa,-30.5595,22.9375,4025375,0,102257,3923118
10/24/22,South Africa,-30.5595,22.9375,4026068,0,102257,3923811
10/25/22,South Africa,-30.5595,22.9375,4026437,0,102257,3924180
10/26/22,South Africa,-30.5595,22.9375,4026786,0,102257,3924529
10/27/22,South Africa,-30.5595,22.9375,4027157,0,102257,3924900
10/28/22,South Africa,-30.5595,22.9375,4027567,0,102311,3925256
10/29/22,South Africa,-30.5595,22.9375,4027744,0,102311,3925433
10/30/22,South Africa,-30.5595,22.9375,4028160,0,102311,3925849
10/31/22,South Africa,-30.5595,22.9375,4028308,0,102311,3925997
11/1/22,South Africa,-30.5595,22.9375,4028651,0,102311,3926340
11/2/22,South Africa,-30.5595,22.9375,4029027,0,102311,3926716
11/3/22,South Africa,-30.5595,22.9375,4029496,0,102311,3927185
11/4/22,South Africa,-30.5595,22.9375,4029737,0,102363,3927374
11/5/22,South Africa,-30.5595,22.9375,4029737,0,102363,3927374
11/6/22,South Africa,-30.5595,22.9375,4029942,0,102363,3927579
11/7/22,South Africa,-30.5595,22.9375,4030660,0,102363,3928297
11/8/22,South Africa,-30.5595,22.9375,4031096,0,102363,3928733
11/9/22,South Africa,-30.5595,22.9375,4031624,0,102363,3929261
11/10/22,South Africa,-30.5595,22.9375,4032109,0,102363,3929746
11/11/22,South Africa,-30.5595,22.9375,4032718,0,102371,3930347
11/12/22,South Africa,-30.5595,22.9375,4033182,0,102371,3930811
11/13/22,South Africa,-30.5595,22.9375,4033182,0,102371,3930811
11/14/22,South Africa,-30.5595,22.9375,4034343,0,102371,3931972
11/15/22,South Africa,-30.5595,22.9375,4035522,0,102371,3933151
11/16/22,South Africa,-30.5595,22.9375,4036165,0,102371,3933794
11/17/22,South Africa,-30.5595,22.9375,4036623,0,102371,3934252
11/18/22,South Africa,-30.5595,22.9375,4037221,0,102395,3934826
11/19/22,South Africa,-30.5595,22.9375,4037221,0,102395,3934826
11/20/22,South Africa,-30.5595,22.9375,4037221,0,102395,3934826
11/21/22,South Africa,-30.5595,22.9375,4038121,0,102395,3935726
11/22/22,South Africa,-30.5595,22.9375,4038501,0,102395,3936106
11/23/22,South Africa,-30.5595,22.9375,4039344,0,102395,3936949
11/24/22,South Africa,-30.5595,22.9375,4039858,0,102395,3937463
11/25/22,South Africa,-30.5595,22.9375,4040289,0,102428,3937861
11/26/22,South Africa,-30.5595,22.9375,4040289,0,102428,3937861
11/27/22,South Africa,-30.5595,22.9375,4040712,0,102428,3938284
11/28/22,South Africa,-30.5595,22.9375,4040980,0,102428,3938552
11/29/22,South Africa,-30.5595,22.9375,4041445,0,102428,3939017
11/30/22,South Africa,-30.5595,22.9375,4041890,0,102428,3939462
12/1/22,South Africa,-30.5595,22.9375,4042208,0,102464,3939744
12/2/22,South Africa,-30.5595,22.9375,4042520,0,102464,3940056
12/3/22,South Africa,-30.5595,22.9375,4042769,0,102464,3940305
12/4/22,South Africa,-30.5595,22.9375,4042912,0,102464,3940448
12/5/22,South Africa,-30.5595,22.9375,4043017,0,102464,3940553
12/6/22,South Africa,-30.5595,22.9375,4043242,0,102464,3940778
12/7/22,South Africa,-30.5595,22.9375,4043543,0,102464,3941079
12/8/22,South Africa,-30.5595,22.9375,4044422,0,102550,3941872
12/9/22,South Africa,-30.5595,22.9375,4044761,0,102550,3942211
12/10/22,South Africa,-30.5595,22.9375,4045070,0,102550,3942520
12/11/22,South Africa,-30.5595,22.9375,4045262,0,102550,3942712
12/12/22,South Africa,-30.5595,22.9375,4045262,0,102550,3942712
12/13/22,South Africa,-30.5595,22.9375,4045472,0,102550,3942922
12/14/22,South Africa,-30.5595,22.9375,4045472,0,102550,3942922
12/15/22,South Africa,-30.5595,22.9375,4046150,0,102568,3943582
12/16/22,South Africa,-30.5595,22.9375,4046568,0,102568,3944000
12/17/22,South Africa,-30.5595,22.9375,4046603,0,102568,3944035
1/1/22,South Korea,35.907757,127.766922,639083,0,5694,633389
1/2/22,South Korea,35.907757,127.766922,642207,0,5730,636477
1/3/22,South Korea,35.907757,127.766922,645226,0,5781,639445
1/4/22,South Korea,35.907757,127.766922,649669,0,5838,643831
1/5/22,South Korea,35.907757,127.766922,653792,0,5887,647905
1/6/22,South Korea,35.907757,127.766922,657508,0,5932,651576
1/7/22,South Korea,35.907757,127.766922,661015,0,5986,655029
1/8/22,South Korea,35.907757,127.766922,664391,0,6037,658354
1/9/22,South Korea,35.907757,127.766922,667390,0,6071,661319
1/10/22,South Korea,35.907757,127.766922,670483,0,6114,664369
1/11/22,South Korea,35.907757,127.766922,674868,0,6166,668702
1/12/22,South Korea,35.907757,127.766922,679030,0,6210,672820
1/13/22,South Korea,35.907757,127.766922,683566,0,6259,677307
1/14/22,South Korea,35.907757,127.766922,687984,0,6281,681703
1/15/22,South Korea,35.907757,127.766922,692174,0,6310,685864
1/16/22,South Korea,35.907757,127.766922,696032,0,6333,689699
1/17/22,South Korea,35.907757,127.766922,700102,0,6378,693724
1/18/22,South Korea,35.907757,127.766922,705902,0,6452,699450
1/19/22,South Korea,35.907757,127.766922,712503,0,6480,706023
1/20/22,South Korea,35.907757,127.766922,719269,0,6501,712768
1/21/22,South Korea,35.907757,127.766922,726274,0,6529,719745
1/22/22,South Korea,35.907757,127.766922,733902,0,6540,727362
1/23/22,South Korea,35.907757,127.766922,741413,0,6565,734848
1/24/22,South Korea,35.907757,127.766922,749979,0,6588,743391
1/25/22,South Korea,35.907757,127.766922,762983,0,6620,756363
1/26/22,South Korea,35.907757,127.766922,777497,0,6654,770843
1/27/22,South Korea,35.907757,127.766922,793582,0,6678,786904
1/28/22,South Korea,35.907757,127.766922,811122,0,6712,804410
1/29/22,South Korea,35.907757,127.766922,828637,0,6732,821905
1/30/22,South Korea,35.907757,127.766922,845709,0,6755,838954
1/31/22,South Korea,35.907757,127.766922,864042,0,6772,857270
2/1/22,South Korea,35.907757,127.766922,884310,0,6787,877523
2/2/22,South Korea,35.907757,127.766922,907214,0,6812,900402
2/3/22,South Korea,35.907757,127.766922,934656,0,6836,927820
2/4/22,South Korea,35.907757,127.766922,971018,0,6858,964160
2/5/22,South Korea,35.907757,127.766922,1009688,0,6873,1002815
2/6/22,South Korea,35.907757,127.766922,1044963,0,6886,1038077
2/7/22,South Korea,35.907757,127.766922,1081681,0,6922,1074759
2/8/22,South Korea,35.907757,127.766922,1131239,0,6943,1124296
2/9/22,South Korea,35.907757,127.766922,1185361,0,6963,1178398
2/10/22,South Korea,35.907757,127.766922,1239287,0,7012,1232275
2/11/22,South Korea,35.907757,127.766922,1294205,0,7045,1287160
2/12/22,South Korea,35.907757,127.766922,1350630,0,7081,1343549
2/13/22,South Korea,35.907757,127.766922,1405246,0,7102,1398144
2/14/22,South Korea,35.907757,127.766922,1462421,0,7163,1455258
2/15/22,South Korea,35.907757,127.766922,1552851,0,7202,1545649
2/16/22,South Korea,35.907757,127.766922,1645978,0,7238,1638740
2/17/22,South Korea,35.907757,127.766922,1755806,0,7283,1748523
2/18/22,South Korea,35.907757,127.766922,1858009,0,7354,1850655
2/19/22,South Korea,35.907757,127.766922,1962837,0,7405,1955432
2/20/22,South Korea,35.907757,127.766922,2058184,0,7450,2050734
2/21/22,South Korea,35.907757,127.766922,2157734,0,7508,2150226
2/22/22,South Korea,35.907757,127.766922,2329182,0,7607,2321575
2/23/22,South Korea,35.907757,127.766922,2499188,0,7689,2491499
2/24/22,South Korea,35.907757,127.766922,2665077,0,7783,2657294
2/25/22,South Korea,35.907757,127.766922,2831283,0,7895,2823388
2/26/22,South Korea,35.907757,127.766922,2994841,0,7944,2986897
2/27/22,South Korea,35.907757,127.766922,3134456,0,8058,3126398
2/28/22,South Korea,35.907757,127.766922,3273449,0,8170,3265279
3/1/22,South Korea,35.907757,127.766922,3492686,0,8266,3484420
3/2/22,South Korea,35.907757,127.766922,3691488,0,8394,3683094
3/3/22,South Korea,35.907757,127.766922,3958326,0,8580,3949746
3/4/22,South Korea,35.907757,127.766922,4212652,0,8796,4203856
3/5/22,South Korea,35.907757,127.766922,4456264,0,8957,4447307
3/6/22,South Korea,35.907757,127.766922,4666977,0,9096,4657881
3/7/22,South Korea,35.907757,127.766922,4869691,0,9282,4860409
3/8/22,South Korea,35.907757,127.766922,5212118,0,9440,5202678
3/9/22,South Korea,35.907757,127.766922,5539650,0,9646,5530004
3/10/22,South Korea,35.907757,127.766922,5822626,0,9875,5812751
3/11/22,South Korea,35.907757,127.766922,6206277,0,10144,6196133
3/12/22,South Korea,35.907757,127.766922,6556453,0,10395,6546058
3/13/22,South Korea,35.907757,127.766922,6866222,0,10595,6855627
3/14/22,South Korea,35.907757,127.766922,7228550,0,10888,7217662
3/15/22,South Korea,35.907757,127.766922,7629275,0,11052,7618223
3/16/22,South Korea,35.907757,127.766922,8250592,0,11481,8239111
3/17/22,South Korea,35.907757,127.766922,8657609,0,11782,8645827
3/18/22,South Korea,35.907757,127.766922,9038938,0,12101,9026837
3/19/22,South Korea,35.907757,127.766922,9373646,0,12428,9361218
3/20/22,South Korea,35.907757,127.766922,9582815,0,12757,9570058
3/21/22,South Korea,35.907757,127.766922,9936540,0,13141,9923399
3/22/22,South Korea,35.907757,127.766922,10427247,0,13432,10413815
3/23/22,South Korea,35.907757,127.766922,10822836,0,13902,10808934
3/24/22,South Korea,35.907757,127.766922,11162232,0,14294,11147938
3/25/22,South Korea,35.907757,127.766922,11497711,0,14617,11483094
3/26/22,South Korea,35.907757,127.766922,11815841,0,14899,11800942
3/27/22,South Korea,35.907757,127.766922,12003054,0,15186,11987868
3/28/22,South Korea,35.907757,127.766922,12350428,0,15423,12335005
3/29/22,South Korea,35.907757,127.766922,12774956,0,15855,12759101
3/30/22,South Korea,35.907757,127.766922,13095631,0,16230,13079401
3/31/22,South Korea,35.907757,127.766922,13375818,0,16590,13359228
4/1/22,South Korea,35.907757,127.766922,13639915,0,16929,13622986
4/2/22,South Korea,35.907757,127.766922,13874216,0,17235,13856981
4/3/22,South Korea,35.907757,127.766922,14001406,0,17453,13983953
4/4/22,South Korea,35.907757,127.766922,14267401,0,17662,14249739
4/5/22,South Korea,35.907757,127.766922,14553644,0,18033,14535611
4/6/22,South Korea,35.907757,127.766922,14778405,0,18381,14760024
4/7/22,South Korea,35.907757,127.766922,14983694,0,18754,14964940
4/8/22,South Korea,35.907757,127.766922,15169189,0,19092,15150097
4/9/22,South Korea,35.907757,127.766922,15333670,0,19421,15314249
4/10/22,South Korea,35.907757,127.766922,15424598,0,19679,15404919
4/11/22,South Korea,35.907757,127.766922,15635274,0,19850,15615424
4/12/22,South Korea,35.907757,127.766922,15830644,0,20034,15810610
4/13/22,South Korea,35.907757,127.766922,15979061,0,20352,15958709
4/14/22,South Korea,35.907757,127.766922,16104869,0,20616,16084253
4/15/22,South Korea,35.907757,127.766922,16212751,0,20889,16191862
4/16/22,South Korea,35.907757,127.766922,16305752,0,21092,16284660
4/17/22,South Korea,35.907757,127.766922,16353495,0,21224,16332271
4/18/22,South Korea,35.907757,127.766922,16471940,0,21354,16450586
4/19/22,South Korea,35.907757,127.766922,16583220,0,21520,16561700
4/20/22,South Korea,35.907757,127.766922,16674045,0,21667,16652378
4/21/22,South Korea,35.907757,127.766922,16755055,0,21873,16733182
4/22/22,South Korea,35.907757,127.766922,16830469,0,22024,16808445
4/23/22,South Korea,35.907757,127.766922,16895194,0,22133,16873061
4/24/22,South Korea,35.907757,127.766922,16929564,0,22243,16907321
4/25/22,South Korea,35.907757,127.766922,17009865,0,22243,16987622
4/26/22,South Korea,35.907757,127.766922,17086626,0,22466,17064160
4/27/22,South Korea,35.907757,127.766922,17086626,0,22466,17064160
4/28/22,South Korea,35.907757,127.766922,17194616,0,22724,17171892
4/29/22,South Korea,35.907757,127.766922,17237878,0,22794,17215084
4/30/22,South Korea,35.907757,127.766922,17275649,0,22875,17252774
5/1/22,South Korea,35.907757,127.766922,17295733,0,22958,17272775
5/2/22,South Korea,35.907757,127.766922,17346753,0,23007,17323746
5/3/22,South Korea,35.907757,127.766922,17395791,0,23079,17372712
5/4/22,South Korea,35.907757,127.766922,17438068,0,23158,17414910
5/5/22,South Korea,35.907757,127.766922,17464782,0,23206,17441576
5/6/22,South Korea,35.907757,127.766922,17504334,0,23289,17481045
5/7/22,South Korea,35.907757,127.766922,17544398,0,23360,17521038
5/8/22,South Korea,35.907757,127.766922,17564999,0,23400,17541599
5/9/22,South Korea,35.907757,127.766922,17614895,0,23462,17591433
5/10/22,South Korea,35.907757,127.766922,17658794,0,23491,17635303
5/11/22,South Korea,35.907757,127.766922,17694677,0,23554,17671123
5/12/22,South Korea,35.907757,127.766922,17727086,0,23606,17703480
5/13/22,South Korea,35.907757,127.766922,17756627,0,23661,17732966
5/14/22,South Korea,35.907757,127.766922,17782061,0,23709,17758352
5/15/22,South Korea,35.907757,127.766922,17795357,0,23744,17771613
5/16/22,South Korea,35.907757,127.766922,17830429,0,23771,17806658
5/17/22,South Korea,35.907757,127.766922,17861744,0,23802,17837942
5/18/22,South Korea,35.907757,127.766922,17889849,0,23842,17866007
5/19/22,South Korea,35.907757,127.766922,17914957,0,23885,17891072
5/20/22,South Korea,35.907757,127.766922,17938399,0,23911,17914488
5/21/22,South Korea,35.907757,127.766922,17957697,0,23965,17933732
5/22/22,South Korea,35.907757,127.766922,17967672,0,23987,17943685
5/23/22,South Korea,35.907757,127.766922,17993985,0,24006,17969979
5/24/22,South Korea,35.907757,127.766922,18017923,0,24029,17993894
5/25/22,South Korea,35.907757,127.766922,18036720,0,24063,18012657
5/26/22,South Korea,35.907757,127.766922,18053287,0,24103,18029184
5/27/22,South Korea,35.907757,127.766922,18067669,0,24139,18043530
5/28/22,South Korea,35.907757,127.766922,18080323,0,24158,18056165
5/29/22,South Korea,35.907757,127.766922,18086462,0,24167,18062295
5/30/22,South Korea,35.907757,127.766922,18103638,0,24176,18079462
5/31/22,South Korea,35.907757,127.766922,18119415,0,24197,18095218
6/1/22,South Korea,35.907757,127.766922,18129313,0,24212,18105101
6/2/22,South Korea,35.907757,127.766922,18141835,0,24229,18117606
6/3/22,South Korea,35.907757,127.766922,18153851,0,24238,18129613
6/4/22,South Korea,35.907757,127.766922,18163686,0,24258,18139428
6/5/22,South Korea,35.907757,127.766922,18168708,0,24279,18144429
6/6/22,South Korea,35.907757,127.766922,18174880,0,24299,18150581
6/7/22,South Korea,35.907757,127.766922,18188200,0,24305,18163895
6/8/22,South Korea,35.907757,127.766922,18200346,0,24323,18176023
6/9/22,South Korea,35.907757,127.766922,18209650,0,24341,18185309
6/10/22,South Korea,35.907757,127.766922,18218078,0,24351,18193727
6/11/22,South Korea,35.907757,127.766922,18225460,0,24371,18201089
6/12/22,South Korea,35.907757,127.766922,18229288,0,24388,18204900
6/13/22,South Korea,35.907757,127.766922,18239056,0,24390,18214666
6/14/22,South Korea,35.907757,127.766922,18248479,0,24399,18224080
6/15/22,South Korea,35.907757,127.766922,18256457,0,24407,18232050
6/16/22,South Korea,35.907757,127.766922,18263643,0,24416,18239227
6/17/22,South Korea,35.907757,127.766922,18270481,0,24427,18246054
6/18/22,South Korea,35.907757,127.766922,18276552,0,24441,18252111
6/19/22,South Korea,35.907757,127.766922,18280090,0,24451,18255639
6/20/22,South Korea,35.907757,127.766922,18289373,0,24463,18264910
6/21/22,South Korea,35.907757,127.766922,18298341,0,24474,18273867
6/22/22,South Korea,35.907757,127.766922,18305783,0,24488,18281295
6/23/22,South Korea,35.907757,127.766922,18312993,0,24498,18288495
6/24/22,South Korea,35.907757,127.766922,18319773,0,24516,18295257
6/25/22,South Korea,35.907757,127.766922,18326019,0,24522,18301497
6/26/22,South Korea,35.907757,127.766922,18329448,0,24525,18304923
6/27/22,South Korea,35.907757,127.766922,18339319,0,24530,18314789
6/28/22,South Korea,35.907757,127.766922,18349756,0,24537,18325219
6/29/22,South Korea,35.907757,127.766922,18359341,0,24547,18334794
6/30/22,South Korea,35.907757,127.766922,18368857,0,24555,18344302
7/1/22,South Korea,35.907757,127.766922,18379552,0,24562,18354990
7/2/22,South Korea,35.907757,127.766922,18389611,0,24570,18365041
7/3/22,South Korea,35.907757,127.766922,18395864,0,24574,18371290
7/4/22,South Korea,35.907757,127.766922,18413997,0,24576,18389421
7/5/22,South Korea,35.907757,127.766922,18433359,0,24583,18408776
7/6/22,South Korea,35.907757,127.766922,18451862,0,24593,18427269
7/7/22,South Korea,35.907757,127.766922,18471172,0,24605,18446567
7/8/22,South Korea,35.907757,127.766922,18491435,0,24624,18466811
7/9/22,South Korea,35.907757,127.766922,18511845,0,24643,18487202
7/10/22,South Korea,35.907757,127.766922,18524538,0,24661,18499877
7/11/22,South Korea,35.907757,127.766922,18561861,0,24668,18537193
7/12/22,South Korea,35.907757,127.766922,18602109,0,24680,18577429
7/13/22,South Korea,35.907757,127.766922,18641278,0,24696,18616582
7/14/22,South Korea,35.907757,127.766922,18680142,0,24712,18655430
7/15/22,South Korea,35.907757,127.766922,18721415,0,24728,18696687
7/16/22,South Korea,35.907757,127.766922,18761757,0,24742,18737015
7/17/22,South Korea,35.907757,127.766922,18788056,0,24753,18763303
7/18/22,South Korea,35.907757,127.766922,18861593,0,24765,18836828
7/19/22,South Korea,35.907757,127.766922,18937971,0,24777,18913194
7/20/22,South Korea,35.907757,127.766922,19009080,0,24794,18984286
7/21/22,South Korea,35.907757,127.766922,19077659,0,24825,19052834
7/22/22,South Korea,35.907757,127.766922,19146180,0,24855,19121325
7/23/22,South Korea,35.907757,127.766922,19211613,0,24873,19186740
7/24/22,South Korea,35.907757,127.766922,19247496,0,24890,19222606
7/25/22,South Korea,35.907757,127.766922,19346764,0,24907,19321857
7/26/22,South Korea,35.907757,127.766922,19446946,0,24932,19422014
7/27/22,South Korea,35.907757,127.766922,19535242,0,24957,19510285
7/28/22,South Korea,35.907757,127.766922,19620517,0,24992,19595525
7/29/22,South Korea,35.907757,127.766922,19702461,0,25027,19677434
7/30/22,South Korea,35.907757,127.766922,19776050,0,25047,19751003
7/31/22,South Korea,35.907757,127.766922,19820739,0,25068,19795671
8/1/22,South Korea,35.907757,127.766922,19932439,0,25084,19907355
8/2/22,South Korea,35.907757,127.766922,20052305,0,25110,20027195
8/3/22,South Korea,35.907757,127.766922,20160154,0,25144,20135010
8/4/22,South Korea,35.907757,127.766922,20273011,0,25191,20247820
8/5/22,South Korea,35.907757,127.766922,20383621,0,25236,20358385
8/6/22,South Korea,35.907757,127.766922,20489128,0,25263,20463865
8/7/22,South Korea,35.907757,127.766922,20544420,0,25292,20519128
8/8/22,South Korea,35.907757,127.766922,20694239,0,25332,20668907
8/9/22,South Korea,35.907757,127.766922,20845973,0,25382,20820591
8/10/22,South Korea,35.907757,127.766922,20983169,0,25441,20957728
8/11/22,South Korea,35.907757,127.766922,21111840,0,25499,21086341
8/12/22,South Korea,35.907757,127.766922,21236355,0,25566,21210789
8/13/22,South Korea,35.907757,127.766922,21355958,0,25623,21330335
8/14/22,South Korea,35.907757,127.766922,21418036,0,25673,21392363
8/15/22,South Korea,35.907757,127.766922,21502164,0,25710,21476454
8/16/22,South Korea,35.907757,127.766922,21682816,0,25752,21657064
8/17/22,South Korea,35.907757,127.766922,21861296,0,25813,21835483
8/18/22,South Korea,35.907757,127.766922,22000037,0,25896,21974141
8/19/22,South Korea,35.907757,127.766922,22129387,0,25980,22103407
8/20/22,South Korea,35.907757,127.766922,22240331,0,26044,22214287
8/21/22,South Korea,35.907757,127.766922,22299377,0,26109,22273268
8/22/22,South Korea,35.907757,127.766922,22449475,0,26161,22423314
8/23/22,South Korea,35.907757,127.766922,22588640,0,26224,22562416
8/24/22,South Korea,35.907757,127.766922,22701921,0,26332,22675589
8/25/22,South Korea,35.907757,127.766922,22802985,0,26413,22776572
8/26/22,South Korea,35.907757,127.766922,22898523,0,26499,22872024
8/27/22,South Korea,35.907757,127.766922,22983818,0,26569,22957249
8/28/22,South Korea,35.907757,127.766922,23026960,0,26618,23000342
8/29/22,South Korea,35.907757,127.766922,23142479,0,26689,23115790
8/30/22,South Korea,35.907757,127.766922,23246398,0,26764,23219634
8/31/22,South Korea,35.907757,127.766922,23327897,0,26876,23301021
9/1/22,South Korea,35.907757,127.766922,23417425,0,26940,23390485
9/2/22,South Korea,35.907757,127.766922,23497048,0,27014,23470034
9/3/22,South Korea,35.907757,127.766922,23569192,0,27093,23542099
9/4/22,South Korea,35.907757,127.766922,23606740,0,27149,23579591
9/5/22,South Korea,35.907757,127.766922,23706477,0,27193,23679284
9/6/22,South Korea,35.907757,127.766922,23791961,0,27249,23764712
9/7/22,South Korea,35.907757,127.766922,23864560,0,27313,23837247
9/8/22,South Korea,35.907757,127.766922,23933949,0,27381,23906568
9/9/22,South Korea,35.907757,127.766922,23976673,0,27429,23949244
9/10/22,South Korea,35.907757,127.766922,24004887,0,27476,23977411
9/11/22,South Korea,35.907757,127.766922,24041825,0,27498,24014327
9/12/22,South Korea,35.907757,127.766922,24099134,0,27533,24071601
9/13/22,South Korea,35.907757,127.766922,24099134,0,27533,24071601
9/14/22,South Korea,35.907757,127.766922,24264470,0,27665,24236805
9/15/22,South Korea,35.907757,127.766922,24316302,0,27725,24288577
9/16/22,South Korea,35.907757,127.766922,24359702,0,27782,24331920
9/17/22,South Korea,35.907757,127.766922,24394466,0,27828,24366638
9/18/22,South Korea,35.907757,127.766922,24413873,0,27867,24386006
9/19/22,South Korea,35.907757,127.766922,24461737,0,27891,24433846
9/20/22,South Korea,35.907757,127.766922,24502968,0,27950,24475018
9/21/22,South Korea,35.907757,127.766922,24535940,0,28009,24507931
9/22/22,South Korea,35.907757,127.766922,24565021,0,28077,24536944
9/23/22,South Korea,35.907757,127.766922,24594336,0,28140,24566196
9/24/22,South Korea,35.907757,127.766922,24620128,0,28213,24591915
9/25/22,South Korea,35.907757,127.766922,24634296,0,28246,24606050
9/26/22,South Korea,35.907757,127.766922,24673663,0,28272,24645391
9/27/22,South Korea,35.907757,127.766922,24709789,0,28318,24681471
9/28/22,South Korea,35.907757,127.766922,24740635,0,28364,24712271
9/29/22,South Korea,35.907757,127.766922,24769101,0,28406,24740695
9/30/22,South Korea,35.907757,127.766922,24796014,0,28445,24767569
10/1/22,South Korea,35.907757,127.766922,24819611,0,28489,24791122
10/2/22,South Korea,35.907757,127.766922,24831761,0,28509,24803252
10/3/22,South Korea,35.907757,127.766922,24848184,0,28528,24819656
10/4/22,South Korea,35.907757,127.766922,24882894,0,28544,24854350
10/5/22,South Korea,35.907757,127.766922,24911497,0,28573,24882924
10/6/22,South Korea,35.907757,127.766922,24933756,0,28614,24905142
10/7/22,South Korea,35.907757,127.766922,24953135,0,28646,24924489
10/8/22,South Korea,35.907757,127.766922,24970789,0,28675,24942114
10/9/22,South Korea,35.907757,127.766922,24979770,0,28698,24951072
10/10/22,South Korea,35.907757,127.766922,24995246,0,28708,24966538
10/11/22,South Korea,35.907757,127.766922,25025749,0,28723,24997026
10/12/22,South Korea,35.907757,127.766922,25052677,0,28748,25023929
10/13/22,South Korea,35.907757,127.766922,25076239,0,28783,25047456
10/14/22,South Korea,35.907757,127.766922,25098996,0,28808,25070188
10/15/22,South Korea,35.907757,127.766922,25120465,0,28840,25091625
10/16/22,South Korea,35.907757,127.766922,25131505,0,28851,25102654
10/17/22,South Korea,35.907757,127.766922,25164695,0,28856,25135839
10/18/22,South Korea,35.907757,127.766922,25194177,0,28899,25165278
10/19/22,South Korea,35.907757,127.766922,25219546,0,28922,25190624
10/20/22,South Korea,35.907757,127.766922,25244255,0,28952,25215303
10/21/22,South Korea,35.907757,127.766922,25271078,0,28974,25242104
10/22/22,South Korea,35.907757,127.766922,25297334,0,28990,25268344
10/23/22,South Korea,35.907757,127.766922,25311636,0,29000,25282636
10/24/22,South Korea,35.907757,127.766922,25355350,0,29017,25326333
10/25/22,South Korea,35.907757,127.766922,25396155,0,29043,25367112
10/26/22,South Korea,35.907757,127.766922,25431105,0,29069,25402036
10/27/22,South Korea,35.907757,127.766922,25466992,0,29100,25437892
10/28/22,South Korea,35.907757,127.766922,25504288,0,29131,25475157
10/29/22,South Korea,35.907757,127.766922,25538799,0,29158,25509641
10/30/22,South Korea,35.907757,127.766922,25557309,0,29176,25528133
10/31/22,South Korea,35.907757,127.766922,25615667,0,29209,25586458
11/1/22,South Korea,35.907757,127.766922,25670407,0,29239,25641168
11/2/22,South Korea,35.907757,127.766922,25717277,0,29280,25687997
11/3/22,South Korea,35.907757,127.766922,25760701,0,29315,25731386
11/4/22,South Korea,35.907757,127.766922,25801564,0,29354,25772210
11/5/22,South Korea,35.907757,127.766922,25838239,0,29372,25808867
11/6/22,South Korea,35.907757,127.766922,25856910,0,29390,25827520
11/7/22,South Korea,35.907757,127.766922,25919183,0,29420,25889763
11/8/22,South Korea,35.907757,127.766922,25981655,0,29479,25952176
11/9/22,South Korea,35.907757,127.766922,26037020,0,29531,26007489
11/10/22,South Korea,35.907757,127.766922,26091539,0,29571,26061968
11/11/22,South Korea,35.907757,127.766922,26145764,0,29617,26116147
11/12/22,South Korea,35.907757,127.766922,26194229,0,29665,26164564
11/13/22,South Korea,35.907757,127.766922,26217994,0,29709,26188285
11/14/22,South Korea,35.907757,127.766922,26290877,0,29748,26261129
11/15/22,South Korea,35.907757,127.766922,26357464,0,29795,26327669
11/16/22,South Korea,35.907757,127.766922,26412901,0,29862,26383039
11/17/22,South Korea,35.907757,127.766922,26462319,0,29925,26432394
11/18/22,South Korea,35.907757,127.766922,26512754,0,29990,26482764
11/19/22,South Korea,35.907757,127.766922,26558765,0,30031,26528734
11/20/22,South Korea,35.907757,127.766922,26581856,0,30066,26551790
11/21/22,South Korea,35.907757,127.766922,26654729,0,30111,26624618
11/22/22,South Korea,35.907757,127.766922,26725053,0,30164,26694889
11/23/22,South Korea,35.907757,127.766922,26784142,0,30223,26753919
11/24/22,South Korea,35.907757,127.766922,26837840,0,30278,26807562
11/25/22,South Korea,35.907757,127.766922,26890488,0,30330,26860158
11/26/22,South Korea,35.907757,127.766922,26937516,0,30369,26907147
11/27/22,South Korea,35.907757,127.766922,26959843,0,30413,26929430
11/28/22,South Korea,35.907757,127.766922,27031319,0,30454,27000865
11/29/22,South Korea,35.907757,127.766922,27098734,0,30506,27068228
11/30/22,South Korea,35.907757,127.766922,27155813,0,30568,27125245
12/1/22,South Korea,35.907757,127.766922,27208800,0,30621,27178179
12/2/22,South Korea,35.907757,127.766922,27261526,0,30669,27230857
12/3/22,South Korea,35.907757,127.766922,27308090,0,30729,27277361
12/4/22,South Korea,35.907757,127.766922,27331250,0,30769,27300481
12/5/22,South Korea,35.907757,127.766922,27408854,0,30793,27378061
12/6/22,South Korea,35.907757,127.766922,27483568,0,30847,27452721
12/7/22,South Korea,35.907757,127.766922,27548821,0,30908,27517913
12/8/22,South Korea,35.907757,127.766922,27611555,0,30975,27580580
12/9/22,South Korea,35.907757,127.766922,27674163,0,31029,27643134
12/10/22,South Korea,35.907757,127.766922,27728482,0,31069,27697413
12/11/22,South Korea,35.907757,127.766922,27754149,0,31099,27723050
12/12/22,South Korea,35.907757,127.766922,27841001,0,31128,27809873
12/13/22,South Korea,35.907757,127.766922,27925572,0,31174,27894398
12/14/22,South Korea,35.907757,127.766922,27995726,0,31232,27964494
12/15/22,South Korea,35.907757,127.766922,28062679,0,31298,28031381
12/16/22,South Korea,35.907757,127.766922,28129431,0,31353,28098078
12/17/22,South Korea,35.907757,127.766922,28188293,0,31395,28156898
1/1/22,South Sudan,6.877,31.307,15242,0,135,15107
1/2/22,South Sudan,6.877,31.307,15242,0,135,15107
1/3/22,South Sudan,6.877,31.307,15242,0,135,15107
1/4/22,South Sudan,6.877,31.307,15745,0,136,15609
1/5/22,South Sudan,6.877,31.307,15849,0,136,15713
1/6/22,South Sudan,6.877,31.307,15937,0,136,15801
1/7/22,South Sudan,6.877,31.307,16042,0,136,15906
1/8/22,South Sudan,6.877,31.307,16042,0,136,15906
1/9/22,South Sudan,6.877,31.307,16042,0,136,15906
1/10/22,South Sudan,6.877,31.307,16253,0,136,16117
1/11/22,South Sudan,6.877,31.307,16337,0,136,16201
1/12/22,South Sudan,6.877,31.307,16337,0,136,16201
1/13/22,South Sudan,6.877,31.307,16407,0,136,16271
1/14/22,South Sudan,6.877,31.307,16454,0,136,16318
1/15/22,South Sudan,6.877,31.307,16489,0,136,16353
1/16/22,South Sudan,6.877,31.307,16489,0,136,16353
1/17/22,South Sudan,6.877,31.307,16533,0,136,16397
1/18/22,South Sudan,6.877,31.307,16547,0,136,16411
1/19/22,South Sudan,6.877,31.307,16607,0,136,16471
1/20/22,South Sudan,6.877,31.307,16627,0,137,16490
1/21/22,South Sudan,6.877,31.307,16653,0,137,16516
1/22/22,South Sudan,6.877,31.307,16673,0,137,16536
1/23/22,South Sudan,6.877,31.307,16673,0,137,16536
1/24/22,South Sudan,6.877,31.307,16715,0,137,16578
1/25/22,South Sudan,6.877,31.307,16738,0,137,16601
1/26/22,South Sudan,6.877,31.307,16752,0,137,16615
1/27/22,South Sudan,6.877,31.307,16767,0,137,16630
1/28/22,South Sudan,6.877,31.307,16775,0,137,16638
1/29/22,South Sudan,6.877,31.307,16779,0,137,16642
1/30/22,South Sudan,6.877,31.307,16779,0,137,16642
1/31/22,South Sudan,6.877,31.307,16794,0,137,16657
2/1/22,South Sudan,6.877,31.307,16810,0,137,16673
2/2/22,South Sudan,6.877,31.307,16810,0,137,16673
2/3/22,South Sudan,6.877,31.307,16820,0,137,16683
2/4/22,South Sudan,6.877,31.307,16833,0,137,16696
2/5/22,South Sudan,6.877,31.307,16833,0,137,16696
2/6/22,South Sudan,6.877,31.307,16833,0,137,16696
2/7/22,South Sudan,6.877,31.307,16856,0,137,16719
2/8/22,South Sudan,6.877,31.307,16861,0,137,16724
2/9/22,South Sudan,6.877,31.307,16873,0,137,16736
2/10/22,South Sudan,6.877,31.307,16880,0,137,16743
2/11/22,South Sudan,6.877,31.307,16880,0,137,16743
2/12/22,South Sudan,6.877,31.307,16880,0,137,16743
2/13/22,South Sudan,6.877,31.307,16880,0,137,16743
2/14/22,South Sudan,6.877,31.307,16897,0,137,16760
2/15/22,South Sudan,6.877,31.307,16900,0,137,16763
2/16/22,South Sudan,6.877,31.307,16903,0,137,16766
2/17/22,South Sudan,6.877,31.307,16903,0,137,16766
2/18/22,South Sudan,6.877,31.307,16903,0,137,16766
2/19/22,South Sudan,6.877,31.307,16903,0,137,16766
2/20/22,South Sudan,6.877,31.307,16903,0,137,16766
2/21/22,South Sudan,6.877,31.307,16936,0,137,16799
2/22/22,South Sudan,6.877,31.307,16940,0,137,16803
2/23/22,South Sudan,6.877,31.307,16946,0,137,16809
2/24/22,South Sudan,6.877,31.307,16950,0,137,16813
2/25/22,South Sudan,6.877,31.307,16955,0,137,16818
2/26/22,South Sudan,6.877,31.307,16955,0,137,16818
2/27/22,South Sudan,6.877,31.307,16955,0,137,16818
2/28/22,South Sudan,6.877,31.307,16973,0,137,16836
3/1/22,South Sudan,6.877,31.307,16978,0,137,16841
3/2/22,South Sudan,6.877,31.307,16989,0,137,16852
3/3/22,South Sudan,6.877,31.307,16993,0,137,16856
3/4/22,South Sudan,6.877,31.307,16999,0,137,16862
3/5/22,South Sudan,6.877,31.307,16999,0,137,16862
3/6/22,South Sudan,6.877,31.307,16999,0,137,16862
3/7/22,South Sudan,6.877,31.307,17015,0,137,16878
3/8/22,South Sudan,6.877,31.307,17025,0,137,16888
3/9/22,South Sudan,6.877,31.307,17034,0,137,16897
3/10/22,South Sudan,6.877,31.307,17044,0,138,16906
3/11/22,South Sudan,6.877,31.307,17051,0,138,16913
3/12/22,South Sudan,6.877,31.307,17051,0,138,16913
3/13/22,South Sudan,6.877,31.307,17061,0,138,16923
3/14/22,South Sudan,6.877,31.307,17064,0,138,16926
3/15/22,South Sudan,6.877,31.307,17067,0,138,16929
3/16/22,South Sudan,6.877,31.307,17073,0,138,16935
3/17/22,South Sudan,6.877,31.307,17084,0,138,16946
3/18/22,South Sudan,6.877,31.307,17093,0,138,16955
3/19/22,South Sudan,6.877,31.307,17093,0,138,16955
3/20/22,South Sudan,6.877,31.307,17093,0,138,16955
3/21/22,South Sudan,6.877,31.307,17137,0,138,16999
3/22/22,South Sudan,6.877,31.307,17144,0,138,17006
3/23/22,South Sudan,6.877,31.307,17153,0,138,17015
3/24/22,South Sudan,6.877,31.307,17184,0,138,17046
3/25/22,South Sudan,6.877,31.307,17184,0,138,17046
3/26/22,South Sudan,6.877,31.307,17184,0,138,17046
3/27/22,South Sudan,6.877,31.307,17184,0,138,17046
3/28/22,South Sudan,6.877,31.307,17222,0,138,17084
3/29/22,South Sudan,6.877,31.307,17237,0,138,17099
3/30/22,South Sudan,6.877,31.307,17237,0,138,17099
3/31/22,South Sudan,6.877,31.307,17262,0,138,17124
4/1/22,South Sudan,6.877,31.307,17278,0,138,17140
4/2/22,South Sudan,6.877,31.307,17278,0,138,17140
4/3/22,South Sudan,6.877,31.307,17278,0,138,17140
4/4/22,South Sudan,6.877,31.307,17301,0,138,17163
4/5/22,South Sudan,6.877,31.307,17311,0,138,17173
4/6/22,South Sudan,6.877,31.307,17311,0,138,17173
4/7/22,South Sudan,6.877,31.307,17321,0,138,17183
4/8/22,South Sudan,6.877,31.307,17333,0,138,17195
4/9/22,South Sudan,6.877,31.307,17333,0,138,17195
4/10/22,South Sudan,6.877,31.307,17333,0,138,17195
4/11/22,South Sudan,6.877,31.307,17353,0,138,17215
4/12/22,South Sudan,6.877,31.307,17356,0,138,17218
4/13/22,South Sudan,6.877,31.307,17362,0,138,17224
4/14/22,South Sudan,6.877,31.307,17369,0,138,17231
4/15/22,South Sudan,6.877,31.307,17369,0,138,17231
4/16/22,South Sudan,6.877,31.307,17369,0,138,17231
4/17/22,South Sudan,6.877,31.307,17369,0,138,17231
4/18/22,South Sudan,6.877,31.307,17408,0,138,17270
4/19/22,South Sudan,6.877,31.307,17410,0,138,17272
4/20/22,South Sudan,6.877,31.307,17420,0,138,17282
4/21/22,South Sudan,6.877,31.307,17420,0,138,17282
4/22/22,South Sudan,6.877,31.307,17422,0,138,17284
4/23/22,South Sudan,6.877,31.307,17422,0,138,17284
4/24/22,South Sudan,6.877,31.307,17422,0,138,17284
4/25/22,South Sudan,6.877,31.307,17443,0,138,17305
4/26/22,South Sudan,6.877,31.307,17445,0,138,17307
4/27/22,South Sudan,6.877,31.307,17450,0,138,17312
4/28/22,South Sudan,6.877,31.307,17456,0,138,17318
4/29/22,South Sudan,6.877,31.307,17461,0,138,17323
4/30/22,South Sudan,6.877,31.307,17461,0,138,17323
5/1/22,South Sudan,6.877,31.307,17461,0,138,17323
5/2/22,South Sudan,6.877,31.307,17483,0,138,17345
5/3/22,South Sudan,6.877,31.307,17487,0,138,17349
5/4/22,South Sudan,6.877,31.307,17490,0,138,17352
5/5/22,South Sudan,6.877,31.307,17491,0,138,17353
5/6/22,South Sudan,6.877,31.307,17492,0,138,17354
5/7/22,South Sudan,6.877,31.307,17492,0,138,17354
5/8/22,South Sudan,6.877,31.307,17492,0,138,17354
5/9/22,South Sudan,6.877,31.307,17505,0,138,17367
5/10/22,South Sudan,6.877,31.307,17513,0,138,17375
5/11/22,South Sudan,6.877,31.307,17513,0,138,17375
5/12/22,South Sudan,6.877,31.307,17525,0,138,17387
5/13/22,South Sudan,6.877,31.307,17525,0,138,17387
5/14/22,South Sudan,6.877,31.307,17525,0,138,17387
5/15/22,South Sudan,6.877,31.307,17525,0,138,17387
5/16/22,South Sudan,6.877,31.307,17541,0,138,17403
5/17/22,South Sudan,6.877,31.307,17550,0,138,17412
5/18/22,South Sudan,6.877,31.307,17551,0,138,17413
5/19/22,South Sudan,6.877,31.307,17551,0,138,17413
5/20/22,South Sudan,6.877,31.307,17573,0,138,17435
5/21/22,South Sudan,6.877,31.307,17573,0,138,17435
5/22/22,South Sudan,6.877,31.307,17573,0,138,17435
5/23/22,South Sudan,6.877,31.307,17573,0,138,17435
5/24/22,South Sudan,6.877,31.307,17575,0,138,17437
5/25/22,South Sudan,6.877,31.307,17575,0,138,17437
5/26/22,South Sudan,6.877,31.307,17590,0,138,17452
5/27/22,South Sudan,6.877,31.307,17590,0,138,17452
5/28/22,South Sudan,6.877,31.307,17590,0,138,17452
5/29/22,South Sudan,6.877,31.307,17590,0,138,17452
5/30/22,South Sudan,6.877,31.307,17592,0,138,17454
5/31/22,South Sudan,6.877,31.307,17617,0,138,17479
6/1/22,South Sudan,6.877,31.307,17617,0,138,17479
6/2/22,South Sudan,6.877,31.307,17625,0,138,17487
6/3/22,South Sudan,6.877,31.307,17626,0,138,17488
6/4/22,South Sudan,6.877,31.307,17626,0,138,17488
6/5/22,South Sudan,6.877,31.307,17626,0,138,17488
6/6/22,South Sudan,6.877,31.307,17630,0,138,17492
6/7/22,South Sudan,6.877,31.307,17630,0,138,17492
6/8/22,South Sudan,6.877,31.307,17630,0,138,17492
6/9/22,South Sudan,6.877,31.307,17630,0,138,17492
6/10/22,South Sudan,6.877,31.307,17644,0,138,17506
6/11/22,South Sudan,6.877,31.307,17644,0,138,17506
6/12/22,South Sudan,6.877,31.307,17644,0,138,17506
6/13/22,South Sudan,6.877,31.307,17644,0,138,17506
6/14/22,South Sudan,6.877,31.307,17659,0,138,17521
6/15/22,South Sudan,6.877,31.307,17675,0,138,17537
6/16/22,South Sudan,6.877,31.307,17679,0,138,17541
6/17/22,South Sudan,6.877,31.307,17697,0,138,17559
6/18/22,South Sudan,6.877,31.307,17697,0,138,17559
6/19/22,South Sudan,6.877,31.307,17697,0,138,17559
6/20/22,South Sudan,6.877,31.307,17697,0,138,17559
6/21/22,South Sudan,6.877,31.307,17697,0,138,17559
6/22/22,South Sudan,6.877,31.307,17697,0,138,17559
6/23/22,South Sudan,6.877,31.307,17697,0,138,17559
6/24/22,South Sudan,6.877,31.307,17697,0,138,17559
6/25/22,South Sudan,6.877,31.307,17697,0,138,17559
6/26/22,South Sudan,6.877,31.307,17697,0,138,17559
6/27/22,South Sudan,6.877,31.307,17697,0,138,17559
6/28/22,South Sudan,6.877,31.307,17722,0,138,17584
6/29/22,South Sudan,6.877,31.307,17722,0,138,17584
6/30/22,South Sudan,6.877,31.307,17722,0,138,17584
7/1/22,South Sudan,6.877,31.307,17722,0,138,17584
7/2/22,South Sudan,6.877,31.307,17722,0,138,17584
7/3/22,South Sudan,6.877,31.307,17722,0,138,17584
7/4/22,South Sudan,6.877,31.307,17722,0,138,17584
7/5/22,South Sudan,6.877,31.307,17733,0,138,17595
7/6/22,South Sudan,6.877,31.307,17733,0,138,17595
7/7/22,South Sudan,6.877,31.307,17733,0,138,17595
7/8/22,South Sudan,6.877,31.307,17733,0,138,17595
7/9/22,South Sudan,6.877,31.307,17733,0,138,17595
7/10/22,South Sudan,6.877,31.307,17733,0,138,17595
7/11/22,South Sudan,6.877,31.307,17733,0,138,17595
7/12/22,South Sudan,6.877,31.307,17733,0,138,17595
7/13/22,South Sudan,6.877,31.307,17733,0,138,17595
7/14/22,South Sudan,6.877,31.307,17733,0,138,17595
7/15/22,South Sudan,6.877,31.307,17733,0,138,17595
7/16/22,South Sudan,6.877,31.307,17733,0,138,17595
7/17/22,South Sudan,6.877,31.307,17733,0,138,17595
7/18/22,South Sudan,6.877,31.307,17733,0,138,17595
7/19/22,South Sudan,6.877,31.307,17733,0,138,17595
7/20/22,South Sudan,6.877,31.307,17733,0,138,17595
7/21/22,South Sudan,6.877,31.307,17733,0,138,17595
7/22/22,South Sudan,6.877,31.307,17733,0,138,17595
7/23/22,South Sudan,6.877,31.307,17733,0,138,17595
7/24/22,South Sudan,6.877,31.307,17733,0,138,17595
7/25/22,South Sudan,6.877,31.307,17733,0,138,17595
7/26/22,South Sudan,6.877,31.307,17733,0,138,17595
7/27/22,South Sudan,6.877,31.307,17733,0,138,17595
7/28/22,South Sudan,6.877,31.307,17733,0,138,17595
7/29/22,South Sudan,6.877,31.307,17733,0,138,17595
7/30/22,South Sudan,6.877,31.307,17733,0,138,17595
7/31/22,South Sudan,6.877,31.307,17733,0,138,17595
8/1/22,South Sudan,6.877,31.307,17733,0,138,17595
8/2/22,South Sudan,6.877,31.307,17780,0,138,17642
8/3/22,South Sudan,6.877,31.307,17780,0,138,17642
8/4/22,South Sudan,6.877,31.307,17780,0,138,17642
8/5/22,South Sudan,6.877,31.307,17780,0,138,17642
8/6/22,South Sudan,6.877,31.307,17780,0,138,17642
8/7/22,South Sudan,6.877,31.307,17780,0,138,17642
8/8/22,South Sudan,6.877,31.307,17780,0,138,17642
8/9/22,South Sudan,6.877,31.307,17780,0,138,17642
8/10/22,South Sudan,6.877,31.307,17780,0,138,17642
8/11/22,South Sudan,6.877,31.307,17823,0,138,17685
8/12/22,South Sudan,6.877,31.307,17823,0,138,17685
8/13/22,South Sudan,6.877,31.307,17823,0,138,17685
8/14/22,South Sudan,6.877,31.307,17823,0,138,17685
8/15/22,South Sudan,6.877,31.307,17823,0,138,17685
8/16/22,South Sudan,6.877,31.307,17823,0,138,17685
8/17/22,South Sudan,6.877,31.307,17823,0,138,17685
8/18/22,South Sudan,6.877,31.307,17823,0,138,17685
8/19/22,South Sudan,6.877,31.307,17823,0,138,17685
8/20/22,South Sudan,6.877,31.307,17823,0,138,17685
8/21/22,South Sudan,6.877,31.307,17823,0,138,17685
8/22/22,South Sudan,6.877,31.307,17823,0,138,17685
8/23/22,South Sudan,6.877,31.307,17823,0,138,17685
8/24/22,South Sudan,6.877,31.307,17823,0,138,17685
8/25/22,South Sudan,6.877,31.307,17823,0,138,17685
8/26/22,South Sudan,6.877,31.307,17823,0,138,17685
8/27/22,South Sudan,6.877,31.307,17823,0,138,17685
8/28/22,South Sudan,6.877,31.307,17823,0,138,17685
8/29/22,South Sudan,6.877,31.307,17823,0,138,17685
8/30/22,South Sudan,6.877,31.307,17823,0,138,17685
8/31/22,South Sudan,6.877,31.307,17823,0,138,17685
9/1/22,South Sudan,6.877,31.307,17823,0,138,17685
9/2/22,South Sudan,6.877,31.307,17823,0,138,17685
9/3/22,South Sudan,6.877,31.307,17823,0,138,17685
9/4/22,South Sudan,6.877,31.307,17823,0,138,17685
9/5/22,South Sudan,6.877,31.307,17823,0,138,17685
9/6/22,South Sudan,6.877,31.307,17823,0,138,17685
9/7/22,South Sudan,6.877,31.307,17823,0,138,17685
9/8/22,South Sudan,6.877,31.307,17823,0,138,17685
9/9/22,South Sudan,6.877,31.307,17823,0,138,17685
9/10/22,South Sudan,6.877,31.307,17823,0,138,17685
9/11/22,South Sudan,6.877,31.307,17823,0,138,17685
9/12/22,South Sudan,6.877,31.307,17823,0,138,17685
9/13/22,South Sudan,6.877,31.307,17823,0,138,17685
9/14/22,South Sudan,6.877,31.307,17823,0,138,17685
9/15/22,South Sudan,6.877,31.307,17823,0,138,17685
9/16/22,South Sudan,6.877,31.307,17823,0,138,17685
9/17/22,South Sudan,6.877,31.307,17823,0,138,17685
9/18/22,South Sudan,6.877,31.307,17823,0,138,17685
9/19/22,South Sudan,6.877,31.307,17823,0,138,17685
9/20/22,South Sudan,6.877,31.307,17823,0,138,17685
9/21/22,South Sudan,6.877,31.307,17823,0,138,17685
9/22/22,South Sudan,6.877,31.307,17823,0,138,17685
9/23/22,South Sudan,6.877,31.307,17823,0,138,17685
9/24/22,South Sudan,6.877,31.307,17823,0,138,17685
9/25/22,South Sudan,6.877,31.307,17823,0,138,17685
9/26/22,South Sudan,6.877,31.307,17823,0,138,17685
9/27/22,South Sudan,6.877,31.307,17823,0,138,17685
9/28/22,South Sudan,6.877,31.307,17823,0,138,17685
9/29/22,South Sudan,6.877,31.307,17823,0,138,17685
9/30/22,South Sudan,6.877,31.307,17823,0,138,17685
10/1/22,South Sudan,6.877,31.307,17823,0,138,17685
10/2/22,South Sudan,6.877,31.307,17823,0,138,17685
10/3/22,South Sudan,6.877,31.307,17823,0,138,17685
10/4/22,South Sudan,6.877,31.307,17823,0,138,17685
10/5/22,South Sudan,6.877,31.307,17823,0,138,17685
10/6/22,South Sudan,6.877,31.307,17823,0,138,17685
10/7/22,South Sudan,6.877,31.307,17823,0,138,17685
10/8/22,South Sudan,6.877,31.307,17823,0,138,17685
10/9/22,South Sudan,6.877,31.307,17823,0,138,17685
10/10/22,South Sudan,6.877,31.307,17823,0,138,17685
10/11/22,South Sudan,6.877,31.307,17823,0,138,17685
10/12/22,South Sudan,6.877,31.307,17823,0,138,17685
10/13/22,South Sudan,6.877,31.307,17823,0,138,17685
10/14/22,South Sudan,6.877,31.307,17823,0,138,17685
10/15/22,South Sudan,6.877,31.307,17823,0,138,17685
10/16/22,South Sudan,6.877,31.307,17823,0,138,17685
10/17/22,South Sudan,6.877,31.307,17823,0,138,17685
10/18/22,South Sudan,6.877,31.307,17823,0,138,17685
10/19/22,South Sudan,6.877,31.307,17823,0,138,17685
10/20/22,South Sudan,6.877,31.307,17823,0,138,17685
10/21/22,South Sudan,6.877,31.307,17823,0,138,17685
10/22/22,South Sudan,6.877,31.307,17823,0,138,17685
10/23/22,South Sudan,6.877,31.307,17823,0,138,17685
10/24/22,South Sudan,6.877,31.307,17823,0,138,17685
10/25/22,South Sudan,6.877,31.307,17823,0,138,17685
10/26/22,South Sudan,6.877,31.307,17823,0,138,17685
10/27/22,South Sudan,6.877,31.307,17823,0,138,17685
10/28/22,South Sudan,6.877,31.307,17823,0,138,17685
10/29/22,South Sudan,6.877,31.307,17823,0,138,17685
10/30/22,South Sudan,6.877,31.307,17823,0,138,17685
10/31/22,South Sudan,6.877,31.307,17823,0,138,17685
11/1/22,South Sudan,6.877,31.307,17823,0,138,17685
11/2/22,South Sudan,6.877,31.307,18318,0,138,18180
11/3/22,South Sudan,6.877,31.307,18318,0,138,18180
11/4/22,South Sudan,6.877,31.307,18318,0,138,18180
11/5/22,South Sudan,6.877,31.307,18318,0,138,18180
11/6/22,South Sudan,6.877,31.307,18318,0,138,18180
11/7/22,South Sudan,6.877,31.307,18325,0,138,18187
11/8/22,South Sudan,6.877,31.307,18325,0,138,18187
11/9/22,South Sudan,6.877,31.307,18325,0,138,18187
11/10/22,South Sudan,6.877,31.307,18325,0,138,18187
11/11/22,South Sudan,6.877,31.307,18325,0,138,18187
11/12/22,South Sudan,6.877,31.307,18325,0,138,18187
11/13/22,South Sudan,6.877,31.307,18325,0,138,18187
11/14/22,South Sudan,6.877,31.307,18339,0,138,18201
11/15/22,South Sudan,6.877,31.307,18339,0,138,18201
11/16/22,South Sudan,6.877,31.307,18339,0,138,18201
11/17/22,South Sudan,6.877,31.307,18339,0,138,18201
11/18/22,South Sudan,6.877,31.307,18339,0,138,18201
11/19/22,South Sudan,6.877,31.307,18339,0,138,18201
11/20/22,South Sudan,6.877,31.307,18339,0,138,18201
11/21/22,South Sudan,6.877,31.307,18348,0,138,18210
11/22/22,South Sudan,6.877,31.307,18348,0,138,18210
11/23/22,South Sudan,6.877,31.307,18348,0,138,18210
11/24/22,South Sudan,6.877,31.307,18348,0,138,18210
11/25/22,South Sudan,6.877,31.307,18348,0,138,18210
11/26/22,South Sudan,6.877,31.307,18348,0,138,18210
11/27/22,South Sudan,6.877,31.307,18348,0,138,18210
11/28/22,South Sudan,6.877,31.307,18348,0,138,18210
11/29/22,South Sudan,6.877,31.307,18348,0,138,18210
11/30/22,South Sudan,6.877,31.307,18350,0,138,18212
12/1/22,South Sudan,6.877,31.307,18350,0,138,18212
12/2/22,South Sudan,6.877,31.307,18350,0,138,18212
12/3/22,South Sudan,6.877,31.307,18350,0,138,18212
12/4/22,South Sudan,6.877,31.307,18350,0,138,18212
12/5/22,South Sudan,6.877,31.307,18352,0,138,18214
12/6/22,South Sudan,6.877,31.307,18352,0,138,18214
12/7/22,South Sudan,6.877,31.307,18352,0,138,18214
12/8/22,South Sudan,6.877,31.307,18352,0,138,18214
12/9/22,South Sudan,6.877,31.307,18352,0,138,18214
12/10/22,South Sudan,6.877,31.307,18352,0,138,18214
12/11/22,South Sudan,6.877,31.307,18352,0,138,18214
12/12/22,South Sudan,6.877,31.307,18352,0,138,18214
12/13/22,South Sudan,6.877,31.307,18352,0,138,18214
12/14/22,South Sudan,6.877,31.307,18368,0,138,18230
12/15/22,South Sudan,6.877,31.307,18368,0,138,18230
12/16/22,South Sudan,6.877,31.307,18368,0,138,18230
12/17/22,South Sudan,6.877,31.307,18368,0,138,18230
1/1/22,Spain,40.463667,-3.74922,6294745,0,89405,6205340
1/2/22,Spain,40.463667,-3.74922,6294745,0,89405,6205340
1/3/22,Spain,40.463667,-3.74922,6667511,0,89573,6577938
1/4/22,Spain,40.463667,-3.74922,6785286,0,89689,6695597
1/5/22,Spain,40.463667,-3.74922,6922466,0,89837,6832629
1/6/22,Spain,40.463667,-3.74922,6922466,0,89837,6832629
1/7/22,Spain,40.463667,-3.74922,7164906,0,89934,7074972
1/8/22,Spain,40.463667,-3.74922,7164906,0,89934,7074972
1/9/22,Spain,40.463667,-3.74922,7164906,0,89934,7074972
1/10/22,Spain,40.463667,-3.74922,7457300,0,90136,7367164
1/11/22,Spain,40.463667,-3.74922,7592242,0,90383,7501859
1/12/22,Spain,40.463667,-3.74922,7771367,0,90508,7680859
1/13/22,Spain,40.463667,-3.74922,7930528,0,90620,7839908
1/14/22,Spain,40.463667,-3.74922,8093036,0,90759,8002277
1/15/22,Spain,40.463667,-3.74922,8093036,0,90759,8002277
1/16/22,Spain,40.463667,-3.74922,8093036,0,90759,8002277
1/17/22,Spain,40.463667,-3.74922,8424503,0,90993,8333510
1/18/22,Spain,40.463667,-3.74922,8518975,0,91277,8427698
1/19/22,Spain,40.463667,-3.74922,8676916,0,91437,8585479
1/20/22,Spain,40.463667,-3.74922,8834363,0,91599,8742764
1/21/22,Spain,40.463667,-3.74922,8975458,0,91741,8883717
1/22/22,Spain,40.463667,-3.74922,8975458,0,91741,8883717
1/23/22,Spain,40.463667,-3.74922,8975458,0,91741,8883717
1/24/22,Spain,40.463667,-3.74922,9280890,0,91994,9188896
1/25/22,Spain,40.463667,-3.74922,9395767,0,92376,9303391
1/26/22,Spain,40.463667,-3.74922,9529320,0,92591,9436729
1/27/22,Spain,40.463667,-3.74922,9660208,0,92767,9567441
1/28/22,Spain,40.463667,-3.74922,9779130,0,92966,9686164
1/29/22,Spain,40.463667,-3.74922,9779130,0,92966,9686164
1/30/22,Spain,40.463667,-3.74922,9779130,0,92966,9686164
1/31/22,Spain,40.463667,-3.74922,9961253,0,93225,9868028
2/1/22,Spain,40.463667,-3.74922,10039126,0,93633,9945493
2/2/22,Spain,40.463667,-3.74922,10125348,0,93857,10031491
2/3/22,Spain,40.463667,-3.74922,10199716,0,94040,10105676
2/4/22,Spain,40.463667,-3.74922,10199716,0,94040,10105676
2/5/22,Spain,40.463667,-3.74922,10199716,0,94040,10105676
2/6/22,Spain,40.463667,-3.74922,10199716,0,94040,10105676
2/7/22,Spain,40.463667,-3.74922,10395471,0,94570,10300901
2/8/22,Spain,40.463667,-3.74922,10439302,0,94931,10344371
2/9/22,Spain,40.463667,-3.74922,10502141,0,95213,10406928
2/10/22,Spain,40.463667,-3.74922,10555196,0,95606,10459590
2/11/22,Spain,40.463667,-3.74922,10604200,0,95995,10508205
2/12/22,Spain,40.463667,-3.74922,10604200,0,95995,10508205
2/13/22,Spain,40.463667,-3.74922,10604200,0,95995,10508205
2/14/22,Spain,40.463667,-3.74922,10672906,0,96596,10576310
2/15/22,Spain,40.463667,-3.74922,10707286,0,96906,10610380
2/16/22,Spain,40.463667,-3.74922,10744394,0,97350,10647044
2/17/22,Spain,40.463667,-3.74922,10778607,0,97710,10680897
2/18/22,Spain,40.463667,-3.74922,10809222,0,97998,10711224
2/19/22,Spain,40.463667,-3.74922,10809222,0,97998,10711224
2/20/22,Spain,40.463667,-3.74922,10809222,0,97998,10711224
2/21/22,Spain,40.463667,-3.74922,10858000,0,98462,10759538
2/22/22,Spain,40.463667,-3.74922,10880193,0,98635,10781558
2/23/22,Spain,40.463667,-3.74922,10914105,0,98936,10815169
2/24/22,Spain,40.463667,-3.74922,10949997,0,99162,10850835
2/25/22,Spain,40.463667,-3.74922,10977524,0,99410,10878114
2/26/22,Spain,40.463667,-3.74922,10977524,0,99410,10878114
2/27/22,Spain,40.463667,-3.74922,10977524,0,99410,10878114
2/28/22,Spain,40.463667,-3.74922,10977524,0,99410,10878114
3/1/22,Spain,40.463667,-3.74922,11036085,0,99883,10936202
3/2/22,Spain,40.463667,-3.74922,11054888,0,100037,10954851
3/3/22,Spain,40.463667,-3.74922,11078028,0,100239,10977789
3/4/22,Spain,40.463667,-3.74922,11100428,0,100413,11000015
3/5/22,Spain,40.463667,-3.74922,11100428,0,100413,11000015
3/6/22,Spain,40.463667,-3.74922,11100428,0,100413,11000015
3/7/22,Spain,40.463667,-3.74922,11136425,0,100574,11035851
3/8/22,Spain,40.463667,-3.74922,11159574,0,100859,11058715
3/9/22,Spain,40.463667,-3.74922,11181510,0,100992,11080518
3/10/22,Spain,40.463667,-3.74922,11204125,0,101077,11103048
3/11/22,Spain,40.463667,-3.74922,11223974,0,101135,11122839
3/12/22,Spain,40.463667,-3.74922,11223974,0,101135,11122839
3/13/22,Spain,40.463667,-3.74922,11223974,0,101135,11122839
3/14/22,Spain,40.463667,-3.74922,11223974,0,101135,11122839
3/15/22,Spain,40.463667,-3.74922,11260040,0,101416,11158624
3/16/22,Spain,40.463667,-3.74922,11260040,0,101416,11158624
3/17/22,Spain,40.463667,-3.74922,11260040,0,101416,11158624
3/18/22,Spain,40.463667,-3.74922,11324637,0,101703,11222934
3/19/22,Spain,40.463667,-3.74922,11324637,0,101703,11222934
3/20/22,Spain,40.463667,-3.74922,11324637,0,101703,11222934
3/21/22,Spain,40.463667,-3.74922,11324637,0,101703,11222934
3/22/22,Spain,40.463667,-3.74922,11378784,0,102053,11276731
3/23/22,Spain,40.463667,-3.74922,11378784,0,102053,11276731
3/24/22,Spain,40.463667,-3.74922,11378784,0,102053,11276731
3/25/22,Spain,40.463667,-3.74922,11451676,0,102392,11349284
3/26/22,Spain,40.463667,-3.74922,11451676,0,102392,11349284
3/27/22,Spain,40.463667,-3.74922,11451676,0,102392,11349284
3/28/22,Spain,40.463667,-3.74922,11451676,0,102392,11349284
3/29/22,Spain,40.463667,-3.74922,11508309,0,102218,11406091
3/30/22,Spain,40.463667,-3.74922,11508309,0,102218,11406091
3/31/22,Spain,40.463667,-3.74922,11508309,0,102218,11406091
4/1/22,Spain,40.463667,-3.74922,11551574,0,102541,11449033
4/2/22,Spain,40.463667,-3.74922,11551574,0,102541,11449033
4/3/22,Spain,40.463667,-3.74922,11551574,0,102541,11449033
4/4/22,Spain,40.463667,-3.74922,11551574,0,102541,11449033
4/5/22,Spain,40.463667,-3.74922,11578653,0,102747,11475906
4/6/22,Spain,40.463667,-3.74922,11578653,0,102747,11475906
4/7/22,Spain,40.463667,-3.74922,11578653,0,102747,11475906
4/8/22,Spain,40.463667,-3.74922,11627487,0,103104,11524383
4/9/22,Spain,40.463667,-3.74922,11627487,0,103104,11524383
4/10/22,Spain,40.463667,-3.74922,11627487,0,103104,11524383
4/11/22,Spain,40.463667,-3.74922,11627487,0,103104,11524383
4/12/22,Spain,40.463667,-3.74922,11662214,0,103104,11559110
4/13/22,Spain,40.463667,-3.74922,11662214,0,103104,11559110
4/14/22,Spain,40.463667,-3.74922,11662214,0,103104,11559110
4/15/22,Spain,40.463667,-3.74922,11662214,0,103104,11559110
4/16/22,Spain,40.463667,-3.74922,11662214,0,103104,11559110
4/17/22,Spain,40.463667,-3.74922,11662214,0,103104,11559110
4/18/22,Spain,40.463667,-3.74922,11662214,0,103104,11559110
4/19/22,Spain,40.463667,-3.74922,11736893,0,103104,11633789
4/20/22,Spain,40.463667,-3.74922,11736893,0,103721,11633172
4/21/22,Spain,40.463667,-3.74922,11736893,0,103721,11633172
4/22/22,Spain,40.463667,-3.74922,11786036,0,103908,11682128
4/23/22,Spain,40.463667,-3.74922,11786036,0,103908,11682128
4/24/22,Spain,40.463667,-3.74922,11786036,0,103908,11682128
4/25/22,Spain,40.463667,-3.74922,11786036,0,103908,11682128
4/26/22,Spain,40.463667,-3.74922,11833457,0,104227,11729230
4/27/22,Spain,40.463667,-3.74922,11833457,0,104227,11729230
4/28/22,Spain,40.463667,-3.74922,11833457,0,104227,11729230
4/29/22,Spain,40.463667,-3.74922,11896152,0,104456,11791696
4/30/22,Spain,40.463667,-3.74922,11896152,0,104456,11791696
5/1/22,Spain,40.463667,-3.74922,11896152,0,104456,11791696
5/2/22,Spain,40.463667,-3.74922,11896152,0,104456,11791696
5/3/22,Spain,40.463667,-3.74922,11953481,0,104668,11848813
5/4/22,Spain,40.463667,-3.74922,11953481,0,104668,11848813
5/5/22,Spain,40.463667,-3.74922,11953481,0,104668,11848813
5/6/22,Spain,40.463667,-3.74922,12009059,0,104869,11904190
5/7/22,Spain,40.463667,-3.74922,12009059,0,104869,11904190
5/8/22,Spain,40.463667,-3.74922,12009059,0,104869,11904190
5/9/22,Spain,40.463667,-3.74922,12058888,0,105123,11953765
5/10/22,Spain,40.463667,-3.74922,12058888,0,105123,11953765
5/11/22,Spain,40.463667,-3.74922,12058888,0,105123,11953765
5/12/22,Spain,40.463667,-3.74922,12058888,0,105123,11953765
5/13/22,Spain,40.463667,-3.74922,12127122,0,105444,12021678
5/14/22,Spain,40.463667,-3.74922,12127122,0,105444,12021678
5/15/22,Spain,40.463667,-3.74922,12127122,0,105444,12021678
5/16/22,Spain,40.463667,-3.74922,12127122,0,105444,12021678
5/17/22,Spain,40.463667,-3.74922,12179234,0,105642,12073592
5/18/22,Spain,40.463667,-3.74922,12179234,0,105642,12073592
5/19/22,Spain,40.463667,-3.74922,12179234,0,105642,12073592
5/20/22,Spain,40.463667,-3.74922,12179234,0,105642,12073592
5/21/22,Spain,40.463667,-3.74922,12234806,0,105952,12128854
5/22/22,Spain,40.463667,-3.74922,12234806,0,105952,12128854
5/23/22,Spain,40.463667,-3.74922,12234806,0,105952,12128854
5/24/22,Spain,40.463667,-3.74922,12238073,0,105947,12132126
5/25/22,Spain,40.463667,-3.74922,12238073,0,105947,12132126
5/26/22,Spain,40.463667,-3.74922,12280345,0,106105,12174240
5/27/22,Spain,40.463667,-3.74922,12326264,0,106341,12219923
5/28/22,Spain,40.463667,-3.74922,12326264,0,106341,12219923
5/29/22,Spain,40.463667,-3.74922,12326264,0,106341,12219923
5/30/22,Spain,40.463667,-3.74922,12326264,0,106341,12219923
5/31/22,Spain,40.463667,-3.74922,12326264,0,106341,12219923
6/1/22,Spain,40.463667,-3.74922,12360256,0,106493,12253763
6/2/22,Spain,40.463667,-3.74922,12360256,0,106493,12253763
6/3/22,Spain,40.463667,-3.74922,12403245,0,106797,12296448
6/4/22,Spain,40.463667,-3.74922,12403245,0,106797,12296448
6/5/22,Spain,40.463667,-3.74922,12403245,0,106797,12296448
6/6/22,Spain,40.463667,-3.74922,12403245,0,106797,12296448
6/7/22,Spain,40.463667,-3.74922,12436538,0,106914,12329624
6/8/22,Spain,40.463667,-3.74922,12436538,0,106914,12329624
6/9/22,Spain,40.463667,-3.74922,12436538,0,106914,12329624
6/10/22,Spain,40.463667,-3.74922,12478994,0,107108,12371886
6/11/22,Spain,40.463667,-3.74922,12478994,0,107108,12371886
6/12/22,Spain,40.463667,-3.74922,12478994,0,107108,12371886
6/13/22,Spain,40.463667,-3.74922,12478994,0,107108,12371886
6/14/22,Spain,40.463667,-3.74922,12515127,0,107239,12407888
6/15/22,Spain,40.463667,-3.74922,12515127,0,107239,12407888
6/16/22,Spain,40.463667,-3.74922,12515127,0,107239,12407888
6/17/22,Spain,40.463667,-3.74922,12563399,0,107482,12455917
6/18/22,Spain,40.463667,-3.74922,12563399,0,107482,12455917
6/19/22,Spain,40.463667,-3.74922,12563399,0,107482,12455917
6/20/22,Spain,40.463667,-3.74922,12563399,0,107482,12455917
6/21/22,Spain,40.463667,-3.74922,12613634,0,107604,12506030
6/22/22,Spain,40.463667,-3.74922,12613634,0,107604,12506030
6/23/22,Spain,40.463667,-3.74922,12613634,0,107604,12506030
6/24/22,Spain,40.463667,-3.74922,12681820,0,107799,12574021
6/25/22,Spain,40.463667,-3.74922,12681820,0,107799,12574021
6/26/22,Spain,40.463667,-3.74922,12681820,0,107799,12574021
6/27/22,Spain,40.463667,-3.74922,12681820,0,107799,12574021
6/28/22,Spain,40.463667,-3.74922,12734038,0,107906,12626132
6/29/22,Spain,40.463667,-3.74922,12734038,0,107906,12626132
6/30/22,Spain,40.463667,-3.74922,12734038,0,107906,12626132
7/1/22,Spain,40.463667,-3.74922,12818184,0,108111,12710073
7/2/22,Spain,40.463667,-3.74922,12818184,0,108111,12710073
7/3/22,Spain,40.463667,-3.74922,12818184,0,108111,12710073
7/4/22,Spain,40.463667,-3.74922,12818184,0,108111,12710073
7/5/22,Spain,40.463667,-3.74922,12890002,0,108259,12781743
7/6/22,Spain,40.463667,-3.74922,12890002,0,108259,12781743
7/7/22,Spain,40.463667,-3.74922,12890002,0,108259,12781743
7/8/22,Spain,40.463667,-3.74922,12973615,0,108730,12864885
7/9/22,Spain,40.463667,-3.74922,12973615,0,108730,12864885
7/10/22,Spain,40.463667,-3.74922,12973615,0,108730,12864885
7/11/22,Spain,40.463667,-3.74922,12973615,0,108730,12864885
7/12/22,Spain,40.463667,-3.74922,13032841,0,108974,12923867
7/13/22,Spain,40.463667,-3.74922,13032841,0,108974,12923867
7/14/22,Spain,40.463667,-3.74922,13032841,0,108974,12923867
7/15/22,Spain,40.463667,-3.74922,13090476,0,109348,12981128
7/16/22,Spain,40.463667,-3.74922,13090476,0,109348,12981128
7/17/22,Spain,40.463667,-3.74922,13090476,0,109348,12981128
7/18/22,Spain,40.463667,-3.74922,13090476,0,109348,12981128
7/19/22,Spain,40.463667,-3.74922,13132159,0,109642,13022517
7/20/22,Spain,40.463667,-3.74922,13132159,0,109642,13022517
7/21/22,Spain,40.463667,-3.74922,13132159,0,109642,13022517
7/22/22,Spain,40.463667,-3.74922,13204863,0,110187,13094676
7/23/22,Spain,40.463667,-3.74922,13204863,0,110187,13094676
7/24/22,Spain,40.463667,-3.74922,13204863,0,110187,13094676
7/25/22,Spain,40.463667,-3.74922,13204863,0,110187,13094676
7/26/22,Spain,40.463667,-3.74922,13203228,0,110394,13092834
7/27/22,Spain,40.463667,-3.74922,13203228,0,110394,13092834
7/28/22,Spain,40.463667,-3.74922,13203228,0,110394,13092834
7/29/22,Spain,40.463667,-3.74922,13226579,0,110719,13115860
7/30/22,Spain,40.463667,-3.74922,13226579,0,110719,13115860
7/31/22,Spain,40.463667,-3.74922,13226579,0,110719,13115860
8/1/22,Spain,40.463667,-3.74922,13226579,0,110719,13115860
8/2/22,Spain,40.463667,-3.74922,13245996,0,110713,13135283
8/3/22,Spain,40.463667,-3.74922,13245996,0,110713,13135283
8/4/22,Spain,40.463667,-3.74922,13245996,0,110713,13135283
8/5/22,Spain,40.463667,-3.74922,13266184,0,111094,13155090
8/6/22,Spain,40.463667,-3.74922,13266184,0,111094,13155090
8/7/22,Spain,40.463667,-3.74922,13266184,0,111094,13155090
8/8/22,Spain,40.463667,-3.74922,13266184,0,111094,13155090
8/9/22,Spain,40.463667,-3.74922,13280557,0,111339,13169218
8/10/22,Spain,40.463667,-3.74922,13280557,0,111339,13169218
8/11/22,Spain,40.463667,-3.74922,13280557,0,111339,13169218
8/12/22,Spain,40.463667,-3.74922,13294139,0,111667,13182472
8/13/22,Spain,40.463667,-3.74922,13294139,0,111667,13182472
8/14/22,Spain,40.463667,-3.74922,13294139,0,111667,13182472
8/15/22,Spain,40.463667,-3.74922,13294139,0,111667,13182472
8/16/22,Spain,40.463667,-3.74922,13306301,0,111906,13194395
8/17/22,Spain,40.463667,-3.74922,13306301,0,111906,13194395
8/18/22,Spain,40.463667,-3.74922,13306301,0,111906,13194395
8/19/22,Spain,40.463667,-3.74922,13314764,0,112128,13202636
8/20/22,Spain,40.463667,-3.74922,13314764,0,112128,13202636
8/21/22,Spain,40.463667,-3.74922,13314764,0,112128,13202636
8/22/22,Spain,40.463667,-3.74922,13314764,0,112128,13202636
8/23/22,Spain,40.463667,-3.74922,13323784,0,112246,13211538
8/24/22,Spain,40.463667,-3.74922,13323784,0,112246,13211538
8/25/22,Spain,40.463667,-3.74922,13323784,0,112246,13211538
8/26/22,Spain,40.463667,-3.74922,13332976,0,112454,13220522
8/27/22,Spain,40.463667,-3.74922,13332976,0,112454,13220522
8/28/22,Spain,40.463667,-3.74922,13332976,0,112454,13220522
8/29/22,Spain,40.463667,-3.74922,13332976,0,112454,13220522
8/30/22,Spain,40.463667,-3.74922,13342530,0,112600,13229930
8/31/22,Spain,40.463667,-3.74922,13342530,0,112600,13229930
9/1/22,Spain,40.463667,-3.74922,13342530,0,112600,13229930
9/2/22,Spain,40.463667,-3.74922,13352019,0,112804,13239215
9/3/22,Spain,40.463667,-3.74922,13352019,0,112804,13239215
9/4/22,Spain,40.463667,-3.74922,13352019,0,112804,13239215
9/5/22,Spain,40.463667,-3.74922,13352019,0,112804,13239215
9/6/22,Spain,40.463667,-3.74922,13358364,0,112931,13245433
9/7/22,Spain,40.463667,-3.74922,13358722,0,112923,13245799
9/8/22,Spain,40.463667,-3.74922,13358722,0,112923,13245799
9/9/22,Spain,40.463667,-3.74922,13367647,0,113130,13254517
9/10/22,Spain,40.463667,-3.74922,13367647,0,113130,13254517
9/11/22,Spain,40.463667,-3.74922,13367647,0,113130,13254517
9/12/22,Spain,40.463667,-3.74922,13367647,0,113130,13254517
9/13/22,Spain,40.463667,-3.74922,13374116,0,113279,13260837
9/14/22,Spain,40.463667,-3.74922,13374116,0,113279,13260837
9/15/22,Spain,40.463667,-3.74922,13374116,0,113279,13260837
9/16/22,Spain,40.463667,-3.74922,13384876,0,113725,13271151
9/17/22,Spain,40.463667,-3.74922,13384876,0,113725,13271151
9/18/22,Spain,40.463667,-3.74922,13384876,0,113725,13271151
9/19/22,Spain,40.463667,-3.74922,13384876,0,113725,13271151
9/20/22,Spain,40.463667,-3.74922,13393196,0,113845,13279351
9/21/22,Spain,40.463667,-3.74922,13393196,0,113845,13279351
9/22/22,Spain,40.463667,-3.74922,13393196,0,113845,13279351
9/23/22,Spain,40.463667,-3.74922,13403502,0,114009,13289493
9/24/22,Spain,40.463667,-3.74922,13403502,0,114009,13289493
9/25/22,Spain,40.463667,-3.74922,13403502,0,114009,13289493
9/26/22,Spain,40.463667,-3.74922,13403502,0,114009,13289493
9/27/22,Spain,40.463667,-3.74922,13412263,0,114084,13298179
9/28/22,Spain,40.463667,-3.74922,13412263,0,114084,13298179
9/29/22,Spain,40.463667,-3.74922,13412263,0,114084,13298179
9/30/22,Spain,40.463667,-3.74922,13422984,0,114179,13308805
10/1/22,Spain,40.463667,-3.74922,13422984,0,114179,13308805
10/2/22,Spain,40.463667,-3.74922,13422984,0,114179,13308805
10/3/22,Spain,40.463667,-3.74922,13422984,0,114179,13308805
10/4/22,Spain,40.463667,-3.74922,13431098,0,114262,13316836
10/5/22,Spain,40.463667,-3.74922,13431098,0,114262,13316836
10/6/22,Spain,40.463667,-3.74922,13431098,0,114262,13316836
10/7/22,Spain,40.463667,-3.74922,13441941,0,114468,13327473
10/8/22,Spain,40.463667,-3.74922,13441941,0,114468,13327473
10/9/22,Spain,40.463667,-3.74922,13441941,0,114468,13327473
10/10/22,Spain,40.463667,-3.74922,13441941,0,114468,13327473
10/11/22,Spain,40.463667,-3.74922,13441941,0,114468,13327473
10/12/22,Spain,40.463667,-3.74922,13441941,0,114468,13327473
10/13/22,Spain,40.463667,-3.74922,13441941,0,114468,13327473
10/14/22,Spain,40.463667,-3.74922,13462593,0,114641,13347952
10/15/22,Spain,40.463667,-3.74922,13462593,0,114641,13347952
10/16/22,Spain,40.463667,-3.74922,13462593,0,114641,13347952
10/17/22,Spain,40.463667,-3.74922,13462593,0,114641,13347952
10/18/22,Spain,40.463667,-3.74922,13462593,0,114641,13347952
10/19/22,Spain,40.463667,-3.74922,13462593,0,114641,13347952
10/20/22,Spain,40.463667,-3.74922,13462593,0,114641,13347952
10/21/22,Spain,40.463667,-3.74922,13486386,0,114862,13371524
10/22/22,Spain,40.463667,-3.74922,13486386,0,114862,13371524
10/23/22,Spain,40.463667,-3.74922,13486386,0,114862,13371524
10/24/22,Spain,40.463667,-3.74922,13488015,0,114858,13373157
10/25/22,Spain,40.463667,-3.74922,13488015,0,114858,13373157
10/26/22,Spain,40.463667,-3.74922,13488015,0,114858,13373157
10/27/22,Spain,40.463667,-3.74922,13488015,0,114858,13373157
10/28/22,Spain,40.463667,-3.74922,13511768,0,115078,13396690
10/29/22,Spain,40.463667,-3.74922,13511768,0,115078,13396690
10/30/22,Spain,40.463667,-3.74922,13511768,0,115078,13396690
10/31/22,Spain,40.463667,-3.74922,13511768,0,115078,13396690
11/1/22,Spain,40.463667,-3.74922,13511768,0,115078,13396690
11/2/22,Spain,40.463667,-3.74922,13511768,0,115078,13396690
11/3/22,Spain,40.463667,-3.74922,13511768,0,115078,13396690
11/4/22,Spain,40.463667,-3.74922,13529643,0,115239,13414404
11/5/22,Spain,40.463667,-3.74922,13529643,0,115239,13414404
11/6/22,Spain,40.463667,-3.74922,13529643,0,115239,13414404
11/7/22,Spain,40.463667,-3.74922,13529643,0,115239,13414404
11/8/22,Spain,40.463667,-3.74922,13529643,0,115239,13414404
11/9/22,Spain,40.463667,-3.74922,13529643,0,115239,13414404
11/10/22,Spain,40.463667,-3.74922,13529643,0,115239,13414404
11/11/22,Spain,40.463667,-3.74922,13543816,0,115422,13428394
11/12/22,Spain,40.463667,-3.74922,13551539,0,115357,13436182
11/13/22,Spain,40.463667,-3.74922,13551539,0,115357,13436182
11/14/22,Spain,40.463667,-3.74922,13551539,0,115357,13436182
11/15/22,Spain,40.463667,-3.74922,13551539,0,115357,13436182
11/16/22,Spain,40.463667,-3.74922,13551539,0,115357,13436182
11/17/22,Spain,40.463667,-3.74922,13551539,0,115357,13436182
11/18/22,Spain,40.463667,-3.74922,13573721,0,115641,13458080
11/19/22,Spain,40.463667,-3.74922,13573721,0,115641,13458080
11/20/22,Spain,40.463667,-3.74922,13573721,0,115641,13458080
11/21/22,Spain,40.463667,-3.74922,13573721,0,115641,13458080
11/22/22,Spain,40.463667,-3.74922,13573721,0,115641,13458080
11/23/22,Spain,40.463667,-3.74922,13573721,0,115641,13458080
11/24/22,Spain,40.463667,-3.74922,13573721,0,115641,13458080
11/25/22,Spain,40.463667,-3.74922,13595504,0,115901,13479603
11/26/22,Spain,40.463667,-3.74922,13595504,0,115901,13479603
11/27/22,Spain,40.463667,-3.74922,13595504,0,115901,13479603
11/28/22,Spain,40.463667,-3.74922,13595504,0,115901,13479603
11/29/22,Spain,40.463667,-3.74922,13595504,0,115901,13479603
11/30/22,Spain,40.463667,-3.74922,13595504,0,115901,13479603
12/1/22,Spain,40.463667,-3.74922,13595504,0,115901,13479603
12/2/22,Spain,40.463667,-3.74922,13614807,0,116108,13498699
12/3/22,Spain,40.463667,-3.74922,13614807,0,116108,13498699
12/4/22,Spain,40.463667,-3.74922,13614807,0,116108,13498699
12/5/22,Spain,40.463667,-3.74922,13614807,0,116108,13498699
12/6/22,Spain,40.463667,-3.74922,13614807,0,116108,13498699
12/7/22,Spain,40.463667,-3.74922,13614807,0,116108,13498699
12/8/22,Spain,40.463667,-3.74922,13614807,0,116108,13498699
12/9/22,Spain,40.463667,-3.74922,13632635,0,116422,13516213
12/10/22,Spain,40.463667,-3.74922,13632635,0,116422,13516213
12/11/22,Spain,40.463667,-3.74922,13632635,0,116422,13516213
12/12/22,Spain,40.463667,-3.74922,13632635,0,116422,13516213
12/13/22,Spain,40.463667,-3.74922,13632635,0,116422,13516213
12/14/22,Spain,40.463667,-3.74922,13632635,0,116422,13516213
12/15/22,Spain,40.463667,-3.74922,13632635,0,116422,13516213
12/16/22,Spain,40.463667,-3.74922,13651239,0,116658,13534581
12/17/22,Spain,40.463667,-3.74922,13651239,0,116658,13534581
1/1/22,Sri Lanka,7.873054,80.771797,587596,0,14997,572599
1/2/22,Sri Lanka,7.873054,80.771797,587935,0,15019,572916
1/3/22,Sri Lanka,7.873054,80.771797,588300,0,15037,573263
1/4/22,Sri Lanka,7.873054,80.771797,588929,0,15055,573874
1/5/22,Sri Lanka,7.873054,80.771797,589479,0,15065,574414
1/6/22,Sri Lanka,7.873054,80.771797,590063,0,15083,574980
1/7/22,Sri Lanka,7.873054,80.771797,590651,0,15099,575552
1/8/22,Sri Lanka,7.873054,80.771797,591231,0,15112,576119
1/9/22,Sri Lanka,7.873054,80.771797,591667,0,15119,576548
1/10/22,Sri Lanka,7.873054,80.771797,592128,0,15134,576994
1/11/22,Sri Lanka,7.873054,80.771797,593072,0,15149,577923
1/12/22,Sri Lanka,7.873054,80.771797,593725,0,15163,578562
1/13/22,Sri Lanka,7.873054,80.771797,594319,0,15174,579145
1/14/22,Sri Lanka,7.873054,80.771797,594996,0,15190,579806
1/15/22,Sri Lanka,7.873054,80.771797,595657,0,15197,580460
1/16/22,Sri Lanka,7.873054,80.771797,596347,0,15211,581136
1/17/22,Sri Lanka,7.873054,80.771797,597035,0,15218,581817
1/18/22,Sri Lanka,7.873054,80.771797,597707,0,15231,582476
1/19/22,Sri Lanka,7.873054,80.771797,598536,0,15243,583293
1/20/22,Sri Lanka,7.873054,80.771797,599363,0,15255,584108
1/21/22,Sri Lanka,7.873054,80.771797,600203,0,15272,584931
1/22/22,Sri Lanka,7.873054,80.771797,601048,0,15284,585764
1/23/22,Sri Lanka,7.873054,80.771797,601886,0,15299,586587
1/24/22,Sri Lanka,7.873054,80.771797,602763,0,15313,587450
1/25/22,Sri Lanka,7.873054,80.771797,603654,0,15330,588324
1/26/22,Sri Lanka,7.873054,80.771797,604581,0,15346,589235
1/27/22,Sri Lanka,7.873054,80.771797,607104,0,15369,591735
1/28/22,Sri Lanka,7.873054,80.771797,608065,0,15386,592679
1/29/22,Sri Lanka,7.873054,80.771797,609047,0,15400,593647
1/30/22,Sri Lanka,7.873054,80.771797,610103,0,15420,594683
1/31/22,Sri Lanka,7.873054,80.771797,611185,0,15441,595744
2/1/22,Sri Lanka,7.873054,80.771797,612322,0,15474,596848
2/2/22,Sri Lanka,7.873054,80.771797,613478,0,15492,597986
2/3/22,Sri Lanka,7.873054,80.771797,614659,0,15515,599144
2/4/22,Sri Lanka,7.873054,80.771797,615902,0,15544,600358
2/5/22,Sri Lanka,7.873054,80.771797,617189,0,15572,601617
2/6/22,Sri Lanka,7.873054,80.771797,618520,0,15595,602925
2/7/22,Sri Lanka,7.873054,80.771797,620732,0,15621,605111
2/8/22,Sri Lanka,7.873054,80.771797,621985,0,15656,606329
2/9/22,Sri Lanka,7.873054,80.771797,623248,0,15692,607556
2/10/22,Sri Lanka,7.873054,80.771797,624545,0,15723,608822
2/11/22,Sri Lanka,7.873054,80.771797,625804,0,15754,610050
2/12/22,Sri Lanka,7.873054,80.771797,626966,0,15777,611189
2/13/22,Sri Lanka,7.873054,80.771797,628116,0,15808,612308
2/14/22,Sri Lanka,7.873054,80.771797,629347,0,15844,613503
2/15/22,Sri Lanka,7.873054,80.771797,630599,0,15874,614725
2/16/22,Sri Lanka,7.873054,80.771797,631816,0,15899,615917
2/17/22,Sri Lanka,7.873054,80.771797,633051,0,15926,617125
2/18/22,Sri Lanka,7.873054,80.771797,634333,0,15949,618384
2/19/22,Sri Lanka,7.873054,80.771797,635606,0,15969,619637
2/20/22,Sri Lanka,7.873054,80.771797,636837,0,15994,620843
2/21/22,Sri Lanka,7.873054,80.771797,638043,0,16024,622019
2/22/22,Sri Lanka,7.873054,80.771797,639297,0,16055,623242
2/23/22,Sri Lanka,7.873054,80.771797,640578,0,16086,624492
2/24/22,Sri Lanka,7.873054,80.771797,641786,0,16116,625670
2/25/22,Sri Lanka,7.873054,80.771797,643072,0,16142,626930
2/26/22,Sri Lanka,7.873054,80.771797,644060,0,16166,627894
2/27/22,Sri Lanka,7.873054,80.771797,645037,0,16190,628847
2/28/22,Sri Lanka,7.873054,80.771797,646034,0,16222,629812
3/1/22,Sri Lanka,7.873054,80.771797,646948,0,16244,630704
3/2/22,Sri Lanka,7.873054,80.771797,647699,0,16267,631432
3/3/22,Sri Lanka,7.873054,80.771797,648410,0,16287,632123
3/4/22,Sri Lanka,7.873054,80.771797,648993,0,16307,632686
3/5/22,Sri Lanka,7.873054,80.771797,649632,0,16321,633311
3/6/22,Sri Lanka,7.873054,80.771797,650140,0,16331,633809
3/7/22,Sri Lanka,7.873054,80.771797,650802,0,16339,634463
3/8/22,Sri Lanka,7.873054,80.771797,653029,0,16339,636690
3/9/22,Sri Lanka,7.873054,80.771797,654336,0,16361,637975
3/10/22,Sri Lanka,7.873054,80.771797,654916,0,16374,638542
3/11/22,Sri Lanka,7.873054,80.771797,655383,0,16381,639002
3/12/22,Sri Lanka,7.873054,80.771797,655730,0,16390,639340
3/13/22,Sri Lanka,7.873054,80.771797,656041,0,16397,639644
3/14/22,Sri Lanka,7.873054,80.771797,656386,0,16407,639979
3/15/22,Sri Lanka,7.873054,80.771797,656814,0,16415,640399
3/16/22,Sri Lanka,7.873054,80.771797,657134,0,16416,640718
3/17/22,Sri Lanka,7.873054,80.771797,657435,0,16419,641016
3/18/22,Sri Lanka,7.873054,80.771797,657723,0,16422,641301
3/19/22,Sri Lanka,7.873054,80.771797,657961,0,16426,641535
3/20/22,Sri Lanka,7.873054,80.771797,658197,0,16431,641766
3/21/22,Sri Lanka,7.873054,80.771797,658493,0,16436,642057
3/22/22,Sri Lanka,7.873054,80.771797,659859,0,16440,643419
3/23/22,Sri Lanka,7.873054,80.771797,660151,0,16445,643706
3/24/22,Sri Lanka,7.873054,80.771797,660399,0,16450,643949
3/25/22,Sri Lanka,7.873054,80.771797,660633,0,16452,644181
3/26/22,Sri Lanka,7.873054,80.771797,660797,0,16454,644343
3/27/22,Sri Lanka,7.873054,80.771797,660890,0,16459,644431
3/28/22,Sri Lanka,7.873054,80.771797,661053,0,16465,644588
3/29/22,Sri Lanka,7.873054,80.771797,661285,0,16469,644816
3/30/22,Sri Lanka,7.873054,80.771797,661453,0,16473,644980
3/31/22,Sri Lanka,7.873054,80.771797,661631,0,16477,645154
4/1/22,Sri Lanka,7.873054,80.771797,661781,0,16479,645302
4/2/22,Sri Lanka,7.873054,80.771797,661885,0,16480,645405
4/3/22,Sri Lanka,7.873054,80.771797,661991,0,16481,645510
4/4/22,Sri Lanka,7.873054,80.771797,662103,0,16485,645618
4/5/22,Sri Lanka,7.873054,80.771797,662216,0,16485,645731
4/6/22,Sri Lanka,7.873054,80.771797,662342,0,16486,645856
4/7/22,Sri Lanka,7.873054,80.771797,662425,0,16487,645938
4/8/22,Sri Lanka,7.873054,80.771797,662505,0,16489,646016
4/9/22,Sri Lanka,7.873054,80.771797,662559,0,16489,646070
4/10/22,Sri Lanka,7.873054,80.771797,662592,0,16489,646103
4/11/22,Sri Lanka,7.873054,80.771797,662657,0,16492,646165
4/12/22,Sri Lanka,7.873054,80.771797,662717,0,16492,646225
4/13/22,Sri Lanka,7.873054,80.771797,662748,0,16494,646254
4/14/22,Sri Lanka,7.873054,80.771797,662775,0,16495,646280
4/15/22,Sri Lanka,7.873054,80.771797,662794,0,16495,646299
4/16/22,Sri Lanka,7.873054,80.771797,662827,0,16495,646332
4/17/22,Sri Lanka,7.873054,80.771797,662827,0,16495,646332
4/18/22,Sri Lanka,7.873054,80.771797,662912,0,16496,646416
4/19/22,Sri Lanka,7.873054,80.771797,662945,0,16497,646448
4/20/22,Sri Lanka,7.873054,80.771797,663006,0,16497,646509
4/21/22,Sri Lanka,7.873054,80.771797,663041,0,16499,646542
4/22/22,Sri Lanka,7.873054,80.771797,663091,0,16500,646591
4/23/22,Sri Lanka,7.873054,80.771797,663131,0,16502,646629
4/24/22,Sri Lanka,7.873054,80.771797,663131,0,16502,646629
4/25/22,Sri Lanka,7.873054,80.771797,663195,0,16502,646693
4/26/22,Sri Lanka,7.873054,80.771797,663239,0,16503,646736
4/27/22,Sri Lanka,7.873054,80.771797,663239,0,16503,646736
4/28/22,Sri Lanka,7.873054,80.771797,663301,0,16504,646797
4/29/22,Sri Lanka,7.873054,80.771797,663329,0,16504,646825
4/30/22,Sri Lanka,7.873054,80.771797,663362,0,16504,646858
5/1/22,Sri Lanka,7.873054,80.771797,663373,0,16505,646868
5/2/22,Sri Lanka,7.873054,80.771797,663408,0,16505,646903
5/3/22,Sri Lanka,7.873054,80.771797,663426,0,16506,646920
5/4/22,Sri Lanka,7.873054,80.771797,663469,0,16507,646962
5/5/22,Sri Lanka,7.873054,80.771797,663503,0,16507,646996
5/6/22,Sri Lanka,7.873054,80.771797,663520,0,16507,647013
5/7/22,Sri Lanka,7.873054,80.771797,663533,0,16509,647024
5/8/22,Sri Lanka,7.873054,80.771797,663561,0,16509,647052
5/9/22,Sri Lanka,7.873054,80.771797,663561,0,16509,647052
5/10/22,Sri Lanka,7.873054,80.771797,663597,0,16509,647088
5/11/22,Sri Lanka,7.873054,80.771797,663614,0,16510,647104
5/12/22,Sri Lanka,7.873054,80.771797,663632,0,16510,647122
5/13/22,Sri Lanka,7.873054,80.771797,663655,0,16511,647144
5/14/22,Sri Lanka,7.873054,80.771797,663663,0,16511,647152
5/15/22,Sri Lanka,7.873054,80.771797,663671,0,16511,647160
5/16/22,Sri Lanka,7.873054,80.771797,663678,0,16511,647167
5/17/22,Sri Lanka,7.873054,80.771797,663689,0,16511,647178
5/18/22,Sri Lanka,7.873054,80.771797,663720,0,16511,647209
5/19/22,Sri Lanka,7.873054,80.771797,663735,0,16512,647223
5/20/22,Sri Lanka,7.873054,80.771797,663741,0,16512,647229
5/21/22,Sri Lanka,7.873054,80.771797,663749,0,16512,647237
5/22/22,Sri Lanka,7.873054,80.771797,663758,0,16512,647246
5/23/22,Sri Lanka,7.873054,80.771797,663765,0,16512,647253
5/24/22,Sri Lanka,7.873054,80.771797,663779,0,16513,647266
5/25/22,Sri Lanka,7.873054,80.771797,663786,0,16513,647273
5/26/22,Sri Lanka,7.873054,80.771797,663800,0,16513,647287
5/27/22,Sri Lanka,7.873054,80.771797,663804,0,16514,647290
5/28/22,Sri Lanka,7.873054,80.771797,663812,0,16515,647297
5/29/22,Sri Lanka,7.873054,80.771797,663816,0,16516,647300
5/30/22,Sri Lanka,7.873054,80.771797,663823,0,16517,647306
5/31/22,Sri Lanka,7.873054,80.771797,663834,0,16517,647317
6/1/22,Sri Lanka,7.873054,80.771797,663838,0,16518,647320
6/2/22,Sri Lanka,7.873054,80.771797,663845,0,16518,647327
6/3/22,Sri Lanka,7.873054,80.771797,663853,0,16518,647335
6/4/22,Sri Lanka,7.873054,80.771797,663862,0,16518,647344
6/5/22,Sri Lanka,7.873054,80.771797,663869,0,16518,647351
6/6/22,Sri Lanka,7.873054,80.771797,663884,0,16518,647366
6/7/22,Sri Lanka,7.873054,80.771797,663895,0,16518,647377
6/8/22,Sri Lanka,7.873054,80.771797,663901,0,16518,647383
6/9/22,Sri Lanka,7.873054,80.771797,663917,0,16518,647399
6/10/22,Sri Lanka,7.873054,80.771797,663922,0,16518,647404
6/11/22,Sri Lanka,7.873054,80.771797,663937,0,16519,647418
6/12/22,Sri Lanka,7.873054,80.771797,663950,0,16519,647431
6/13/22,Sri Lanka,7.873054,80.771797,663960,0,16519,647441
6/14/22,Sri Lanka,7.873054,80.771797,663965,0,16519,647446
6/15/22,Sri Lanka,7.873054,80.771797,663965,0,16519,647446
6/16/22,Sri Lanka,7.873054,80.771797,663975,0,16519,647456
6/17/22,Sri Lanka,7.873054,80.771797,663984,0,16520,647464
6/18/22,Sri Lanka,7.873054,80.771797,663984,0,16520,647464
6/19/22,Sri Lanka,7.873054,80.771797,663989,0,16520,647469
6/20/22,Sri Lanka,7.873054,80.771797,664010,0,16520,647490
6/21/22,Sri Lanka,7.873054,80.771797,664018,0,16520,647498
6/22/22,Sri Lanka,7.873054,80.771797,664036,0,16520,647516
6/23/22,Sri Lanka,7.873054,80.771797,664047,0,16520,647527
6/24/22,Sri Lanka,7.873054,80.771797,664052,0,16521,647531
6/25/22,Sri Lanka,7.873054,80.771797,664065,0,16521,647544
6/26/22,Sri Lanka,7.873054,80.771797,664080,0,16521,647559
6/27/22,Sri Lanka,7.873054,80.771797,664090,0,16521,647569
6/28/22,Sri Lanka,7.873054,80.771797,664098,0,16521,647577
6/29/22,Sri Lanka,7.873054,80.771797,664110,0,16521,647589
6/30/22,Sri Lanka,7.873054,80.771797,664123,0,16521,647602
7/1/22,Sri Lanka,7.873054,80.771797,664138,0,16521,647617
7/2/22,Sri Lanka,7.873054,80.771797,664150,0,16521,647629
7/3/22,Sri Lanka,7.873054,80.771797,664167,0,16522,647645
7/4/22,Sri Lanka,7.873054,80.771797,664181,0,16522,647659
7/5/22,Sri Lanka,7.873054,80.771797,664194,0,16523,647671
7/6/22,Sri Lanka,7.873054,80.771797,664197,0,16524,647673
7/7/22,Sri Lanka,7.873054,80.771797,664217,0,16525,647692
7/8/22,Sri Lanka,7.873054,80.771797,664235,0,16525,647710
7/9/22,Sri Lanka,7.873054,80.771797,664256,0,16525,647731
7/10/22,Sri Lanka,7.873054,80.771797,664273,0,16525,647748
7/11/22,Sri Lanka,7.873054,80.771797,664292,0,16526,647766
7/12/22,Sri Lanka,7.873054,80.771797,664315,0,16526,647789
7/13/22,Sri Lanka,7.873054,80.771797,664345,0,16526,647819
7/14/22,Sri Lanka,7.873054,80.771797,664364,0,16526,647838
7/15/22,Sri Lanka,7.873054,80.771797,664389,0,16527,647862
7/16/22,Sri Lanka,7.873054,80.771797,664414,0,16528,647886
7/17/22,Sri Lanka,7.873054,80.771797,664448,0,16528,647920
7/18/22,Sri Lanka,7.873054,80.771797,664510,0,16528,647982
7/19/22,Sri Lanka,7.873054,80.771797,664572,0,16531,648041
7/20/22,Sri Lanka,7.873054,80.771797,664647,0,16533,648114
7/21/22,Sri Lanka,7.873054,80.771797,664704,0,16535,648169
7/22/22,Sri Lanka,7.873054,80.771797,664772,0,16536,648236
7/23/22,Sri Lanka,7.873054,80.771797,664844,0,16537,648307
7/24/22,Sri Lanka,7.873054,80.771797,664900,0,16537,648363
7/25/22,Sri Lanka,7.873054,80.771797,664975,0,16539,648436
7/26/22,Sri Lanka,7.873054,80.771797,665094,0,16544,648550
7/27/22,Sri Lanka,7.873054,80.771797,665094,0,16544,648550
7/28/22,Sri Lanka,7.873054,80.771797,665379,0,16548,648831
7/29/22,Sri Lanka,7.873054,80.771797,665543,0,16553,648990
7/30/22,Sri Lanka,7.873054,80.771797,665626,0,16556,649070
7/31/22,Sri Lanka,7.873054,80.771797,665739,0,16556,649183
8/1/22,Sri Lanka,7.873054,80.771797,665847,0,16559,649288
8/2/22,Sri Lanka,7.873054,80.771797,665964,0,16566,649398
8/3/22,Sri Lanka,7.873054,80.771797,666086,0,16574,649512
8/4/22,Sri Lanka,7.873054,80.771797,666232,0,16574,649658
8/5/22,Sri Lanka,7.873054,80.771797,666413,0,16578,649835
8/6/22,Sri Lanka,7.873054,80.771797,666580,0,16583,649997
8/7/22,Sri Lanka,7.873054,80.771797,666764,0,16586,650178
8/8/22,Sri Lanka,7.873054,80.771797,666944,0,16588,650356
8/9/22,Sri Lanka,7.873054,80.771797,667158,0,16594,650564
8/10/22,Sri Lanka,7.873054,80.771797,667385,0,16603,650782
8/11/22,Sri Lanka,7.873054,80.771797,667573,0,16605,650968
8/12/22,Sri Lanka,7.873054,80.771797,667735,0,16614,651121
8/13/22,Sri Lanka,7.873054,80.771797,667916,0,16619,651297
8/14/22,Sri Lanka,7.873054,80.771797,668012,0,16621,651391
8/15/22,Sri Lanka,7.873054,80.771797,668141,0,16624,651517
8/16/22,Sri Lanka,7.873054,80.771797,668336,0,16630,651706
8/17/22,Sri Lanka,7.873054,80.771797,668497,0,16635,651862
8/18/22,Sri Lanka,7.873054,80.771797,668663,0,16640,652023
8/19/22,Sri Lanka,7.873054,80.771797,668827,0,16646,652181
8/20/22,Sri Lanka,7.873054,80.771797,668827,0,16646,652181
8/21/22,Sri Lanka,7.873054,80.771797,669033,0,16654,652379
8/22/22,Sri Lanka,7.873054,80.771797,669136,0,16660,652476
8/23/22,Sri Lanka,7.873054,80.771797,669362,0,16664,652698
8/24/22,Sri Lanka,7.873054,80.771797,669467,0,16669,652798
8/25/22,Sri Lanka,7.873054,80.771797,669581,0,16675,652906
8/26/22,Sri Lanka,7.873054,80.771797,669639,0,16679,652960
8/27/22,Sri Lanka,7.873054,80.771797,669693,0,16685,653008
8/28/22,Sri Lanka,7.873054,80.771797,669749,0,16687,653062
8/29/22,Sri Lanka,7.873054,80.771797,669819,0,16692,653127
8/30/22,Sri Lanka,7.873054,80.771797,669893,0,16695,653198
8/31/22,Sri Lanka,7.873054,80.771797,669957,0,16698,653259
9/1/22,Sri Lanka,7.873054,80.771797,670018,0,16699,653319
9/2/22,Sri Lanka,7.873054,80.771797,670077,0,16703,653374
9/3/22,Sri Lanka,7.873054,80.771797,670127,0,16707,653420
9/4/22,Sri Lanka,7.873054,80.771797,670176,0,16711,653465
9/5/22,Sri Lanka,7.873054,80.771797,670218,0,16712,653506
9/6/22,Sri Lanka,7.873054,80.771797,670251,0,16716,653535
9/7/22,Sri Lanka,7.873054,80.771797,670297,0,16719,653578
9/8/22,Sri Lanka,7.873054,80.771797,670341,0,16724,653617
9/9/22,Sri Lanka,7.873054,80.771797,670376,0,16725,653651
9/10/22,Sri Lanka,7.873054,80.771797,670408,0,16727,653681
9/11/22,Sri Lanka,7.873054,80.771797,670444,0,16728,653716
9/12/22,Sri Lanka,7.873054,80.771797,670471,0,16731,653740
9/13/22,Sri Lanka,7.873054,80.771797,670501,0,16736,653765
9/14/22,Sri Lanka,7.873054,80.771797,670519,0,16737,653782
9/15/22,Sri Lanka,7.873054,80.771797,670519,0,16737,653782
9/16/22,Sri Lanka,7.873054,80.771797,670570,0,16742,653828
9/17/22,Sri Lanka,7.873054,80.771797,670583,0,16744,653839
9/18/22,Sri Lanka,7.873054,80.771797,670596,0,16747,653849
9/19/22,Sri Lanka,7.873054,80.771797,670617,0,16748,653869
9/20/22,Sri Lanka,7.873054,80.771797,670641,0,16748,653893
9/21/22,Sri Lanka,7.873054,80.771797,670655,0,16751,653904
9/22/22,Sri Lanka,7.873054,80.771797,670668,0,16752,653916
9/23/22,Sri Lanka,7.873054,80.771797,670685,0,16753,653932
9/24/22,Sri Lanka,7.873054,80.771797,670694,0,16754,653940
9/25/22,Sri Lanka,7.873054,80.771797,670694,0,16754,653940
9/26/22,Sri Lanka,7.873054,80.771797,670718,0,16756,653962
9/27/22,Sri Lanka,7.873054,80.771797,670732,0,16757,653975
9/28/22,Sri Lanka,7.873054,80.771797,670749,0,16759,653990
9/29/22,Sri Lanka,7.873054,80.771797,670763,0,16761,654002
9/30/22,Sri Lanka,7.873054,80.771797,670773,0,16761,654012
10/1/22,Sri Lanka,7.873054,80.771797,670780,0,16762,654018
10/2/22,Sri Lanka,7.873054,80.771797,670790,0,16762,654028
10/3/22,Sri Lanka,7.873054,80.771797,670805,0,16763,654042
10/4/22,Sri Lanka,7.873054,80.771797,670813,0,16764,654049
10/5/22,Sri Lanka,7.873054,80.771797,670820,0,16766,654054
10/6/22,Sri Lanka,7.873054,80.771797,670838,0,16766,654072
10/7/22,Sri Lanka,7.873054,80.771797,670844,0,16767,654077
10/8/22,Sri Lanka,7.873054,80.771797,670857,0,16767,654090
10/9/22,Sri Lanka,7.873054,80.771797,670869,0,16768,654101
10/10/22,Sri Lanka,7.873054,80.771797,670873,0,16768,654105
10/11/22,Sri Lanka,7.873054,80.771797,670884,0,16768,654116
10/12/22,Sri Lanka,7.873054,80.771797,670896,0,16768,654128
10/13/22,Sri Lanka,7.873054,80.771797,670899,0,16768,654131
10/14/22,Sri Lanka,7.873054,80.771797,670899,0,16768,654131
10/15/22,Sri Lanka,7.873054,80.771797,670918,0,16769,654149
10/16/22,Sri Lanka,7.873054,80.771797,670921,0,16769,654152
10/17/22,Sri Lanka,7.873054,80.771797,670929,0,16769,654160
10/18/22,Sri Lanka,7.873054,80.771797,670942,0,16770,654172
10/19/22,Sri Lanka,7.873054,80.771797,670952,0,16772,654180
10/20/22,Sri Lanka,7.873054,80.771797,670966,0,16773,654193
10/21/22,Sri Lanka,7.873054,80.771797,670977,0,16774,654203
10/22/22,Sri Lanka,7.873054,80.771797,670989,0,16774,654215
10/23/22,Sri Lanka,7.873054,80.771797,670994,0,16774,654220
10/24/22,Sri Lanka,7.873054,80.771797,671003,0,16774,654229
10/25/22,Sri Lanka,7.873054,80.771797,671015,0,16774,654241
10/26/22,Sri Lanka,7.873054,80.771797,671030,0,16776,654254
10/27/22,Sri Lanka,7.873054,80.771797,671037,0,16777,654260
10/28/22,Sri Lanka,7.873054,80.771797,671051,0,16779,654272
10/29/22,Sri Lanka,7.873054,80.771797,671051,0,16779,654272
10/30/22,Sri Lanka,7.873054,80.771797,671070,0,16779,654291
10/31/22,Sri Lanka,7.873054,80.771797,671087,0,16780,654307
11/1/22,Sri Lanka,7.873054,80.771797,671110,0,16781,654329
11/2/22,Sri Lanka,7.873054,80.771797,671125,0,16781,654344
11/3/22,Sri Lanka,7.873054,80.771797,671302,0,16782,654520
11/4/22,Sri Lanka,7.873054,80.771797,671310,0,16782,654528
11/5/22,Sri Lanka,7.873054,80.771797,671320,0,16782,654538
11/6/22,Sri Lanka,7.873054,80.771797,671328,0,16782,654546
11/7/22,Sri Lanka,7.873054,80.771797,671334,0,16782,654552
11/8/22,Sri Lanka,7.873054,80.771797,671350,0,16782,654568
11/9/22,Sri Lanka,7.873054,80.771797,671354,0,16783,654571
11/10/22,Sri Lanka,7.873054,80.771797,671369,0,16783,654586
11/11/22,Sri Lanka,7.873054,80.771797,671384,0,16784,654600
11/12/22,Sri Lanka,7.873054,80.771797,671406,0,16784,654622
11/13/22,Sri Lanka,7.873054,80.771797,671417,0,16784,654633
11/14/22,Sri Lanka,7.873054,80.771797,671431,0,16784,654647
11/15/22,Sri Lanka,7.873054,80.771797,671455,0,16784,654671
11/16/22,Sri Lanka,7.873054,80.771797,671465,0,16785,654680
11/17/22,Sri Lanka,7.873054,80.771797,671481,0,16788,654693
11/18/22,Sri Lanka,7.873054,80.771797,671497,0,16791,654706
11/19/22,Sri Lanka,7.873054,80.771797,671497,0,16791,654706
11/20/22,Sri Lanka,7.873054,80.771797,671522,0,16793,654729
11/21/22,Sri Lanka,7.873054,80.771797,671546,0,16795,654751
11/22/22,Sri Lanka,7.873054,80.771797,671563,0,16795,654768
11/23/22,Sri Lanka,7.873054,80.771797,671586,0,16796,654790
11/24/22,Sri Lanka,7.873054,80.771797,671610,0,16797,654813
11/25/22,Sri Lanka,7.873054,80.771797,671626,0,16799,654827
11/26/22,Sri Lanka,7.873054,80.771797,671638,0,16800,654838
11/27/22,Sri Lanka,7.873054,80.771797,671642,0,16800,654842
11/28/22,Sri Lanka,7.873054,80.771797,671651,0,16802,654849
11/29/22,Sri Lanka,7.873054,80.771797,671671,0,16802,654869
11/30/22,Sri Lanka,7.873054,80.771797,671682,0,16803,654879
12/1/22,Sri Lanka,7.873054,80.771797,671687,0,16805,654882
12/2/22,Sri Lanka,7.873054,80.771797,671695,0,16805,654890
12/3/22,Sri Lanka,7.873054,80.771797,671703,0,16805,654898
12/4/22,Sri Lanka,7.873054,80.771797,671711,0,16805,654906
12/5/22,Sri Lanka,7.873054,80.771797,671714,0,16805,654909
12/6/22,Sri Lanka,7.873054,80.771797,671719,0,16806,654913
12/7/22,Sri Lanka,7.873054,80.771797,671722,0,16806,654916
12/8/22,Sri Lanka,7.873054,80.771797,671742,0,16807,654935
12/9/22,Sri Lanka,7.873054,80.771797,671745,0,16808,654937
12/10/22,Sri Lanka,7.873054,80.771797,671752,0,16808,654944
12/11/22,Sri Lanka,7.873054,80.771797,671756,0,16808,654948
12/12/22,Sri Lanka,7.873054,80.771797,671761,0,16808,654953
12/13/22,Sri Lanka,7.873054,80.771797,671770,0,16809,654961
12/14/22,Sri Lanka,7.873054,80.771797,671776,0,16809,654967
12/15/22,Sri Lanka,7.873054,80.771797,671793,0,16812,654981
12/16/22,Sri Lanka,7.873054,80.771797,671797,0,16813,654984
12/17/22,Sri Lanka,7.873054,80.771797,671808,0,16814,654994
1/1/22,Sudan,12.8628,30.2176,46518,0,3331,43187
1/2/22,Sudan,12.8628,30.2176,46518,0,3331,43187
1/3/22,Sudan,12.8628,30.2176,46518,0,3331,43187
1/4/22,Sudan,12.8628,30.2176,47272,0,3340,43932
1/5/22,Sudan,12.8628,30.2176,47272,0,3340,43932
1/6/22,Sudan,12.8628,30.2176,47443,0,3340,44103
1/7/22,Sudan,12.8628,30.2176,47443,0,3340,44103
1/8/22,Sudan,12.8628,30.2176,47443,0,3340,44103
1/9/22,Sudan,12.8628,30.2176,47443,0,3340,44103
1/10/22,Sudan,12.8628,30.2176,48355,0,3340,45015
1/11/22,Sudan,12.8628,30.2176,48813,0,3347,45466
1/12/22,Sudan,12.8628,30.2176,49096,0,3358,45738
1/13/22,Sudan,12.8628,30.2176,49916,0,3358,46558
1/14/22,Sudan,12.8628,30.2176,50111,0,3358,46753
1/15/22,Sudan,12.8628,30.2176,50984,0,3358,47626
1/16/22,Sudan,12.8628,30.2176,50984,0,3358,47626
1/17/22,Sudan,12.8628,30.2176,51802,0,3388,48414
1/18/22,Sudan,12.8628,30.2176,52345,0,3390,48955
1/19/22,Sudan,12.8628,30.2176,53080,0,3390,49690
1/20/22,Sudan,12.8628,30.2176,53959,0,3393,50566
1/21/22,Sudan,12.8628,30.2176,53959,0,3393,50566
1/22/22,Sudan,12.8628,30.2176,53959,0,3393,50566
1/23/22,Sudan,12.8628,30.2176,53959,0,3393,50566
1/24/22,Sudan,12.8628,30.2176,55149,0,3404,51745
1/25/22,Sudan,12.8628,30.2176,55833,0,3411,52422
1/26/22,Sudan,12.8628,30.2176,56595,0,3411,53184
1/27/22,Sudan,12.8628,30.2176,57106,0,3422,53684
1/28/22,Sudan,12.8628,30.2176,57106,0,3422,53684
1/29/22,Sudan,12.8628,30.2176,57106,0,3422,53684
1/30/22,Sudan,12.8628,30.2176,57106,0,3422,53684
1/31/22,Sudan,12.8628,30.2176,57632,0,3441,54191
2/1/22,Sudan,12.8628,30.2176,58208,0,3442,54766
2/2/22,Sudan,12.8628,30.2176,58623,0,3533,55090
2/3/22,Sudan,12.8628,30.2176,58874,0,3588,55286
2/4/22,Sudan,12.8628,30.2176,58874,0,3588,55286
2/5/22,Sudan,12.8628,30.2176,58874,0,3588,55286
2/6/22,Sudan,12.8628,30.2176,58874,0,3588,55286
2/7/22,Sudan,12.8628,30.2176,59194,0,3604,55590
2/8/22,Sudan,12.8628,30.2176,59294,0,3632,55662
2/9/22,Sudan,12.8628,30.2176,59345,0,3758,55587
2/10/22,Sudan,12.8628,30.2176,59455,0,3764,55691
2/11/22,Sudan,12.8628,30.2176,59525,0,3764,55761
2/12/22,Sudan,12.8628,30.2176,59631,0,3831,55800
2/13/22,Sudan,12.8628,30.2176,59631,0,3831,55800
2/14/22,Sudan,12.8628,30.2176,59903,0,3831,56072
2/15/22,Sudan,12.8628,30.2176,59903,0,3831,56072
2/16/22,Sudan,12.8628,30.2176,59939,0,3831,56108
2/17/22,Sudan,12.8628,30.2176,59939,0,3831,56108
2/18/22,Sudan,12.8628,30.2176,59939,0,3831,56108
2/19/22,Sudan,12.8628,30.2176,59939,0,3831,56108
2/20/22,Sudan,12.8628,30.2176,59939,0,3831,56108
2/21/22,Sudan,12.8628,30.2176,61223,0,3892,57331
2/22/22,Sudan,12.8628,30.2176,61251,0,3894,57357
2/23/22,Sudan,12.8628,30.2176,61350,0,3895,57455
2/24/22,Sudan,12.8628,30.2176,61376,0,3901,57475
2/25/22,Sudan,12.8628,30.2176,61376,0,3901,57475
2/26/22,Sudan,12.8628,30.2176,61376,0,3901,57475
2/27/22,Sudan,12.8628,30.2176,61376,0,3901,57475
2/28/22,Sudan,12.8628,30.2176,61458,0,3908,57550
3/1/22,Sudan,12.8628,30.2176,61488,0,3909,57579
3/2/22,Sudan,12.8628,30.2176,61512,0,3910,57602
3/3/22,Sudan,12.8628,30.2176,61554,0,3911,57643
3/4/22,Sudan,12.8628,30.2176,61569,0,3912,57657
3/5/22,Sudan,12.8628,30.2176,61569,0,3912,57657
3/6/22,Sudan,12.8628,30.2176,61569,0,3912,57657
3/7/22,Sudan,12.8628,30.2176,61625,0,4865,56760
3/8/22,Sudan,12.8628,30.2176,61631,0,4865,56766
3/9/22,Sudan,12.8628,30.2176,61643,0,4865,56778
3/10/22,Sudan,12.8628,30.2176,61643,0,4865,56778
3/11/22,Sudan,12.8628,30.2176,61655,0,4865,56790
3/12/22,Sudan,12.8628,30.2176,61655,0,4865,56790
3/13/22,Sudan,12.8628,30.2176,61655,0,4865,56790
3/14/22,Sudan,12.8628,30.2176,61713,0,4872,56841
3/15/22,Sudan,12.8628,30.2176,61715,0,4874,56841
3/16/22,Sudan,12.8628,30.2176,61715,0,4874,56841
3/17/22,Sudan,12.8628,30.2176,61775,0,4888,56887
3/18/22,Sudan,12.8628,30.2176,61775,0,4888,56887
3/19/22,Sudan,12.8628,30.2176,61775,0,4888,56887
3/20/22,Sudan,12.8628,30.2176,61775,0,4888,56887
3/21/22,Sudan,12.8628,30.2176,61842,0,4897,56945
3/22/22,Sudan,12.8628,30.2176,61853,0,4898,56955
3/23/22,Sudan,12.8628,30.2176,61862,0,4900,56962
3/24/22,Sudan,12.8628,30.2176,61862,0,4900,56962
3/25/22,Sudan,12.8628,30.2176,61889,0,4901,56988
3/26/22,Sudan,12.8628,30.2176,61889,0,4901,56988
3/27/22,Sudan,12.8628,30.2176,61889,0,4901,56988
3/28/22,Sudan,12.8628,30.2176,61916,0,4902,57014
3/29/22,Sudan,12.8628,30.2176,61929,0,4905,57024
3/30/22,Sudan,12.8628,30.2176,61929,0,4905,57024
3/31/22,Sudan,12.8628,30.2176,61955,0,4907,57048
4/1/22,Sudan,12.8628,30.2176,61955,0,4907,57048
4/2/22,Sudan,12.8628,30.2176,61955,0,4907,57048
4/3/22,Sudan,12.8628,30.2176,61955,0,4907,57048
4/4/22,Sudan,12.8628,30.2176,61966,0,4907,57059
4/5/22,Sudan,12.8628,30.2176,61987,0,4907,57080
4/6/22,Sudan,12.8628,30.2176,61987,0,4907,57080
4/7/22,Sudan,12.8628,30.2176,61987,0,4907,57080
4/8/22,Sudan,12.8628,30.2176,61987,0,4907,57080
4/9/22,Sudan,12.8628,30.2176,61987,0,4907,57080
4/10/22,Sudan,12.8628,30.2176,61987,0,4907,57080
4/11/22,Sudan,12.8628,30.2176,62034,0,4925,57109
4/12/22,Sudan,12.8628,30.2176,62034,0,4925,57109
4/13/22,Sudan,12.8628,30.2176,62057,0,4929,57128
4/14/22,Sudan,12.8628,30.2176,62057,0,4929,57128
4/15/22,Sudan,12.8628,30.2176,62057,0,4929,57128
4/16/22,Sudan,12.8628,30.2176,62057,0,4929,57128
4/17/22,Sudan,12.8628,30.2176,62057,0,4929,57128
4/18/22,Sudan,12.8628,30.2176,62057,0,4929,57128
4/19/22,Sudan,12.8628,30.2176,62079,0,4929,57150
4/20/22,Sudan,12.8628,30.2176,62079,0,4929,57150
4/21/22,Sudan,12.8628,30.2176,62084,0,4929,57155
4/22/22,Sudan,12.8628,30.2176,62093,0,4930,57163
4/23/22,Sudan,12.8628,30.2176,62093,0,4930,57163
4/24/22,Sudan,12.8628,30.2176,62093,0,4930,57163
4/25/22,Sudan,12.8628,30.2176,62093,0,4930,57163
4/26/22,Sudan,12.8628,30.2176,62117,0,4931,57186
4/27/22,Sudan,12.8628,30.2176,62117,0,4931,57186
4/28/22,Sudan,12.8628,30.2176,62117,0,4931,57186
4/29/22,Sudan,12.8628,30.2176,62117,0,4931,57186
4/30/22,Sudan,12.8628,30.2176,62117,0,4931,57186
5/1/22,Sudan,12.8628,30.2176,62117,0,4931,57186
5/2/22,Sudan,12.8628,30.2176,62117,0,4931,57186
5/3/22,Sudan,12.8628,30.2176,62117,0,4931,57186
5/4/22,Sudan,12.8628,30.2176,62135,0,4933,57202
5/5/22,Sudan,12.8628,30.2176,62135,0,4933,57202
5/6/22,Sudan,12.8628,30.2176,62135,0,4933,57202
5/7/22,Sudan,12.8628,30.2176,62135,0,4933,57202
5/8/22,Sudan,12.8628,30.2176,62135,0,4933,57202
5/9/22,Sudan,12.8628,30.2176,62149,0,4935,57214
5/10/22,Sudan,12.8628,30.2176,62161,0,4936,57225
5/11/22,Sudan,12.8628,30.2176,62161,0,4936,57225
5/12/22,Sudan,12.8628,30.2176,62161,0,4936,57225
5/13/22,Sudan,12.8628,30.2176,62161,0,4936,57225
5/14/22,Sudan,12.8628,30.2176,62161,0,4936,57225
5/15/22,Sudan,12.8628,30.2176,62161,0,4936,57225
5/16/22,Sudan,12.8628,30.2176,62195,0,4936,57259
5/17/22,Sudan,12.8628,30.2176,62195,0,4936,57259
5/18/22,Sudan,12.8628,30.2176,62211,0,4937,57274
5/19/22,Sudan,12.8628,30.2176,62211,0,4937,57274
5/20/22,Sudan,12.8628,30.2176,62211,0,4937,57274
5/21/22,Sudan,12.8628,30.2176,62211,0,4937,57274
5/22/22,Sudan,12.8628,30.2176,62211,0,4937,57274
5/23/22,Sudan,12.8628,30.2176,62229,0,4939,57290
5/24/22,Sudan,12.8628,30.2176,62240,0,4941,57299
5/25/22,Sudan,12.8628,30.2176,62251,0,4941,57310
5/26/22,Sudan,12.8628,30.2176,62251,0,4941,57310
5/27/22,Sudan,12.8628,30.2176,62251,0,4941,57310
5/28/22,Sudan,12.8628,30.2176,62251,0,4941,57310
5/29/22,Sudan,12.8628,30.2176,62251,0,4941,57310
5/30/22,Sudan,12.8628,30.2176,62321,0,4941,57380
5/31/22,Sudan,12.8628,30.2176,62355,0,4942,57413
6/1/22,Sudan,12.8628,30.2176,62374,0,4942,57432
6/2/22,Sudan,12.8628,30.2176,62374,0,4942,57432
6/3/22,Sudan,12.8628,30.2176,62374,0,4942,57432
6/4/22,Sudan,12.8628,30.2176,62374,0,4942,57432
6/5/22,Sudan,12.8628,30.2176,62374,0,4942,57432
6/6/22,Sudan,12.8628,30.2176,62382,0,4942,57440
6/7/22,Sudan,12.8628,30.2176,62399,0,4942,57457
6/8/22,Sudan,12.8628,30.2176,62444,0,4950,57494
6/9/22,Sudan,12.8628,30.2176,62444,0,4950,57494
6/10/22,Sudan,12.8628,30.2176,62444,0,4950,57494
6/11/22,Sudan,12.8628,30.2176,62444,0,4950,57494
6/12/22,Sudan,12.8628,30.2176,62444,0,4950,57494
6/13/22,Sudan,12.8628,30.2176,62475,0,4950,57525
6/14/22,Sudan,12.8628,30.2176,62475,0,4950,57525
6/15/22,Sudan,12.8628,30.2176,62489,0,4950,57539
6/16/22,Sudan,12.8628,30.2176,62489,0,4950,57539
6/17/22,Sudan,12.8628,30.2176,62489,0,4950,57539
6/18/22,Sudan,12.8628,30.2176,62489,0,4950,57539
6/19/22,Sudan,12.8628,30.2176,62489,0,4950,57539
6/20/22,Sudan,12.8628,30.2176,62521,0,4950,57571
6/21/22,Sudan,12.8628,30.2176,62533,0,4950,57583
6/22/22,Sudan,12.8628,30.2176,62541,0,4951,57590
6/23/22,Sudan,12.8628,30.2176,62551,0,4951,57600
6/24/22,Sudan,12.8628,30.2176,62551,0,4951,57600
6/25/22,Sudan,12.8628,30.2176,62551,0,4951,57600
6/26/22,Sudan,12.8628,30.2176,62551,0,4951,57600
6/27/22,Sudan,12.8628,30.2176,62551,0,4951,57600
6/28/22,Sudan,12.8628,30.2176,62551,0,4951,57600
6/29/22,Sudan,12.8628,30.2176,62624,0,4951,57673
6/30/22,Sudan,12.8628,30.2176,62624,0,4951,57673
7/1/22,Sudan,12.8628,30.2176,62624,0,4951,57673
7/2/22,Sudan,12.8628,30.2176,62624,0,4951,57673
7/3/22,Sudan,12.8628,30.2176,62624,0,4951,57673
7/4/22,Sudan,12.8628,30.2176,62696,0,4952,57744
7/5/22,Sudan,12.8628,30.2176,62704,0,4952,57752
7/6/22,Sudan,12.8628,30.2176,62704,0,4952,57752
7/7/22,Sudan,12.8628,30.2176,62745,0,4952,57793
7/8/22,Sudan,12.8628,30.2176,62745,0,4952,57793
7/9/22,Sudan,12.8628,30.2176,62745,0,4952,57793
7/10/22,Sudan,12.8628,30.2176,62745,0,4952,57793
7/11/22,Sudan,12.8628,30.2176,62745,0,4952,57793
7/12/22,Sudan,12.8628,30.2176,62795,0,4955,57840
7/13/22,Sudan,12.8628,30.2176,62795,0,4955,57840
7/14/22,Sudan,12.8628,30.2176,62795,0,4955,57840
7/15/22,Sudan,12.8628,30.2176,62795,0,4955,57840
7/16/22,Sudan,12.8628,30.2176,62795,0,4955,57840
7/17/22,Sudan,12.8628,30.2176,62795,0,4955,57840
7/18/22,Sudan,12.8628,30.2176,62872,0,4955,57917
7/19/22,Sudan,12.8628,30.2176,62874,0,4955,57919
7/20/22,Sudan,12.8628,30.2176,62914,0,4955,57959
7/21/22,Sudan,12.8628,30.2176,62914,0,4955,57959
7/22/22,Sudan,12.8628,30.2176,62914,0,4955,57959
7/23/22,Sudan,12.8628,30.2176,62914,0,4955,57959
7/24/22,Sudan,12.8628,30.2176,62914,0,4955,57959
7/25/22,Sudan,12.8628,30.2176,62914,0,4955,57959
7/26/22,Sudan,12.8628,30.2176,63006,0,4957,58049
7/27/22,Sudan,12.8628,30.2176,63006,0,4957,58049
7/28/22,Sudan,12.8628,30.2176,63006,0,4957,58049
7/29/22,Sudan,12.8628,30.2176,63006,0,4957,58049
7/30/22,Sudan,12.8628,30.2176,63006,0,4957,58049
7/31/22,Sudan,12.8628,30.2176,63006,0,4957,58049
8/1/22,Sudan,12.8628,30.2176,63006,0,4957,58049
8/2/22,Sudan,12.8628,30.2176,63074,0,4958,58116
8/3/22,Sudan,12.8628,30.2176,63074,0,4958,58116
8/4/22,Sudan,12.8628,30.2176,63074,0,4958,58116
8/5/22,Sudan,12.8628,30.2176,63074,0,4958,58116
8/6/22,Sudan,12.8628,30.2176,63074,0,4958,58116
8/7/22,Sudan,12.8628,30.2176,63074,0,4958,58116
8/8/22,Sudan,12.8628,30.2176,63128,0,4960,58168
8/9/22,Sudan,12.8628,30.2176,63128,0,4960,58168
8/10/22,Sudan,12.8628,30.2176,63128,0,4960,58168
8/11/22,Sudan,12.8628,30.2176,63128,0,4960,58168
8/12/22,Sudan,12.8628,30.2176,63128,0,4960,58168
8/13/22,Sudan,12.8628,30.2176,63128,0,4960,58168
8/14/22,Sudan,12.8628,30.2176,63128,0,4960,58168
8/15/22,Sudan,12.8628,30.2176,63147,0,4961,58186
8/16/22,Sudan,12.8628,30.2176,63147,0,4961,58186
8/17/22,Sudan,12.8628,30.2176,63147,0,4961,58186
8/18/22,Sudan,12.8628,30.2176,63147,0,4961,58186
8/19/22,Sudan,12.8628,30.2176,63147,0,4961,58186
8/20/22,Sudan,12.8628,30.2176,63147,0,4961,58186
8/21/22,Sudan,12.8628,30.2176,63147,0,4961,58186
8/22/22,Sudan,12.8628,30.2176,63172,0,4961,58211
8/23/22,Sudan,12.8628,30.2176,63173,0,4961,58212
8/24/22,Sudan,12.8628,30.2176,63173,0,4961,58212
8/25/22,Sudan,12.8628,30.2176,63173,0,4961,58212
8/26/22,Sudan,12.8628,30.2176,63173,0,4961,58212
8/27/22,Sudan,12.8628,30.2176,63173,0,4961,58212
8/28/22,Sudan,12.8628,30.2176,63173,0,4961,58212
8/29/22,Sudan,12.8628,30.2176,63173,0,4961,58212
8/30/22,Sudan,12.8628,30.2176,63228,0,4961,58267
8/31/22,Sudan,12.8628,30.2176,63228,0,4961,58267
9/1/22,Sudan,12.8628,30.2176,63228,0,4961,58267
9/2/22,Sudan,12.8628,30.2176,63228,0,4961,58267
9/3/22,Sudan,12.8628,30.2176,63228,0,4961,58267
9/4/22,Sudan,12.8628,30.2176,63228,0,4961,58267
9/5/22,Sudan,12.8628,30.2176,63266,0,4961,58305
9/6/22,Sudan,12.8628,30.2176,63270,0,4961,58309
9/7/22,Sudan,12.8628,30.2176,63270,0,4961,58309
9/8/22,Sudan,12.8628,30.2176,63270,0,4961,58309
9/9/22,Sudan,12.8628,30.2176,63270,0,4961,58309
9/10/22,Sudan,12.8628,30.2176,63270,0,4961,58309
9/11/22,Sudan,12.8628,30.2176,63270,0,4961,58309
9/12/22,Sudan,12.8628,30.2176,63275,0,4961,58314
9/13/22,Sudan,12.8628,30.2176,63275,0,4961,58314
9/14/22,Sudan,12.8628,30.2176,63275,0,4961,58314
9/15/22,Sudan,12.8628,30.2176,63275,0,4961,58314
9/16/22,Sudan,12.8628,30.2176,63275,0,4961,58314
9/17/22,Sudan,12.8628,30.2176,63275,0,4961,58314
9/18/22,Sudan,12.8628,30.2176,63275,0,4961,58314
9/19/22,Sudan,12.8628,30.2176,63285,0,4961,58324
9/20/22,Sudan,12.8628,30.2176,63285,0,4961,58324
9/21/22,Sudan,12.8628,30.2176,63285,0,4961,58324
9/22/22,Sudan,12.8628,30.2176,63285,0,4961,58324
9/23/22,Sudan,12.8628,30.2176,63285,0,4961,58324
9/24/22,Sudan,12.8628,30.2176,63285,0,4961,58324
9/25/22,Sudan,12.8628,30.2176,63285,0,4961,58324
9/26/22,Sudan,12.8628,30.2176,63285,0,4961,58324
9/27/22,Sudan,12.8628,30.2176,63285,0,4961,58324
9/28/22,Sudan,12.8628,30.2176,63285,0,4961,58324
9/29/22,Sudan,12.8628,30.2176,63285,0,4961,58324
9/30/22,Sudan,12.8628,30.2176,63285,0,4961,58324
10/1/22,Sudan,12.8628,30.2176,63285,0,4961,58324
10/2/22,Sudan,12.8628,30.2176,63285,0,4961,58324
10/3/22,Sudan,12.8628,30.2176,63285,0,4961,58324
10/4/22,Sudan,12.8628,30.2176,63285,0,4961,58324
10/5/22,Sudan,12.8628,30.2176,63285,0,4961,58324
10/6/22,Sudan,12.8628,30.2176,63339,0,4962,58377
10/7/22,Sudan,12.8628,30.2176,63339,0,4962,58377
10/8/22,Sudan,12.8628,30.2176,63339,0,4962,58377
10/9/22,Sudan,12.8628,30.2176,63339,0,4962,58377
10/10/22,Sudan,12.8628,30.2176,63344,0,4962,58382
10/11/22,Sudan,12.8628,30.2176,63344,0,4962,58382
10/12/22,Sudan,12.8628,30.2176,63375,0,4963,58412
10/13/22,Sudan,12.8628,30.2176,63375,0,4963,58412
10/14/22,Sudan,12.8628,30.2176,63375,0,4963,58412
10/15/22,Sudan,12.8628,30.2176,63375,0,4963,58412
10/16/22,Sudan,12.8628,30.2176,63375,0,4963,58412
10/17/22,Sudan,12.8628,30.2176,63449,0,4964,58485
10/18/22,Sudan,12.8628,30.2176,63449,0,4964,58485
10/19/22,Sudan,12.8628,30.2176,63449,0,4965,58484
10/20/22,Sudan,12.8628,30.2176,63449,0,4965,58484
10/21/22,Sudan,12.8628,30.2176,63449,0,4965,58484
10/22/22,Sudan,12.8628,30.2176,63449,0,4965,58484
10/23/22,Sudan,12.8628,30.2176,63449,0,4965,58484
10/24/22,Sudan,12.8628,30.2176,63449,0,4966,58483
10/25/22,Sudan,12.8628,30.2176,63449,0,4966,58483
10/26/22,Sudan,12.8628,30.2176,63473,0,4972,58501
10/27/22,Sudan,12.8628,30.2176,63473,0,4972,58501
10/28/22,Sudan,12.8628,30.2176,63473,0,4972,58501
10/29/22,Sudan,12.8628,30.2176,63473,0,4972,58501
10/30/22,Sudan,12.8628,30.2176,63473,0,4972,58501
10/31/22,Sudan,12.8628,30.2176,63481,0,4972,58509
11/1/22,Sudan,12.8628,30.2176,63481,0,4972,58509
11/2/22,Sudan,12.8628,30.2176,63509,0,4972,58537
11/3/22,Sudan,12.8628,30.2176,63509,0,4972,58537
11/4/22,Sudan,12.8628,30.2176,63509,0,4972,58537
11/5/22,Sudan,12.8628,30.2176,63509,0,4972,58537
11/6/22,Sudan,12.8628,30.2176,63509,0,4972,58537
11/7/22,Sudan,12.8628,30.2176,63518,0,4972,58546
11/8/22,Sudan,12.8628,30.2176,63558,0,4978,58580
11/9/22,Sudan,12.8628,30.2176,63558,0,4978,58580
11/10/22,Sudan,12.8628,30.2176,63561,0,4980,58581
11/11/22,Sudan,12.8628,30.2176,63561,0,4980,58581
11/12/22,Sudan,12.8628,30.2176,63561,0,4980,58581
11/13/22,Sudan,12.8628,30.2176,63561,0,4980,58581
11/14/22,Sudan,12.8628,30.2176,63595,0,4981,58614
11/15/22,Sudan,12.8628,30.2176,63595,0,4981,58614
11/16/22,Sudan,12.8628,30.2176,63595,0,4981,58614
11/17/22,Sudan,12.8628,30.2176,63595,0,4981,58614
11/18/22,Sudan,12.8628,30.2176,63595,0,4981,58614
11/19/22,Sudan,12.8628,30.2176,63595,0,4981,58614
11/20/22,Sudan,12.8628,30.2176,63595,0,4981,58614
11/21/22,Sudan,12.8628,30.2176,63617,0,4986,58631
11/22/22,Sudan,12.8628,30.2176,63625,0,4986,58639
11/23/22,Sudan,12.8628,30.2176,63625,0,4986,58639
11/24/22,Sudan,12.8628,30.2176,63637,0,4990,58647
11/25/22,Sudan,12.8628,30.2176,63637,0,4990,58647
11/26/22,Sudan,12.8628,30.2176,63637,0,4990,58647
11/27/22,Sudan,12.8628,30.2176,63637,0,4990,58647
11/28/22,Sudan,12.8628,30.2176,63637,0,4990,58647
11/29/22,Sudan,12.8628,30.2176,63637,0,4990,58647
11/30/22,Sudan,12.8628,30.2176,63637,0,4990,58647
12/1/22,Sudan,12.8628,30.2176,63637,0,4990,58647
12/2/22,Sudan,12.8628,30.2176,63637,0,4990,58647
12/3/22,Sudan,12.8628,30.2176,63637,0,4990,58647
12/4/22,Sudan,12.8628,30.2176,63637,0,4990,58647
12/5/22,Sudan,12.8628,30.2176,63655,0,4991,58664
12/6/22,Sudan,12.8628,30.2176,63655,0,4991,58664
12/7/22,Sudan,12.8628,30.2176,63655,0,4991,58664
12/8/22,Sudan,12.8628,30.2176,63660,0,4992,58668
12/9/22,Sudan,12.8628,30.2176,63660,0,4992,58668
12/10/22,Sudan,12.8628,30.2176,63660,0,4992,58668
12/11/22,Sudan,12.8628,30.2176,63660,0,4992,58668
12/12/22,Sudan,12.8628,30.2176,63663,0,4992,58671
12/13/22,Sudan,12.8628,30.2176,63663,0,4992,58671
12/14/22,Sudan,12.8628,30.2176,63663,0,4992,58671
12/15/22,Sudan,12.8628,30.2176,63663,0,4992,58671
12/16/22,Sudan,12.8628,30.2176,63663,0,4992,58671
12/17/22,Sudan,12.8628,30.2176,63663,0,4992,58671
1/1/22,Summer Olympics 2020,35.6491,139.7737,865,0,0,865
1/2/22,Summer Olympics 2020,35.6491,139.7737,865,0,0,865
1/3/22,Summer Olympics 2020,35.6491,139.7737,865,0,0,865
1/4/22,Summer Olympics 2020,35.6491,139.7737,865,0,0,865
1/5/22,Summer Olympics 2020,35.6491,139.7737,865,0,0,865
1/6/22,Summer Olympics 2020,35.6491,139.7737,865,0,0,865
1/7/22,Summer Olympics 2020,35.6491,139.7737,865,0,0,865
1/8/22,Summer Olympics 2020,35.6491,139.7737,865,0,0,865
1/9/22,Summer Olympics 2020,35.6491,139.7737,865,0,0,865
1/10/22,Summer Olympics 2020,35.6491,139.7737,865,0,0,865
1/11/22,Summer Olympics 2020,35.6491,139.7737,865,0,0,865
1/12/22,Summer Olympics 2020,35.6491,139.7737,865,0,0,865
1/13/22,Summer Olympics 2020,35.6491,139.7737,865,0,0,865
1/14/22,Summer Olympics 2020,35.6491,139.7737,865,0,0,865
1/15/22,Summer Olympics 2020,35.6491,139.7737,865,0,0,865
1/16/22,Summer Olympics 2020,35.6491,139.7737,865,0,0,865
1/17/22,Summer Olympics 2020,35.6491,139.7737,865,0,0,865
1/18/22,Summer Olympics 2020,35.6491,139.7737,865,0,0,865
1/19/22,Summer Olympics 2020,35.6491,139.7737,865,0,0,865
1/20/22,Summer Olympics 2020,35.6491,139.7737,865,0,0,865
1/21/22,Summer Olympics 2020,35.6491,139.7737,865,0,0,865
1/22/22,Summer Olympics 2020,35.6491,139.7737,865,0,0,865
1/23/22,Summer Olympics 2020,35.6491,139.7737,865,0,0,865
1/24/22,Summer Olympics 2020,35.6491,139.7737,865,0,0,865
1/25/22,Summer Olympics 2020,35.6491,139.7737,865,0,0,865
1/26/22,Summer Olympics 2020,35.6491,139.7737,865,0,0,865
1/27/22,Summer Olympics 2020,35.6491,139.7737,865,0,0,865
1/28/22,Summer Olympics 2020,35.6491,139.7737,865,0,0,865
1/29/22,Summer Olympics 2020,35.6491,139.7737,865,0,0,865
1/30/22,Summer Olympics 2020,35.6491,139.7737,865,0,0,865
1/31/22,Summer Olympics 2020,35.6491,139.7737,865,0,0,865
2/1/22,Summer Olympics 2020,35.6491,139.7737,865,0,0,865
2/2/22,Summer Olympics 2020,35.6491,139.7737,865,0,0,865
2/3/22,Summer Olympics 2020,35.6491,139.7737,865,0,0,865
2/4/22,Summer Olympics 2020,35.6491,139.7737,865,0,0,865
2/5/22,Summer Olympics 2020,35.6491,139.7737,865,0,0,865
2/6/22,Summer Olympics 2020,35.6491,139.7737,865,0,0,865
2/7/22,Summer Olympics 2020,35.6491,139.7737,865,0,0,865
2/8/22,Summer Olympics 2020,35.6491,139.7737,865,0,0,865
2/9/22,Summer Olympics 2020,35.6491,139.7737,865,0,0,865
2/10/22,Summer Olympics 2020,35.6491,139.7737,865,0,0,865
2/11/22,Summer Olympics 2020,35.6491,139.7737,865,0,0,865
2/12/22,Summer Olympics 2020,35.6491,139.7737,865,0,0,865
2/13/22,Summer Olympics 2020,35.6491,139.7737,865,0,0,865
2/14/22,Summer Olympics 2020,35.6491,139.7737,865,0,0,865
2/15/22,Summer Olympics 2020,35.6491,139.7737,865,0,0,865
2/16/22,Summer Olympics 2020,35.6491,139.7737,865,0,0,865
2/17/22,Summer Olympics 2020,35.6491,139.7737,865,0,0,865
2/18/22,Summer Olympics 2020,35.6491,139.7737,865,0,0,865
2/19/22,Summer Olympics 2020,35.6491,139.7737,865,0,0,865
2/20/22,Summer Olympics 2020,35.6491,139.7737,865,0,0,865
2/21/22,Summer Olympics 2020,35.6491,139.7737,865,0,0,865
2/22/22,Summer Olympics 2020,35.6491,139.7737,865,0,0,865
2/23/22,Summer Olympics 2020,35.6491,139.7737,865,0,0,865
2/24/22,Summer Olympics 2020,35.6491,139.7737,865,0,0,865
2/25/22,Summer Olympics 2020,35.6491,139.7737,865,0,0,865
2/26/22,Summer Olympics 2020,35.6491,139.7737,865,0,0,865
2/27/22,Summer Olympics 2020,35.6491,139.7737,865,0,0,865
2/28/22,Summer Olympics 2020,35.6491,139.7737,865,0,0,865
3/1/22,Summer Olympics 2020,35.6491,139.7737,865,0,0,865
3/2/22,Summer Olympics 2020,35.6491,139.7737,865,0,0,865
3/3/22,Summer Olympics 2020,35.6491,139.7737,865,0,0,865
3/4/22,Summer Olympics 2020,35.6491,139.7737,865,0,0,865
3/5/22,Summer Olympics 2020,35.6491,139.7737,865,0,0,865
3/6/22,Summer Olympics 2020,35.6491,139.7737,865,0,0,865
3/7/22,Summer Olympics 2020,35.6491,139.7737,865,0,0,865
3/8/22,Summer Olympics 2020,35.6491,139.7737,865,0,0,865
3/9/22,Summer Olympics 2020,35.6491,139.7737,865,0,0,865
3/10/22,Summer Olympics 2020,35.6491,139.7737,865,0,0,865
3/11/22,Summer Olympics 2020,35.6491,139.7737,865,0,0,865
3/12/22,Summer Olympics 2020,35.6491,139.7737,865,0,0,865
3/13/22,Summer Olympics 2020,35.6491,139.7737,865,0,0,865
3/14/22,Summer Olympics 2020,35.6491,139.7737,865,0,0,865
3/15/22,Summer Olympics 2020,35.6491,139.7737,865,0,0,865
3/16/22,Summer Olympics 2020,35.6491,139.7737,865,0,0,865
3/17/22,Summer Olympics 2020,35.6491,139.7737,865,0,0,865
3/18/22,Summer Olympics 2020,35.6491,139.7737,865,0,0,865
3/19/22,Summer Olympics 2020,35.6491,139.7737,865,0,0,865
3/20/22,Summer Olympics 2020,35.6491,139.7737,865,0,0,865
3/21/22,Summer Olympics 2020,35.6491,139.7737,865,0,0,865
3/22/22,Summer Olympics 2020,35.6491,139.7737,865,0,0,865
3/23/22,Summer Olympics 2020,35.6491,139.7737,865,0,0,865
3/24/22,Summer Olympics 2020,35.6491,139.7737,865,0,0,865
3/25/22,Summer Olympics 2020,35.6491,139.7737,865,0,0,865
3/26/22,Summer Olympics 2020,35.6491,139.7737,865,0,0,865
3/27/22,Summer Olympics 2020,35.6491,139.7737,865,0,0,865
3/28/22,Summer Olympics 2020,35.6491,139.7737,865,0,0,865
3/29/22,Summer Olympics 2020,35.6491,139.7737,865,0,0,865
3/30/22,Summer Olympics 2020,35.6491,139.7737,865,0,0,865
3/31/22,Summer Olympics 2020,35.6491,139.7737,865,0,0,865
4/1/22,Summer Olympics 2020,35.6491,139.7737,865,0,0,865
4/2/22,Summer Olympics 2020,35.6491,139.7737,865,0,0,865
4/3/22,Summer Olympics 2020,35.6491,139.7737,865,0,0,865
4/4/22,Summer Olympics 2020,35.6491,139.7737,865,0,0,865
4/5/22,Summer Olympics 2020,35.6491,139.7737,865,0,0,865
4/6/22,Summer Olympics 2020,35.6491,139.7737,865,0,0,865
4/7/22,Summer Olympics 2020,35.6491,139.7737,865,0,0,865
4/8/22,Summer Olympics 2020,35.6491,139.7737,865,0,0,865
4/9/22,Summer Olympics 2020,35.6491,139.7737,865,0,0,865
4/10/22,Summer Olympics 2020,35.6491,139.7737,865,0,0,865
4/11/22,Summer Olympics 2020,35.6491,139.7737,865,0,0,865
4/12/22,Summer Olympics 2020,35.6491,139.7737,865,0,0,865
4/13/22,Summer Olympics 2020,35.6491,139.7737,865,0,0,865
4/14/22,Summer Olympics 2020,35.6491,139.7737,865,0,0,865
4/15/22,Summer Olympics 2020,35.6491,139.7737,865,0,0,865
4/16/22,Summer Olympics 2020,35.6491,139.7737,865,0,0,865
4/17/22,Summer Olympics 2020,35.6491,139.7737,865,0,0,865
4/18/22,Summer Olympics 2020,35.6491,139.7737,865,0,0,865
4/19/22,Summer Olympics 2020,35.6491,139.7737,865,0,0,865
4/20/22,Summer Olympics 2020,35.6491,139.7737,865,0,0,865
4/21/22,Summer Olympics 2020,35.6491,139.7737,865,0,0,865
4/22/22,Summer Olympics 2020,35.6491,139.7737,865,0,0,865
4/23/22,Summer Olympics 2020,35.6491,139.7737,865,0,0,865
4/24/22,Summer Olympics 2020,35.6491,139.7737,865,0,0,865
4/25/22,Summer Olympics 2020,35.6491,139.7737,865,0,0,865
4/26/22,Summer Olympics 2020,35.6491,139.7737,865,0,0,865
4/27/22,Summer Olympics 2020,35.6491,139.7737,865,0,0,865
4/28/22,Summer Olympics 2020,35.6491,139.7737,865,0,0,865
4/29/22,Summer Olympics 2020,35.6491,139.7737,865,0,0,865
4/30/22,Summer Olympics 2020,35.6491,139.7737,865,0,0,865
5/1/22,Summer Olympics 2020,35.6491,139.7737,865,0,0,865
5/2/22,Summer Olympics 2020,35.6491,139.7737,865,0,0,865
5/3/22,Summer Olympics 2020,35.6491,139.7737,865,0,0,865
5/4/22,Summer Olympics 2020,35.6491,139.7737,865,0,0,865
5/5/22,Summer Olympics 2020,35.6491,139.7737,865,0,0,865
5/6/22,Summer Olympics 2020,35.6491,139.7737,865,0,0,865
5/7/22,Summer Olympics 2020,35.6491,139.7737,865,0,0,865
5/8/22,Summer Olympics 2020,35.6491,139.7737,865,0,0,865
5/9/22,Summer Olympics 2020,35.6491,139.7737,865,0,0,865
5/10/22,Summer Olympics 2020,35.6491,139.7737,865,0,0,865
5/11/22,Summer Olympics 2020,35.6491,139.7737,865,0,0,865
5/12/22,Summer Olympics 2020,35.6491,139.7737,865,0,0,865
5/13/22,Summer Olympics 2020,35.6491,139.7737,865,0,0,865
5/14/22,Summer Olympics 2020,35.6491,139.7737,865,0,0,865
5/15/22,Summer Olympics 2020,35.6491,139.7737,865,0,0,865
5/16/22,Summer Olympics 2020,35.6491,139.7737,865,0,0,865
5/17/22,Summer Olympics 2020,35.6491,139.7737,865,0,0,865
5/18/22,Summer Olympics 2020,35.6491,139.7737,865,0,0,865
5/19/22,Summer Olympics 2020,35.6491,139.7737,865,0,0,865
5/20/22,Summer Olympics 2020,35.6491,139.7737,865,0,0,865
5/21/22,Summer Olympics 2020,35.6491,139.7737,865,0,0,865
5/22/22,Summer Olympics 2020,35.6491,139.7737,865,0,0,865
5/23/22,Summer Olympics 2020,35.6491,139.7737,865,0,0,865
5/24/22,Summer Olympics 2020,35.6491,139.7737,865,0,0,865
5/25/22,Summer Olympics 2020,35.6491,139.7737,865,0,0,865
5/26/22,Summer Olympics 2020,35.6491,139.7737,865,0,0,865
5/27/22,Summer Olympics 2020,35.6491,139.7737,865,0,0,865
5/28/22,Summer Olympics 2020,35.6491,139.7737,865,0,0,865
5/29/22,Summer Olympics 2020,35.6491,139.7737,865,0,0,865
5/30/22,Summer Olympics 2020,35.6491,139.7737,865,0,0,865
5/31/22,Summer Olympics 2020,35.6491,139.7737,865,0,0,865
6/1/22,Summer Olympics 2020,35.6491,139.7737,865,0,0,865
6/2/22,Summer Olympics 2020,35.6491,139.7737,865,0,0,865
6/3/22,Summer Olympics 2020,35.6491,139.7737,865,0,0,865
6/4/22,Summer Olympics 2020,35.6491,139.7737,865,0,0,865
6/5/22,Summer Olympics 2020,35.6491,139.7737,865,0,0,865
6/6/22,Summer Olympics 2020,35.6491,139.7737,865,0,0,865
6/7/22,Summer Olympics 2020,35.6491,139.7737,865,0,0,865
6/8/22,Summer Olympics 2020,35.6491,139.7737,865,0,0,865
6/9/22,Summer Olympics 2020,35.6491,139.7737,865,0,0,865
6/10/22,Summer Olympics 2020,35.6491,139.7737,865,0,0,865
6/11/22,Summer Olympics 2020,35.6491,139.7737,865,0,0,865
6/12/22,Summer Olympics 2020,35.6491,139.7737,865,0,0,865
6/13/22,Summer Olympics 2020,35.6491,139.7737,865,0,0,865
6/14/22,Summer Olympics 2020,35.6491,139.7737,865,0,0,865
6/15/22,Summer Olympics 2020,35.6491,139.7737,865,0,0,865
6/16/22,Summer Olympics 2020,35.6491,139.7737,865,0,0,865
6/17/22,Summer Olympics 2020,35.6491,139.7737,865,0,0,865
6/18/22,Summer Olympics 2020,35.6491,139.7737,865,0,0,865
6/19/22,Summer Olympics 2020,35.6491,139.7737,865,0,0,865
6/20/22,Summer Olympics 2020,35.6491,139.7737,865,0,0,865
6/21/22,Summer Olympics 2020,35.6491,139.7737,865,0,0,865
6/22/22,Summer Olympics 2020,35.6491,139.7737,865,0,0,865
6/23/22,Summer Olympics 2020,35.6491,139.7737,865,0,0,865
6/24/22,Summer Olympics 2020,35.6491,139.7737,865,0,0,865
6/25/22,Summer Olympics 2020,35.6491,139.7737,865,0,0,865
6/26/22,Summer Olympics 2020,35.6491,139.7737,865,0,0,865
6/27/22,Summer Olympics 2020,35.6491,139.7737,865,0,0,865
6/28/22,Summer Olympics 2020,35.6491,139.7737,865,0,0,865
6/29/22,Summer Olympics 2020,35.6491,139.7737,865,0,0,865
6/30/22,Summer Olympics 2020,35.6491,139.7737,865,0,0,865
7/1/22,Summer Olympics 2020,35.6491,139.7737,865,0,0,865
7/2/22,Summer Olympics 2020,35.6491,139.7737,865,0,0,865
7/3/22,Summer Olympics 2020,35.6491,139.7737,865,0,0,865
7/4/22,Summer Olympics 2020,35.6491,139.7737,865,0,0,865
7/5/22,Summer Olympics 2020,35.6491,139.7737,865,0,0,865
7/6/22,Summer Olympics 2020,35.6491,139.7737,865,0,0,865
7/7/22,Summer Olympics 2020,35.6491,139.7737,865,0,0,865
7/8/22,Summer Olympics 2020,35.6491,139.7737,865,0,0,865
7/9/22,Summer Olympics 2020,35.6491,139.7737,865,0,0,865
7/10/22,Summer Olympics 2020,35.6491,139.7737,865,0,0,865
7/11/22,Summer Olympics 2020,35.6491,139.7737,865,0,0,865
7/12/22,Summer Olympics 2020,35.6491,139.7737,865,0,0,865
7/13/22,Summer Olympics 2020,35.6491,139.7737,865,0,0,865
7/14/22,Summer Olympics 2020,35.6491,139.7737,865,0,0,865
7/15/22,Summer Olympics 2020,35.6491,139.7737,865,0,0,865
7/16/22,Summer Olympics 2020,35.6491,139.7737,865,0,0,865
7/17/22,Summer Olympics 2020,35.6491,139.7737,865,0,0,865
7/18/22,Summer Olympics 2020,35.6491,139.7737,865,0,0,865
7/19/22,Summer Olympics 2020,35.6491,139.7737,865,0,0,865
7/20/22,Summer Olympics 2020,35.6491,139.7737,865,0,0,865
7/21/22,Summer Olympics 2020,35.6491,139.7737,865,0,0,865
7/22/22,Summer Olympics 2020,35.6491,139.7737,865,0,0,865
7/23/22,Summer Olympics 2020,35.6491,139.7737,865,0,0,865
7/24/22,Summer Olympics 2020,35.6491,139.7737,865,0,0,865
7/25/22,Summer Olympics 2020,35.6491,139.7737,865,0,0,865
7/26/22,Summer Olympics 2020,35.6491,139.7737,865,0,0,865
7/27/22,Summer Olympics 2020,35.6491,139.7737,865,0,0,865
7/28/22,Summer Olympics 2020,35.6491,139.7737,865,0,0,865
7/29/22,Summer Olympics 2020,35.6491,139.7737,865,0,0,865
7/30/22,Summer Olympics 2020,35.6491,139.7737,865,0,0,865
7/31/22,Summer Olympics 2020,35.6491,139.7737,865,0,0,865
8/1/22,Summer Olympics 2020,35.6491,139.7737,865,0,0,865
8/2/22,Summer Olympics 2020,35.6491,139.7737,865,0,0,865
8/3/22,Summer Olympics 2020,35.6491,139.7737,865,0,0,865
8/4/22,Summer Olympics 2020,35.6491,139.7737,865,0,0,865
8/5/22,Summer Olympics 2020,35.6491,139.7737,865,0,0,865
8/6/22,Summer Olympics 2020,35.6491,139.7737,865,0,0,865
8/7/22,Summer Olympics 2020,35.6491,139.7737,865,0,0,865
8/8/22,Summer Olympics 2020,35.6491,139.7737,865,0,0,865
8/9/22,Summer Olympics 2020,35.6491,139.7737,865,0,0,865
8/10/22,Summer Olympics 2020,35.6491,139.7737,865,0,0,865
8/11/22,Summer Olympics 2020,35.6491,139.7737,865,0,0,865
8/12/22,Summer Olympics 2020,35.6491,139.7737,865,0,0,865
8/13/22,Summer Olympics 2020,35.6491,139.7737,865,0,0,865
8/14/22,Summer Olympics 2020,35.6491,139.7737,865,0,0,865
8/15/22,Summer Olympics 2020,35.6491,139.7737,865,0,0,865
8/16/22,Summer Olympics 2020,35.6491,139.7737,865,0,0,865
8/17/22,Summer Olympics 2020,35.6491,139.7737,865,0,0,865
8/18/22,Summer Olympics 2020,35.6491,139.7737,865,0,0,865
8/19/22,Summer Olympics 2020,35.6491,139.7737,865,0,0,865
8/20/22,Summer Olympics 2020,35.6491,139.7737,865,0,0,865
8/21/22,Summer Olympics 2020,35.6491,139.7737,865,0,0,865
8/22/22,Summer Olympics 2020,35.6491,139.7737,865,0,0,865
8/23/22,Summer Olympics 2020,35.6491,139.7737,865,0,0,865
8/24/22,Summer Olympics 2020,35.6491,139.7737,865,0,0,865
8/25/22,Summer Olympics 2020,35.6491,139.7737,865,0,0,865
8/26/22,Summer Olympics 2020,35.6491,139.7737,865,0,0,865
8/27/22,Summer Olympics 2020,35.6491,139.7737,865,0,0,865
8/28/22,Summer Olympics 2020,35.6491,139.7737,865,0,0,865
8/29/22,Summer Olympics 2020,35.6491,139.7737,865,0,0,865
8/30/22,Summer Olympics 2020,35.6491,139.7737,865,0,0,865
8/31/22,Summer Olympics 2020,35.6491,139.7737,865,0,0,865
9/1/22,Summer Olympics 2020,35.6491,139.7737,865,0,0,865
9/2/22,Summer Olympics 2020,35.6491,139.7737,865,0,0,865
9/3/22,Summer Olympics 2020,35.6491,139.7737,865,0,0,865
9/4/22,Summer Olympics 2020,35.6491,139.7737,865,0,0,865
9/5/22,Summer Olympics 2020,35.6491,139.7737,865,0,0,865
9/6/22,Summer Olympics 2020,35.6491,139.7737,865,0,0,865
9/7/22,Summer Olympics 2020,35.6491,139.7737,865,0,0,865
9/8/22,Summer Olympics 2020,35.6491,139.7737,865,0,0,865
9/9/22,Summer Olympics 2020,35.6491,139.7737,865,0,0,865
9/10/22,Summer Olympics 2020,35.6491,139.7737,865,0,0,865
9/11/22,Summer Olympics 2020,35.6491,139.7737,865,0,0,865
9/12/22,Summer Olympics 2020,35.6491,139.7737,865,0,0,865
9/13/22,Summer Olympics 2020,35.6491,139.7737,865,0,0,865
9/14/22,Summer Olympics 2020,35.6491,139.7737,865,0,0,865
9/15/22,Summer Olympics 2020,35.6491,139.7737,865,0,0,865
9/16/22,Summer Olympics 2020,35.6491,139.7737,865,0,0,865
9/17/22,Summer Olympics 2020,35.6491,139.7737,865,0,0,865
9/18/22,Summer Olympics 2020,35.6491,139.7737,865,0,0,865
9/19/22,Summer Olympics 2020,35.6491,139.7737,865,0,0,865
9/20/22,Summer Olympics 2020,35.6491,139.7737,865,0,0,865
9/21/22,Summer Olympics 2020,35.6491,139.7737,865,0,0,865
9/22/22,Summer Olympics 2020,35.6491,139.7737,865,0,0,865
9/23/22,Summer Olympics 2020,35.6491,139.7737,865,0,0,865
9/24/22,Summer Olympics 2020,35.6491,139.7737,865,0,0,865
9/25/22,Summer Olympics 2020,35.6491,139.7737,865,0,0,865
9/26/22,Summer Olympics 2020,35.6491,139.7737,865,0,0,865
9/27/22,Summer Olympics 2020,35.6491,139.7737,865,0,0,865
9/28/22,Summer Olympics 2020,35.6491,139.7737,865,0,0,865
9/29/22,Summer Olympics 2020,35.6491,139.7737,865,0,0,865
9/30/22,Summer Olympics 2020,35.6491,139.7737,865,0,0,865
10/1/22,Summer Olympics 2020,35.6491,139.7737,865,0,0,865
10/2/22,Summer Olympics 2020,35.6491,139.7737,865,0,0,865
10/3/22,Summer Olympics 2020,35.6491,139.7737,865,0,0,865
10/4/22,Summer Olympics 2020,35.6491,139.7737,865,0,0,865
10/5/22,Summer Olympics 2020,35.6491,139.7737,865,0,0,865
10/6/22,Summer Olympics 2020,35.6491,139.7737,865,0,0,865
10/7/22,Summer Olympics 2020,35.6491,139.7737,865,0,0,865
10/8/22,Summer Olympics 2020,35.6491,139.7737,865,0,0,865
10/9/22,Summer Olympics 2020,35.6491,139.7737,865,0,0,865
10/10/22,Summer Olympics 2020,35.6491,139.7737,865,0,0,865
10/11/22,Summer Olympics 2020,35.6491,139.7737,865,0,0,865
10/12/22,Summer Olympics 2020,35.6491,139.7737,865,0,0,865
10/13/22,Summer Olympics 2020,35.6491,139.7737,865,0,0,865
10/14/22,Summer Olympics 2020,35.6491,139.7737,865,0,0,865
10/15/22,Summer Olympics 2020,35.6491,139.7737,865,0,0,865
10/16/22,Summer Olympics 2020,35.6491,139.7737,865,0,0,865
10/17/22,Summer Olympics 2020,35.6491,139.7737,865,0,0,865
10/18/22,Summer Olympics 2020,35.6491,139.7737,865,0,0,865
10/19/22,Summer Olympics 2020,35.6491,139.7737,865,0,0,865
10/20/22,Summer Olympics 2020,35.6491,139.7737,865,0,0,865
10/21/22,Summer Olympics 2020,35.6491,139.7737,865,0,0,865
10/22/22,Summer Olympics 2020,35.6491,139.7737,865,0,0,865
10/23/22,Summer Olympics 2020,35.6491,139.7737,865,0,0,865
10/24/22,Summer Olympics 2020,35.6491,139.7737,865,0,0,865
10/25/22,Summer Olympics 2020,35.6491,139.7737,865,0,0,865
10/26/22,Summer Olympics 2020,35.6491,139.7737,865,0,0,865
10/27/22,Summer Olympics 2020,35.6491,139.7737,865,0,0,865
10/28/22,Summer Olympics 2020,35.6491,139.7737,865,0,0,865
10/29/22,Summer Olympics 2020,35.6491,139.7737,865,0,0,865
10/30/22,Summer Olympics 2020,35.6491,139.7737,865,0,0,865
10/31/22,Summer Olympics 2020,35.6491,139.7737,865,0,0,865
11/1/22,Summer Olympics 2020,35.6491,139.7737,865,0,0,865
11/2/22,Summer Olympics 2020,35.6491,139.7737,865,0,0,865
11/3/22,Summer Olympics 2020,35.6491,139.7737,865,0,0,865
11/4/22,Summer Olympics 2020,35.6491,139.7737,865,0,0,865
11/5/22,Summer Olympics 2020,35.6491,139.7737,865,0,0,865
11/6/22,Summer Olympics 2020,35.6491,139.7737,865,0,0,865
11/7/22,Summer Olympics 2020,35.6491,139.7737,865,0,0,865
11/8/22,Summer Olympics 2020,35.6491,139.7737,865,0,0,865
11/9/22,Summer Olympics 2020,35.6491,139.7737,865,0,0,865
11/10/22,Summer Olympics 2020,35.6491,139.7737,865,0,0,865
11/11/22,Summer Olympics 2020,35.6491,139.7737,865,0,0,865
11/12/22,Summer Olympics 2020,35.6491,139.7737,865,0,0,865
11/13/22,Summer Olympics 2020,35.6491,139.7737,865,0,0,865
11/14/22,Summer Olympics 2020,35.6491,139.7737,865,0,0,865
11/15/22,Summer Olympics 2020,35.6491,139.7737,865,0,0,865
11/16/22,Summer Olympics 2020,35.6491,139.7737,865,0,0,865
11/17/22,Summer Olympics 2020,35.6491,139.7737,865,0,0,865
11/18/22,Summer Olympics 2020,35.6491,139.7737,865,0,0,865
11/19/22,Summer Olympics 2020,35.6491,139.7737,865,0,0,865
11/20/22,Summer Olympics 2020,35.6491,139.7737,865,0,0,865
11/21/22,Summer Olympics 2020,35.6491,139.7737,865,0,0,865
11/22/22,Summer Olympics 2020,35.6491,139.7737,865,0,0,865
11/23/22,Summer Olympics 2020,35.6491,139.7737,865,0,0,865
11/24/22,Summer Olympics 2020,35.6491,139.7737,865,0,0,865
11/25/22,Summer Olympics 2020,35.6491,139.7737,865,0,0,865
11/26/22,Summer Olympics 2020,35.6491,139.7737,865,0,0,865
11/27/22,Summer Olympics 2020,35.6491,139.7737,865,0,0,865
11/28/22,Summer Olympics 2020,35.6491,139.7737,865,0,0,865
11/29/22,Summer Olympics 2020,35.6491,139.7737,865,0,0,865
11/30/22,Summer Olympics 2020,35.6491,139.7737,865,0,0,865
12/1/22,Summer Olympics 2020,35.6491,139.7737,865,0,0,865
12/2/22,Summer Olympics 2020,35.6491,139.7737,865,0,0,865
12/3/22,Summer Olympics 2020,35.6491,139.7737,865,0,0,865
12/4/22,Summer Olympics 2020,35.6491,139.7737,865,0,0,865
12/5/22,Summer Olympics 2020,35.6491,139.7737,865,0,0,865
12/6/22,Summer Olympics 2020,35.6491,139.7737,865,0,0,865
12/7/22,Summer Olympics 2020,35.6491,139.7737,865,0,0,865
12/8/22,Summer Olympics 2020,35.6491,139.7737,865,0,0,865
12/9/22,Summer Olympics 2020,35.6491,139.7737,865,0,0,865
12/10/22,Summer Olympics 2020,35.6491,139.7737,865,0,0,865
12/11/22,Summer Olympics 2020,35.6491,139.7737,865,0,0,865
12/12/22,Summer Olympics 2020,35.6491,139.7737,865,0,0,865
12/13/22,Summer Olympics 2020,35.6491,139.7737,865,0,0,865
12/14/22,Summer Olympics 2020,35.6491,139.7737,865,0,0,865
12/15/22,Summer Olympics 2020,35.6491,139.7737,865,0,0,865
12/16/22,Summer Olympics 2020,35.6491,139.7737,865,0,0,865
12/17/22,Summer Olympics 2020,35.6491,139.7737,865,0,0,865
1/1/22,Suriname,3.9193,-56.0278,52612,0,1190,51422
1/2/22,Suriname,3.9193,-56.0278,52895,0,1190,51705
1/3/22,Suriname,3.9193,-56.0278,53640,0,1190,52450
1/4/22,Suriname,3.9193,-56.0278,54460,0,1192,53268
1/5/22,Suriname,3.9193,-56.0278,55376,0,1193,54183
1/6/22,Suriname,3.9193,-56.0278,56041,0,1195,54846
1/7/22,Suriname,3.9193,-56.0278,56792,0,1196,55596
1/8/22,Suriname,3.9193,-56.0278,57339,0,1196,56143
1/9/22,Suriname,3.9193,-56.0278,57705,0,1198,56507
1/10/22,Suriname,3.9193,-56.0278,58714,0,1198,57516
1/11/22,Suriname,3.9193,-56.0278,59776,0,1199,58577
1/12/22,Suriname,3.9193,-56.0278,60823,0,1201,59622
1/13/22,Suriname,3.9193,-56.0278,61708,0,1203,60505
1/14/22,Suriname,3.9193,-56.0278,62734,0,1208,61526
1/15/22,Suriname,3.9193,-56.0278,63443,0,1212,62231
1/16/22,Suriname,3.9193,-56.0278,63878,0,1213,62665
1/17/22,Suriname,3.9193,-56.0278,65282,0,1216,64066
1/18/22,Suriname,3.9193,-56.0278,66633,0,1221,65412
1/19/22,Suriname,3.9193,-56.0278,67768,0,1222,66546
1/20/22,Suriname,3.9193,-56.0278,68560,0,1228,67332
1/21/22,Suriname,3.9193,-56.0278,69275,0,1231,68044
1/22/22,Suriname,3.9193,-56.0278,69741,0,1237,68504
1/23/22,Suriname,3.9193,-56.0278,70074,0,1239,68835
1/24/22,Suriname,3.9193,-56.0278,70937,0,1242,69695
1/25/22,Suriname,3.9193,-56.0278,71629,0,1247,70382
1/26/22,Suriname,3.9193,-56.0278,72088,0,1252,70836
1/27/22,Suriname,3.9193,-56.0278,72548,0,1256,71292
1/28/22,Suriname,3.9193,-56.0278,72943,0,1257,71686
1/29/22,Suriname,3.9193,-56.0278,73162,0,1260,71902
1/30/22,Suriname,3.9193,-56.0278,73162,0,1260,71902
1/31/22,Suriname,3.9193,-56.0278,73769,0,1263,72506
2/1/22,Suriname,3.9193,-56.0278,73956,0,1267,72689
2/2/22,Suriname,3.9193,-56.0278,74470,0,1271,73199
2/3/22,Suriname,3.9193,-56.0278,74858,0,1274,73584
2/4/22,Suriname,3.9193,-56.0278,75252,0,1274,73978
2/5/22,Suriname,3.9193,-56.0278,75402,0,1279,74123
2/6/22,Suriname,3.9193,-56.0278,75531,0,1283,74248
2/7/22,Suriname,3.9193,-56.0278,75889,0,1285,74604
2/8/22,Suriname,3.9193,-56.0278,76239,0,1288,74951
2/9/22,Suriname,3.9193,-56.0278,76498,0,1291,75207
2/10/22,Suriname,3.9193,-56.0278,76703,0,1294,75409
2/11/22,Suriname,3.9193,-56.0278,76876,0,1298,75578
2/12/22,Suriname,3.9193,-56.0278,76975,0,1298,75677
2/13/22,Suriname,3.9193,-56.0278,77036,0,1299,75737
2/14/22,Suriname,3.9193,-56.0278,77203,0,1303,75900
2/15/22,Suriname,3.9193,-56.0278,77334,0,1303,76031
2/16/22,Suriname,3.9193,-56.0278,77450,0,1304,76146
2/17/22,Suriname,3.9193,-56.0278,77549,0,1307,76242
2/18/22,Suriname,3.9193,-56.0278,77634,0,1309,76325
2/19/22,Suriname,3.9193,-56.0278,77686,0,1309,76377
2/20/22,Suriname,3.9193,-56.0278,77716,0,1310,76406
2/21/22,Suriname,3.9193,-56.0278,77810,0,1314,76496
2/22/22,Suriname,3.9193,-56.0278,77880,0,1314,76566
2/23/22,Suriname,3.9193,-56.0278,77935,0,1314,76621
2/24/22,Suriname,3.9193,-56.0278,78016,0,1315,76701
2/25/22,Suriname,3.9193,-56.0278,78070,0,1315,76755
2/26/22,Suriname,3.9193,-56.0278,78092,0,1316,76776
2/27/22,Suriname,3.9193,-56.0278,78123,0,1316,76807
2/28/22,Suriname,3.9193,-56.0278,78216,0,1317,76899
3/1/22,Suriname,3.9193,-56.0278,78294,0,1317,76977
3/2/22,Suriname,3.9193,-56.0278,78353,0,1317,77036
3/3/22,Suriname,3.9193,-56.0278,78394,0,1317,77077
3/4/22,Suriname,3.9193,-56.0278,78454,0,1317,77137
3/5/22,Suriname,3.9193,-56.0278,78487,0,1318,77169
3/6/22,Suriname,3.9193,-56.0278,78511,0,1318,77193
3/7/22,Suriname,3.9193,-56.0278,78579,0,1319,77260
3/8/22,Suriname,3.9193,-56.0278,78623,0,1319,77304
3/9/22,Suriname,3.9193,-56.0278,78654,0,1319,77335
3/10/22,Suriname,3.9193,-56.0278,78705,0,1319,77386
3/11/22,Suriname,3.9193,-56.0278,78740,0,1320,77420
3/12/22,Suriname,3.9193,-56.0278,78754,0,1321,77433
3/13/22,Suriname,3.9193,-56.0278,78763,0,1321,77442
3/14/22,Suriname,3.9193,-56.0278,78793,0,1321,77472
3/15/22,Suriname,3.9193,-56.0278,78828,0,1322,77506
3/16/22,Suriname,3.9193,-56.0278,78860,0,1322,77538
3/17/22,Suriname,3.9193,-56.0278,78893,0,1322,77571
3/18/22,Suriname,3.9193,-56.0278,78916,0,1323,77593
3/19/22,Suriname,3.9193,-56.0278,78928,0,1323,77605
3/20/22,Suriname,3.9193,-56.0278,78946,0,1323,77623
3/21/22,Suriname,3.9193,-56.0278,79025,0,1324,77701
3/22/22,Suriname,3.9193,-56.0278,79055,0,1324,77731
3/23/22,Suriname,3.9193,-56.0278,79100,0,1324,77776
3/24/22,Suriname,3.9193,-56.0278,79112,0,1324,77788
3/25/22,Suriname,3.9193,-56.0278,79133,0,1324,77809
3/26/22,Suriname,3.9193,-56.0278,79150,0,1324,77826
3/27/22,Suriname,3.9193,-56.0278,79155,0,1324,77831
3/28/22,Suriname,3.9193,-56.0278,79173,0,1324,77849
3/29/22,Suriname,3.9193,-56.0278,79188,0,1324,77864
3/30/22,Suriname,3.9193,-56.0278,79202,0,1324,77878
3/31/22,Suriname,3.9193,-56.0278,79221,0,1324,77897
4/1/22,Suriname,3.9193,-56.0278,79229,0,1325,77904
4/2/22,Suriname,3.9193,-56.0278,79229,0,1325,77904
4/3/22,Suriname,3.9193,-56.0278,79232,0,1325,77907
4/4/22,Suriname,3.9193,-56.0278,79236,0,1325,77911
4/5/22,Suriname,3.9193,-56.0278,79241,0,1325,77916
4/6/22,Suriname,3.9193,-56.0278,79241,0,1325,77916
4/7/22,Suriname,3.9193,-56.0278,79241,0,1325,77916
4/8/22,Suriname,3.9193,-56.0278,79241,0,1325,77916
4/9/22,Suriname,3.9193,-56.0278,79241,0,1325,77916
4/10/22,Suriname,3.9193,-56.0278,79241,0,1325,77916
4/11/22,Suriname,3.9193,-56.0278,79241,0,1325,77916
4/12/22,Suriname,3.9193,-56.0278,79276,0,1325,77951
4/13/22,Suriname,3.9193,-56.0278,79276,0,1325,77951
4/14/22,Suriname,3.9193,-56.0278,79276,0,1325,77951
4/15/22,Suriname,3.9193,-56.0278,79276,0,1325,77951
4/16/22,Suriname,3.9193,-56.0278,79276,0,1325,77951
4/17/22,Suriname,3.9193,-56.0278,79276,0,1325,77951
4/18/22,Suriname,3.9193,-56.0278,79276,0,1325,77951
4/19/22,Suriname,3.9193,-56.0278,79302,0,1327,77975
4/20/22,Suriname,3.9193,-56.0278,79302,0,1327,77975
4/21/22,Suriname,3.9193,-56.0278,79302,0,1327,77975
4/22/22,Suriname,3.9193,-56.0278,79302,0,1327,77975
4/23/22,Suriname,3.9193,-56.0278,79302,0,1327,77975
4/24/22,Suriname,3.9193,-56.0278,79302,0,1327,77975
4/25/22,Suriname,3.9193,-56.0278,79302,0,1327,77975
4/26/22,Suriname,3.9193,-56.0278,79336,0,1328,78008
4/27/22,Suriname,3.9193,-56.0278,79336,0,1328,78008
4/28/22,Suriname,3.9193,-56.0278,79336,0,1328,78008
4/29/22,Suriname,3.9193,-56.0278,79336,0,1328,78008
4/30/22,Suriname,3.9193,-56.0278,79336,0,1328,78008
5/1/22,Suriname,3.9193,-56.0278,79336,0,1328,78008
5/2/22,Suriname,3.9193,-56.0278,79336,0,1328,78008
5/3/22,Suriname,3.9193,-56.0278,79393,0,1328,78065
5/4/22,Suriname,3.9193,-56.0278,79393,0,1328,78065
5/5/22,Suriname,3.9193,-56.0278,79393,0,1328,78065
5/6/22,Suriname,3.9193,-56.0278,79393,0,1328,78065
5/7/22,Suriname,3.9193,-56.0278,79393,0,1328,78065
5/8/22,Suriname,3.9193,-56.0278,79393,0,1328,78065
5/9/22,Suriname,3.9193,-56.0278,79393,0,1328,78065
5/10/22,Suriname,3.9193,-56.0278,80008,0,1337,78671
5/11/22,Suriname,3.9193,-56.0278,80008,0,1337,78671
5/12/22,Suriname,3.9193,-56.0278,80008,0,1337,78671
5/13/22,Suriname,3.9193,-56.0278,80008,0,1337,78671
5/14/22,Suriname,3.9193,-56.0278,80008,0,1337,78671
5/15/22,Suriname,3.9193,-56.0278,80008,0,1337,78671
5/16/22,Suriname,3.9193,-56.0278,80008,0,1337,78671
5/17/22,Suriname,3.9193,-56.0278,80240,0,1339,78901
5/18/22,Suriname,3.9193,-56.0278,80240,0,1339,78901
5/19/22,Suriname,3.9193,-56.0278,80240,0,1339,78901
5/20/22,Suriname,3.9193,-56.0278,80240,0,1339,78901
5/21/22,Suriname,3.9193,-56.0278,80240,0,1339,78901
5/22/22,Suriname,3.9193,-56.0278,80240,0,1339,78901
5/23/22,Suriname,3.9193,-56.0278,80240,0,1339,78901
5/24/22,Suriname,3.9193,-56.0278,80416,0,1341,79075
5/25/22,Suriname,3.9193,-56.0278,80416,0,1341,79075
5/26/22,Suriname,3.9193,-56.0278,80416,0,1341,79075
5/27/22,Suriname,3.9193,-56.0278,80416,0,1341,79075
5/28/22,Suriname,3.9193,-56.0278,80416,0,1341,79075
5/29/22,Suriname,3.9193,-56.0278,80416,0,1341,79075
5/30/22,Suriname,3.9193,-56.0278,80416,0,1341,79075
5/31/22,Suriname,3.9193,-56.0278,80547,0,1350,79197
6/1/22,Suriname,3.9193,-56.0278,80547,0,1350,79197
6/2/22,Suriname,3.9193,-56.0278,80547,0,1350,79197
6/3/22,Suriname,3.9193,-56.0278,80547,0,1350,79197
6/4/22,Suriname,3.9193,-56.0278,80547,0,1350,79197
6/5/22,Suriname,3.9193,-56.0278,80547,0,1350,79197
6/6/22,Suriname,3.9193,-56.0278,80547,0,1350,79197
6/7/22,Suriname,3.9193,-56.0278,80673,0,1352,79321
6/8/22,Suriname,3.9193,-56.0278,80673,0,1352,79321
6/9/22,Suriname,3.9193,-56.0278,80673,0,1352,79321
6/10/22,Suriname,3.9193,-56.0278,80673,0,1352,79321
6/11/22,Suriname,3.9193,-56.0278,80673,0,1352,79321
6/12/22,Suriname,3.9193,-56.0278,80673,0,1352,79321
6/13/22,Suriname,3.9193,-56.0278,80673,0,1352,79321
6/14/22,Suriname,3.9193,-56.0278,80766,0,1355,79411
6/15/22,Suriname,3.9193,-56.0278,80766,0,1355,79411
6/16/22,Suriname,3.9193,-56.0278,80766,0,1355,79411
6/17/22,Suriname,3.9193,-56.0278,80766,0,1355,79411
6/18/22,Suriname,3.9193,-56.0278,80766,0,1355,79411
6/19/22,Suriname,3.9193,-56.0278,80766,0,1355,79411
6/20/22,Suriname,3.9193,-56.0278,80766,0,1355,79411
6/21/22,Suriname,3.9193,-56.0278,80817,0,1359,79458
6/22/22,Suriname,3.9193,-56.0278,80817,0,1359,79458
6/23/22,Suriname,3.9193,-56.0278,80817,0,1359,79458
6/24/22,Suriname,3.9193,-56.0278,80817,0,1359,79458
6/25/22,Suriname,3.9193,-56.0278,80817,0,1359,79458
6/26/22,Suriname,3.9193,-56.0278,80817,0,1359,79458
6/27/22,Suriname,3.9193,-56.0278,80817,0,1359,79458
6/28/22,Suriname,3.9193,-56.0278,80864,0,1369,79495
6/29/22,Suriname,3.9193,-56.0278,80864,0,1369,79495
6/30/22,Suriname,3.9193,-56.0278,80864,0,1369,79495
7/1/22,Suriname,3.9193,-56.0278,80864,0,1369,79495
7/2/22,Suriname,3.9193,-56.0278,80864,0,1369,79495
7/3/22,Suriname,3.9193,-56.0278,80864,0,1369,79495
7/4/22,Suriname,3.9193,-56.0278,80864,0,1369,79495
7/5/22,Suriname,3.9193,-56.0278,80890,0,1376,79514
7/6/22,Suriname,3.9193,-56.0278,80890,0,1376,79514
7/7/22,Suriname,3.9193,-56.0278,80890,0,1376,79514
7/8/22,Suriname,3.9193,-56.0278,80890,0,1376,79514
7/9/22,Suriname,3.9193,-56.0278,80890,0,1376,79514
7/10/22,Suriname,3.9193,-56.0278,80890,0,1376,79514
7/11/22,Suriname,3.9193,-56.0278,80890,0,1376,79514
7/12/22,Suriname,3.9193,-56.0278,80919,0,1377,79542
7/13/22,Suriname,3.9193,-56.0278,80919,0,1377,79542
7/14/22,Suriname,3.9193,-56.0278,80919,0,1377,79542
7/15/22,Suriname,3.9193,-56.0278,80919,0,1377,79542
7/16/22,Suriname,3.9193,-56.0278,80919,0,1377,79542
7/17/22,Suriname,3.9193,-56.0278,80919,0,1377,79542
7/18/22,Suriname,3.9193,-56.0278,80919,0,1377,79542
7/19/22,Suriname,3.9193,-56.0278,80949,0,1379,79570
7/20/22,Suriname,3.9193,-56.0278,80949,0,1379,79570
7/21/22,Suriname,3.9193,-56.0278,80949,0,1379,79570
7/22/22,Suriname,3.9193,-56.0278,80949,0,1379,79570
7/23/22,Suriname,3.9193,-56.0278,80949,0,1379,79570
7/24/22,Suriname,3.9193,-56.0278,80949,0,1379,79570
7/25/22,Suriname,3.9193,-56.0278,80949,0,1379,79570
7/26/22,Suriname,3.9193,-56.0278,80966,0,1380,79586
7/27/22,Suriname,3.9193,-56.0278,80966,0,1380,79586
7/28/22,Suriname,3.9193,-56.0278,80966,0,1380,79586
7/29/22,Suriname,3.9193,-56.0278,80966,0,1380,79586
7/30/22,Suriname,3.9193,-56.0278,80966,0,1380,79586
7/31/22,Suriname,3.9193,-56.0278,80966,0,1380,79586
8/1/22,Suriname,3.9193,-56.0278,80966,0,1380,79586
8/2/22,Suriname,3.9193,-56.0278,80982,0,1380,79602
8/3/22,Suriname,3.9193,-56.0278,80982,0,1380,79602
8/4/22,Suriname,3.9193,-56.0278,80982,0,1380,79602
8/5/22,Suriname,3.9193,-56.0278,80982,0,1380,79602
8/6/22,Suriname,3.9193,-56.0278,80982,0,1380,79602
8/7/22,Suriname,3.9193,-56.0278,80982,0,1380,79602
8/8/22,Suriname,3.9193,-56.0278,80982,0,1380,79602
8/9/22,Suriname,3.9193,-56.0278,80988,0,1380,79608
8/10/22,Suriname,3.9193,-56.0278,80988,0,1380,79608
8/11/22,Suriname,3.9193,-56.0278,80988,0,1380,79608
8/12/22,Suriname,3.9193,-56.0278,80988,0,1380,79608
8/13/22,Suriname,3.9193,-56.0278,80988,0,1380,79608
8/14/22,Suriname,3.9193,-56.0278,80988,0,1380,79608
8/15/22,Suriname,3.9193,-56.0278,80988,0,1380,79608
8/16/22,Suriname,3.9193,-56.0278,81007,0,1382,79625
8/17/22,Suriname,3.9193,-56.0278,81007,0,1382,79625
8/18/22,Suriname,3.9193,-56.0278,81007,0,1382,79625
8/19/22,Suriname,3.9193,-56.0278,81007,0,1382,79625
8/20/22,Suriname,3.9193,-56.0278,81007,0,1382,79625
8/21/22,Suriname,3.9193,-56.0278,81007,0,1382,79625
8/22/22,Suriname,3.9193,-56.0278,81007,0,1382,79625
8/23/22,Suriname,3.9193,-56.0278,81022,0,1383,79639
8/24/22,Suriname,3.9193,-56.0278,81022,0,1383,79639
8/25/22,Suriname,3.9193,-56.0278,81022,0,1383,79639
8/26/22,Suriname,3.9193,-56.0278,81022,0,1383,79639
8/27/22,Suriname,3.9193,-56.0278,81022,0,1383,79639
8/28/22,Suriname,3.9193,-56.0278,81022,0,1383,79639
8/29/22,Suriname,3.9193,-56.0278,81022,0,1383,79639
8/30/22,Suriname,3.9193,-56.0278,81039,0,1383,79656
8/31/22,Suriname,3.9193,-56.0278,81039,0,1383,79656
9/1/22,Suriname,3.9193,-56.0278,81039,0,1383,79656
9/2/22,Suriname,3.9193,-56.0278,81039,0,1383,79656
9/3/22,Suriname,3.9193,-56.0278,81039,0,1383,79656
9/4/22,Suriname,3.9193,-56.0278,81039,0,1383,79656
9/5/22,Suriname,3.9193,-56.0278,81039,0,1383,79656
9/6/22,Suriname,3.9193,-56.0278,81039,0,1383,79656
9/7/22,Suriname,3.9193,-56.0278,81057,0,1384,79673
9/8/22,Suriname,3.9193,-56.0278,81057,0,1384,79673
9/9/22,Suriname,3.9193,-56.0278,81057,0,1384,79673
9/10/22,Suriname,3.9193,-56.0278,81057,0,1384,79673
9/11/22,Suriname,3.9193,-56.0278,81057,0,1384,79673
9/12/22,Suriname,3.9193,-56.0278,81057,0,1384,79673
9/13/22,Suriname,3.9193,-56.0278,81078,0,1384,79694
9/14/22,Suriname,3.9193,-56.0278,81078,0,1384,79694
9/15/22,Suriname,3.9193,-56.0278,81078,0,1384,79694
9/16/22,Suriname,3.9193,-56.0278,81078,0,1384,79694
9/17/22,Suriname,3.9193,-56.0278,81078,0,1384,79694
9/18/22,Suriname,3.9193,-56.0278,81078,0,1384,79694
9/19/22,Suriname,3.9193,-56.0278,81078,0,1384,79694
9/20/22,Suriname,3.9193,-56.0278,81099,0,1385,79714
9/21/22,Suriname,3.9193,-56.0278,81099,0,1385,79714
9/22/22,Suriname,3.9193,-56.0278,81099,0,1385,79714
9/23/22,Suriname,3.9193,-56.0278,81099,0,1385,79714
9/24/22,Suriname,3.9193,-56.0278,81099,0,1385,79714
9/25/22,Suriname,3.9193,-56.0278,81099,0,1385,79714
9/26/22,Suriname,3.9193,-56.0278,81099,0,1385,79714
9/27/22,Suriname,3.9193,-56.0278,81106,0,1385,79721
9/28/22,Suriname,3.9193,-56.0278,81106,0,1385,79721
9/29/22,Suriname,3.9193,-56.0278,81106,0,1385,79721
9/30/22,Suriname,3.9193,-56.0278,81106,0,1385,79721
10/1/22,Suriname,3.9193,-56.0278,81106,0,1385,79721
10/2/22,Suriname,3.9193,-56.0278,81106,0,1385,79721
10/3/22,Suriname,3.9193,-56.0278,81106,0,1385,79721
10/4/22,Suriname,3.9193,-56.0278,81114,0,1385,79729
10/5/22,Suriname,3.9193,-56.0278,81114,0,1385,79729
10/6/22,Suriname,3.9193,-56.0278,81114,0,1385,79729
10/7/22,Suriname,3.9193,-56.0278,81114,0,1385,79729
10/8/22,Suriname,3.9193,-56.0278,81114,0,1385,79729
10/9/22,Suriname,3.9193,-56.0278,81114,0,1385,79729
10/10/22,Suriname,3.9193,-56.0278,81114,0,1385,79729
10/11/22,Suriname,3.9193,-56.0278,81131,0,1385,79746
10/12/22,Suriname,3.9193,-56.0278,81131,0,1385,79746
10/13/22,Suriname,3.9193,-56.0278,81131,0,1385,79746
10/14/22,Suriname,3.9193,-56.0278,81131,0,1385,79746
10/15/22,Suriname,3.9193,-56.0278,81131,0,1385,79746
10/16/22,Suriname,3.9193,-56.0278,81131,0,1385,79746
10/17/22,Suriname,3.9193,-56.0278,81131,0,1385,79746
10/18/22,Suriname,3.9193,-56.0278,81158,0,1386,79772
10/19/22,Suriname,3.9193,-56.0278,81158,0,1386,79772
10/20/22,Suriname,3.9193,-56.0278,81158,0,1386,79772
10/21/22,Suriname,3.9193,-56.0278,81158,0,1386,79772
10/22/22,Suriname,3.9193,-56.0278,81158,0,1386,79772
10/23/22,Suriname,3.9193,-56.0278,81158,0,1386,79772
10/24/22,Suriname,3.9193,-56.0278,81158,0,1386,79772
10/25/22,Suriname,3.9193,-56.0278,81185,0,1390,79795
10/26/22,Suriname,3.9193,-56.0278,81185,0,1390,79795
10/27/22,Suriname,3.9193,-56.0278,81185,0,1390,79795
10/28/22,Suriname,3.9193,-56.0278,81185,0,1390,79795
10/29/22,Suriname,3.9193,-56.0278,81185,0,1390,79795
10/30/22,Suriname,3.9193,-56.0278,81185,0,1390,79795
10/31/22,Suriname,3.9193,-56.0278,81185,0,1390,79795
11/1/22,Suriname,3.9193,-56.0278,81228,0,1392,79836
11/2/22,Suriname,3.9193,-56.0278,81228,0,1392,79836
11/3/22,Suriname,3.9193,-56.0278,81228,0,1392,79836
11/4/22,Suriname,3.9193,-56.0278,81228,0,1392,79836
11/5/22,Suriname,3.9193,-56.0278,81228,0,1392,79836
11/6/22,Suriname,3.9193,-56.0278,81228,0,1392,79836
11/7/22,Suriname,3.9193,-56.0278,81228,0,1392,79836
11/8/22,Suriname,3.9193,-56.0278,81228,0,1392,79836
11/9/22,Suriname,3.9193,-56.0278,81228,0,1392,79836
11/10/22,Suriname,3.9193,-56.0278,81228,0,1392,79836
11/11/22,Suriname,3.9193,-56.0278,81228,0,1392,79836
11/12/22,Suriname,3.9193,-56.0278,81228,0,1392,79836
11/13/22,Suriname,3.9193,-56.0278,81228,0,1392,79836
11/14/22,Suriname,3.9193,-56.0278,81228,0,1392,79836
11/15/22,Suriname,3.9193,-56.0278,81228,0,1392,79836
11/16/22,Suriname,3.9193,-56.0278,81228,0,1392,79836
11/17/22,Suriname,3.9193,-56.0278,81228,0,1392,79836
11/18/22,Suriname,3.9193,-56.0278,81228,0,1392,79836
11/19/22,Suriname,3.9193,-56.0278,81228,0,1392,79836
11/20/22,Suriname,3.9193,-56.0278,81228,0,1392,79836
11/21/22,Suriname,3.9193,-56.0278,81228,0,1392,79836
11/22/22,Suriname,3.9193,-56.0278,81228,0,1392,79836
11/23/22,Suriname,3.9193,-56.0278,81228,0,1392,79836
11/24/22,Suriname,3.9193,-56.0278,81228,0,1392,79836
11/25/22,Suriname,3.9193,-56.0278,81228,0,1392,79836
11/26/22,Suriname,3.9193,-56.0278,81228,0,1392,79836
11/27/22,Suriname,3.9193,-56.0278,81228,0,1392,79836
11/28/22,Suriname,3.9193,-56.0278,81228,0,1392,79836
11/29/22,Suriname,3.9193,-56.0278,81228,0,1392,79836
11/30/22,Suriname,3.9193,-56.0278,81581,0,1393,80188
12/1/22,Suriname,3.9193,-56.0278,81581,0,1393,80188
12/2/22,Suriname,3.9193,-56.0278,81581,0,1393,80188
12/3/22,Suriname,3.9193,-56.0278,81581,0,1393,80188
12/4/22,Suriname,3.9193,-56.0278,81581,0,1393,80188
12/5/22,Suriname,3.9193,-56.0278,81581,0,1393,80188
12/6/22,Suriname,3.9193,-56.0278,81581,0,1393,80188
12/7/22,Suriname,3.9193,-56.0278,81581,0,1393,80188
12/8/22,Suriname,3.9193,-56.0278,81581,0,1393,80188
12/9/22,Suriname,3.9193,-56.0278,81581,0,1393,80188
12/10/22,Suriname,3.9193,-56.0278,81581,0,1393,80188
12/11/22,Suriname,3.9193,-56.0278,81581,0,1393,80188
12/12/22,Suriname,3.9193,-56.0278,81581,0,1393,80188
12/13/22,Suriname,3.9193,-56.0278,81581,0,1393,80188
12/14/22,Suriname,3.9193,-56.0278,81581,0,1393,80188
12/15/22,Suriname,3.9193,-56.0278,81581,0,1393,80188
12/16/22,Suriname,3.9193,-56.0278,81581,0,1393,80188
12/17/22,Suriname,3.9193,-56.0278,81581,0,1393,80188
1/1/22,Sweden,60.128161,18.643501,1314784,0,15310,1299474
1/2/22,Sweden,60.128161,18.643501,1314784,0,15310,1299474
1/3/22,Sweden,60.128161,18.643501,1314784,0,15310,1299474
1/4/22,Sweden,60.128161,18.643501,1357753,0,15330,1342423
1/5/22,Sweden,60.128161,18.643501,1375267,0,15369,1359898
1/6/22,Sweden,60.128161,18.643501,1375267,0,15369,1359898
1/7/22,Sweden,60.128161,18.643501,1416650,0,15377,1401273
1/8/22,Sweden,60.128161,18.643501,1416650,0,15377,1401273
1/9/22,Sweden,60.128161,18.643501,1416650,0,15377,1401273
1/10/22,Sweden,60.128161,18.643501,1416650,0,15377,1401273
1/11/22,Sweden,60.128161,18.643501,1487291,0,15431,1471860
1/12/22,Sweden,60.128161,18.643501,1509230,0,15462,1493768
1/13/22,Sweden,60.128161,18.643501,1534797,0,15482,1519315
1/14/22,Sweden,60.128161,18.643501,1560363,0,15513,1544850
1/15/22,Sweden,60.128161,18.643501,1560363,0,15513,1544850
1/16/22,Sweden,60.128161,18.643501,1560363,0,15513,1544850
1/17/22,Sweden,60.128161,18.643501,1560363,0,15513,1544850
1/18/22,Sweden,60.128161,18.643501,1657611,0,15558,1642053
1/19/22,Sweden,60.128161,18.643501,1700336,0,15625,1684711
1/20/22,Sweden,60.128161,18.643501,1741710,0,15631,1726079
1/21/22,Sweden,60.128161,18.643501,1784005,0,15674,1768331
1/22/22,Sweden,60.128161,18.643501,1784005,0,15674,1768331
1/23/22,Sweden,60.128161,18.643501,1784005,0,15674,1768331
1/24/22,Sweden,60.128161,18.643501,1784005,0,15674,1768331
1/25/22,Sweden,60.128161,18.643501,1922990,0,15693,1907297
1/26/22,Sweden,60.128161,18.643501,1973485,0,15768,1957717
1/27/22,Sweden,60.128161,18.643501,2015276,0,15778,1999498
1/28/22,Sweden,60.128161,18.643501,2070456,0,15855,2054601
1/29/22,Sweden,60.128161,18.643501,2070456,0,15855,2054601
1/30/22,Sweden,60.128161,18.643501,2070456,0,15855,2054601
1/31/22,Sweden,60.128161,18.643501,2070456,0,15855,2054601
2/1/22,Sweden,60.128161,18.643501,2183910,0,15961,2167949
2/2/22,Sweden,60.128161,18.643501,2223115,0,16028,2207087
2/3/22,Sweden,60.128161,18.643501,2259656,0,16100,2243556
2/4/22,Sweden,60.128161,18.643501,2287785,0,16180,2271605
2/5/22,Sweden,60.128161,18.643501,2287785,0,16180,2271605
2/6/22,Sweden,60.128161,18.643501,2287785,0,16180,2271605
2/7/22,Sweden,60.128161,18.643501,2287785,0,16180,2271605
2/8/22,Sweden,60.128161,18.643501,2354455,0,16244,2338211
2/9/22,Sweden,60.128161,18.643501,2372637,0,16358,2356279
2/10/22,Sweden,60.128161,18.643501,2389605,0,16395,2373210
2/11/22,Sweden,60.128161,18.643501,2397330,0,16501,2380829
2/12/22,Sweden,60.128161,18.643501,2397330,0,16501,2380829
2/13/22,Sweden,60.128161,18.643501,2397330,0,16501,2380829
2/14/22,Sweden,60.128161,18.643501,2397330,0,16501,2380829
2/15/22,Sweden,60.128161,18.643501,2409081,0,16579,2392502
2/16/22,Sweden,60.128161,18.643501,2414463,0,16716,2397747
2/17/22,Sweden,60.128161,18.643501,2418560,0,16768,2401792
2/18/22,Sweden,60.128161,18.643501,2422856,0,16852,2406004
2/19/22,Sweden,60.128161,18.643501,2422856,0,16852,2406004
2/20/22,Sweden,60.128161,18.643501,2422856,0,16852,2406004
2/21/22,Sweden,60.128161,18.643501,2422856,0,16852,2406004
2/22/22,Sweden,60.128161,18.643501,2431365,0,16933,2414432
2/23/22,Sweden,60.128161,18.643501,2434783,0,17064,2417719
2/24/22,Sweden,60.128161,18.643501,2437850,0,17083,2420767
2/25/22,Sweden,60.128161,18.643501,2441142,0,17142,2424000
2/26/22,Sweden,60.128161,18.643501,2441142,0,17142,2424000
2/27/22,Sweden,60.128161,18.643501,2441142,0,17142,2424000
2/28/22,Sweden,60.128161,18.643501,2441142,0,17142,2424000
3/1/22,Sweden,60.128161,18.643501,2448182,0,17242,2430940
3/2/22,Sweden,60.128161,18.643501,2451464,0,17355,2434109
3/3/22,Sweden,60.128161,18.643501,2453936,0,17425,2436511
3/4/22,Sweden,60.128161,18.643501,2455966,0,17512,2438454
3/5/22,Sweden,60.128161,18.643501,2455966,0,17512,2438454
3/6/22,Sweden,60.128161,18.643501,2455966,0,17512,2438454
3/7/22,Sweden,60.128161,18.643501,2455966,0,17512,2438454
3/8/22,Sweden,60.128161,18.643501,2460783,0,17549,2443234
3/9/22,Sweden,60.128161,18.643501,2462952,0,17693,2445259
3/10/22,Sweden,60.128161,18.643501,2465099,0,17749,2447350
3/11/22,Sweden,60.128161,18.643501,2466577,0,17798,2448779
3/12/22,Sweden,60.128161,18.643501,2466577,0,17798,2448779
3/13/22,Sweden,60.128161,18.643501,2466577,0,17798,2448779
3/14/22,Sweden,60.128161,18.643501,2466577,0,17798,2448779
3/15/22,Sweden,60.128161,18.643501,2470254,0,17874,2452380
3/16/22,Sweden,60.128161,18.643501,2472068,0,17937,2454131
3/17/22,Sweden,60.128161,18.643501,2473707,0,17994,2455713
3/18/22,Sweden,60.128161,18.643501,2475687,0,18053,2457634
3/19/22,Sweden,60.128161,18.643501,2475687,0,18053,2457634
3/20/22,Sweden,60.128161,18.643501,2475687,0,18053,2457634
3/21/22,Sweden,60.128161,18.643501,2475687,0,18053,2457634
3/22/22,Sweden,60.128161,18.643501,2475687,0,18053,2457634
3/23/22,Sweden,60.128161,18.643501,2475687,0,18053,2457634
3/24/22,Sweden,60.128161,18.643501,2481736,0,18189,2463547
3/25/22,Sweden,60.128161,18.643501,2481736,0,18189,2463547
3/26/22,Sweden,60.128161,18.643501,2481736,0,18189,2463547
3/27/22,Sweden,60.128161,18.643501,2481736,0,18189,2463547
3/28/22,Sweden,60.128161,18.643501,2481736,0,18189,2463547
3/29/22,Sweden,60.128161,18.643501,2481736,0,18189,2463547
3/30/22,Sweden,60.128161,18.643501,2481736,0,18189,2463547
3/31/22,Sweden,60.128161,18.643501,2487852,0,18365,2469487
4/1/22,Sweden,60.128161,18.643501,2487852,0,18365,2469487
4/2/22,Sweden,60.128161,18.643501,2487852,0,18365,2469487
4/3/22,Sweden,60.128161,18.643501,2487852,0,18365,2469487
4/4/22,Sweden,60.128161,18.643501,2487852,0,18365,2469487
4/5/22,Sweden,60.128161,18.643501,2487852,0,18365,2469487
4/6/22,Sweden,60.128161,18.643501,2487852,0,18365,2469487
4/7/22,Sweden,60.128161,18.643501,2491980,0,18506,2473474
4/8/22,Sweden,60.128161,18.643501,2491980,0,18506,2473474
4/9/22,Sweden,60.128161,18.643501,2491980,0,18506,2473474
4/10/22,Sweden,60.128161,18.643501,2491980,0,18506,2473474
4/11/22,Sweden,60.128161,18.643501,2491980,0,18506,2473474
4/12/22,Sweden,60.128161,18.643501,2491980,0,18506,2473474
4/13/22,Sweden,60.128161,18.643501,2491980,0,18506,2473474
4/14/22,Sweden,60.128161,18.643501,2495996,0,18605,2477391
4/15/22,Sweden,60.128161,18.643501,2495996,0,18605,2477391
4/16/22,Sweden,60.128161,18.643501,2495996,0,18605,2477391
4/17/22,Sweden,60.128161,18.643501,2495996,0,18605,2477391
4/18/22,Sweden,60.128161,18.643501,2495996,0,18605,2477391
4/19/22,Sweden,60.128161,18.643501,2495996,0,18605,2477391
4/20/22,Sweden,60.128161,18.643501,2495996,0,18605,2477391
4/21/22,Sweden,60.128161,18.643501,2498388,0,18689,2479699
4/22/22,Sweden,60.128161,18.643501,2498388,0,18689,2479699
4/23/22,Sweden,60.128161,18.643501,2498388,0,18689,2479699
4/24/22,Sweden,60.128161,18.643501,2498388,0,18689,2479699
4/25/22,Sweden,60.128161,18.643501,2498388,0,18689,2479699
4/26/22,Sweden,60.128161,18.643501,2498388,0,18689,2479699
4/27/22,Sweden,60.128161,18.643501,2498388,0,18689,2479699
4/28/22,Sweden,60.128161,18.643501,2500917,0,18772,2482145
4/29/22,Sweden,60.128161,18.643501,2500917,0,18772,2482145
4/30/22,Sweden,60.128161,18.643501,2500917,0,18772,2482145
5/1/22,Sweden,60.128161,18.643501,2500917,0,18772,2482145
5/2/22,Sweden,60.128161,18.643501,2500917,0,18772,2482145
5/3/22,Sweden,60.128161,18.643501,2500917,0,18772,2482145
5/4/22,Sweden,60.128161,18.643501,2500917,0,18772,2482145
5/5/22,Sweden,60.128161,18.643501,2503090,0,18824,2484266
5/6/22,Sweden,60.128161,18.643501,2503090,0,18824,2484266
5/7/22,Sweden,60.128161,18.643501,2503090,0,18824,2484266
5/8/22,Sweden,60.128161,18.643501,2503090,0,18824,2484266
5/9/22,Sweden,60.128161,18.643501,2503090,0,18824,2484266
5/10/22,Sweden,60.128161,18.643501,2503090,0,18824,2484266
5/11/22,Sweden,60.128161,18.643501,2503090,0,18824,2484266
5/12/22,Sweden,60.128161,18.643501,2504894,0,18897,2485997
5/13/22,Sweden,60.128161,18.643501,2504894,0,18897,2485997
5/14/22,Sweden,60.128161,18.643501,2504894,0,18897,2485997
5/15/22,Sweden,60.128161,18.643501,2504894,0,18897,2485997
5/16/22,Sweden,60.128161,18.643501,2504894,0,18897,2485997
5/17/22,Sweden,60.128161,18.643501,2504894,0,18897,2485997
5/18/22,Sweden,60.128161,18.643501,2504894,0,18897,2485997
5/19/22,Sweden,60.128161,18.643501,2506607,0,18941,2487666
5/20/22,Sweden,60.128161,18.643501,2506607,0,18941,2487666
5/21/22,Sweden,60.128161,18.643501,2506607,0,18941,2487666
5/22/22,Sweden,60.128161,18.643501,2506607,0,18941,2487666
5/23/22,Sweden,60.128161,18.643501,2506607,0,18941,2487666
5/24/22,Sweden,60.128161,18.643501,2506607,0,18941,2487666
5/25/22,Sweden,60.128161,18.643501,2507948,0,18977,2488971
5/26/22,Sweden,60.128161,18.643501,2507948,0,18977,2488971
5/27/22,Sweden,60.128161,18.643501,2507948,0,18977,2488971
5/28/22,Sweden,60.128161,18.643501,2507948,0,18977,2488971
5/29/22,Sweden,60.128161,18.643501,2507948,0,18977,2488971
5/30/22,Sweden,60.128161,18.643501,2507948,0,18977,2488971
5/31/22,Sweden,60.128161,18.643501,2507948,0,18977,2488971
6/1/22,Sweden,60.128161,18.643501,2507948,0,18977,2488971
6/2/22,Sweden,60.128161,18.643501,2509366,0,19014,2490352
6/3/22,Sweden,60.128161,18.643501,2509366,0,19014,2490352
6/4/22,Sweden,60.128161,18.643501,2509366,0,19014,2490352
6/5/22,Sweden,60.128161,18.643501,2509366,0,19014,2490352
6/6/22,Sweden,60.128161,18.643501,2509366,0,19014,2490352
6/7/22,Sweden,60.128161,18.643501,2509366,0,19014,2490352
6/8/22,Sweden,60.128161,18.643501,2509366,0,19014,2490352
6/9/22,Sweden,60.128161,18.643501,2510930,0,19049,2491881
6/10/22,Sweden,60.128161,18.643501,2510930,0,19049,2491881
6/11/22,Sweden,60.128161,18.643501,2510930,0,19049,2491881
6/12/22,Sweden,60.128161,18.643501,2510930,0,19049,2491881
6/13/22,Sweden,60.128161,18.643501,2510930,0,19049,2491881
6/14/22,Sweden,60.128161,18.643501,2510930,0,19049,2491881
6/15/22,Sweden,60.128161,18.643501,2510930,0,19049,2491881
6/16/22,Sweden,60.128161,18.643501,2512853,0,19075,2493778
6/17/22,Sweden,60.128161,18.643501,2512853,0,19075,2493778
6/18/22,Sweden,60.128161,18.643501,2512853,0,19075,2493778
6/19/22,Sweden,60.128161,18.643501,2512853,0,19075,2493778
6/20/22,Sweden,60.128161,18.643501,2512853,0,19075,2493778
6/21/22,Sweden,60.128161,18.643501,2512853,0,19075,2493778
6/22/22,Sweden,60.128161,18.643501,2512853,0,19075,2493778
6/23/22,Sweden,60.128161,18.643501,2515769,0,19093,2496676
6/24/22,Sweden,60.128161,18.643501,2515769,0,19093,2496676
6/25/22,Sweden,60.128161,18.643501,2515769,0,19093,2496676
6/26/22,Sweden,60.128161,18.643501,2515769,0,19093,2496676
6/27/22,Sweden,60.128161,18.643501,2515769,0,19093,2496676
6/28/22,Sweden,60.128161,18.643501,2515769,0,19093,2496676
6/29/22,Sweden,60.128161,18.643501,2515769,0,19093,2496676
6/30/22,Sweden,60.128161,18.643501,2519199,0,19124,2500075
7/1/22,Sweden,60.128161,18.643501,2519199,0,19124,2500075
7/2/22,Sweden,60.128161,18.643501,2519199,0,19124,2500075
7/3/22,Sweden,60.128161,18.643501,2519199,0,19124,2500075
7/4/22,Sweden,60.128161,18.643501,2519199,0,19124,2500075
7/5/22,Sweden,60.128161,18.643501,2519199,0,19124,2500075
7/6/22,Sweden,60.128161,18.643501,2519199,0,19124,2500075
7/7/22,Sweden,60.128161,18.643501,2523404,0,19144,2504260
7/8/22,Sweden,60.128161,18.643501,2523404,0,19144,2504260
7/9/22,Sweden,60.128161,18.643501,2523404,0,19144,2504260
7/10/22,Sweden,60.128161,18.643501,2523404,0,19144,2504260
7/11/22,Sweden,60.128161,18.643501,2523404,0,19144,2504260
7/12/22,Sweden,60.128161,18.643501,2523404,0,19144,2504260
7/13/22,Sweden,60.128161,18.643501,2523404,0,19144,2504260
7/14/22,Sweden,60.128161,18.643501,2528166,0,19203,2508963
7/15/22,Sweden,60.128161,18.643501,2528166,0,19203,2508963
7/16/22,Sweden,60.128161,18.643501,2528166,0,19203,2508963
7/17/22,Sweden,60.128161,18.643501,2528166,0,19203,2508963
7/18/22,Sweden,60.128161,18.643501,2528166,0,19203,2508963
7/19/22,Sweden,60.128161,18.643501,2528166,0,19203,2508963
7/20/22,Sweden,60.128161,18.643501,2528166,0,19203,2508963
7/21/22,Sweden,60.128161,18.643501,2533978,0,19249,2514729
7/22/22,Sweden,60.128161,18.643501,2533978,0,19249,2514729
7/23/22,Sweden,60.128161,18.643501,2533978,0,19249,2514729
7/24/22,Sweden,60.128161,18.643501,2533978,0,19249,2514729
7/25/22,Sweden,60.128161,18.643501,2533978,0,19249,2514729
7/26/22,Sweden,60.128161,18.643501,2533978,0,19249,2514729
7/27/22,Sweden,60.128161,18.643501,2533978,0,19249,2514729
7/28/22,Sweden,60.128161,18.643501,2539715,0,19358,2520357
7/29/22,Sweden,60.128161,18.643501,2539715,0,19358,2520357
7/30/22,Sweden,60.128161,18.643501,2539715,0,19358,2520357
7/31/22,Sweden,60.128161,18.643501,2539715,0,19358,2520357
8/1/22,Sweden,60.128161,18.643501,2539715,0,19358,2520357
8/2/22,Sweden,60.128161,18.643501,2539715,0,19358,2520357
8/3/22,Sweden,60.128161,18.643501,2539715,0,19358,2520357
8/4/22,Sweden,60.128161,18.643501,2545671,0,19433,2526238
8/5/22,Sweden,60.128161,18.643501,2545671,0,19433,2526238
8/6/22,Sweden,60.128161,18.643501,2545671,0,19433,2526238
8/7/22,Sweden,60.128161,18.643501,2545671,0,19433,2526238
8/8/22,Sweden,60.128161,18.643501,2545671,0,19433,2526238
8/9/22,Sweden,60.128161,18.643501,2545671,0,19433,2526238
8/10/22,Sweden,60.128161,18.643501,2545671,0,19433,2526238
8/11/22,Sweden,60.128161,18.643501,2551996,0,19528,2532468
8/12/22,Sweden,60.128161,18.643501,2551996,0,19528,2532468
8/13/22,Sweden,60.128161,18.643501,2551996,0,19528,2532468
8/14/22,Sweden,60.128161,18.643501,2551996,0,19528,2532468
8/15/22,Sweden,60.128161,18.643501,2551996,0,19528,2532468
8/16/22,Sweden,60.128161,18.643501,2551996,0,19528,2532468
8/17/22,Sweden,60.128161,18.643501,2551996,0,19528,2532468
8/18/22,Sweden,60.128161,18.643501,2558943,0,19682,2539261
8/19/22,Sweden,60.128161,18.643501,2558943,0,19682,2539261
8/20/22,Sweden,60.128161,18.643501,2558943,0,19682,2539261
8/21/22,Sweden,60.128161,18.643501,2558943,0,19682,2539261
8/22/22,Sweden,60.128161,18.643501,2558943,0,19682,2539261
8/23/22,Sweden,60.128161,18.643501,2558943,0,19682,2539261
8/24/22,Sweden,60.128161,18.643501,2558943,0,19682,2539261
8/25/22,Sweden,60.128161,18.643501,2564423,0,19810,2544613
8/26/22,Sweden,60.128161,18.643501,2564423,0,19810,2544613
8/27/22,Sweden,60.128161,18.643501,2564423,0,19810,2544613
8/28/22,Sweden,60.128161,18.643501,2564423,0,19810,2544613
8/29/22,Sweden,60.128161,18.643501,2564423,0,19810,2544613
8/30/22,Sweden,60.128161,18.643501,2564423,0,19810,2544613
8/31/22,Sweden,60.128161,18.643501,2564423,0,19810,2544613
9/1/22,Sweden,60.128161,18.643501,2569152,0,19904,2549248
9/2/22,Sweden,60.128161,18.643501,2569152,0,19904,2549248
9/3/22,Sweden,60.128161,18.643501,2569152,0,19904,2549248
9/4/22,Sweden,60.128161,18.643501,2569152,0,19904,2549248
9/5/22,Sweden,60.128161,18.643501,2569152,0,19904,2549248
9/6/22,Sweden,60.128161,18.643501,2569152,0,19904,2549248
9/7/22,Sweden,60.128161,18.643501,2569152,0,19904,2549248
9/8/22,Sweden,60.128161,18.643501,2573548,0,20006,2553542
9/9/22,Sweden,60.128161,18.643501,2573548,0,20006,2553542
9/10/22,Sweden,60.128161,18.643501,2573548,0,20006,2553542
9/11/22,Sweden,60.128161,18.643501,2573548,0,20006,2553542
9/12/22,Sweden,60.128161,18.643501,2573548,0,20006,2553542
9/13/22,Sweden,60.128161,18.643501,2573548,0,20006,2553542
9/14/22,Sweden,60.128161,18.643501,2573548,0,20006,2553542
9/15/22,Sweden,60.128161,18.643501,2578521,0,20100,2558421
9/16/22,Sweden,60.128161,18.643501,2578521,0,20100,2558421
9/17/22,Sweden,60.128161,18.643501,2578521,0,20100,2558421
9/18/22,Sweden,60.128161,18.643501,2578521,0,20100,2558421
9/19/22,Sweden,60.128161,18.643501,2578521,0,20100,2558421
9/20/22,Sweden,60.128161,18.643501,2578521,0,20100,2558421
9/21/22,Sweden,60.128161,18.643501,2578521,0,20100,2558421
9/22/22,Sweden,60.128161,18.643501,2583370,0,20178,2563192
9/23/22,Sweden,60.128161,18.643501,2583370,0,20178,2563192
9/24/22,Sweden,60.128161,18.643501,2583370,0,20178,2563192
9/25/22,Sweden,60.128161,18.643501,2583370,0,20178,2563192
9/26/22,Sweden,60.128161,18.643501,2583370,0,20178,2563192
9/27/22,Sweden,60.128161,18.643501,2583370,0,20178,2563192
9/28/22,Sweden,60.128161,18.643501,2583370,0,20178,2563192
9/29/22,Sweden,60.128161,18.643501,2588441,0,20225,2568216
9/30/22,Sweden,60.128161,18.643501,2588441,0,20225,2568216
10/1/22,Sweden,60.128161,18.643501,2588441,0,20225,2568216
10/2/22,Sweden,60.128161,18.643501,2588441,0,20225,2568216
10/3/22,Sweden,60.128161,18.643501,2588441,0,20225,2568216
10/4/22,Sweden,60.128161,18.643501,2588441,0,20225,2568216
10/5/22,Sweden,60.128161,18.643501,2588441,0,20225,2568216
10/6/22,Sweden,60.128161,18.643501,2601153,0,20274,2580879
10/7/22,Sweden,60.128161,18.643501,2601153,0,20274,2580879
10/8/22,Sweden,60.128161,18.643501,2601153,0,20274,2580879
10/9/22,Sweden,60.128161,18.643501,2601153,0,20274,2580879
10/10/22,Sweden,60.128161,18.643501,2601153,0,20274,2580879
10/11/22,Sweden,60.128161,18.643501,2601153,0,20274,2580879
10/12/22,Sweden,60.128161,18.643501,2601153,0,20274,2580879
10/13/22,Sweden,60.128161,18.643501,2604866,0,20438,2584428
10/14/22,Sweden,60.128161,18.643501,2604866,0,20438,2584428
10/15/22,Sweden,60.128161,18.643501,2604866,0,20438,2584428
10/16/22,Sweden,60.128161,18.643501,2604866,0,20438,2584428
10/17/22,Sweden,60.128161,18.643501,2604866,0,20438,2584428
10/18/22,Sweden,60.128161,18.643501,2604866,0,20438,2584428
10/19/22,Sweden,60.128161,18.643501,2604866,0,20438,2584428
10/20/22,Sweden,60.128161,18.643501,2608289,0,20562,2587727
10/21/22,Sweden,60.128161,18.643501,2608289,0,20562,2587727
10/22/22,Sweden,60.128161,18.643501,2608289,0,20562,2587727
10/23/22,Sweden,60.128161,18.643501,2608289,0,20562,2587727
10/24/22,Sweden,60.128161,18.643501,2608289,0,20562,2587727
10/25/22,Sweden,60.128161,18.643501,2608289,0,20562,2587727
10/26/22,Sweden,60.128161,18.643501,2608289,0,20562,2587727
10/27/22,Sweden,60.128161,18.643501,2611580,0,20659,2590921
10/28/22,Sweden,60.128161,18.643501,2611580,0,20659,2590921
10/29/22,Sweden,60.128161,18.643501,2611580,0,20659,2590921
10/30/22,Sweden,60.128161,18.643501,2611580,0,20659,2590921
10/31/22,Sweden,60.128161,18.643501,2611580,0,20659,2590921
11/1/22,Sweden,60.128161,18.643501,2611580,0,20659,2590921
11/2/22,Sweden,60.128161,18.643501,2611580,0,20659,2590921
11/3/22,Sweden,60.128161,18.643501,2614997,0,20753,2594244
11/4/22,Sweden,60.128161,18.643501,2614997,0,20753,2594244
11/5/22,Sweden,60.128161,18.643501,2614997,0,20753,2594244
11/6/22,Sweden,60.128161,18.643501,2614997,0,20753,2594244
11/7/22,Sweden,60.128161,18.643501,2614997,0,20753,2594244
11/8/22,Sweden,60.128161,18.643501,2614997,0,20753,2594244
11/9/22,Sweden,60.128161,18.643501,2614997,0,20753,2594244
11/10/22,Sweden,60.128161,18.643501,2618688,0,20857,2597831
11/11/22,Sweden,60.128161,18.643501,2618688,0,20857,2597831
11/12/22,Sweden,60.128161,18.643501,2618688,0,20857,2597831
11/13/22,Sweden,60.128161,18.643501,2618688,0,20857,2597831
11/14/22,Sweden,60.128161,18.643501,2618688,0,20857,2597831
11/15/22,Sweden,60.128161,18.643501,2618688,0,20857,2597831
11/16/22,Sweden,60.128161,18.643501,2618688,0,20857,2597831
11/17/22,Sweden,60.128161,18.643501,2622790,0,20928,2601862
11/18/22,Sweden,60.128161,18.643501,2622790,0,20928,2601862
11/19/22,Sweden,60.128161,18.643501,2622790,0,20928,2601862
11/20/22,Sweden,60.128161,18.643501,2622790,0,20928,2601862
11/21/22,Sweden,60.128161,18.643501,2622790,0,20928,2601862
11/22/22,Sweden,60.128161,18.643501,2622790,0,20928,2601862
11/23/22,Sweden,60.128161,18.643501,2622790,0,20928,2601862
11/24/22,Sweden,60.128161,18.643501,2626686,0,21034,2605652
11/25/22,Sweden,60.128161,18.643501,2626686,0,21034,2605652
11/26/22,Sweden,60.128161,18.643501,2626686,0,21034,2605652
11/27/22,Sweden,60.128161,18.643501,2626686,0,21034,2605652
11/28/22,Sweden,60.128161,18.643501,2626686,0,21034,2605652
11/29/22,Sweden,60.128161,18.643501,2626686,0,21034,2605652
11/30/22,Sweden,60.128161,18.643501,2626686,0,21034,2605652
12/1/22,Sweden,60.128161,18.643501,2632091,0,21127,2610964
12/2/22,Sweden,60.128161,18.643501,2632091,0,21127,2610964
12/3/22,Sweden,60.128161,18.643501,2632091,0,21127,2610964
12/4/22,Sweden,60.128161,18.643501,2632091,0,21127,2610964
12/5/22,Sweden,60.128161,18.643501,2632091,0,21127,2610964
12/6/22,Sweden,60.128161,18.643501,2632091,0,21127,2610964
12/7/22,Sweden,60.128161,18.643501,2632091,0,21127,2610964
12/8/22,Sweden,60.128161,18.643501,2640369,0,21234,2619135
12/9/22,Sweden,60.128161,18.643501,2640369,0,21234,2619135
12/10/22,Sweden,60.128161,18.643501,2640369,0,21234,2619135
12/11/22,Sweden,60.128161,18.643501,2640369,0,21234,2619135
12/12/22,Sweden,60.128161,18.643501,2640369,0,21234,2619135
12/13/22,Sweden,60.128161,18.643501,2640369,0,21234,2619135
12/14/22,Sweden,60.128161,18.643501,2640369,0,21234,2619135
12/15/22,Sweden,60.128161,18.643501,2651702,0,21364,2630338
12/16/22,Sweden,60.128161,18.643501,2651702,0,21364,2630338
12/17/22,Sweden,60.128161,18.643501,2651702,0,21364,2630338
1/1/22,Switzerland,46.8182,8.2275,1332615,0,12220,1320395
1/2/22,Switzerland,46.8182,8.2275,1332615,0,12227,1320388
1/3/22,Switzerland,46.8182,8.2275,1371062,0,12268,1358794
1/4/22,Switzerland,46.8182,8.2275,1391814,0,12229,1379585
1/5/22,Switzerland,46.8182,8.2275,1422932,0,12303,1410629
1/6/22,Switzerland,46.8182,8.2275,1455174,0,12325,1442849
1/7/22,Switzerland,46.8182,8.2275,1483212,0,12339,1470873
1/8/22,Switzerland,46.8182,8.2275,1483212,0,12337,1470875
1/9/22,Switzerland,46.8182,8.2275,1483212,0,12349,1470863
1/10/22,Switzerland,46.8182,8.2275,1546877,0,12387,1534490
1/11/22,Switzerland,46.8182,8.2275,1571481,0,12409,1559072
1/12/22,Switzerland,46.8182,8.2275,1604371,0,12427,1591944
1/13/22,Switzerland,46.8182,8.2275,1634258,0,12447,1621811
1/14/22,Switzerland,46.8182,8.2275,1666441,0,12464,1653977
1/15/22,Switzerland,46.8182,8.2275,1666441,0,12469,1653972
1/16/22,Switzerland,46.8182,8.2275,1666441,0,12469,1653972
1/17/22,Switzerland,46.8182,8.2275,1734346,0,12515,1721831
1/18/22,Switzerland,46.8182,8.2275,1763497,0,12529,1750968
1/19/22,Switzerland,46.8182,8.2275,1801522,0,12544,1788978
1/20/22,Switzerland,46.8182,8.2275,1841317,0,12569,1828748
1/21/22,Switzerland,46.8182,8.2275,1879319,0,12579,1866740
1/22/22,Switzerland,46.8182,8.2275,1879319,0,12582,1866737
1/23/22,Switzerland,46.8182,8.2275,1879319,0,12586,1866733
1/24/22,Switzerland,46.8182,8.2275,1966600,0,12621,1953979
1/25/22,Switzerland,46.8182,8.2275,2003262,0,12635,1990627
1/26/22,Switzerland,46.8182,8.2275,2046465,0,12649,2033816
1/27/22,Switzerland,46.8182,8.2275,2091306,0,12666,2078640
1/28/22,Switzerland,46.8182,8.2275,2131077,0,12679,2118398
1/29/22,Switzerland,46.8182,8.2275,2131077,0,12680,2118397
1/30/22,Switzerland,46.8182,8.2275,2131077,0,12684,2118393
1/31/22,Switzerland,46.8182,8.2275,2220539,0,12708,2207831
2/1/22,Switzerland,46.8182,8.2275,2253288,0,12723,2240565
2/2/22,Switzerland,46.8182,8.2275,2294471,0,12749,2281722
2/3/22,Switzerland,46.8182,8.2275,2331213,0,12768,2318445
2/4/22,Switzerland,46.8182,8.2275,2364613,0,12779,2351834
2/5/22,Switzerland,46.8182,8.2275,2364613,0,12782,2351831
2/6/22,Switzerland,46.8182,8.2275,2364613,0,12786,2351827
2/7/22,Switzerland,46.8182,8.2275,2433265,0,12808,2420457
2/8/22,Switzerland,46.8182,8.2275,2460036,0,12865,2447171
2/9/22,Switzerland,46.8182,8.2275,2489172,0,12890,2476282
2/10/22,Switzerland,46.8182,8.2275,2515506,0,12915,2502591
2/11/22,Switzerland,46.8182,8.2275,2537734,0,12932,2524802
2/12/22,Switzerland,46.8182,8.2275,2537734,0,12933,2524801
2/13/22,Switzerland,46.8182,8.2275,2537734,0,12936,2524798
2/14/22,Switzerland,46.8182,8.2275,2586724,0,12963,2573761
2/15/22,Switzerland,46.8182,8.2275,2607052,0,12975,2594077
2/16/22,Switzerland,46.8182,8.2275,2628093,0,12979,2615114
2/17/22,Switzerland,46.8182,8.2275,2628093,0,13003,2615090
2/18/22,Switzerland,46.8182,8.2275,2664194,0,13012,2651182
2/19/22,Switzerland,46.8182,8.2275,2664194,0,13016,2651178
2/20/22,Switzerland,46.8182,8.2275,2664194,0,13016,2651178
2/21/22,Switzerland,46.8182,8.2275,2696491,0,13032,2683459
2/22/22,Switzerland,46.8182,8.2275,2711618,0,13044,2698574
2/23/22,Switzerland,46.8182,8.2275,2730037,0,13062,2716975
2/24/22,Switzerland,46.8182,8.2275,2747563,0,13073,2734490
2/25/22,Switzerland,46.8182,8.2275,2765218,0,13082,2752136
2/26/22,Switzerland,46.8182,8.2275,2765218,0,13082,2752136
2/27/22,Switzerland,46.8182,8.2275,2765218,0,13080,2752138
2/28/22,Switzerland,46.8182,8.2275,2801951,0,13101,2788850
3/1/22,Switzerland,46.8182,8.2275,2818720,0,13110,2805610
3/2/22,Switzerland,46.8182,8.2275,2842412,0,13119,2829293
3/3/22,Switzerland,46.8182,8.2275,2865436,0,13131,2852305
3/4/22,Switzerland,46.8182,8.2275,2890568,0,13173,2877395
3/5/22,Switzerland,46.8182,8.2275,2890568,0,13174,2877394
3/6/22,Switzerland,46.8182,8.2275,2890568,0,13173,2877395
3/7/22,Switzerland,46.8182,8.2275,2948689,0,13193,2935496
3/8/22,Switzerland,46.8182,8.2275,2974778,0,13203,2961575
3/9/22,Switzerland,46.8182,8.2275,3008537,0,13213,2995324
3/10/22,Switzerland,46.8182,8.2275,3040668,0,13231,3027437
3/11/22,Switzerland,46.8182,8.2275,3072758,0,13265,3059493
3/12/22,Switzerland,46.8182,8.2275,3072758,0,13266,3059492
3/13/22,Switzerland,46.8182,8.2275,3072758,0,13266,3059492
3/14/22,Switzerland,46.8182,8.2275,3141904,0,13286,3128618
3/15/22,Switzerland,46.8182,8.2275,3170937,0,13294,3157643
3/16/22,Switzerland,46.8182,8.2275,3206975,0,13312,3193663
3/17/22,Switzerland,46.8182,8.2275,3241348,0,13322,3228026
3/18/22,Switzerland,46.8182,8.2275,3268953,0,13328,3255625
3/19/22,Switzerland,46.8182,8.2275,3268953,0,13328,3255625
3/20/22,Switzerland,46.8182,8.2275,3268953,0,13423,3255530
3/21/22,Switzerland,46.8182,8.2275,3329950,0,13445,3316505
3/22/22,Switzerland,46.8182,8.2275,3353754,0,13456,3340298
3/23/22,Switzerland,46.8182,8.2275,3379845,0,13483,3366362
3/24/22,Switzerland,46.8182,8.2275,3402297,0,13498,3388799
3/25/22,Switzerland,46.8182,8.2275,3419549,0,13507,3406042
3/26/22,Switzerland,46.8182,8.2275,3419549,0,13507,3406042
3/27/22,Switzerland,46.8182,8.2275,3419549,0,13507,3406042
3/28/22,Switzerland,46.8182,8.2275,3453885,0,13524,3440361
3/29/22,Switzerland,46.8182,8.2275,3468289,0,13534,3454755
3/30/22,Switzerland,46.8182,8.2275,3484702,0,13558,3471144
3/31/22,Switzerland,46.8182,8.2275,3497499,0,13564,3483935
4/1/22,Switzerland,46.8182,8.2275,3507309,0,13570,3493739
4/2/22,Switzerland,46.8182,8.2275,3507309,0,13572,3493737
4/3/22,Switzerland,46.8182,8.2275,3507309,0,13573,3493736
4/4/22,Switzerland,46.8182,8.2275,3507309,0,13582,3493727
4/5/22,Switzerland,46.8182,8.2275,3528689,0,13588,3515101
4/6/22,Switzerland,46.8182,8.2275,3528689,0,13600,3515089
4/7/22,Switzerland,46.8182,8.2275,3528689,0,13604,3515085
4/8/22,Switzerland,46.8182,8.2275,3528689,0,13607,3515082
4/9/22,Switzerland,46.8182,8.2275,3528689,0,13607,3515082
4/10/22,Switzerland,46.8182,8.2275,3528689,0,13607,3515082
4/11/22,Switzerland,46.8182,8.2275,3528689,0,13616,3515073
4/12/22,Switzerland,46.8182,8.2275,3568616,0,13620,3554996
4/13/22,Switzerland,46.8182,8.2275,3568616,0,13620,3554996
4/14/22,Switzerland,46.8182,8.2275,3568616,0,13645,3554971
4/15/22,Switzerland,46.8182,8.2275,3568616,0,13647,3554969
4/16/22,Switzerland,46.8182,8.2275,3568616,0,13647,3554969
4/17/22,Switzerland,46.8182,8.2275,3568616,0,13647,3554969
4/18/22,Switzerland,46.8182,8.2275,3568616,0,13647,3554969
4/19/22,Switzerland,46.8182,8.2275,3596855,0,13664,3583191
4/20/22,Switzerland,46.8182,8.2275,3596855,0,13669,3583186
4/21/22,Switzerland,46.8182,8.2275,3596855,0,13672,3583183
4/22/22,Switzerland,46.8182,8.2275,3596855,0,13676,3583179
4/23/22,Switzerland,46.8182,8.2275,3596855,0,13676,3583179
4/24/22,Switzerland,46.8182,8.2275,3596855,0,13676,3583179
4/25/22,Switzerland,46.8182,8.2275,3596855,0,13684,3583171
4/26/22,Switzerland,46.8182,8.2275,3619598,0,13690,3605908
4/27/22,Switzerland,46.8182,8.2275,3619598,0,13701,3605897
4/28/22,Switzerland,46.8182,8.2275,3619598,0,13710,3605888
4/29/22,Switzerland,46.8182,8.2275,3619598,0,13712,3605886
4/30/22,Switzerland,46.8182,8.2275,3619598,0,13712,3605886
5/1/22,Switzerland,46.8182,8.2275,3619598,0,13712,3605886
5/2/22,Switzerland,46.8182,8.2275,3619598,0,13714,3605884
5/3/22,Switzerland,46.8182,8.2275,3636226,0,13718,3622508
5/4/22,Switzerland,46.8182,8.2275,3636226,0,13719,3622507
5/5/22,Switzerland,46.8182,8.2275,3636226,0,13725,3622501
5/6/22,Switzerland,46.8182,8.2275,3636226,0,13726,3622500
5/7/22,Switzerland,46.8182,8.2275,3636226,0,13726,3622500
5/8/22,Switzerland,46.8182,8.2275,3636226,0,13726,3622500
5/9/22,Switzerland,46.8182,8.2275,3636226,0,13729,3622497
5/10/22,Switzerland,46.8182,8.2275,3649155,0,13773,3635382
5/11/22,Switzerland,46.8182,8.2275,3649155,0,13778,3635377
5/12/22,Switzerland,46.8182,8.2275,3649155,0,13779,3635376
5/13/22,Switzerland,46.8182,8.2275,3649155,0,13781,3635374
5/14/22,Switzerland,46.8182,8.2275,3649155,0,13781,3635374
5/15/22,Switzerland,46.8182,8.2275,3649155,0,13781,3635374
5/16/22,Switzerland,46.8182,8.2275,3649155,0,13784,3635371
5/17/22,Switzerland,46.8182,8.2275,3659937,0,13790,3646147
5/18/22,Switzerland,46.8182,8.2275,3659937,0,13791,3646146
5/19/22,Switzerland,46.8182,8.2275,3659937,0,13791,3646146
5/20/22,Switzerland,46.8182,8.2275,3659937,0,13791,3646146
5/21/22,Switzerland,46.8182,8.2275,3659937,0,13791,3646146
5/22/22,Switzerland,46.8182,8.2275,3659937,0,13791,3646146
5/23/22,Switzerland,46.8182,8.2275,3659937,0,13790,3646147
5/24/22,Switzerland,46.8182,8.2275,3668054,0,13791,3654263
5/25/22,Switzerland,46.8182,8.2275,3668054,0,13794,3654260
5/26/22,Switzerland,46.8182,8.2275,3668054,0,13794,3654260
5/27/22,Switzerland,46.8182,8.2275,3668054,0,13794,3654260
5/28/22,Switzerland,46.8182,8.2275,3668054,0,13794,3654260
5/29/22,Switzerland,46.8182,8.2275,3668054,0,13794,3654260
5/30/22,Switzerland,46.8182,8.2275,3668054,0,13799,3654255
5/31/22,Switzerland,46.8182,8.2275,3674986,0,13800,3661186
6/1/22,Switzerland,46.8182,8.2275,3674986,0,13801,3661185
6/2/22,Switzerland,46.8182,8.2275,3674986,0,13804,3661182
6/3/22,Switzerland,46.8182,8.2275,3674986,0,13804,3661182
6/4/22,Switzerland,46.8182,8.2275,3674986,0,13804,3661182
6/5/22,Switzerland,46.8182,8.2275,3674986,0,13804,3661182
6/6/22,Switzerland,46.8182,8.2275,3674986,0,13804,3661182
6/7/22,Switzerland,46.8182,8.2275,3685281,0,13809,3671472
6/8/22,Switzerland,46.8182,8.2275,3685281,0,13813,3671468
6/9/22,Switzerland,46.8182,8.2275,3685281,0,13814,3671467
6/10/22,Switzerland,46.8182,8.2275,3685281,0,13814,3671467
6/11/22,Switzerland,46.8182,8.2275,3685281,0,13814,3671467
6/12/22,Switzerland,46.8182,8.2275,3685281,0,13814,3671467
6/13/22,Switzerland,46.8182,8.2275,3685281,0,13815,3671466
6/14/22,Switzerland,46.8182,8.2275,3701895,0,13817,3688078
6/15/22,Switzerland,46.8182,8.2275,3701895,0,13817,3688078
6/16/22,Switzerland,46.8182,8.2275,3701895,0,13817,3688078
6/17/22,Switzerland,46.8182,8.2275,3701895,0,13817,3688078
6/18/22,Switzerland,46.8182,8.2275,3701895,0,13817,3688078
6/19/22,Switzerland,46.8182,8.2275,3701895,0,13817,3688078
6/20/22,Switzerland,46.8182,8.2275,3701895,0,13820,3688075
6/21/22,Switzerland,46.8182,8.2275,3726615,0,13820,3712795
6/22/22,Switzerland,46.8182,8.2275,3726615,0,13822,3712793
6/23/22,Switzerland,46.8182,8.2275,3726615,0,13822,3712793
6/24/22,Switzerland,46.8182,8.2275,3726615,0,13822,3712793
6/25/22,Switzerland,46.8182,8.2275,3726615,0,13822,3712793
6/26/22,Switzerland,46.8182,8.2275,3726615,0,13822,3712793
6/27/22,Switzerland,46.8182,8.2275,3726615,0,13824,3712791
6/28/22,Switzerland,46.8182,8.2275,3759730,0,13824,3745906
6/29/22,Switzerland,46.8182,8.2275,3759730,0,13828,3745902
6/30/22,Switzerland,46.8182,8.2275,3759730,0,13831,3745899
7/1/22,Switzerland,46.8182,8.2275,3759730,0,13832,3745898
7/2/22,Switzerland,46.8182,8.2275,3759730,0,13832,3745898
7/3/22,Switzerland,46.8182,8.2275,3759730,0,13832,3745898
7/4/22,Switzerland,46.8182,8.2275,3759730,0,13833,3745897
7/5/22,Switzerland,46.8182,8.2275,3805774,0,13835,3791939
7/6/22,Switzerland,46.8182,8.2275,3805774,0,13841,3791933
7/7/22,Switzerland,46.8182,8.2275,3805774,0,13842,3791932
7/8/22,Switzerland,46.8182,8.2275,3805774,0,13842,3791932
7/9/22,Switzerland,46.8182,8.2275,3805774,0,13842,3791932
7/10/22,Switzerland,46.8182,8.2275,3805774,0,13842,3791932
7/11/22,Switzerland,46.8182,8.2275,3805774,0,13844,3791930
7/12/22,Switzerland,46.8182,8.2275,3861756,0,13848,3847908
7/13/22,Switzerland,46.8182,8.2275,3861756,0,13857,3847899
7/14/22,Switzerland,46.8182,8.2275,3861756,0,13857,3847899
7/15/22,Switzerland,46.8182,8.2275,3861756,0,13857,3847899
7/16/22,Switzerland,46.8182,8.2275,3861756,0,13857,3847899
7/17/22,Switzerland,46.8182,8.2275,3861756,0,13857,3847899
7/18/22,Switzerland,46.8182,8.2275,3861756,0,13860,3847896
7/19/22,Switzerland,46.8182,8.2275,3911515,0,13862,3897653
7/20/22,Switzerland,46.8182,8.2275,3911515,0,13873,3897642
7/21/22,Switzerland,46.8182,8.2275,3911515,0,13874,3897641
7/22/22,Switzerland,46.8182,8.2275,3911515,0,13876,3897639
7/23/22,Switzerland,46.8182,8.2275,3911515,0,13876,3897639
7/24/22,Switzerland,46.8182,8.2275,3911515,0,13876,3897639
7/25/22,Switzerland,46.8182,8.2275,3911515,0,13877,3897638
7/26/22,Switzerland,46.8182,8.2275,3949259,0,13882,3935377
7/27/22,Switzerland,46.8182,8.2275,3949259,0,13891,3935368
7/28/22,Switzerland,46.8182,8.2275,3949259,0,13891,3935368
7/29/22,Switzerland,46.8182,8.2275,3949259,0,13891,3935368
7/30/22,Switzerland,46.8182,8.2275,3949259,0,13891,3935368
7/31/22,Switzerland,46.8182,8.2275,3949259,0,13891,3935368
8/1/22,Switzerland,46.8182,8.2275,3949259,0,13891,3935368
8/2/22,Switzerland,46.8182,8.2275,3972622,0,13900,3958722
8/3/22,Switzerland,46.8182,8.2275,3972622,0,13917,3958705
8/4/22,Switzerland,46.8182,8.2275,3972622,0,13918,3958704
8/5/22,Switzerland,46.8182,8.2275,3972622,0,13918,3958704
8/6/22,Switzerland,46.8182,8.2275,3972622,0,13918,3958704
8/7/22,Switzerland,46.8182,8.2275,3972622,0,13918,3958704
8/8/22,Switzerland,46.8182,8.2275,3972622,0,13920,3958702
8/9/22,Switzerland,46.8182,8.2275,3994397,0,13925,3980472
8/10/22,Switzerland,46.8182,8.2275,3994397,0,13938,3980459
8/11/22,Switzerland,46.8182,8.2275,3994397,0,13938,3980459
8/12/22,Switzerland,46.8182,8.2275,3994397,0,13939,3980458
8/13/22,Switzerland,46.8182,8.2275,3994397,0,13939,3980458
8/14/22,Switzerland,46.8182,8.2275,3994397,0,13939,3980458
8/15/22,Switzerland,46.8182,8.2275,3994397,0,13939,3980458
8/16/22,Switzerland,46.8182,8.2275,4012610,0,13946,3998664
8/17/22,Switzerland,46.8182,8.2275,4012610,0,13951,3998659
8/18/22,Switzerland,46.8182,8.2275,4012610,0,13951,3998659
8/19/22,Switzerland,46.8182,8.2275,4012610,0,13953,3998657
8/20/22,Switzerland,46.8182,8.2275,4012610,0,13953,3998657
8/21/22,Switzerland,46.8182,8.2275,4012610,0,13953,3998657
8/22/22,Switzerland,46.8182,8.2275,4012610,0,13955,3998655
8/23/22,Switzerland,46.8182,8.2275,4029657,0,13958,4015699
8/24/22,Switzerland,46.8182,8.2275,4029657,0,13966,4015691
8/25/22,Switzerland,46.8182,8.2275,4029657,0,13966,4015691
8/26/22,Switzerland,46.8182,8.2275,4029657,0,13966,4015691
8/27/22,Switzerland,46.8182,8.2275,4029657,0,13966,4015691
8/28/22,Switzerland,46.8182,8.2275,4029657,0,13966,4015691
8/29/22,Switzerland,46.8182,8.2275,4029657,0,13967,4015690
8/30/22,Switzerland,46.8182,8.2275,4045011,0,13969,4031042
8/31/22,Switzerland,46.8182,8.2275,4045011,0,13974,4031037
9/1/22,Switzerland,46.8182,8.2275,4045011,0,13974,4031037
9/2/22,Switzerland,46.8182,8.2275,4045011,0,13974,4031037
9/3/22,Switzerland,46.8182,8.2275,4045011,0,13975,4031036
9/4/22,Switzerland,46.8182,8.2275,4045011,0,13975,4031036
9/5/22,Switzerland,46.8182,8.2275,4045011,0,13975,4031036
9/6/22,Switzerland,46.8182,8.2275,4059532,0,13976,4045556
9/7/22,Switzerland,46.8182,8.2275,4059532,0,13986,4045546
9/8/22,Switzerland,46.8182,8.2275,4059532,0,13986,4045546
9/9/22,Switzerland,46.8182,8.2275,4059532,0,13987,4045545
9/10/22,Switzerland,46.8182,8.2275,4059532,0,13987,4045545
9/11/22,Switzerland,46.8182,8.2275,4059532,0,13987,4045545
9/12/22,Switzerland,46.8182,8.2275,4059532,0,13988,4045544
9/13/22,Switzerland,46.8182,8.2275,4073348,0,13992,4059356
9/14/22,Switzerland,46.8182,8.2275,4073348,0,13992,4059356
9/15/22,Switzerland,46.8182,8.2275,4073348,0,13992,4059356
9/16/22,Switzerland,46.8182,8.2275,4073348,0,13992,4059356
9/17/22,Switzerland,46.8182,8.2275,4073348,0,13992,4059356
9/18/22,Switzerland,46.8182,8.2275,4073348,0,13992,4059356
9/19/22,Switzerland,46.8182,8.2275,4073348,0,13995,4059353
9/20/22,Switzerland,46.8182,8.2275,4087087,0,13996,4073091
9/21/22,Switzerland,46.8182,8.2275,4087087,0,13998,4073089
9/22/22,Switzerland,46.8182,8.2275,4087087,0,13998,4073089
9/23/22,Switzerland,46.8182,8.2275,4087087,0,13998,4073089
9/24/22,Switzerland,46.8182,8.2275,4087087,0,13998,4073089
9/25/22,Switzerland,46.8182,8.2275,4087087,0,13998,4073089
9/26/22,Switzerland,46.8182,8.2275,4087087,0,14001,4073086
9/27/22,Switzerland,46.8182,8.2275,4103959,0,14001,4089958
9/28/22,Switzerland,46.8182,8.2275,4103959,0,14008,4089951
9/29/22,Switzerland,46.8182,8.2275,4103959,0,14008,4089951
9/30/22,Switzerland,46.8182,8.2275,4103959,0,14009,4089950
10/1/22,Switzerland,46.8182,8.2275,4103959,0,14009,4089950
10/2/22,Switzerland,46.8182,8.2275,4103959,0,14009,4089950
10/3/22,Switzerland,46.8182,8.2275,4103959,0,14009,4089950
10/4/22,Switzerland,46.8182,8.2275,4129096,0,14010,4115086
10/5/22,Switzerland,46.8182,8.2275,4129096,0,14017,4115079
10/6/22,Switzerland,46.8182,8.2275,4129096,0,14017,4115079
10/7/22,Switzerland,46.8182,8.2275,4129096,0,14017,4115079
10/8/22,Switzerland,46.8182,8.2275,4129096,0,14017,4115079
10/9/22,Switzerland,46.8182,8.2275,4129096,0,14017,4115079
10/10/22,Switzerland,46.8182,8.2275,4129096,0,14019,4115077
10/11/22,Switzerland,46.8182,8.2275,4164685,0,14020,4150665
10/12/22,Switzerland,46.8182,8.2275,4164685,0,14021,4150664
10/13/22,Switzerland,46.8182,8.2275,4164685,0,14022,4150663
10/14/22,Switzerland,46.8182,8.2275,4164685,0,14022,4150663
10/15/22,Switzerland,46.8182,8.2275,4164685,0,14022,4150663
10/16/22,Switzerland,46.8182,8.2275,4164685,0,14022,4150663
10/17/22,Switzerland,46.8182,8.2275,4164685,0,14025,4150660
10/18/22,Switzerland,46.8182,8.2275,4164685,0,14031,4150654
10/19/22,Switzerland,46.8182,8.2275,4164685,0,14041,4150644
10/20/22,Switzerland,46.8182,8.2275,4201711,0,14041,4187670
10/21/22,Switzerland,46.8182,8.2275,4201711,0,14042,4187669
10/22/22,Switzerland,46.8182,8.2275,4201711,0,14042,4187669
10/23/22,Switzerland,46.8182,8.2275,4201711,0,14042,4187669
10/24/22,Switzerland,46.8182,8.2275,4201711,0,14046,4187665
10/25/22,Switzerland,46.8182,8.2275,4232022,0,14055,4217967
10/26/22,Switzerland,46.8182,8.2275,4232022,0,14061,4217961
10/27/22,Switzerland,46.8182,8.2275,4232022,0,14062,4217960
10/28/22,Switzerland,46.8182,8.2275,4232022,0,14062,4217960
10/29/22,Switzerland,46.8182,8.2275,4232022,0,14062,4217960
10/30/22,Switzerland,46.8182,8.2275,4232022,0,14062,4217960
10/31/22,Switzerland,46.8182,8.2275,4232022,0,14065,4217957
11/1/22,Switzerland,46.8182,8.2275,4255891,0,14070,4241821
11/2/22,Switzerland,46.8182,8.2275,4255891,0,14080,4241811
11/3/22,Switzerland,46.8182,8.2275,4255891,0,14081,4241810
11/4/22,Switzerland,46.8182,8.2275,4255891,0,14081,4241810
11/5/22,Switzerland,46.8182,8.2275,4255891,0,14081,4241810
11/6/22,Switzerland,46.8182,8.2275,4255891,0,14081,4241810
11/7/22,Switzerland,46.8182,8.2275,4255891,0,14085,4241806
11/8/22,Switzerland,46.8182,8.2275,4276848,0,14089,4262759
11/9/22,Switzerland,46.8182,8.2275,4276848,0,14097,4262751
11/10/22,Switzerland,46.8182,8.2275,4276848,0,14097,4262751
11/11/22,Switzerland,46.8182,8.2275,4276848,0,14097,4262751
11/12/22,Switzerland,46.8182,8.2275,4276848,0,14097,4262751
11/13/22,Switzerland,46.8182,8.2275,4276848,0,14097,4262751
11/14/22,Switzerland,46.8182,8.2275,4276848,0,14098,4262750
11/15/22,Switzerland,46.8182,8.2275,4297635,0,14101,4283534
11/16/22,Switzerland,46.8182,8.2275,4297635,0,14110,4283525
11/17/22,Switzerland,46.8182,8.2275,4297635,0,14110,4283525
11/18/22,Switzerland,46.8182,8.2275,4297635,0,14110,4283525
11/19/22,Switzerland,46.8182,8.2275,4297635,0,14110,4283525
11/20/22,Switzerland,46.8182,8.2275,4297635,0,14110,4283525
11/21/22,Switzerland,46.8182,8.2275,4297635,0,14110,4283525
11/22/22,Switzerland,46.8182,8.2275,4318881,0,14114,4304767
11/23/22,Switzerland,46.8182,8.2275,4318881,0,14116,4304765
11/24/22,Switzerland,46.8182,8.2275,4318881,0,14116,4304765
11/25/22,Switzerland,46.8182,8.2275,4318881,0,14116,4304765
11/26/22,Switzerland,46.8182,8.2275,4318881,0,14116,4304765
11/27/22,Switzerland,46.8182,8.2275,4318881,0,14116,4304765
11/28/22,Switzerland,46.8182,8.2275,4318881,0,14124,4304757
11/29/22,Switzerland,46.8182,8.2275,4337983,0,14130,4323853
11/30/22,Switzerland,46.8182,8.2275,4337983,0,14137,4323846
12/1/22,Switzerland,46.8182,8.2275,4337983,0,14137,4323846
12/2/22,Switzerland,46.8182,8.2275,4337983,0,14137,4323846
12/3/22,Switzerland,46.8182,8.2275,4337983,0,14137,4323846
12/4/22,Switzerland,46.8182,8.2275,4337983,0,14137,4323846
12/5/22,Switzerland,46.8182,8.2275,4337983,0,14138,4323845
12/6/22,Switzerland,46.8182,8.2275,4356582,0,14142,4342440
12/7/22,Switzerland,46.8182,8.2275,4356582,0,14147,4342435
12/8/22,Switzerland,46.8182,8.2275,4356582,0,14147,4342435
12/9/22,Switzerland,46.8182,8.2275,4356582,0,14147,4342435
12/10/22,Switzerland,46.8182,8.2275,4356582,0,14147,4342435
12/11/22,Switzerland,46.8182,8.2275,4356582,0,14147,4342435
12/12/22,Switzerland,46.8182,8.2275,4356582,0,14148,4342434
12/13/22,Switzerland,46.8182,8.2275,4373011,0,14153,4358858
12/14/22,Switzerland,46.8182,8.2275,4373011,0,14156,4358855
12/15/22,Switzerland,46.8182,8.2275,4373011,0,14157,4358854
12/16/22,Switzerland,46.8182,8.2275,4373011,0,14157,4358854
12/17/22,Switzerland,46.8182,8.2275,4373011,0,14157,4358854
1/1/22,Syria,34.802075,38.996815,50310,0,2901,47409
1/2/22,Syria,34.802075,38.996815,50337,0,2905,47432
1/3/22,Syria,34.802075,38.996815,50364,0,2908,47456
1/4/22,Syria,34.802075,38.996815,50390,0,2912,47478
1/5/22,Syria,34.802075,38.996815,50417,0,2915,47502
1/6/22,Syria,34.802075,38.996815,50442,0,2918,47524
1/7/22,Syria,34.802075,38.996815,50464,0,2921,47543
1/8/22,Syria,34.802075,38.996815,50482,0,2924,47558
1/9/22,Syria,34.802075,38.996815,50502,0,2926,47576
1/10/22,Syria,34.802075,38.996815,50527,0,2930,47597
1/11/22,Syria,34.802075,38.996815,50552,0,2933,47619
1/12/22,Syria,34.802075,38.996815,50580,0,2936,47644
1/13/22,Syria,34.802075,38.996815,50580,0,2936,47644
1/14/22,Syria,34.802075,38.996815,50641,0,2941,47700
1/15/22,Syria,34.802075,38.996815,50674,0,2944,47730
1/16/22,Syria,34.802075,38.996815,50710,0,2947,47763
1/17/22,Syria,34.802075,38.996815,50748,0,2950,47798
1/18/22,Syria,34.802075,38.996815,50784,0,2953,47831
1/19/22,Syria,34.802075,38.996815,50821,0,2956,47865
1/20/22,Syria,34.802075,38.996815,50862,0,2959,47903
1/21/22,Syria,34.802075,38.996815,50902,0,2962,47940
1/22/22,Syria,34.802075,38.996815,50943,0,2965,47978
1/23/22,Syria,34.802075,38.996815,50985,0,2968,48017
1/24/22,Syria,34.802075,38.996815,51029,0,2971,48058
1/25/22,Syria,34.802075,38.996815,51075,0,2974,48101
1/26/22,Syria,34.802075,38.996815,51124,0,2977,48147
1/27/22,Syria,34.802075,38.996815,51177,0,2979,48198
1/28/22,Syria,34.802075,38.996815,51230,0,2982,48248
1/29/22,Syria,34.802075,38.996815,51284,0,2984,48300
1/30/22,Syria,34.802075,38.996815,51341,0,2986,48355
1/31/22,Syria,34.802075,38.996815,51402,0,2989,48413
2/1/22,Syria,34.802075,38.996815,51483,0,2992,48491
2/2/22,Syria,34.802075,38.996815,51569,0,2995,48574
2/3/22,Syria,34.802075,38.996815,51656,0,2998,48658
2/4/22,Syria,34.802075,38.996815,51741,0,3001,48740
2/5/22,Syria,34.802075,38.996815,51826,0,3004,48822
2/6/22,Syria,34.802075,38.996815,51915,0,3008,48907
2/7/22,Syria,34.802075,38.996815,51915,0,3008,48907
2/8/22,Syria,34.802075,38.996815,52119,0,3014,49105
2/9/22,Syria,34.802075,38.996815,52243,0,3017,49226
2/10/22,Syria,34.802075,38.996815,52378,0,3020,49358
2/11/22,Syria,34.802075,38.996815,52504,0,3023,49481
2/12/22,Syria,34.802075,38.996815,52626,0,3026,49600
2/13/22,Syria,34.802075,38.996815,52751,0,3029,49722
2/14/22,Syria,34.802075,38.996815,52881,0,3032,49849
2/15/22,Syria,34.802075,38.996815,53011,0,3035,49976
2/16/22,Syria,34.802075,38.996815,53148,0,3038,50110
2/17/22,Syria,34.802075,38.996815,53278,0,3041,50237
2/18/22,Syria,34.802075,38.996815,53403,0,3044,50359
2/19/22,Syria,34.802075,38.996815,53527,0,3047,50480
2/20/22,Syria,34.802075,38.996815,53659,0,3050,50609
2/21/22,Syria,34.802075,38.996815,53784,0,3053,50731
2/22/22,Syria,34.802075,38.996815,53912,0,3056,50856
2/23/22,Syria,34.802075,38.996815,54040,0,3059,50981
2/24/22,Syria,34.802075,38.996815,54160,0,3062,51098
2/25/22,Syria,34.802075,38.996815,54275,0,3065,51210
2/26/22,Syria,34.802075,38.996815,54380,0,3068,51312
2/27/22,Syria,34.802075,38.996815,54480,0,3071,51409
2/28/22,Syria,34.802075,38.996815,54575,0,3075,51500
3/1/22,Syria,34.802075,38.996815,54664,0,3079,51585
3/2/22,Syria,34.802075,38.996815,54744,0,3082,51662
3/3/22,Syria,34.802075,38.996815,54822,0,3085,51737
3/4/22,Syria,34.802075,38.996815,54894,0,3089,51805
3/5/22,Syria,34.802075,38.996815,54963,0,3092,51871
3/6/22,Syria,34.802075,38.996815,55026,0,3095,51931
3/7/22,Syria,34.802075,38.996815,55085,0,3099,51986
3/8/22,Syria,34.802075,38.996815,55140,0,3102,52038
3/9/22,Syria,34.802075,38.996815,55193,0,3105,52088
3/10/22,Syria,34.802075,38.996815,55243,0,3107,52136
3/11/22,Syria,34.802075,38.996815,55288,0,3110,52178
3/12/22,Syria,34.802075,38.996815,55329,0,3114,52215
3/13/22,Syria,34.802075,38.996815,55366,0,3117,52249
3/14/22,Syria,34.802075,38.996815,55399,0,3117,52282
3/15/22,Syria,34.802075,38.996815,55431,0,3118,52313
3/16/22,Syria,34.802075,38.996815,55460,0,3120,52340
3/17/22,Syria,34.802075,38.996815,55488,0,3122,52366
3/18/22,Syria,34.802075,38.996815,55488,0,3122,52366
3/19/22,Syria,34.802075,38.996815,55538,0,3125,52413
3/20/22,Syria,34.802075,38.996815,55558,0,3127,52431
3/21/22,Syria,34.802075,38.996815,55577,0,3127,52450
3/22/22,Syria,34.802075,38.996815,55577,0,3127,52450
3/23/22,Syria,34.802075,38.996815,55595,0,3128,52467
3/24/22,Syria,34.802075,38.996815,55623,0,3130,52493
3/25/22,Syria,34.802075,38.996815,55623,0,3130,52493
3/26/22,Syria,34.802075,38.996815,55634,0,3131,52503
3/27/22,Syria,34.802075,38.996815,55663,0,3135,52528
3/28/22,Syria,34.802075,38.996815,55672,0,3137,52535
3/29/22,Syria,34.802075,38.996815,55680,0,3138,52542
3/30/22,Syria,34.802075,38.996815,55688,0,3140,52548
3/31/22,Syria,34.802075,38.996815,55695,0,3141,52554
4/1/22,Syria,34.802075,38.996815,55701,0,3142,52559
4/2/22,Syria,34.802075,38.996815,55706,0,3144,52562
4/3/22,Syria,34.802075,38.996815,55711,0,3144,52567
4/4/22,Syria,34.802075,38.996815,55718,0,3145,52573
4/5/22,Syria,34.802075,38.996815,55723,0,3145,52578
4/6/22,Syria,34.802075,38.996815,55727,0,3145,52582
4/7/22,Syria,34.802075,38.996815,55731,0,3146,52585
4/8/22,Syria,34.802075,38.996815,55735,0,3146,52589
4/9/22,Syria,34.802075,38.996815,55739,0,3146,52593
4/10/22,Syria,34.802075,38.996815,55742,0,3146,52596
4/11/22,Syria,34.802075,38.996815,55745,0,3146,52599
4/12/22,Syria,34.802075,38.996815,55750,0,3147,52603
4/13/22,Syria,34.802075,38.996815,55756,0,3148,52608
4/14/22,Syria,34.802075,38.996815,55761,0,3148,52613
4/15/22,Syria,34.802075,38.996815,55765,0,3148,52617
4/16/22,Syria,34.802075,38.996815,55769,0,3149,52620
4/17/22,Syria,34.802075,38.996815,55773,0,3150,52623
4/18/22,Syria,34.802075,38.996815,55778,0,3150,52628
4/19/22,Syria,34.802075,38.996815,55782,0,3150,52632
4/20/22,Syria,34.802075,38.996815,55785,0,3150,52635
4/21/22,Syria,34.802075,38.996815,55790,0,3150,52640
4/22/22,Syria,34.802075,38.996815,55792,0,3150,52642
4/23/22,Syria,34.802075,38.996815,55795,0,3150,52645
4/24/22,Syria,34.802075,38.996815,55797,0,3150,52647
4/25/22,Syria,34.802075,38.996815,55799,0,3150,52649
4/26/22,Syria,34.802075,38.996815,55803,0,3150,52653
4/27/22,Syria,34.802075,38.996815,55807,0,3150,52657
4/28/22,Syria,34.802075,38.996815,55810,0,3150,52660
4/29/22,Syria,34.802075,38.996815,55813,0,3150,52663
4/30/22,Syria,34.802075,38.996815,55813,0,3150,52663
5/1/22,Syria,34.802075,38.996815,55813,0,3150,52663
5/2/22,Syria,34.802075,38.996815,55825,0,3150,52675
5/3/22,Syria,34.802075,38.996815,55829,0,3150,52679
5/4/22,Syria,34.802075,38.996815,55833,0,3150,52683
5/5/22,Syria,34.802075,38.996815,55837,0,3150,52687
5/6/22,Syria,34.802075,38.996815,55842,0,3150,52692
5/7/22,Syria,34.802075,38.996815,55847,0,3150,52697
5/8/22,Syria,34.802075,38.996815,55853,0,3150,52703
5/9/22,Syria,34.802075,38.996815,55858,0,3150,52708
5/10/22,Syria,34.802075,38.996815,55863,0,3150,52713
5/11/22,Syria,34.802075,38.996815,55865,0,3150,52715
5/12/22,Syria,34.802075,38.996815,55867,0,3150,52717
5/13/22,Syria,34.802075,38.996815,55868,0,3150,52718
5/14/22,Syria,34.802075,38.996815,55869,0,3150,52719
5/15/22,Syria,34.802075,38.996815,55870,0,3150,52720
5/16/22,Syria,34.802075,38.996815,55871,0,3150,52721
5/17/22,Syria,34.802075,38.996815,55872,0,3150,52722
5/18/22,Syria,34.802075,38.996815,55873,0,3150,52723
5/19/22,Syria,34.802075,38.996815,55875,0,3150,52725
5/20/22,Syria,34.802075,38.996815,55877,0,3150,52727
5/21/22,Syria,34.802075,38.996815,55878,0,3150,52728
5/22/22,Syria,34.802075,38.996815,55879,0,3150,52729
5/23/22,Syria,34.802075,38.996815,55880,0,3150,52730
5/24/22,Syria,34.802075,38.996815,55880,0,3150,52730
5/25/22,Syria,34.802075,38.996815,55883,0,3150,52733
5/26/22,Syria,34.802075,38.996815,55885,0,3150,52735
5/27/22,Syria,34.802075,38.996815,55885,0,3150,52735
5/28/22,Syria,34.802075,38.996815,55885,0,3150,52735
5/29/22,Syria,34.802075,38.996815,55885,0,3150,52735
5/30/22,Syria,34.802075,38.996815,55891,0,3150,52741
5/31/22,Syria,34.802075,38.996815,55892,0,3150,52742
6/1/22,Syria,34.802075,38.996815,55893,0,3150,52743
6/2/22,Syria,34.802075,38.996815,55894,0,3150,52744
6/3/22,Syria,34.802075,38.996815,55894,0,3150,52744
6/4/22,Syria,34.802075,38.996815,55894,0,3150,52744
6/5/22,Syria,34.802075,38.996815,55894,0,3150,52744
6/6/22,Syria,34.802075,38.996815,55898,0,3150,52748
6/7/22,Syria,34.802075,38.996815,55899,0,3150,52749
6/8/22,Syria,34.802075,38.996815,55900,0,3150,52750
6/9/22,Syria,34.802075,38.996815,55901,0,3150,52751
6/10/22,Syria,34.802075,38.996815,55904,0,3150,52754
6/11/22,Syria,34.802075,38.996815,55904,0,3150,52754
6/12/22,Syria,34.802075,38.996815,55904,0,3150,52754
6/13/22,Syria,34.802075,38.996815,55907,0,3150,52757
6/14/22,Syria,34.802075,38.996815,55908,0,3150,52758
6/15/22,Syria,34.802075,38.996815,55909,0,3150,52759
6/16/22,Syria,34.802075,38.996815,55912,0,3150,52762
6/17/22,Syria,34.802075,38.996815,55913,0,3150,52763
6/18/22,Syria,34.802075,38.996815,55913,0,3150,52763
6/19/22,Syria,34.802075,38.996815,55913,0,3150,52763
6/20/22,Syria,34.802075,38.996815,55916,0,3150,52766
6/21/22,Syria,34.802075,38.996815,55917,0,3150,52767
6/22/22,Syria,34.802075,38.996815,55918,0,3150,52768
6/23/22,Syria,34.802075,38.996815,55919,0,3150,52769
6/24/22,Syria,34.802075,38.996815,55920,0,3150,52770
6/25/22,Syria,34.802075,38.996815,55920,0,3150,52770
6/26/22,Syria,34.802075,38.996815,55920,0,3150,52770
6/27/22,Syria,34.802075,38.996815,55923,0,3150,52773
6/28/22,Syria,34.802075,38.996815,55925,0,3150,52775
6/29/22,Syria,34.802075,38.996815,55926,0,3150,52776
6/30/22,Syria,34.802075,38.996815,55927,0,3150,52777
7/1/22,Syria,34.802075,38.996815,55929,0,3150,52779
7/2/22,Syria,34.802075,38.996815,55929,0,3150,52779
7/3/22,Syria,34.802075,38.996815,55929,0,3150,52779
7/4/22,Syria,34.802075,38.996815,55934,0,3150,52784
7/5/22,Syria,34.802075,38.996815,55937,0,3150,52787
7/6/22,Syria,34.802075,38.996815,55940,0,3150,52790
7/7/22,Syria,34.802075,38.996815,55945,0,3150,52795
7/8/22,Syria,34.802075,38.996815,55949,0,3150,52799
7/9/22,Syria,34.802075,38.996815,55949,0,3150,52799
7/10/22,Syria,34.802075,38.996815,55949,0,3150,52799
7/11/22,Syria,34.802075,38.996815,55955,0,3150,52805
7/12/22,Syria,34.802075,38.996815,55957,0,3150,52807
7/13/22,Syria,34.802075,38.996815,55960,0,3150,52810
7/14/22,Syria,34.802075,38.996815,55966,0,3150,52816
7/15/22,Syria,34.802075,38.996815,55973,0,3150,52823
7/16/22,Syria,34.802075,38.996815,55973,0,3150,52823
7/17/22,Syria,34.802075,38.996815,55973,0,3150,52823
7/18/22,Syria,34.802075,38.996815,56005,0,3150,52855
7/19/22,Syria,34.802075,38.996815,56022,0,3150,52872
7/20/22,Syria,34.802075,38.996815,56027,0,3150,52877
7/21/22,Syria,34.802075,38.996815,56044,0,3150,52894
7/22/22,Syria,34.802075,38.996815,56067,0,3150,52917
7/23/22,Syria,34.802075,38.996815,56067,0,3150,52917
7/24/22,Syria,34.802075,38.996815,56067,0,3150,52917
7/25/22,Syria,34.802075,38.996815,56156,0,3150,53006
7/26/22,Syria,34.802075,38.996815,56188,0,3150,53038
7/27/22,Syria,34.802075,38.996815,56214,0,3150,53064
7/28/22,Syria,34.802075,38.996815,56269,0,3150,53119
7/29/22,Syria,34.802075,38.996815,56275,0,3150,53125
7/30/22,Syria,34.802075,38.996815,56275,0,3150,53125
7/31/22,Syria,34.802075,38.996815,56275,0,3150,53125
8/1/22,Syria,34.802075,38.996815,56353,0,3150,53203
8/2/22,Syria,34.802075,38.996815,56386,0,3150,53236
8/3/22,Syria,34.802075,38.996815,56419,0,3150,53269
8/4/22,Syria,34.802075,38.996815,56453,0,3150,53303
8/5/22,Syria,34.802075,38.996815,56464,0,3150,53314
8/6/22,Syria,34.802075,38.996815,56464,0,3150,53314
8/7/22,Syria,34.802075,38.996815,56464,0,3150,53314
8/8/22,Syria,34.802075,38.996815,56564,0,3153,53411
8/9/22,Syria,34.802075,38.996815,56604,0,3155,53449
8/10/22,Syria,34.802075,38.996815,56634,0,3156,53478
8/11/22,Syria,34.802075,38.996815,56670,0,3156,53514
8/12/22,Syria,34.802075,38.996815,56691,0,3157,53534
8/13/22,Syria,34.802075,38.996815,56700,0,3157,53543
8/14/22,Syria,34.802075,38.996815,56700,0,3157,53543
8/15/22,Syria,34.802075,38.996815,56756,0,3159,53597
8/16/22,Syria,34.802075,38.996815,56772,0,3159,53613
8/17/22,Syria,34.802075,38.996815,56797,0,3160,53637
8/18/22,Syria,34.802075,38.996815,56819,0,3160,53659
8/19/22,Syria,34.802075,38.996815,56831,0,3160,53671
8/20/22,Syria,34.802075,38.996815,56838,0,3160,53678
8/21/22,Syria,34.802075,38.996815,56861,0,3160,53701
8/22/22,Syria,34.802075,38.996815,56876,0,3161,53715
8/23/22,Syria,34.802075,38.996815,56902,0,3162,53740
8/24/22,Syria,34.802075,38.996815,56924,0,3162,53762
8/25/22,Syria,34.802075,38.996815,56947,0,3162,53785
8/26/22,Syria,34.802075,38.996815,56969,0,3163,53806
8/27/22,Syria,34.802075,38.996815,56973,0,3163,53810
8/28/22,Syria,34.802075,38.996815,56985,0,3163,53822
8/29/22,Syria,34.802075,38.996815,57008,0,3163,53845
8/30/22,Syria,34.802075,38.996815,57026,0,3163,53863
8/31/22,Syria,34.802075,38.996815,57043,0,3163,53880
9/1/22,Syria,34.802075,38.996815,57058,0,3163,53895
9/2/22,Syria,34.802075,38.996815,57069,0,3163,53906
9/3/22,Syria,34.802075,38.996815,57069,0,3163,53906
9/4/22,Syria,34.802075,38.996815,57085,0,3163,53922
9/5/22,Syria,34.802075,38.996815,57098,0,3163,53935
9/6/22,Syria,34.802075,38.996815,57114,0,3163,53951
9/7/22,Syria,34.802075,38.996815,57129,0,3163,53966
9/8/22,Syria,34.802075,38.996815,57129,0,3163,53966
9/9/22,Syria,34.802075,38.996815,57144,0,3163,53981
9/10/22,Syria,34.802075,38.996815,57144,0,3163,53981
9/11/22,Syria,34.802075,38.996815,57166,0,3163,54003
9/12/22,Syria,34.802075,38.996815,57172,0,3163,54009
9/13/22,Syria,34.802075,38.996815,57189,0,3163,54026
9/14/22,Syria,34.802075,38.996815,57197,0,3163,54034
9/15/22,Syria,34.802075,38.996815,57207,0,3163,54044
9/16/22,Syria,34.802075,38.996815,57211,0,3163,54048
9/17/22,Syria,34.802075,38.996815,57211,0,3163,54048
9/18/22,Syria,34.802075,38.996815,57220,0,3163,54057
9/19/22,Syria,34.802075,38.996815,57227,0,3163,54064
9/20/22,Syria,34.802075,38.996815,57227,0,3163,54064
9/21/22,Syria,34.802075,38.996815,57253,0,3163,54090
9/22/22,Syria,34.802075,38.996815,57261,0,3163,54098
9/23/22,Syria,34.802075,38.996815,57265,0,3163,54102
9/24/22,Syria,34.802075,38.996815,57265,0,3163,54102
9/25/22,Syria,34.802075,38.996815,57272,0,3163,54109
9/26/22,Syria,34.802075,38.996815,57280,0,3163,54117
9/27/22,Syria,34.802075,38.996815,57284,0,3163,54121
9/28/22,Syria,34.802075,38.996815,57288,0,3163,54125
9/29/22,Syria,34.802075,38.996815,57299,0,3163,54136
9/30/22,Syria,34.802075,38.996815,57302,0,3163,54139
10/1/22,Syria,34.802075,38.996815,57307,0,3163,54144
10/2/22,Syria,34.802075,38.996815,57309,0,3163,54146
10/3/22,Syria,34.802075,38.996815,57313,0,3163,54150
10/4/22,Syria,34.802075,38.996815,57314,0,3163,54151
10/5/22,Syria,34.802075,38.996815,57319,0,3163,54156
10/6/22,Syria,34.802075,38.996815,57320,0,3163,54157
10/7/22,Syria,34.802075,38.996815,57321,0,3163,54158
10/8/22,Syria,34.802075,38.996815,57321,0,3163,54158
10/9/22,Syria,34.802075,38.996815,57321,0,3163,54158
10/10/22,Syria,34.802075,38.996815,57325,0,3163,54162
10/11/22,Syria,34.802075,38.996815,57326,0,3163,54163
10/12/22,Syria,34.802075,38.996815,57329,0,3163,54166
10/13/22,Syria,34.802075,38.996815,57331,0,3163,54168
10/14/22,Syria,34.802075,38.996815,57332,0,3163,54169
10/15/22,Syria,34.802075,38.996815,57332,0,3163,54169
10/16/22,Syria,34.802075,38.996815,57334,0,3163,54171
10/17/22,Syria,34.802075,38.996815,57337,0,3163,54174
10/18/22,Syria,34.802075,38.996815,57338,0,3163,54175
10/19/22,Syria,34.802075,38.996815,57340,0,3163,54177
10/20/22,Syria,34.802075,38.996815,57344,0,3163,54181
10/21/22,Syria,34.802075,38.996815,57344,0,3163,54181
10/22/22,Syria,34.802075,38.996815,57344,0,3163,54181
10/23/22,Syria,34.802075,38.996815,57344,0,3163,54181
10/24/22,Syria,34.802075,38.996815,57348,0,3163,54185
10/25/22,Syria,34.802075,38.996815,57353,0,3163,54190
10/26/22,Syria,34.802075,38.996815,57354,0,3163,54191
10/27/22,Syria,34.802075,38.996815,57356,0,3163,54193
10/28/22,Syria,34.802075,38.996815,57357,0,3163,54194
10/29/22,Syria,34.802075,38.996815,57357,0,3163,54194
10/30/22,Syria,34.802075,38.996815,57357,0,3163,54194
10/31/22,Syria,34.802075,38.996815,57360,0,3163,54197
11/1/22,Syria,34.802075,38.996815,57362,0,3163,54199
11/2/22,Syria,34.802075,38.996815,57364,0,3163,54201
11/3/22,Syria,34.802075,38.996815,57365,0,3163,54202
11/4/22,Syria,34.802075,38.996815,57367,0,3163,54204
11/5/22,Syria,34.802075,38.996815,57367,0,3163,54204
11/6/22,Syria,34.802075,38.996815,57367,0,3163,54204
11/7/22,Syria,34.802075,38.996815,57371,0,3163,54208
11/8/22,Syria,34.802075,38.996815,57372,0,3163,54209
11/9/22,Syria,34.802075,38.996815,57374,0,3163,54211
11/10/22,Syria,34.802075,38.996815,57377,0,3163,54214
11/11/22,Syria,34.802075,38.996815,57378,0,3163,54215
11/12/22,Syria,34.802075,38.996815,57378,0,3163,54215
11/13/22,Syria,34.802075,38.996815,57378,0,3163,54215
11/14/22,Syria,34.802075,38.996815,57382,0,3163,54219
11/15/22,Syria,34.802075,38.996815,57383,0,3163,54220
11/16/22,Syria,34.802075,38.996815,57384,0,3163,54221
11/17/22,Syria,34.802075,38.996815,57385,0,3163,54222
11/18/22,Syria,34.802075,38.996815,57386,0,3163,54223
11/19/22,Syria,34.802075,38.996815,57386,0,3163,54223
11/20/22,Syria,34.802075,38.996815,57386,0,3163,54223
11/21/22,Syria,34.802075,38.996815,57389,0,3163,54226
11/22/22,Syria,34.802075,38.996815,57390,0,3163,54227
11/23/22,Syria,34.802075,38.996815,57391,0,3163,54228
11/24/22,Syria,34.802075,38.996815,57392,0,3163,54229
11/25/22,Syria,34.802075,38.996815,57393,0,3163,54230
11/26/22,Syria,34.802075,38.996815,57393,0,3163,54230
11/27/22,Syria,34.802075,38.996815,57393,0,3163,54230
11/28/22,Syria,34.802075,38.996815,57396,0,3163,54233
11/29/22,Syria,34.802075,38.996815,57397,0,3163,54234
11/30/22,Syria,34.802075,38.996815,57399,0,3163,54236
12/1/22,Syria,34.802075,38.996815,57400,0,3163,54237
12/2/22,Syria,34.802075,38.996815,57404,0,3163,54241
12/3/22,Syria,34.802075,38.996815,57404,0,3163,54241
12/4/22,Syria,34.802075,38.996815,57404,0,3163,54241
12/5/22,Syria,34.802075,38.996815,57407,0,3163,54244
12/6/22,Syria,34.802075,38.996815,57409,0,3163,54246
12/7/22,Syria,34.802075,38.996815,57410,0,3163,54247
12/8/22,Syria,34.802075,38.996815,57411,0,3163,54248
12/9/22,Syria,34.802075,38.996815,57412,0,3163,54249
12/10/22,Syria,34.802075,38.996815,57413,0,3163,54250
12/11/22,Syria,34.802075,38.996815,57414,0,3163,54251
12/12/22,Syria,34.802075,38.996815,57420,0,3163,54257
12/13/22,Syria,34.802075,38.996815,57421,0,3163,54258
12/14/22,Syria,34.802075,38.996815,57422,0,3163,54259
12/15/22,Syria,34.802075,38.996815,57423,0,3163,54260
12/16/22,Syria,34.802075,38.996815,57423,0,3163,54260
12/17/22,Syria,34.802075,38.996815,57423,0,3163,54260
1/1/22,Taiwan,23.7,121.0,17050,0,850,16200
1/2/22,Taiwan,23.7,121.0,17070,0,850,16220
1/3/22,Taiwan,23.7,121.0,17095,0,850,16245
1/4/22,Taiwan,23.7,121.0,17129,0,850,16279
1/5/22,Taiwan,23.7,121.0,17155,0,850,16305
1/6/22,Taiwan,23.7,121.0,17198,0,850,16348
1/7/22,Taiwan,23.7,121.0,17258,0,850,16408
1/8/22,Taiwan,23.7,121.0,17302,0,850,16452
1/9/22,Taiwan,23.7,121.0,17362,0,850,16512
1/10/22,Taiwan,23.7,121.0,17394,0,850,16544
1/11/22,Taiwan,23.7,121.0,17463,0,850,16613
1/12/22,Taiwan,23.7,121.0,17559,0,850,16709
1/13/22,Taiwan,23.7,121.0,17624,0,851,16773
1/14/22,Taiwan,23.7,121.0,17692,0,851,16841
1/15/22,Taiwan,23.7,121.0,17769,0,851,16918
1/16/22,Taiwan,23.7,121.0,17820,0,851,16969
1/17/22,Taiwan,23.7,121.0,17885,0,851,17034
1/18/22,Taiwan,23.7,121.0,17951,0,851,17100
1/19/22,Taiwan,23.7,121.0,18005,0,851,17154
1/20/22,Taiwan,23.7,121.0,18041,0,851,17190
1/21/22,Taiwan,23.7,121.0,18109,0,851,17258
1/22/22,Taiwan,23.7,121.0,18238,0,851,17387
1/23/22,Taiwan,23.7,121.0,18325,0,851,17474
1/24/22,Taiwan,23.7,121.0,18376,0,851,17525
1/25/22,Taiwan,23.7,121.0,18411,0,851,17560
1/26/22,Taiwan,23.7,121.0,18503,0,851,17652
1/27/22,Taiwan,23.7,121.0,18566,0,851,17715
1/28/22,Taiwan,23.7,121.0,18634,0,851,17783
1/29/22,Taiwan,23.7,121.0,18681,0,851,17830
1/30/22,Taiwan,23.7,121.0,18735,0,851,17884
1/31/22,Taiwan,23.7,121.0,18790,0,851,17939
2/1/22,Taiwan,23.7,121.0,18850,0,851,17999
2/2/22,Taiwan,23.7,121.0,18903,0,851,18052
2/3/22,Taiwan,23.7,121.0,18958,0,851,18107
2/4/22,Taiwan,23.7,121.0,19029,0,851,18178
2/5/22,Taiwan,23.7,121.0,19101,0,851,18250
2/6/22,Taiwan,23.7,121.0,19144,0,851,18293
2/7/22,Taiwan,23.7,121.0,19192,0,851,18341
2/8/22,Taiwan,23.7,121.0,19239,0,851,18388
2/9/22,Taiwan,23.7,121.0,19293,0,851,18442
2/10/22,Taiwan,23.7,121.0,19376,0,851,18525
2/11/22,Taiwan,23.7,121.0,19455,0,851,18604
2/12/22,Taiwan,23.7,121.0,19515,0,851,18664
2/13/22,Taiwan,23.7,121.0,19567,0,851,18716
2/14/22,Taiwan,23.7,121.0,19621,0,851,18770
2/15/22,Taiwan,23.7,121.0,19666,0,852,18814
2/16/22,Taiwan,23.7,121.0,19732,0,852,18880
2/17/22,Taiwan,23.7,121.0,19797,0,852,18945
2/18/22,Taiwan,23.7,121.0,19864,0,852,19012
2/19/22,Taiwan,23.7,121.0,19937,0,852,19085
2/20/22,Taiwan,23.7,121.0,20007,0,852,19155
2/21/22,Taiwan,23.7,121.0,20056,0,852,19204
2/22/22,Taiwan,23.7,121.0,20100,0,852,19248
2/23/22,Taiwan,23.7,121.0,20156,0,852,19304
2/24/22,Taiwan,23.7,121.0,20236,0,852,19384
2/25/22,Taiwan,23.7,121.0,20304,0,853,19451
2/26/22,Taiwan,23.7,121.0,20373,0,853,19520
2/27/22,Taiwan,23.7,121.0,20433,0,853,19580
2/28/22,Taiwan,23.7,121.0,20489,0,853,19636
3/1/22,Taiwan,23.7,121.0,20533,0,853,19680
3/2/22,Taiwan,23.7,121.0,20582,0,853,19729
3/3/22,Taiwan,23.7,121.0,20653,0,853,19800
3/4/22,Taiwan,23.7,121.0,20717,0,853,19864
3/5/22,Taiwan,23.7,121.0,20797,0,853,19944
3/6/22,Taiwan,23.7,121.0,20840,0,853,19987
3/7/22,Taiwan,23.7,121.0,20869,0,853,20016
3/8/22,Taiwan,23.7,121.0,20922,0,853,20069
3/9/22,Taiwan,23.7,121.0,20999,0,853,20146
3/10/22,Taiwan,23.7,121.0,21081,0,853,20228
3/11/22,Taiwan,23.7,121.0,21163,0,853,20310
3/12/22,Taiwan,23.7,121.0,21225,0,853,20372
3/13/22,Taiwan,23.7,121.0,21288,0,853,20435
3/14/22,Taiwan,23.7,121.0,21363,0,853,20510
3/15/22,Taiwan,23.7,121.0,21402,0,853,20549
3/16/22,Taiwan,23.7,121.0,21492,0,853,20639
3/17/22,Taiwan,23.7,121.0,21583,0,853,20730
3/18/22,Taiwan,23.7,121.0,21658,0,853,20805
3/19/22,Taiwan,23.7,121.0,21784,0,853,20931
3/20/22,Taiwan,23.7,121.0,21905,0,853,21052
3/21/22,Taiwan,23.7,121.0,22003,0,853,21150
3/22/22,Taiwan,23.7,121.0,22091,0,853,21238
3/23/22,Taiwan,23.7,121.0,22188,0,853,21335
3/24/22,Taiwan,23.7,121.0,22327,0,853,21474
3/25/22,Taiwan,23.7,121.0,22463,0,853,21610
3/26/22,Taiwan,23.7,121.0,22566,0,853,21713
3/27/22,Taiwan,23.7,121.0,22769,0,853,21916
3/28/22,Taiwan,23.7,121.0,22896,0,853,22043
3/29/22,Taiwan,23.7,121.0,22992,0,853,22139
3/30/22,Taiwan,23.7,121.0,23155,0,853,22302
3/31/22,Taiwan,23.7,121.0,23394,0,853,22541
4/1/22,Taiwan,23.7,121.0,23629,0,853,22776
4/2/22,Taiwan,23.7,121.0,24033,0,853,23180
4/3/22,Taiwan,23.7,121.0,24313,0,853,23460
4/4/22,Taiwan,23.7,121.0,24588,0,853,23735
4/5/22,Taiwan,23.7,121.0,24866,0,853,24013
4/6/22,Taiwan,23.7,121.0,25225,0,853,24372
4/7/22,Taiwan,23.7,121.0,25756,0,853,24903
4/8/22,Taiwan,23.7,121.0,26263,0,853,25410
4/9/22,Taiwan,23.7,121.0,26836,0,854,25982
4/10/22,Taiwan,23.7,121.0,27410,0,854,26556
4/11/22,Taiwan,23.7,121.0,28040,0,854,27186
4/12/22,Taiwan,23.7,121.0,28666,0,854,27812
4/13/22,Taiwan,23.7,121.0,29593,0,854,28739
4/14/22,Taiwan,23.7,121.0,30574,0,854,29720
4/15/22,Taiwan,23.7,121.0,31857,0,854,31003
4/16/22,Taiwan,23.7,121.0,33205,0,854,32351
4/17/22,Taiwan,23.7,121.0,34507,0,854,33653
4/18/22,Taiwan,23.7,121.0,35983,0,854,35129
4/19/22,Taiwan,23.7,121.0,37710,0,854,36856
4/20/22,Taiwan,23.7,121.0,40186,0,856,39330
4/21/22,Taiwan,23.7,121.0,43243,0,856,42387
4/22/22,Taiwan,23.7,121.0,47100,0,856,46244
4/23/22,Taiwan,23.7,121.0,51298,0,856,50442
4/24/22,Taiwan,23.7,121.0,56468,0,856,55612
4/25/22,Taiwan,23.7,121.0,61686,0,856,60830
4/26/22,Taiwan,23.7,121.0,68022,0,856,67166
4/27/22,Taiwan,23.7,121.0,76938,0,858,76080
4/28/22,Taiwan,23.7,121.0,88446,0,860,87586
4/29/22,Taiwan,23.7,121.0,100753,0,862,99891
4/30/22,Taiwan,23.7,121.0,115883,0,865,115018
5/1/22,Taiwan,23.7,121.0,132955,0,868,132087
5/2/22,Taiwan,23.7,121.0,132955,0,868,132087
5/3/22,Taiwan,23.7,121.0,173942,0,876,173066
5/4/22,Taiwan,23.7,121.0,202418,0,881,201537
5/5/22,Taiwan,23.7,121.0,232402,0,886,231516
5/6/22,Taiwan,23.7,121.0,268569,0,896,267673
5/7/22,Taiwan,23.7,121.0,268569,0,896,267673
5/8/22,Taiwan,23.7,121.0,268569,0,896,267673
5/9/22,Taiwan,23.7,121.0,397504,0,931,396573
5/10/22,Taiwan,23.7,121.0,448323,0,943,447380
5/11/22,Taiwan,23.7,121.0,505455,0,951,504504
5/12/22,Taiwan,23.7,121.0,570870,0,968,569902
5/13/22,Taiwan,23.7,121.0,570870,0,968,569902
5/14/22,Taiwan,23.7,121.0,699824,0,1049,698775
5/15/22,Taiwan,23.7,121.0,768543,0,1068,767475
5/16/22,Taiwan,23.7,121.0,830257,0,1097,829160
5/17/22,Taiwan,23.7,121.0,896059,0,1135,894924
5/18/22,Taiwan,23.7,121.0,981141,0,1176,979965
5/19/22,Taiwan,23.7,121.0,1070561,0,1235,1069326
5/20/22,Taiwan,23.7,121.0,1156291,0,1284,1155007
5/21/22,Taiwan,23.7,121.0,1240897,0,1343,1239554
5/22/22,Taiwan,23.7,121.0,1320371,0,1396,1318975
5/23/22,Taiwan,23.7,121.0,1386640,0,1436,1385204
5/24/22,Taiwan,23.7,121.0,1469019,0,1478,1467541
5/25/22,Taiwan,23.7,121.0,1558380,0,1554,1556826
5/26/22,Taiwan,23.7,121.0,1640271,0,1658,1638613
5/27/22,Taiwan,23.7,121.0,1735067,0,1784,1733283
5/28/22,Taiwan,23.7,121.0,1815703,0,1947,1813756
5/29/22,Taiwan,23.7,121.0,1892272,0,2056,1890216
5/30/22,Taiwan,23.7,121.0,1952355,0,2165,1950190
5/31/22,Taiwan,23.7,121.0,2032983,0,2255,2030728
6/1/22,Taiwan,23.7,121.0,2121231,0,2377,2118854
6/2/22,Taiwan,23.7,121.0,2198161,0,2521,2195640
6/3/22,Taiwan,23.7,121.0,2274666,0,2663,2272003
6/4/22,Taiwan,23.7,121.0,2342794,0,2663,2340131
6/5/22,Taiwan,23.7,121.0,2404871,0,2939,2401932
6/6/22,Taiwan,23.7,121.0,2457881,0,3090,2454791
6/7/22,Taiwan,23.7,121.0,2540871,0,3214,2537657
6/8/22,Taiwan,23.7,121.0,2620941,0,3373,2617568
6/9/22,Taiwan,23.7,121.0,2693787,0,3584,2690203
6/10/22,Taiwan,23.7,121.0,2762080,0,3797,2758283
6/11/22,Taiwan,23.7,121.0,2841696,0,4008,2837688
6/12/22,Taiwan,23.7,121.0,2892263,0,4171,2888092
6/13/22,Taiwan,23.7,121.0,2937363,0,4280,2933083
6/14/22,Taiwan,23.7,121.0,3003501,0,4403,2999098
6/15/22,Taiwan,23.7,121.0,3072432,0,4546,3067886
6/16/22,Taiwan,23.7,121.0,3135565,0,4714,3130851
6/17/22,Taiwan,23.7,121.0,3190787,0,4868,3185919
6/18/22,Taiwan,23.7,121.0,3244453,0,5049,3239404
6/19/22,Taiwan,23.7,121.0,3295076,0,5221,3289855
6/20/22,Taiwan,23.7,121.0,3330695,0,5365,3325330
6/21/22,Taiwan,23.7,121.0,3387061,0,5480,3381581
6/22/22,Taiwan,23.7,121.0,3439279,0,5651,3433628
6/23/22,Taiwan,23.7,121.0,3487599,0,5817,3481782
6/24/22,Taiwan,23.7,121.0,3533335,0,5969,3527366
6/25/22,Taiwan,23.7,121.0,3573703,0,6120,3567583
6/26/22,Taiwan,23.7,121.0,3613345,0,6254,3607091
6/27/22,Taiwan,23.7,121.0,3641921,0,6345,3635576
6/28/22,Taiwan,23.7,121.0,3686338,0,6448,3679890
6/29/22,Taiwan,23.7,121.0,3728363,0,6533,3721830
6/30/22,Taiwan,23.7,121.0,3767283,0,6651,3760632
7/1/22,Taiwan,23.7,121.0,3803049,0,6772,3796277
7/2/22,Taiwan,23.7,121.0,3837856,0,6868,3830988
7/3/22,Taiwan,23.7,121.0,3870528,0,6956,3863572
7/4/22,Taiwan,23.7,121.0,3893643,0,7025,3886618
7/5/22,Taiwan,23.7,121.0,3929627,0,7128,3922499
7/6/22,Taiwan,23.7,121.0,3964188,0,7223,3956965
7/7/22,Taiwan,23.7,121.0,3995621,0,7328,3988293
7/8/22,Taiwan,23.7,121.0,4026067,0,7459,4018608
7/9/22,Taiwan,23.7,121.0,4054189,0,7553,4046636
7/10/22,Taiwan,23.7,121.0,4082028,0,7624,4074404
7/11/22,Taiwan,23.7,121.0,4101156,0,7720,4093436
7/12/22,Taiwan,23.7,121.0,4132429,0,7780,4124649
7/13/22,Taiwan,23.7,121.0,4162290,0,7829,4154461
7/14/22,Taiwan,23.7,121.0,4189929,0,7917,4182012
7/15/22,Taiwan,23.7,121.0,4215200,0,8031,4207169
7/16/22,Taiwan,23.7,121.0,4240466,0,8103,4232363
7/17/22,Taiwan,23.7,121.0,4264788,0,8176,4256612
7/18/22,Taiwan,23.7,121.0,4282777,0,8224,4274553
7/19/22,Taiwan,23.7,121.0,4309904,0,8261,4301643
7/20/22,Taiwan,23.7,121.0,4337076,0,8318,4328758
7/21/22,Taiwan,23.7,121.0,4362227,0,8392,4353835
7/22/22,Taiwan,23.7,121.0,4386289,0,8478,4377811
7/23/22,Taiwan,23.7,121.0,4408857,0,8531,4400326
7/24/22,Taiwan,23.7,121.0,4430583,0,8596,4421987
7/25/22,Taiwan,23.7,121.0,4447707,0,8649,4439058
7/26/22,Taiwan,23.7,121.0,4472755,0,8686,4464069
7/27/22,Taiwan,23.7,121.0,4498416,0,8714,4489702
7/28/22,Taiwan,23.7,121.0,4522365,0,8776,4513589
7/29/22,Taiwan,23.7,121.0,4545636,0,8833,4536803
7/30/22,Taiwan,23.7,121.0,4567122,0,8893,4558229
7/31/22,Taiwan,23.7,121.0,4588185,0,8927,4579258
8/1/22,Taiwan,23.7,121.0,4604761,0,8963,4595798
8/2/22,Taiwan,23.7,121.0,4628294,0,8994,4619300
8/3/22,Taiwan,23.7,121.0,4652186,0,9026,4643160
8/4/22,Taiwan,23.7,121.0,4675128,0,9082,4666046
8/5/22,Taiwan,23.7,121.0,4696969,0,9136,4687833
8/6/22,Taiwan,23.7,121.0,4716819,0,9187,4707632
8/7/22,Taiwan,23.7,121.0,4738861,0,9229,4729632
8/8/22,Taiwan,23.7,121.0,4754268,0,9255,4745013
8/9/22,Taiwan,23.7,121.0,4777903,0,9273,4768630
8/10/22,Taiwan,23.7,121.0,4801676,0,9298,4792378
8/11/22,Taiwan,23.7,121.0,4824550,0,9342,4815208
8/12/22,Taiwan,23.7,121.0,4846501,0,9373,4837128
8/13/22,Taiwan,23.7,121.0,4867766,0,9413,4858353
8/14/22,Taiwan,23.7,121.0,4888840,0,9435,4879405
8/15/22,Taiwan,23.7,121.0,4904622,0,9457,4895165
8/16/22,Taiwan,23.7,121.0,4927754,0,9473,4918281
8/17/22,Taiwan,23.7,121.0,4952570,0,9506,4943064
8/18/22,Taiwan,23.7,121.0,4975970,0,9540,4966430
8/19/22,Taiwan,23.7,121.0,4998765,0,9572,4989193
8/20/22,Taiwan,23.7,121.0,5020895,0,9608,5011287
8/21/22,Taiwan,23.7,121.0,5043275,0,9634,5033641
8/22/22,Taiwan,23.7,121.0,5060178,0,9657,5050521
8/23/22,Taiwan,23.7,121.0,5086521,0,9673,5076848
8/24/22,Taiwan,23.7,121.0,5115052,0,9691,5105361
8/25/22,Taiwan,23.7,121.0,5142279,0,9728,5132551
8/26/22,Taiwan,23.7,121.0,5168997,0,9773,5159224
8/27/22,Taiwan,23.7,121.0,5194850,0,9813,5185037
8/28/22,Taiwan,23.7,121.0,5221585,0,9844,5211741
8/29/22,Taiwan,23.7,121.0,5242009,0,9866,5232143
8/30/22,Taiwan,23.7,121.0,5273449,0,9893,5263556
8/31/22,Taiwan,23.7,121.0,5308029,0,9914,5298115
9/1/22,Taiwan,23.7,121.0,5342106,0,9950,5332156
9/2/22,Taiwan,23.7,121.0,5375883,0,9986,5365897
9/3/22,Taiwan,23.7,121.0,5408641,0,10028,5398613
9/4/22,Taiwan,23.7,121.0,5442981,0,10063,5432918
9/5/22,Taiwan,23.7,121.0,5467059,0,10094,5456965
9/6/22,Taiwan,23.7,121.0,5503725,0,10115,5493610
9/7/22,Taiwan,23.7,121.0,5544974,0,10141,5534833
9/8/22,Taiwan,23.7,121.0,5580027,0,10170,5569857
9/9/22,Taiwan,23.7,121.0,5614227,0,10225,5604002
9/10/22,Taiwan,23.7,121.0,5650028,0,10255,5639773
9/11/22,Taiwan,23.7,121.0,5682133,0,10284,5671849
9/12/22,Taiwan,23.7,121.0,5707688,0,10312,5697376
9/13/22,Taiwan,23.7,121.0,5754683,0,10329,5744354
9/14/22,Taiwan,23.7,121.0,5804343,0,10366,5793977
9/15/22,Taiwan,23.7,121.0,5849748,0,10423,5839325
9/16/22,Taiwan,23.7,121.0,5891355,0,10469,5880886
9/17/22,Taiwan,23.7,121.0,5930927,0,10509,5920418
9/18/22,Taiwan,23.7,121.0,5970438,0,10548,5959890
9/19/22,Taiwan,23.7,121.0,5998860,0,10579,5988281
9/20/22,Taiwan,23.7,121.0,6043539,0,10604,6032935
9/21/22,Taiwan,23.7,121.0,6090373,0,10643,6079730
9/22/22,Taiwan,23.7,121.0,6132794,0,10702,6122092
9/23/22,Taiwan,23.7,121.0,6172769,0,10743,6162026
9/24/22,Taiwan,23.7,121.0,6211093,0,10794,6200299
9/25/22,Taiwan,23.7,121.0,6250051,0,10828,6239223
9/26/22,Taiwan,23.7,121.0,6278794,0,10884,6267910
9/27/22,Taiwan,23.7,121.0,6324578,0,10912,6313666
9/28/22,Taiwan,23.7,121.0,6373121,0,10950,6362171
9/29/22,Taiwan,23.7,121.0,6417941,0,11003,6406938
9/30/22,Taiwan,23.7,121.0,6461400,0,11053,6450347
10/1/22,Taiwan,23.7,121.0,6504422,0,11101,6493321
10/2/22,Taiwan,23.7,121.0,6547708,0,11163,6536545
10/3/22,Taiwan,23.7,121.0,6581117,0,11201,6569916
10/4/22,Taiwan,23.7,121.0,6630642,0,11232,6619410
10/5/22,Taiwan,23.7,121.0,6685516,0,11280,6674236
10/6/22,Taiwan,23.7,121.0,6731939,0,11337,6720602
10/7/22,Taiwan,23.7,121.0,6782664,0,11389,6771275
10/8/22,Taiwan,23.7,121.0,6826989,0,11465,6815524
10/9/22,Taiwan,23.7,121.0,6871538,0,11527,6860011
10/10/22,Taiwan,23.7,121.0,6903610,0,11584,6892026
10/11/22,Taiwan,23.7,121.0,6945018,0,11620,6933398
10/12/22,Taiwan,23.7,121.0,6997376,0,11657,6985719
10/13/22,Taiwan,23.7,121.0,7050750,0,11686,7039064
10/14/22,Taiwan,23.7,121.0,7098970,0,11766,7087204
10/15/22,Taiwan,23.7,121.0,7142418,0,11843,7130575
10/16/22,Taiwan,23.7,121.0,7183912,0,11908,7172004
10/17/22,Taiwan,23.7,121.0,7212738,0,11961,7200777
10/18/22,Taiwan,23.7,121.0,7257592,0,11994,7245598
10/19/22,Taiwan,23.7,121.0,7302188,0,12036,7290152
10/20/22,Taiwan,23.7,121.0,7341966,0,12128,7329838
10/21/22,Taiwan,23.7,121.0,7379205,0,12206,7366999
10/22/22,Taiwan,23.7,121.0,7414829,0,12258,7402571
10/23/22,Taiwan,23.7,121.0,7450158,0,12323,7437835
10/24/22,Taiwan,23.7,121.0,7476478,0,12385,7464093
10/25/22,Taiwan,23.7,121.0,7515630,0,12427,7503203
10/26/22,Taiwan,23.7,121.0,7555884,0,12479,7543405
10/27/22,Taiwan,23.7,121.0,7591541,0,12563,7578978
10/28/22,Taiwan,23.7,121.0,7626103,0,12620,7613483
10/29/22,Taiwan,23.7,121.0,7658580,0,12696,7645884
10/30/22,Taiwan,23.7,121.0,7690110,0,12772,7677338
10/31/22,Taiwan,23.7,121.0,7712726,0,12831,7699895
11/1/22,Taiwan,23.7,121.0,7746969,0,12876,7734093
11/2/22,Taiwan,23.7,121.0,7780125,0,12929,7767196
11/3/22,Taiwan,23.7,121.0,7810077,0,13010,7797067
11/4/22,Taiwan,23.7,121.0,7837658,0,13084,7824574
11/5/22,Taiwan,23.7,121.0,7863193,0,13151,7850042
11/6/22,Taiwan,23.7,121.0,7887538,0,13198,7874340
11/7/22,Taiwan,23.7,121.0,7904094,0,13232,7890862
11/8/22,Taiwan,23.7,121.0,7929052,0,13247,7915805
11/9/22,Taiwan,23.7,121.0,7953885,0,13313,7940572
11/10/22,Taiwan,23.7,121.0,7976205,0,13379,7962826
11/11/22,Taiwan,23.7,121.0,7996490,0,13441,7983049
11/12/22,Taiwan,23.7,121.0,8015698,0,13501,8002197
11/13/22,Taiwan,23.7,121.0,8034295,0,13562,8020733
11/14/22,Taiwan,23.7,121.0,8050901,0,13602,8037299
11/15/22,Taiwan,23.7,121.0,8069442,0,13645,8055797
11/16/22,Taiwan,23.7,121.0,8092118,0,13714,8078404
11/17/22,Taiwan,23.7,121.0,8112234,0,13791,8098443
11/18/22,Taiwan,23.7,121.0,8130231,0,13848,8116383
11/19/22,Taiwan,23.7,121.0,8146790,0,13907,8132883
11/20/22,Taiwan,23.7,121.0,8163008,0,13950,8149058
11/21/22,Taiwan,23.7,121.0,8174903,0,13991,8160912
11/22/22,Taiwan,23.7,121.0,8193072,0,14029,8179043
11/23/22,Taiwan,23.7,121.0,8210955,0,14060,8196895
11/24/22,Taiwan,23.7,121.0,8226995,0,14125,8212870
11/25/22,Taiwan,23.7,121.0,8241178,0,14181,8226997
11/26/22,Taiwan,23.7,121.0,8254423,0,14210,8240213
11/27/22,Taiwan,23.7,121.0,8267720,0,14235,8253485
11/28/22,Taiwan,23.7,121.0,8278371,0,14276,8264095
11/29/22,Taiwan,23.7,121.0,8295652,0,14297,8281355
11/30/22,Taiwan,23.7,121.0,8313366,0,14334,8299032
12/1/22,Taiwan,23.7,121.0,8329008,0,14387,8314621
12/2/22,Taiwan,23.7,121.0,8343081,0,14416,8328665
12/3/22,Taiwan,23.7,121.0,8356217,0,14449,8341768
12/4/22,Taiwan,23.7,121.0,8369226,0,14478,8354748
12/5/22,Taiwan,23.7,121.0,8379467,0,14500,8364967
12/6/22,Taiwan,23.7,121.0,8395477,0,14522,8380955
12/7/22,Taiwan,23.7,121.0,8412200,0,14548,8397652
12/8/22,Taiwan,23.7,121.0,8427473,0,14585,8412888
12/9/22,Taiwan,23.7,121.0,8441828,0,14617,8427211
12/10/22,Taiwan,23.7,121.0,8456104,0,14641,8441463
12/11/22,Taiwan,23.7,121.0,8470187,0,14679,8455508
12/12/22,Taiwan,23.7,121.0,8481040,0,14710,8466330
12/13/22,Taiwan,23.7,121.0,8498195,0,14722,8483473
12/14/22,Taiwan,23.7,121.0,8498195,0,14722,8483473
12/15/22,Taiwan,23.7,121.0,8498195,0,14722,8483473
12/16/22,Taiwan,23.7,121.0,8498195,0,14722,8483473
12/17/22,Taiwan,23.7,121.0,8498195,0,14722,8483473
1/1/22,Tajikistan,38.861,71.2761,17493,0,125,17368
1/2/22,Tajikistan,38.861,71.2761,17493,0,125,17368
1/3/22,Tajikistan,38.861,71.2761,17493,0,125,17368
1/4/22,Tajikistan,38.861,71.2761,17493,0,125,17368
1/5/22,Tajikistan,38.861,71.2761,17493,0,125,17368
1/6/22,Tajikistan,38.861,71.2761,17493,0,125,17368
1/7/22,Tajikistan,38.861,71.2761,17493,0,125,17368
1/8/22,Tajikistan,38.861,71.2761,17493,0,125,17368
1/9/22,Tajikistan,38.861,71.2761,17493,0,125,17368
1/10/22,Tajikistan,38.861,71.2761,17493,0,125,17368
1/11/22,Tajikistan,38.861,71.2761,17493,0,125,17368
1/12/22,Tajikistan,38.861,71.2761,17493,0,125,17368
1/13/22,Tajikistan,38.861,71.2761,17493,0,125,17368
1/14/22,Tajikistan,38.861,71.2761,17493,0,125,17368
1/15/22,Tajikistan,38.861,71.2761,17493,0,125,17368
1/16/22,Tajikistan,38.861,71.2761,17493,0,125,17368
1/17/22,Tajikistan,38.861,71.2761,17493,0,125,17368
1/18/22,Tajikistan,38.861,71.2761,17493,0,125,17368
1/19/22,Tajikistan,38.861,71.2761,17493,0,125,17368
1/20/22,Tajikistan,38.861,71.2761,17493,0,125,17368
1/21/22,Tajikistan,38.861,71.2761,17493,0,125,17368
1/22/22,Tajikistan,38.861,71.2761,17493,0,125,17368
1/23/22,Tajikistan,38.861,71.2761,17493,0,125,17368
1/24/22,Tajikistan,38.861,71.2761,17578,0,125,17453
1/25/22,Tajikistan,38.861,71.2761,17609,0,125,17484
1/26/22,Tajikistan,38.861,71.2761,17627,0,125,17502
1/27/22,Tajikistan,38.861,71.2761,17639,0,125,17514
1/28/22,Tajikistan,38.861,71.2761,17663,0,125,17538
1/29/22,Tajikistan,38.861,71.2761,17663,0,125,17538
1/30/22,Tajikistan,38.861,71.2761,17663,0,125,17538
1/31/22,Tajikistan,38.861,71.2761,17706,0,125,17581
2/1/22,Tajikistan,38.861,71.2761,17716,0,125,17591
2/2/22,Tajikistan,38.861,71.2761,17724,0,125,17599
2/3/22,Tajikistan,38.861,71.2761,17729,0,125,17604
2/4/22,Tajikistan,38.861,71.2761,17733,0,125,17608
2/5/22,Tajikistan,38.861,71.2761,17733,0,125,17608
2/6/22,Tajikistan,38.861,71.2761,17733,0,125,17608
2/7/22,Tajikistan,38.861,71.2761,17745,0,125,17620
2/8/22,Tajikistan,38.861,71.2761,17749,0,125,17624
2/9/22,Tajikistan,38.861,71.2761,17753,0,125,17628
2/10/22,Tajikistan,38.861,71.2761,17759,0,125,17634
2/11/22,Tajikistan,38.861,71.2761,17765,0,125,17640
2/12/22,Tajikistan,38.861,71.2761,17765,0,125,17640
2/13/22,Tajikistan,38.861,71.2761,17765,0,125,17640
2/14/22,Tajikistan,38.861,71.2761,17773,0,125,17648
2/15/22,Tajikistan,38.861,71.2761,17780,0,125,17655
2/16/22,Tajikistan,38.861,71.2761,17783,0,125,17658
2/17/22,Tajikistan,38.861,71.2761,17783,0,125,17658
2/18/22,Tajikistan,38.861,71.2761,17783,0,125,17658
2/19/22,Tajikistan,38.861,71.2761,17783,0,125,17658
2/20/22,Tajikistan,38.861,71.2761,17783,0,125,17658
2/21/22,Tajikistan,38.861,71.2761,17786,0,125,17661
2/22/22,Tajikistan,38.861,71.2761,17786,0,125,17661
2/23/22,Tajikistan,38.861,71.2761,17786,0,125,17661
2/24/22,Tajikistan,38.861,71.2761,17786,0,125,17661
2/25/22,Tajikistan,38.861,71.2761,17786,0,125,17661
2/26/22,Tajikistan,38.861,71.2761,17786,0,125,17661
2/27/22,Tajikistan,38.861,71.2761,17786,0,125,17661
2/28/22,Tajikistan,38.861,71.2761,17786,0,125,17661
3/1/22,Tajikistan,38.861,71.2761,17786,0,125,17661
3/2/22,Tajikistan,38.861,71.2761,17786,0,125,17661
3/3/22,Tajikistan,38.861,71.2761,17786,0,125,17661
3/4/22,Tajikistan,38.861,71.2761,17786,0,125,17661
3/5/22,Tajikistan,38.861,71.2761,17786,0,125,17661
3/6/22,Tajikistan,38.861,71.2761,17786,0,125,17661
3/7/22,Tajikistan,38.861,71.2761,17786,0,125,17661
3/8/22,Tajikistan,38.861,71.2761,17786,0,125,17661
3/9/22,Tajikistan,38.861,71.2761,17786,0,125,17661
3/10/22,Tajikistan,38.861,71.2761,17786,0,125,17661
3/11/22,Tajikistan,38.861,71.2761,17786,0,125,17661
3/12/22,Tajikistan,38.861,71.2761,17786,0,125,17661
3/13/22,Tajikistan,38.861,71.2761,17786,0,125,17661
3/14/22,Tajikistan,38.861,71.2761,17786,0,125,17661
3/15/22,Tajikistan,38.861,71.2761,17786,0,125,17661
3/16/22,Tajikistan,38.861,71.2761,17786,0,125,17661
3/17/22,Tajikistan,38.861,71.2761,17786,0,125,17661
3/18/22,Tajikistan,38.861,71.2761,17786,0,125,17661
3/19/22,Tajikistan,38.861,71.2761,17786,0,125,17661
3/20/22,Tajikistan,38.861,71.2761,17786,0,125,17661
3/21/22,Tajikistan,38.861,71.2761,17786,0,125,17661
3/22/22,Tajikistan,38.861,71.2761,17786,0,125,17661
3/23/22,Tajikistan,38.861,71.2761,17786,0,125,17661
3/24/22,Tajikistan,38.861,71.2761,17786,0,125,17661
3/25/22,Tajikistan,38.861,71.2761,17786,0,125,17661
3/26/22,Tajikistan,38.861,71.2761,17786,0,125,17661
3/27/22,Tajikistan,38.861,71.2761,17786,0,125,17661
3/28/22,Tajikistan,38.861,71.2761,17786,0,125,17661
3/29/22,Tajikistan,38.861,71.2761,17786,0,125,17661
3/30/22,Tajikistan,38.861,71.2761,17786,0,125,17661
3/31/22,Tajikistan,38.861,71.2761,17786,0,125,17661
4/1/22,Tajikistan,38.861,71.2761,17786,0,125,17661
4/2/22,Tajikistan,38.861,71.2761,17786,0,125,17661
4/3/22,Tajikistan,38.861,71.2761,17786,0,125,17661
4/4/22,Tajikistan,38.861,71.2761,17786,0,125,17661
4/5/22,Tajikistan,38.861,71.2761,17786,0,125,17661
4/6/22,Tajikistan,38.861,71.2761,17786,0,125,17661
4/7/22,Tajikistan,38.861,71.2761,17786,0,125,17661
4/8/22,Tajikistan,38.861,71.2761,17786,0,125,17661
4/9/22,Tajikistan,38.861,71.2761,17786,0,125,17661
4/10/22,Tajikistan,38.861,71.2761,17786,0,125,17661
4/11/22,Tajikistan,38.861,71.2761,17786,0,125,17661
4/12/22,Tajikistan,38.861,71.2761,17786,0,125,17661
4/13/22,Tajikistan,38.861,71.2761,17786,0,125,17661
4/14/22,Tajikistan,38.861,71.2761,17786,0,125,17661
4/15/22,Tajikistan,38.861,71.2761,17786,0,125,17661
4/16/22,Tajikistan,38.861,71.2761,17786,0,125,17661
4/17/22,Tajikistan,38.861,71.2761,17786,0,125,17661
4/18/22,Tajikistan,38.861,71.2761,17786,0,125,17661
4/19/22,Tajikistan,38.861,71.2761,17786,0,125,17661
4/20/22,Tajikistan,38.861,71.2761,17786,0,125,17661
4/21/22,Tajikistan,38.861,71.2761,17786,0,125,17661
4/22/22,Tajikistan,38.861,71.2761,17786,0,125,17661
4/23/22,Tajikistan,38.861,71.2761,17786,0,125,17661
4/24/22,Tajikistan,38.861,71.2761,17786,0,125,17661
4/25/22,Tajikistan,38.861,71.2761,17786,0,125,17661
4/26/22,Tajikistan,38.861,71.2761,17786,0,125,17661
4/27/22,Tajikistan,38.861,71.2761,17786,0,125,17661
4/28/22,Tajikistan,38.861,71.2761,17786,0,125,17661
4/29/22,Tajikistan,38.861,71.2761,17786,0,125,17661
4/30/22,Tajikistan,38.861,71.2761,17786,0,125,17661
5/1/22,Tajikistan,38.861,71.2761,17786,0,125,17661
5/2/22,Tajikistan,38.861,71.2761,17786,0,125,17661
5/3/22,Tajikistan,38.861,71.2761,17786,0,125,17661
5/4/22,Tajikistan,38.861,71.2761,17786,0,125,17661
5/5/22,Tajikistan,38.861,71.2761,17786,0,125,17661
5/6/22,Tajikistan,38.861,71.2761,17786,0,125,17661
5/7/22,Tajikistan,38.861,71.2761,17786,0,125,17661
5/8/22,Tajikistan,38.861,71.2761,17786,0,125,17661
5/9/22,Tajikistan,38.861,71.2761,17786,0,125,17661
5/10/22,Tajikistan,38.861,71.2761,17786,0,125,17661
5/11/22,Tajikistan,38.861,71.2761,17786,0,125,17661
5/12/22,Tajikistan,38.861,71.2761,17786,0,125,17661
5/13/22,Tajikistan,38.861,71.2761,17786,0,125,17661
5/14/22,Tajikistan,38.861,71.2761,17786,0,125,17661
5/15/22,Tajikistan,38.861,71.2761,17786,0,125,17661
5/16/22,Tajikistan,38.861,71.2761,17786,0,125,17661
5/17/22,Tajikistan,38.861,71.2761,17786,0,125,17661
5/18/22,Tajikistan,38.861,71.2761,17786,0,125,17661
5/19/22,Tajikistan,38.861,71.2761,17786,0,125,17661
5/20/22,Tajikistan,38.861,71.2761,17786,0,125,17661
5/21/22,Tajikistan,38.861,71.2761,17786,0,125,17661
5/22/22,Tajikistan,38.861,71.2761,17786,0,125,17661
5/23/22,Tajikistan,38.861,71.2761,17786,0,125,17661
5/24/22,Tajikistan,38.861,71.2761,17786,0,125,17661
5/25/22,Tajikistan,38.861,71.2761,17786,0,125,17661
5/26/22,Tajikistan,38.861,71.2761,17786,0,125,17661
5/27/22,Tajikistan,38.861,71.2761,17786,0,125,17661
5/28/22,Tajikistan,38.861,71.2761,17786,0,125,17661
5/29/22,Tajikistan,38.861,71.2761,17786,0,125,17661
5/30/22,Tajikistan,38.861,71.2761,17786,0,125,17661
5/31/22,Tajikistan,38.861,71.2761,17786,0,125,17661
6/1/22,Tajikistan,38.861,71.2761,17786,0,125,17661
6/2/22,Tajikistan,38.861,71.2761,17786,0,125,17661
6/3/22,Tajikistan,38.861,71.2761,17786,0,125,17661
6/4/22,Tajikistan,38.861,71.2761,17786,0,125,17661
6/5/22,Tajikistan,38.861,71.2761,17786,0,125,17661
6/6/22,Tajikistan,38.861,71.2761,17786,0,125,17661
6/7/22,Tajikistan,38.861,71.2761,17786,0,125,17661
6/8/22,Tajikistan,38.861,71.2761,17786,0,125,17661
6/9/22,Tajikistan,38.861,71.2761,17786,0,125,17661
6/10/22,Tajikistan,38.861,71.2761,17786,0,125,17661
6/11/22,Tajikistan,38.861,71.2761,17786,0,125,17661
6/12/22,Tajikistan,38.861,71.2761,17786,0,125,17661
6/13/22,Tajikistan,38.861,71.2761,17786,0,125,17661
6/14/22,Tajikistan,38.861,71.2761,17786,0,125,17661
6/15/22,Tajikistan,38.861,71.2761,17786,0,125,17661
6/16/22,Tajikistan,38.861,71.2761,17786,0,125,17661
6/17/22,Tajikistan,38.861,71.2761,17786,0,125,17661
6/18/22,Tajikistan,38.861,71.2761,17786,0,125,17661
6/19/22,Tajikistan,38.861,71.2761,17786,0,125,17661
6/20/22,Tajikistan,38.861,71.2761,17786,0,125,17661
6/21/22,Tajikistan,38.861,71.2761,17786,0,125,17661
6/22/22,Tajikistan,38.861,71.2761,17786,0,125,17661
6/23/22,Tajikistan,38.861,71.2761,17786,0,125,17661
6/24/22,Tajikistan,38.861,71.2761,17786,0,125,17661
6/25/22,Tajikistan,38.861,71.2761,17786,0,125,17661
6/26/22,Tajikistan,38.861,71.2761,17786,0,125,17661
6/27/22,Tajikistan,38.861,71.2761,17786,0,125,17661
6/28/22,Tajikistan,38.861,71.2761,17786,0,125,17661
6/29/22,Tajikistan,38.861,71.2761,17786,0,125,17661
6/30/22,Tajikistan,38.861,71.2761,17786,0,125,17661
7/1/22,Tajikistan,38.861,71.2761,17786,0,125,17661
7/2/22,Tajikistan,38.861,71.2761,17786,0,125,17661
7/3/22,Tajikistan,38.861,71.2761,17786,0,125,17661
7/4/22,Tajikistan,38.861,71.2761,17786,0,125,17661
7/5/22,Tajikistan,38.861,71.2761,17786,0,125,17661
7/6/22,Tajikistan,38.861,71.2761,17786,0,125,17661
7/7/22,Tajikistan,38.861,71.2761,17786,0,125,17661
7/8/22,Tajikistan,38.861,71.2761,17786,0,125,17661
7/9/22,Tajikistan,38.861,71.2761,17786,0,125,17661
7/10/22,Tajikistan,38.861,71.2761,17786,0,125,17661
7/11/22,Tajikistan,38.861,71.2761,17786,0,125,17661
7/12/22,Tajikistan,38.861,71.2761,17786,0,125,17661
7/13/22,Tajikistan,38.861,71.2761,17786,0,125,17661
7/14/22,Tajikistan,38.861,71.2761,17786,0,125,17661
7/15/22,Tajikistan,38.861,71.2761,17786,0,125,17661
7/16/22,Tajikistan,38.861,71.2761,17786,0,125,17661
7/17/22,Tajikistan,38.861,71.2761,17786,0,125,17661
7/18/22,Tajikistan,38.861,71.2761,17786,0,125,17661
7/19/22,Tajikistan,38.861,71.2761,17786,0,125,17661
7/20/22,Tajikistan,38.861,71.2761,17786,0,125,17661
7/21/22,Tajikistan,38.861,71.2761,17786,0,125,17661
7/22/22,Tajikistan,38.861,71.2761,17786,0,125,17661
7/23/22,Tajikistan,38.861,71.2761,17786,0,125,17661
7/24/22,Tajikistan,38.861,71.2761,17786,0,125,17661
7/25/22,Tajikistan,38.861,71.2761,17786,0,125,17661
7/26/22,Tajikistan,38.861,71.2761,17786,0,125,17661
7/27/22,Tajikistan,38.861,71.2761,17786,0,125,17661
7/28/22,Tajikistan,38.861,71.2761,17786,0,125,17661
7/29/22,Tajikistan,38.861,71.2761,17786,0,125,17661
7/30/22,Tajikistan,38.861,71.2761,17786,0,125,17661
7/31/22,Tajikistan,38.861,71.2761,17786,0,125,17661
8/1/22,Tajikistan,38.861,71.2761,17786,0,125,17661
8/2/22,Tajikistan,38.861,71.2761,17786,0,125,17661
8/3/22,Tajikistan,38.861,71.2761,17786,0,125,17661
8/4/22,Tajikistan,38.861,71.2761,17786,0,125,17661
8/5/22,Tajikistan,38.861,71.2761,17786,0,125,17661
8/6/22,Tajikistan,38.861,71.2761,17786,0,125,17661
8/7/22,Tajikistan,38.861,71.2761,17786,0,125,17661
8/8/22,Tajikistan,38.861,71.2761,17786,0,125,17661
8/9/22,Tajikistan,38.861,71.2761,17786,0,125,17661
8/10/22,Tajikistan,38.861,71.2761,17786,0,125,17661
8/11/22,Tajikistan,38.861,71.2761,17786,0,125,17661
8/12/22,Tajikistan,38.861,71.2761,17786,0,125,17661
8/13/22,Tajikistan,38.861,71.2761,17786,0,125,17661
8/14/22,Tajikistan,38.861,71.2761,17786,0,125,17661
8/15/22,Tajikistan,38.861,71.2761,17786,0,125,17661
8/16/22,Tajikistan,38.861,71.2761,17786,0,125,17661
8/17/22,Tajikistan,38.861,71.2761,17786,0,125,17661
8/18/22,Tajikistan,38.861,71.2761,17786,0,125,17661
8/19/22,Tajikistan,38.861,71.2761,17786,0,125,17661
8/20/22,Tajikistan,38.861,71.2761,17786,0,125,17661
8/21/22,Tajikistan,38.861,71.2761,17786,0,125,17661
8/22/22,Tajikistan,38.861,71.2761,17786,0,125,17661
8/23/22,Tajikistan,38.861,71.2761,17786,0,125,17661
8/24/22,Tajikistan,38.861,71.2761,17786,0,125,17661
8/25/22,Tajikistan,38.861,71.2761,17786,0,125,17661
8/26/22,Tajikistan,38.861,71.2761,17786,0,125,17661
8/27/22,Tajikistan,38.861,71.2761,17786,0,125,17661
8/28/22,Tajikistan,38.861,71.2761,17786,0,125,17661
8/29/22,Tajikistan,38.861,71.2761,17786,0,125,17661
8/30/22,Tajikistan,38.861,71.2761,17786,0,125,17661
8/31/22,Tajikistan,38.861,71.2761,17786,0,125,17661
9/1/22,Tajikistan,38.861,71.2761,17786,0,125,17661
9/2/22,Tajikistan,38.861,71.2761,17786,0,125,17661
9/3/22,Tajikistan,38.861,71.2761,17786,0,125,17661
9/4/22,Tajikistan,38.861,71.2761,17786,0,125,17661
9/5/22,Tajikistan,38.861,71.2761,17786,0,125,17661
9/6/22,Tajikistan,38.861,71.2761,17786,0,125,17661
9/7/22,Tajikistan,38.861,71.2761,17786,0,125,17661
9/8/22,Tajikistan,38.861,71.2761,17786,0,125,17661
9/9/22,Tajikistan,38.861,71.2761,17786,0,125,17661
9/10/22,Tajikistan,38.861,71.2761,17786,0,125,17661
9/11/22,Tajikistan,38.861,71.2761,17786,0,125,17661
9/12/22,Tajikistan,38.861,71.2761,17786,0,125,17661
9/13/22,Tajikistan,38.861,71.2761,17786,0,125,17661
9/14/22,Tajikistan,38.861,71.2761,17786,0,125,17661
9/15/22,Tajikistan,38.861,71.2761,17786,0,125,17661
9/16/22,Tajikistan,38.861,71.2761,17786,0,125,17661
9/17/22,Tajikistan,38.861,71.2761,17786,0,125,17661
9/18/22,Tajikistan,38.861,71.2761,17786,0,125,17661
9/19/22,Tajikistan,38.861,71.2761,17786,0,125,17661
9/20/22,Tajikistan,38.861,71.2761,17786,0,125,17661
9/21/22,Tajikistan,38.861,71.2761,17786,0,125,17661
9/22/22,Tajikistan,38.861,71.2761,17786,0,125,17661
9/23/22,Tajikistan,38.861,71.2761,17786,0,125,17661
9/24/22,Tajikistan,38.861,71.2761,17786,0,125,17661
9/25/22,Tajikistan,38.861,71.2761,17786,0,125,17661
9/26/22,Tajikistan,38.861,71.2761,17786,0,125,17661
9/27/22,Tajikistan,38.861,71.2761,17786,0,125,17661
9/28/22,Tajikistan,38.861,71.2761,17786,0,125,17661
9/29/22,Tajikistan,38.861,71.2761,17786,0,125,17661
9/30/22,Tajikistan,38.861,71.2761,17786,0,125,17661
10/1/22,Tajikistan,38.861,71.2761,17786,0,125,17661
10/2/22,Tajikistan,38.861,71.2761,17786,0,125,17661
10/3/22,Tajikistan,38.861,71.2761,17786,0,125,17661
10/4/22,Tajikistan,38.861,71.2761,17786,0,125,17661
10/5/22,Tajikistan,38.861,71.2761,17786,0,125,17661
10/6/22,Tajikistan,38.861,71.2761,17786,0,125,17661
10/7/22,Tajikistan,38.861,71.2761,17786,0,125,17661
10/8/22,Tajikistan,38.861,71.2761,17786,0,125,17661
10/9/22,Tajikistan,38.861,71.2761,17786,0,125,17661
10/10/22,Tajikistan,38.861,71.2761,17786,0,125,17661
10/11/22,Tajikistan,38.861,71.2761,17786,0,125,17661
10/12/22,Tajikistan,38.861,71.2761,17786,0,125,17661
10/13/22,Tajikistan,38.861,71.2761,17786,0,125,17661
10/14/22,Tajikistan,38.861,71.2761,17786,0,125,17661
10/15/22,Tajikistan,38.861,71.2761,17786,0,125,17661
10/16/22,Tajikistan,38.861,71.2761,17786,0,125,17661
10/17/22,Tajikistan,38.861,71.2761,17786,0,125,17661
10/18/22,Tajikistan,38.861,71.2761,17786,0,125,17661
10/19/22,Tajikistan,38.861,71.2761,17786,0,125,17661
10/20/22,Tajikistan,38.861,71.2761,17786,0,125,17661
10/21/22,Tajikistan,38.861,71.2761,17786,0,125,17661
10/22/22,Tajikistan,38.861,71.2761,17786,0,125,17661
10/23/22,Tajikistan,38.861,71.2761,17786,0,125,17661
10/24/22,Tajikistan,38.861,71.2761,17786,0,125,17661
10/25/22,Tajikistan,38.861,71.2761,17786,0,125,17661
10/26/22,Tajikistan,38.861,71.2761,17786,0,125,17661
10/27/22,Tajikistan,38.861,71.2761,17786,0,125,17661
10/28/22,Tajikistan,38.861,71.2761,17786,0,125,17661
10/29/22,Tajikistan,38.861,71.2761,17786,0,125,17661
10/30/22,Tajikistan,38.861,71.2761,17786,0,125,17661
10/31/22,Tajikistan,38.861,71.2761,17786,0,125,17661
11/1/22,Tajikistan,38.861,71.2761,17786,0,125,17661
11/2/22,Tajikistan,38.861,71.2761,17786,0,125,17661
11/3/22,Tajikistan,38.861,71.2761,17786,0,125,17661
11/4/22,Tajikistan,38.861,71.2761,17786,0,125,17661
11/5/22,Tajikistan,38.861,71.2761,17786,0,125,17661
11/6/22,Tajikistan,38.861,71.2761,17786,0,125,17661
11/7/22,Tajikistan,38.861,71.2761,17786,0,125,17661
11/8/22,Tajikistan,38.861,71.2761,17786,0,125,17661
11/9/22,Tajikistan,38.861,71.2761,17786,0,125,17661
11/10/22,Tajikistan,38.861,71.2761,17786,0,125,17661
11/11/22,Tajikistan,38.861,71.2761,17786,0,125,17661
11/12/22,Tajikistan,38.861,71.2761,17786,0,125,17661
11/13/22,Tajikistan,38.861,71.2761,17786,0,125,17661
11/14/22,Tajikistan,38.861,71.2761,17786,0,125,17661
11/15/22,Tajikistan,38.861,71.2761,17786,0,125,17661
11/16/22,Tajikistan,38.861,71.2761,17786,0,125,17661
11/17/22,Tajikistan,38.861,71.2761,17786,0,125,17661
11/18/22,Tajikistan,38.861,71.2761,17786,0,125,17661
11/19/22,Tajikistan,38.861,71.2761,17786,0,125,17661
11/20/22,Tajikistan,38.861,71.2761,17786,0,125,17661
11/21/22,Tajikistan,38.861,71.2761,17786,0,125,17661
11/22/22,Tajikistan,38.861,71.2761,17786,0,125,17661
11/23/22,Tajikistan,38.861,71.2761,17786,0,125,17661
11/24/22,Tajikistan,38.861,71.2761,17786,0,125,17661
11/25/22,Tajikistan,38.861,71.2761,17786,0,125,17661
11/26/22,Tajikistan,38.861,71.2761,17786,0,125,17661
11/27/22,Tajikistan,38.861,71.2761,17786,0,125,17661
11/28/22,Tajikistan,38.861,71.2761,17786,0,125,17661
11/29/22,Tajikistan,38.861,71.2761,17786,0,125,17661
11/30/22,Tajikistan,38.861,71.2761,17786,0,125,17661
12/1/22,Tajikistan,38.861,71.2761,17786,0,125,17661
12/2/22,Tajikistan,38.861,71.2761,17786,0,125,17661
12/3/22,Tajikistan,38.861,71.2761,17786,0,125,17661
12/4/22,Tajikistan,38.861,71.2761,17786,0,125,17661
12/5/22,Tajikistan,38.861,71.2761,17786,0,125,17661
12/6/22,Tajikistan,38.861,71.2761,17786,0,125,17661
12/7/22,Tajikistan,38.861,71.2761,17786,0,125,17661
12/8/22,Tajikistan,38.861,71.2761,17786,0,125,17661
12/9/22,Tajikistan,38.861,71.2761,17786,0,125,17661
12/10/22,Tajikistan,38.861,71.2761,17786,0,125,17661
12/11/22,Tajikistan,38.861,71.2761,17786,0,125,17661
12/12/22,Tajikistan,38.861,71.2761,17786,0,125,17661
12/13/22,Tajikistan,38.861,71.2761,17786,0,125,17661
12/14/22,Tajikistan,38.861,71.2761,17786,0,125,17661
12/15/22,Tajikistan,38.861,71.2761,17786,0,125,17661
12/16/22,Tajikistan,38.861,71.2761,17786,0,125,17661
12/17/22,Tajikistan,38.861,71.2761,17786,0,125,17661
1/1/22,Tanzania,-6.369028,34.888822,29306,0,737,28569
1/2/22,Tanzania,-6.369028,34.888822,29306,0,737,28569
1/3/22,Tanzania,-6.369028,34.888822,29306,0,737,28569
1/4/22,Tanzania,-6.369028,34.888822,29306,0,737,28569
1/5/22,Tanzania,-6.369028,34.888822,30564,0,740,29824
1/6/22,Tanzania,-6.369028,34.888822,30564,0,740,29824
1/7/22,Tanzania,-6.369028,34.888822,30564,0,740,29824
1/8/22,Tanzania,-6.369028,34.888822,30564,0,740,29824
1/9/22,Tanzania,-6.369028,34.888822,30564,0,740,29824
1/10/22,Tanzania,-6.369028,34.888822,30564,0,740,29824
1/11/22,Tanzania,-6.369028,34.888822,30564,0,740,29824
1/12/22,Tanzania,-6.369028,34.888822,30564,0,740,29824
1/13/22,Tanzania,-6.369028,34.888822,30564,0,740,29824
1/14/22,Tanzania,-6.369028,34.888822,30564,0,740,29824
1/15/22,Tanzania,-6.369028,34.888822,30564,0,740,29824
1/16/22,Tanzania,-6.369028,34.888822,30564,0,740,29824
1/17/22,Tanzania,-6.369028,34.888822,31395,0,745,30650
1/18/22,Tanzania,-6.369028,34.888822,31395,0,745,30650
1/19/22,Tanzania,-6.369028,34.888822,32393,0,753,31640
1/20/22,Tanzania,-6.369028,34.888822,32393,0,753,31640
1/21/22,Tanzania,-6.369028,34.888822,32393,0,753,31640
1/22/22,Tanzania,-6.369028,34.888822,32393,0,753,31640
1/23/22,Tanzania,-6.369028,34.888822,32393,0,753,31640
1/24/22,Tanzania,-6.369028,34.888822,32393,0,753,31640
1/25/22,Tanzania,-6.369028,34.888822,32920,0,778,32142
1/26/22,Tanzania,-6.369028,34.888822,32920,0,778,32142
1/27/22,Tanzania,-6.369028,34.888822,32920,0,778,32142
1/28/22,Tanzania,-6.369028,34.888822,32920,0,778,32142
1/29/22,Tanzania,-6.369028,34.888822,32920,0,778,32142
1/30/22,Tanzania,-6.369028,34.888822,32920,0,778,32142
1/31/22,Tanzania,-6.369028,34.888822,33230,0,789,32441
2/1/22,Tanzania,-6.369028,34.888822,33230,0,789,32441
2/2/22,Tanzania,-6.369028,34.888822,33230,0,789,32441
2/3/22,Tanzania,-6.369028,34.888822,33230,0,789,32441
2/4/22,Tanzania,-6.369028,34.888822,33230,0,789,32441
2/5/22,Tanzania,-6.369028,34.888822,33230,0,789,32441
2/6/22,Tanzania,-6.369028,34.888822,33230,0,789,32441
2/7/22,Tanzania,-6.369028,34.888822,33230,0,789,32441
2/8/22,Tanzania,-6.369028,34.888822,33230,0,789,32441
2/9/22,Tanzania,-6.369028,34.888822,33436,0,792,32644
2/10/22,Tanzania,-6.369028,34.888822,33436,0,792,32644
2/11/22,Tanzania,-6.369028,34.888822,33436,0,792,32644
2/12/22,Tanzania,-6.369028,34.888822,33436,0,792,32644
2/13/22,Tanzania,-6.369028,34.888822,33436,0,792,32644
2/14/22,Tanzania,-6.369028,34.888822,33436,0,792,32644
2/15/22,Tanzania,-6.369028,34.888822,33549,0,796,32753
2/16/22,Tanzania,-6.369028,34.888822,33549,0,796,32753
2/17/22,Tanzania,-6.369028,34.888822,33549,0,796,32753
2/18/22,Tanzania,-6.369028,34.888822,33549,0,796,32753
2/19/22,Tanzania,-6.369028,34.888822,33549,0,796,32753
2/20/22,Tanzania,-6.369028,34.888822,33549,0,796,32753
2/21/22,Tanzania,-6.369028,34.888822,33549,0,796,32753
2/22/22,Tanzania,-6.369028,34.888822,33620,0,798,32822
2/23/22,Tanzania,-6.369028,34.888822,33620,0,798,32822
2/24/22,Tanzania,-6.369028,34.888822,33620,0,798,32822
2/25/22,Tanzania,-6.369028,34.888822,33620,0,798,32822
2/26/22,Tanzania,-6.369028,34.888822,33620,0,798,32822
2/27/22,Tanzania,-6.369028,34.888822,33620,0,798,32822
2/28/22,Tanzania,-6.369028,34.888822,33620,0,798,32822
3/1/22,Tanzania,-6.369028,34.888822,33620,0,798,32822
3/2/22,Tanzania,-6.369028,34.888822,33620,0,798,32822
3/3/22,Tanzania,-6.369028,34.888822,33620,0,798,32822
3/4/22,Tanzania,-6.369028,34.888822,33620,0,798,32822
3/5/22,Tanzania,-6.369028,34.888822,33620,0,798,32822
3/6/22,Tanzania,-6.369028,34.888822,33620,0,798,32822
3/7/22,Tanzania,-6.369028,34.888822,33620,0,798,32822
3/8/22,Tanzania,-6.369028,34.888822,33620,0,798,32822
3/9/22,Tanzania,-6.369028,34.888822,33726,0,800,32926
3/10/22,Tanzania,-6.369028,34.888822,33726,0,800,32926
3/11/22,Tanzania,-6.369028,34.888822,33726,0,800,32926
3/12/22,Tanzania,-6.369028,34.888822,33726,0,800,32926
3/13/22,Tanzania,-6.369028,34.888822,33726,0,800,32926
3/14/22,Tanzania,-6.369028,34.888822,33726,0,800,32926
3/15/22,Tanzania,-6.369028,34.888822,33726,0,800,32926
3/16/22,Tanzania,-6.369028,34.888822,33773,0,800,32973
3/17/22,Tanzania,-6.369028,34.888822,33773,0,800,32973
3/18/22,Tanzania,-6.369028,34.888822,33773,0,800,32973
3/19/22,Tanzania,-6.369028,34.888822,33773,0,800,32973
3/20/22,Tanzania,-6.369028,34.888822,33773,0,800,32973
3/21/22,Tanzania,-6.369028,34.888822,33773,0,800,32973
3/22/22,Tanzania,-6.369028,34.888822,33797,0,800,32997
3/23/22,Tanzania,-6.369028,34.888822,33797,0,800,32997
3/24/22,Tanzania,-6.369028,34.888822,33797,0,800,32997
3/25/22,Tanzania,-6.369028,34.888822,33797,0,800,32997
3/26/22,Tanzania,-6.369028,34.888822,33797,0,800,32997
3/27/22,Tanzania,-6.369028,34.888822,33797,0,800,32997
3/28/22,Tanzania,-6.369028,34.888822,33797,0,800,32997
3/29/22,Tanzania,-6.369028,34.888822,33797,0,800,32997
3/30/22,Tanzania,-6.369028,34.888822,33815,0,800,33015
3/31/22,Tanzania,-6.369028,34.888822,33815,0,800,33015
4/1/22,Tanzania,-6.369028,34.888822,33815,0,800,33015
4/2/22,Tanzania,-6.369028,34.888822,33815,0,800,33015
4/3/22,Tanzania,-6.369028,34.888822,33815,0,800,33015
4/4/22,Tanzania,-6.369028,34.888822,33815,0,800,33015
4/5/22,Tanzania,-6.369028,34.888822,33815,0,800,33015
4/6/22,Tanzania,-6.369028,34.888822,33815,0,800,33015
4/7/22,Tanzania,-6.369028,34.888822,33815,0,800,33015
4/8/22,Tanzania,-6.369028,34.888822,33815,0,800,33015
4/9/22,Tanzania,-6.369028,34.888822,33815,0,800,33015
4/10/22,Tanzania,-6.369028,34.888822,33815,0,800,33015
4/11/22,Tanzania,-6.369028,34.888822,33815,0,800,33015
4/12/22,Tanzania,-6.369028,34.888822,33851,0,803,33048
4/13/22,Tanzania,-6.369028,34.888822,33851,0,803,33048
4/14/22,Tanzania,-6.369028,34.888822,33851,0,803,33048
4/15/22,Tanzania,-6.369028,34.888822,33851,0,803,33048
4/16/22,Tanzania,-6.369028,34.888822,33851,0,803,33048
4/17/22,Tanzania,-6.369028,34.888822,33851,0,803,33048
4/18/22,Tanzania,-6.369028,34.888822,33851,0,803,33048
4/19/22,Tanzania,-6.369028,34.888822,33864,0,803,33061
4/20/22,Tanzania,-6.369028,34.888822,33864,0,803,33061
4/21/22,Tanzania,-6.369028,34.888822,33864,0,803,33061
4/22/22,Tanzania,-6.369028,34.888822,33864,0,803,33061
4/23/22,Tanzania,-6.369028,34.888822,33864,0,803,33061
4/24/22,Tanzania,-6.369028,34.888822,33864,0,803,33061
4/25/22,Tanzania,-6.369028,34.888822,33864,0,803,33061
4/26/22,Tanzania,-6.369028,34.888822,33872,0,803,33069
4/27/22,Tanzania,-6.369028,34.888822,33872,0,803,33069
4/28/22,Tanzania,-6.369028,34.888822,33872,0,803,33069
4/29/22,Tanzania,-6.369028,34.888822,33872,0,803,33069
4/30/22,Tanzania,-6.369028,34.888822,33872,0,803,33069
5/1/22,Tanzania,-6.369028,34.888822,33872,0,803,33069
5/2/22,Tanzania,-6.369028,34.888822,33872,0,803,33069
5/3/22,Tanzania,-6.369028,34.888822,33872,0,803,33069
5/4/22,Tanzania,-6.369028,34.888822,33872,0,803,33069
5/5/22,Tanzania,-6.369028,34.888822,33872,0,803,33069
5/6/22,Tanzania,-6.369028,34.888822,33872,0,803,33069
5/7/22,Tanzania,-6.369028,34.888822,33872,0,803,33069
5/8/22,Tanzania,-6.369028,34.888822,33872,0,803,33069
5/9/22,Tanzania,-6.369028,34.888822,33872,0,803,33069
5/10/22,Tanzania,-6.369028,34.888822,35354,0,840,34514
5/11/22,Tanzania,-6.369028,34.888822,35354,0,840,34514
5/12/22,Tanzania,-6.369028,34.888822,35354,0,840,34514
5/13/22,Tanzania,-6.369028,34.888822,35354,0,840,34514
5/14/22,Tanzania,-6.369028,34.888822,35354,0,840,34514
5/15/22,Tanzania,-6.369028,34.888822,35354,0,840,34514
5/16/22,Tanzania,-6.369028,34.888822,35354,0,840,34514
5/17/22,Tanzania,-6.369028,34.888822,35354,0,840,34514
5/18/22,Tanzania,-6.369028,34.888822,35354,0,840,34514
5/19/22,Tanzania,-6.369028,34.888822,35354,0,840,34514
5/20/22,Tanzania,-6.369028,34.888822,35354,0,840,34514
5/21/22,Tanzania,-6.369028,34.888822,35354,0,840,34514
5/22/22,Tanzania,-6.369028,34.888822,35354,0,840,34514
5/23/22,Tanzania,-6.369028,34.888822,35354,0,840,34514
5/24/22,Tanzania,-6.369028,34.888822,35354,0,840,34514
5/25/22,Tanzania,-6.369028,34.888822,35354,0,840,34514
5/26/22,Tanzania,-6.369028,34.888822,35354,0,840,34514
5/27/22,Tanzania,-6.369028,34.888822,35354,0,840,34514
5/28/22,Tanzania,-6.369028,34.888822,35354,0,840,34514
5/29/22,Tanzania,-6.369028,34.888822,35354,0,840,34514
5/30/22,Tanzania,-6.369028,34.888822,35354,0,840,34514
5/31/22,Tanzania,-6.369028,34.888822,35354,0,840,34514
6/1/22,Tanzania,-6.369028,34.888822,35354,0,840,34514
6/2/22,Tanzania,-6.369028,34.888822,35354,0,840,34514
6/3/22,Tanzania,-6.369028,34.888822,35354,0,840,34514
6/4/22,Tanzania,-6.369028,34.888822,35354,0,840,34514
6/5/22,Tanzania,-6.369028,34.888822,35354,0,840,34514
6/6/22,Tanzania,-6.369028,34.888822,35354,0,840,34514
6/7/22,Tanzania,-6.369028,34.888822,35354,0,840,34514
6/8/22,Tanzania,-6.369028,34.888822,35354,0,840,34514
6/9/22,Tanzania,-6.369028,34.888822,35354,0,840,34514
6/10/22,Tanzania,-6.369028,34.888822,35354,0,840,34514
6/11/22,Tanzania,-6.369028,34.888822,35354,0,840,34514
6/12/22,Tanzania,-6.369028,34.888822,35354,0,840,34514
6/13/22,Tanzania,-6.369028,34.888822,35354,0,840,34514
6/14/22,Tanzania,-6.369028,34.888822,35354,0,840,34514
6/15/22,Tanzania,-6.369028,34.888822,35354,0,840,34514
6/16/22,Tanzania,-6.369028,34.888822,35354,0,840,34514
6/17/22,Tanzania,-6.369028,34.888822,35354,0,840,34514
6/18/22,Tanzania,-6.369028,34.888822,35354,0,840,34514
6/19/22,Tanzania,-6.369028,34.888822,35354,0,840,34514
6/20/22,Tanzania,-6.369028,34.888822,35354,0,840,34514
6/21/22,Tanzania,-6.369028,34.888822,35354,0,840,34514
6/22/22,Tanzania,-6.369028,34.888822,35366,0,841,34525
6/23/22,Tanzania,-6.369028,34.888822,35366,0,841,34525
6/24/22,Tanzania,-6.369028,34.888822,35366,0,841,34525
6/25/22,Tanzania,-6.369028,34.888822,35366,0,841,34525
6/26/22,Tanzania,-6.369028,34.888822,35366,0,841,34525
6/27/22,Tanzania,-6.369028,34.888822,35366,0,841,34525
6/28/22,Tanzania,-6.369028,34.888822,35366,0,841,34525
6/29/22,Tanzania,-6.369028,34.888822,35366,0,841,34525
6/30/22,Tanzania,-6.369028,34.888822,35768,0,841,34927
7/1/22,Tanzania,-6.369028,34.888822,35768,0,841,34927
7/2/22,Tanzania,-6.369028,34.888822,35768,0,841,34927
7/3/22,Tanzania,-6.369028,34.888822,35768,0,841,34927
7/4/22,Tanzania,-6.369028,34.888822,35768,0,841,34927
7/5/22,Tanzania,-6.369028,34.888822,35768,0,841,34927
7/6/22,Tanzania,-6.369028,34.888822,35768,0,841,34927
7/7/22,Tanzania,-6.369028,34.888822,35768,0,841,34927
7/8/22,Tanzania,-6.369028,34.888822,35768,0,841,34927
7/9/22,Tanzania,-6.369028,34.888822,35768,0,841,34927
7/10/22,Tanzania,-6.369028,34.888822,35768,0,841,34927
7/11/22,Tanzania,-6.369028,34.888822,36174,0,841,35333
7/12/22,Tanzania,-6.369028,34.888822,36174,0,841,35333
7/13/22,Tanzania,-6.369028,34.888822,36174,0,841,35333
7/14/22,Tanzania,-6.369028,34.888822,37510,0,841,36669
7/15/22,Tanzania,-6.369028,34.888822,37510,0,841,36669
7/16/22,Tanzania,-6.369028,34.888822,37510,0,841,36669
7/17/22,Tanzania,-6.369028,34.888822,37510,0,841,36669
7/18/22,Tanzania,-6.369028,34.888822,37510,0,841,36669
7/19/22,Tanzania,-6.369028,34.888822,37510,0,841,36669
7/20/22,Tanzania,-6.369028,34.888822,37510,0,841,36669
7/21/22,Tanzania,-6.369028,34.888822,37510,0,841,36669
7/22/22,Tanzania,-6.369028,34.888822,37510,0,841,36669
7/23/22,Tanzania,-6.369028,34.888822,37510,0,841,36669
7/24/22,Tanzania,-6.369028,34.888822,37510,0,841,36669
7/25/22,Tanzania,-6.369028,34.888822,37510,0,841,36669
7/26/22,Tanzania,-6.369028,34.888822,37510,0,841,36669
7/27/22,Tanzania,-6.369028,34.888822,37510,0,841,36669
7/28/22,Tanzania,-6.369028,34.888822,37510,0,841,36669
7/29/22,Tanzania,-6.369028,34.888822,37510,0,841,36669
7/30/22,Tanzania,-6.369028,34.888822,37510,0,841,36669
7/31/22,Tanzania,-6.369028,34.888822,37510,0,841,36669
8/1/22,Tanzania,-6.369028,34.888822,37510,0,841,36669
8/2/22,Tanzania,-6.369028,34.888822,37510,0,841,36669
8/3/22,Tanzania,-6.369028,34.888822,37865,0,841,37024
8/4/22,Tanzania,-6.369028,34.888822,37865,0,841,37024
8/5/22,Tanzania,-6.369028,34.888822,37865,0,841,37024
8/6/22,Tanzania,-6.369028,34.888822,37865,0,841,37024
8/7/22,Tanzania,-6.369028,34.888822,37865,0,841,37024
8/8/22,Tanzania,-6.369028,34.888822,37865,0,841,37024
8/9/22,Tanzania,-6.369028,34.888822,37865,0,841,37024
8/10/22,Tanzania,-6.369028,34.888822,38205,0,841,37364
8/11/22,Tanzania,-6.369028,34.888822,38205,0,841,37364
8/12/22,Tanzania,-6.369028,34.888822,38205,0,841,37364
8/13/22,Tanzania,-6.369028,34.888822,38205,0,841,37364
8/14/22,Tanzania,-6.369028,34.888822,38205,0,841,37364
8/15/22,Tanzania,-6.369028,34.888822,38205,0,841,37364
8/16/22,Tanzania,-6.369028,34.888822,38454,0,841,37613
8/17/22,Tanzania,-6.369028,34.888822,38454,0,841,37613
8/18/22,Tanzania,-6.369028,34.888822,38454,0,841,37613
8/19/22,Tanzania,-6.369028,34.888822,38454,0,841,37613
8/20/22,Tanzania,-6.369028,34.888822,38454,0,841,37613
8/21/22,Tanzania,-6.369028,34.888822,38454,0,841,37613
8/22/22,Tanzania,-6.369028,34.888822,38454,0,841,37613
8/23/22,Tanzania,-6.369028,34.888822,38712,0,841,37871
8/24/22,Tanzania,-6.369028,34.888822,38712,0,841,37871
8/25/22,Tanzania,-6.369028,34.888822,38712,0,841,37871
8/26/22,Tanzania,-6.369028,34.888822,38712,0,841,37871
8/27/22,Tanzania,-6.369028,34.888822,38712,0,841,37871
8/28/22,Tanzania,-6.369028,34.888822,38712,0,841,37871
8/29/22,Tanzania,-6.369028,34.888822,38712,0,841,37871
8/30/22,Tanzania,-6.369028,34.888822,38712,0,841,37871
8/31/22,Tanzania,-6.369028,34.888822,38712,0,841,37871
9/1/22,Tanzania,-6.369028,34.888822,38712,0,841,37871
9/2/22,Tanzania,-6.369028,34.888822,38712,0,841,37871
9/3/22,Tanzania,-6.369028,34.888822,38712,0,841,37871
9/4/22,Tanzania,-6.369028,34.888822,38712,0,841,37871
9/5/22,Tanzania,-6.369028,34.888822,38951,0,845,38106
9/6/22,Tanzania,-6.369028,34.888822,38951,0,845,38106
9/7/22,Tanzania,-6.369028,34.888822,39168,0,845,38323
9/8/22,Tanzania,-6.369028,34.888822,39168,0,845,38323
9/9/22,Tanzania,-6.369028,34.888822,39168,0,845,38323
9/10/22,Tanzania,-6.369028,34.888822,39168,0,845,38323
9/11/22,Tanzania,-6.369028,34.888822,39168,0,845,38323
9/12/22,Tanzania,-6.369028,34.888822,39168,0,845,38323
9/13/22,Tanzania,-6.369028,34.888822,39168,0,845,38323
9/14/22,Tanzania,-6.369028,34.888822,39253,0,845,38408
9/15/22,Tanzania,-6.369028,34.888822,39253,0,845,38408
9/16/22,Tanzania,-6.369028,34.888822,39253,0,845,38408
9/17/22,Tanzania,-6.369028,34.888822,39253,0,845,38408
9/18/22,Tanzania,-6.369028,34.888822,39253,0,845,38408
9/19/22,Tanzania,-6.369028,34.888822,39253,0,845,38408
9/20/22,Tanzania,-6.369028,34.888822,39253,0,845,38408
9/21/22,Tanzania,-6.369028,34.888822,39341,0,845,38496
9/22/22,Tanzania,-6.369028,34.888822,39341,0,845,38496
9/23/22,Tanzania,-6.369028,34.888822,39341,0,845,38496
9/24/22,Tanzania,-6.369028,34.888822,39341,0,845,38496
9/25/22,Tanzania,-6.369028,34.888822,39341,0,845,38496
9/26/22,Tanzania,-6.369028,34.888822,39341,0,845,38496
9/27/22,Tanzania,-6.369028,34.888822,39341,0,845,38496
9/28/22,Tanzania,-6.369028,34.888822,39341,0,845,38496
9/29/22,Tanzania,-6.369028,34.888822,39440,0,845,38595
9/30/22,Tanzania,-6.369028,34.888822,39440,0,845,38595
10/1/22,Tanzania,-6.369028,34.888822,39440,0,845,38595
10/2/22,Tanzania,-6.369028,34.888822,39440,0,845,38595
10/3/22,Tanzania,-6.369028,34.888822,39440,0,845,38595
10/4/22,Tanzania,-6.369028,34.888822,39440,0,845,38595
10/5/22,Tanzania,-6.369028,34.888822,39513,0,845,38668
10/6/22,Tanzania,-6.369028,34.888822,39513,0,845,38668
10/7/22,Tanzania,-6.369028,34.888822,39513,0,845,38668
10/8/22,Tanzania,-6.369028,34.888822,39513,0,845,38668
10/9/22,Tanzania,-6.369028,34.888822,39513,0,845,38668
10/10/22,Tanzania,-6.369028,34.888822,39513,0,845,38668
10/11/22,Tanzania,-6.369028,34.888822,39513,0,845,38668
10/12/22,Tanzania,-6.369028,34.888822,39679,0,845,38834
10/13/22,Tanzania,-6.369028,34.888822,39679,0,845,38834
10/14/22,Tanzania,-6.369028,34.888822,39679,0,845,38834
10/15/22,Tanzania,-6.369028,34.888822,39679,0,845,38834
10/16/22,Tanzania,-6.369028,34.888822,39679,0,845,38834
10/17/22,Tanzania,-6.369028,34.888822,39679,0,845,38834
10/18/22,Tanzania,-6.369028,34.888822,39679,0,845,38834
10/19/22,Tanzania,-6.369028,34.888822,39679,0,845,38834
10/20/22,Tanzania,-6.369028,34.888822,39679,0,845,38834
10/21/22,Tanzania,-6.369028,34.888822,39679,0,845,38834
10/22/22,Tanzania,-6.369028,34.888822,39679,0,845,38834
10/23/22,Tanzania,-6.369028,34.888822,39679,0,845,38834
10/24/22,Tanzania,-6.369028,34.888822,39804,0,845,38959
10/25/22,Tanzania,-6.369028,34.888822,39804,0,845,38959
10/26/22,Tanzania,-6.369028,34.888822,39804,0,845,38959
10/27/22,Tanzania,-6.369028,34.888822,39804,0,845,38959
10/28/22,Tanzania,-6.369028,34.888822,39804,0,845,38959
10/29/22,Tanzania,-6.369028,34.888822,39804,0,845,38959
10/30/22,Tanzania,-6.369028,34.888822,39804,0,845,38959
10/31/22,Tanzania,-6.369028,34.888822,39920,0,845,39075
11/1/22,Tanzania,-6.369028,34.888822,40054,0,845,39209
11/2/22,Tanzania,-6.369028,34.888822,40054,0,845,39209
11/3/22,Tanzania,-6.369028,34.888822,40054,0,845,39209
11/4/22,Tanzania,-6.369028,34.888822,40054,0,845,39209
11/5/22,Tanzania,-6.369028,34.888822,40054,0,845,39209
11/6/22,Tanzania,-6.369028,34.888822,40054,0,845,39209
11/7/22,Tanzania,-6.369028,34.888822,40054,0,845,39209
11/8/22,Tanzania,-6.369028,34.888822,40054,0,845,39209
11/9/22,Tanzania,-6.369028,34.888822,40054,0,845,39209
11/10/22,Tanzania,-6.369028,34.888822,40152,0,845,39307
11/11/22,Tanzania,-6.369028,34.888822,40152,0,845,39307
11/12/22,Tanzania,-6.369028,34.888822,40152,0,845,39307
11/13/22,Tanzania,-6.369028,34.888822,40152,0,845,39307
11/14/22,Tanzania,-6.369028,34.888822,40152,0,845,39307
11/15/22,Tanzania,-6.369028,34.888822,40311,0,845,39466
11/16/22,Tanzania,-6.369028,34.888822,40311,0,845,39466
11/17/22,Tanzania,-6.369028,34.888822,40311,0,845,39466
11/18/22,Tanzania,-6.369028,34.888822,40311,0,845,39466
11/19/22,Tanzania,-6.369028,34.888822,40311,0,845,39466
11/20/22,Tanzania,-6.369028,34.888822,40311,0,845,39466
11/21/22,Tanzania,-6.369028,34.888822,40311,0,845,39466
11/22/22,Tanzania,-6.369028,34.888822,40471,0,845,39626
11/23/22,Tanzania,-6.369028,34.888822,40471,0,845,39626
11/24/22,Tanzania,-6.369028,34.888822,40471,0,845,39626
11/25/22,Tanzania,-6.369028,34.888822,40471,0,845,39626
11/26/22,Tanzania,-6.369028,34.888822,40471,0,845,39626
11/27/22,Tanzania,-6.369028,34.888822,40471,0,845,39626
11/28/22,Tanzania,-6.369028,34.888822,40471,0,845,39626
11/29/22,Tanzania,-6.369028,34.888822,40656,0,845,39811
11/30/22,Tanzania,-6.369028,34.888822,40656,0,845,39811
12/1/22,Tanzania,-6.369028,34.888822,40656,0,845,39811
12/2/22,Tanzania,-6.369028,34.888822,40656,0,845,39811
12/3/22,Tanzania,-6.369028,34.888822,40656,0,845,39811
12/4/22,Tanzania,-6.369028,34.888822,40656,0,845,39811
12/5/22,Tanzania,-6.369028,34.888822,40656,0,845,39811
12/6/22,Tanzania,-6.369028,34.888822,40806,0,845,39961
12/7/22,Tanzania,-6.369028,34.888822,40806,0,845,39961
12/8/22,Tanzania,-6.369028,34.888822,40806,0,845,39961
12/9/22,Tanzania,-6.369028,34.888822,40806,0,845,39961
12/10/22,Tanzania,-6.369028,34.888822,40806,0,845,39961
12/11/22,Tanzania,-6.369028,34.888822,40806,0,845,39961
12/12/22,Tanzania,-6.369028,34.888822,40806,0,845,39961
12/13/22,Tanzania,-6.369028,34.888822,40806,0,845,39961
12/14/22,Tanzania,-6.369028,34.888822,40806,0,845,39961
12/15/22,Tanzania,-6.369028,34.888822,40806,0,845,39961
12/16/22,Tanzania,-6.369028,34.888822,42111,0,845,41266
12/17/22,Tanzania,-6.369028,34.888822,42111,0,845,41266
1/1/22,Thailand,15.870032,100.992541,2226446,0,21708,2204738
1/2/22,Thailand,15.870032,100.992541,2229558,0,21720,2207838
1/3/22,Thailand,15.870032,100.992541,2232485,0,21738,2210747
1/4/22,Thailand,15.870032,100.992541,2235576,0,21750,2213826
1/5/22,Thailand,15.870032,100.992541,2239475,0,21769,2217706
1/6/22,Thailand,15.870032,100.992541,2245250,0,21780,2223470
1/7/22,Thailand,15.870032,100.992541,2252776,0,21799,2230977
1/8/22,Thailand,15.870032,100.992541,2261039,0,21813,2239226
1/9/22,Thailand,15.870032,100.992541,2269550,0,21825,2247725
1/10/22,Thailand,15.870032,100.992541,2277476,0,21838,2255638
1/11/22,Thailand,15.870032,100.992541,2284609,0,21850,2262759
1/12/22,Thailand,15.870032,100.992541,2292290,0,21869,2270421
1/13/22,Thailand,15.870032,100.992541,2300457,0,21883,2278574
1/14/22,Thailand,15.870032,100.992541,2308615,0,21898,2286717
1/15/22,Thailand,15.870032,100.992541,2316408,0,21916,2294492
1/16/22,Thailand,15.870032,100.992541,2324485,0,21925,2302560
1/17/22,Thailand,15.870032,100.992541,2331414,0,21938,2309476
1/18/22,Thailand,15.870032,100.992541,2337811,0,21956,2315855
1/19/22,Thailand,15.870032,100.992541,2344933,0,21968,2322965
1/20/22,Thailand,15.870032,100.992541,2353062,0,21987,2331075
1/21/22,Thailand,15.870032,100.992541,2361702,0,22000,2339702
1/22/22,Thailand,15.870032,100.992541,2369814,0,22019,2347795
1/23/22,Thailand,15.870032,100.992541,2377500,0,22032,2355468
1/24/22,Thailand,15.870032,100.992541,2384639,0,22045,2362594
1/25/22,Thailand,15.870032,100.992541,2391357,0,22057,2369300
1/26/22,Thailand,15.870032,100.992541,2398944,0,22076,2376868
1/27/22,Thailand,15.870032,100.992541,2407022,0,22098,2384924
1/28/22,Thailand,15.870032,100.992541,2415472,0,22126,2393346
1/29/22,Thailand,15.870032,100.992541,2424090,0,22145,2401945
1/30/22,Thailand,15.870032,100.992541,2432534,0,22157,2410377
1/31/22,Thailand,15.870032,100.992541,2440542,0,22173,2418369
2/1/22,Thailand,15.870032,100.992541,2447964,0,22185,2425779
2/2/22,Thailand,15.870032,100.992541,2456551,0,22207,2434344
2/3/22,Thailand,15.870032,100.992541,2465723,0,22228,2443495
2/4/22,Thailand,15.870032,100.992541,2475632,0,22250,2453382
2/5/22,Thailand,15.870032,100.992541,2486122,0,22271,2463851
2/6/22,Thailand,15.870032,100.992541,2497001,0,22291,2474710
2/7/22,Thailand,15.870032,100.992541,2507471,0,22303,2485168
2/8/22,Thailand,15.870032,100.992541,2517869,0,22320,2495549
2/9/22,Thailand,15.870032,100.992541,2531051,0,22344,2508707
2/10/22,Thailand,15.870032,100.992541,2545873,0,22364,2523509
2/11/22,Thailand,15.870032,100.992541,2561115,0,22387,2538728
2/12/22,Thailand,15.870032,100.992541,2577445,0,22412,2555033
2/13/22,Thailand,15.870032,100.992541,2593327,0,22436,2570891
2/14/22,Thailand,15.870032,100.992541,2608227,0,22462,2585765
2/15/22,Thailand,15.870032,100.992541,2622600,0,22489,2600111
2/16/22,Thailand,15.870032,100.992541,2639062,0,22516,2616546
2/17/22,Thailand,15.870032,100.992541,2656411,0,22538,2633873
2/18/22,Thailand,15.870032,100.992541,2674477,0,22565,2651912
2/19/22,Thailand,15.870032,100.992541,2693362,0,22594,2670768
2/20/22,Thailand,15.870032,100.992541,2712315,0,22624,2689691
2/21/22,Thailand,15.870032,100.992541,2731198,0,22656,2708542
2/22/22,Thailand,15.870032,100.992541,2749561,0,22691,2726870
2/23/22,Thailand,15.870032,100.992541,2770793,0,22730,2748063
2/24/22,Thailand,15.870032,100.992541,2794350,0,22768,2771582
2/25/22,Thailand,15.870032,100.992541,2819282,0,22809,2796473
2/26/22,Thailand,15.870032,100.992541,2844897,0,22849,2822048
2/27/22,Thailand,15.870032,100.992541,2869616,0,22891,2846725
2/28/22,Thailand,15.870032,100.992541,2891927,0,22933,2868994
3/1/22,Thailand,15.870032,100.992541,2912347,0,22976,2889371
3/2/22,Thailand,15.870032,100.992541,2934544,0,23021,2911523
3/3/22,Thailand,15.870032,100.992541,2958162,0,23070,2935092
3/4/22,Thailand,15.870032,100.992541,2981996,0,23124,2958872
3/5/22,Thailand,15.870032,100.992541,3004814,0,23176,2981638
3/6/22,Thailand,15.870032,100.992541,3026695,0,23235,3003460
3/7/22,Thailand,15.870032,100.992541,3047857,0,23300,3024557
3/8/22,Thailand,15.870032,100.992541,3066800,0,23369,3043431
3/9/22,Thailand,15.870032,100.992541,3088873,0,23438,3065435
3/10/22,Thailand,15.870032,100.992541,3111857,0,23512,3088345
3/11/22,Thailand,15.870032,100.992541,3136649,0,23575,3113074
3/12/22,Thailand,15.870032,100.992541,3161241,0,23643,3137598
3/13/22,Thailand,15.870032,100.992541,3184825,0,23709,3161116
3/14/22,Thailand,15.870032,100.992541,3206955,0,23778,3183177
3/15/22,Thailand,15.870032,100.992541,3226697,0,23848,3202849
3/16/22,Thailand,15.870032,100.992541,3250642,0,23918,3226724
3/17/22,Thailand,15.870032,100.992541,3276098,0,23995,3252103
3/18/22,Thailand,15.870032,100.992541,3303169,0,24075,3279094
3/19/22,Thailand,15.870032,100.992541,3328973,0,24162,3304811
3/20/22,Thailand,15.870032,100.992541,3353969,0,24246,3329723
3/21/22,Thailand,15.870032,100.992541,3377410,0,24334,3353076
3/22/22,Thailand,15.870032,100.992541,3398792,0,24417,3374375
3/23/22,Thailand,15.870032,100.992541,3423956,0,24497,3399459
3/24/22,Thailand,15.870032,100.992541,3450980,0,24579,3426401
3/25/22,Thailand,15.870032,100.992541,3477030,0,24648,3452382
3/26/22,Thailand,15.870032,100.992541,3503264,0,24715,3478549
3/27/22,Thailand,15.870032,100.992541,3529085,0,24799,3504286
3/28/22,Thailand,15.870032,100.992541,3553720,0,24880,3528840
3/29/22,Thailand,15.870032,100.992541,3575398,0,24958,3550440
3/30/22,Thailand,15.870032,100.992541,3600787,0,25045,3575742
3/31/22,Thailand,15.870032,100.992541,3628347,0,25130,3603217
4/1/22,Thailand,15.870032,100.992541,3656726,0,25222,3631504
4/2/22,Thailand,15.870032,100.992541,3684755,0,25318,3659437
4/3/22,Thailand,15.870032,100.992541,3711595,0,25415,3686180
4/4/22,Thailand,15.870032,100.992541,3736487,0,25512,3710975
4/5/22,Thailand,15.870032,100.992541,3757575,0,25603,3731972
4/6/22,Thailand,15.870032,100.992541,3781827,0,25697,3756130
4/7/22,Thailand,15.870032,100.992541,3807908,0,25788,3782120
4/8/22,Thailand,15.870032,100.992541,3833048,0,25877,3807171
4/9/22,Thailand,15.870032,100.992541,3858346,0,25975,3832371
4/10/22,Thailand,15.870032,100.992541,3883485,0,26083,3857402
4/11/22,Thailand,15.870032,100.992541,3905872,0,26188,3879684
4/12/22,Thailand,15.870032,100.992541,3925854,0,26289,3899565
4/13/22,Thailand,15.870032,100.992541,3973003,0,26510,3946493
4/14/22,Thailand,15.870032,100.992541,3973003,0,26510,3946493
4/15/22,Thailand,15.870032,100.992541,3993292,0,26629,3966663
4/16/22,Thailand,15.870032,100.992541,4012184,0,26754,3985430
4/17/22,Thailand,15.870032,100.992541,4029959,0,26882,4003077
4/18/22,Thailand,15.870032,100.992541,4046953,0,27006,4019947
4/19/22,Thailand,15.870032,100.992541,4063844,0,27135,4036709
4/20/22,Thailand,15.870032,100.992541,4084299,0,27263,4057036
4/21/22,Thailand,15.870032,100.992541,4106230,0,27392,4078838
4/22/22,Thailand,15.870032,100.992541,4128038,0,27520,4100518
4/23/22,Thailand,15.870032,100.992541,4148090,0,27649,4120441
4/24/22,Thailand,15.870032,100.992541,4165874,0,27775,4138099
4/25/22,Thailand,15.870032,100.992541,4180868,0,27899,4152969
4/26/22,Thailand,15.870032,100.992541,4194684,0,28019,4166665
4/27/22,Thailand,15.870032,100.992541,4209571,0,28144,4181427
4/28/22,Thailand,15.870032,100.992541,4224008,0,28271,4195737
4/29/22,Thailand,15.870032,100.992541,4238061,0,28400,4209661
4/30/22,Thailand,15.870032,100.992541,4250949,0,28526,4222423
5/1/22,Thailand,15.870032,100.992541,4262484,0,28617,4233867
5/2/22,Thailand,15.870032,100.992541,4271815,0,28701,4243114
5/3/22,Thailand,15.870032,100.992541,4281536,0,28778,4252758
5/4/22,Thailand,15.870032,100.992541,4290824,0,28860,4261964
5/5/22,Thailand,15.870032,100.992541,4300614,0,28914,4271700
5/6/22,Thailand,15.870032,100.992541,4308319,0,28976,4279343
5/7/22,Thailand,15.870032,100.992541,4316769,0,29034,4287735
5/8/22,Thailand,15.870032,100.992541,4324850,0,29088,4295762
5/9/22,Thailand,15.870032,100.992541,4331338,0,29143,4302195
5/10/22,Thailand,15.870032,100.992541,4337568,0,29196,4308372
5/11/22,Thailand,15.870032,100.992541,4345218,0,29252,4315966
5/12/22,Thailand,15.870032,100.992541,4353237,0,29311,4323926
5/13/22,Thailand,15.870032,100.992541,4361016,0,29367,4331649
5/14/22,Thailand,15.870032,100.992541,4367752,0,29421,4338331
5/15/22,Thailand,15.870032,100.992541,4373846,0,29472,4344374
5/16/22,Thailand,15.870032,100.992541,4379084,0,29512,4349572
5/17/22,Thailand,15.870032,100.992541,4382977,0,29550,4353427
5/18/22,Thailand,15.870032,100.992541,4388610,0,29595,4359015
5/19/22,Thailand,15.870032,100.992541,4394915,0,29637,4365278
5/20/22,Thailand,15.870032,100.992541,4401378,0,29678,4371700
5/21/22,Thailand,15.870032,100.992541,4406755,0,29715,4377040
5/22/22,Thailand,15.870032,100.992541,4397413,0,29640,4367773
5/23/22,Thailand,15.870032,100.992541,4415593,0,29775,4385818
5/24/22,Thailand,15.870032,100.992541,4419737,0,29811,4389926
5/25/22,Thailand,15.870032,100.992541,4424750,0,29844,4394906
5/26/22,Thailand,15.870032,100.992541,4429674,0,29881,4399793
5/27/22,Thailand,15.870032,100.992541,4434511,0,29910,4404601
5/28/22,Thailand,15.870032,100.992541,4438999,0,29948,4409051
5/29/22,Thailand,15.870032,100.992541,4442648,0,29972,4412676
5/30/22,Thailand,15.870032,100.992541,4446502,0,29998,4416504
5/31/22,Thailand,15.870032,100.992541,4450457,0,30019,4420438
6/1/22,Thailand,15.870032,100.992541,4455020,0,30047,4424973
6/2/22,Thailand,15.870032,100.992541,4457580,0,30081,4427499
6/3/22,Thailand,15.870032,100.992541,4460556,0,30113,4430443
6/4/22,Thailand,15.870032,100.992541,4463557,0,30143,4433414
6/5/22,Thailand,15.870032,100.992541,4466793,0,30171,4436622
6/6/22,Thailand,15.870032,100.992541,4468955,0,30198,4438757
6/7/22,Thailand,15.870032,100.992541,4471179,0,30218,4440961
6/8/22,Thailand,15.870032,100.992541,4473867,0,30239,4443628
6/9/22,Thailand,15.870032,100.992541,4477052,0,30262,4446790
6/10/22,Thailand,15.870032,100.992541,4479888,0,30286,4449602
6/11/22,Thailand,15.870032,100.992541,4482389,0,30314,4452075
6/12/22,Thailand,15.870032,100.992541,4484863,0,30334,4454529
6/13/22,Thailand,15.870032,100.992541,4486664,0,30349,4456315
6/14/22,Thailand,15.870032,100.992541,4488497,0,30368,4458129
6/15/22,Thailand,15.870032,100.992541,4490760,0,30386,4460374
6/16/22,Thailand,15.870032,100.992541,4492913,0,30403,4462510
6/17/22,Thailand,15.870032,100.992541,4494880,0,30422,4464458
6/18/22,Thailand,15.870032,100.992541,4497152,0,30445,4466707
6/19/22,Thailand,15.870032,100.992541,4499044,0,30467,4468577
6/20/22,Thailand,15.870032,100.992541,4500828,0,30485,4470343
6/21/22,Thailand,15.870032,100.992541,4502542,0,30506,4472036
6/22/22,Thailand,15.870032,100.992541,4504929,0,30525,4474404
6/23/22,Thailand,15.870032,100.992541,4507228,0,30543,4476685
6/24/22,Thailand,15.870032,100.992541,4509541,0,30559,4478982
6/25/22,Thailand,15.870032,100.992541,4511777,0,30575,4481202
6/26/22,Thailand,15.870032,100.992541,4514155,0,30592,4483563
6/27/22,Thailand,15.870032,100.992541,4515890,0,30607,4485283
6/28/22,Thailand,15.870032,100.992541,4517651,0,30620,4487031
6/29/22,Thailand,15.870032,100.992541,4520220,0,30634,4489586
6/30/22,Thailand,15.870032,100.992541,4522915,0,30648,4492267
7/1/22,Thailand,15.870032,100.992541,4525269,0,30664,4494605
7/2/22,Thailand,15.870032,100.992541,4527777,0,30681,4497096
7/3/22,Thailand,15.870032,100.992541,4530105,0,30700,4499405
7/4/22,Thailand,15.870032,100.992541,4532100,0,30718,4501382
7/5/22,Thailand,15.870032,100.992541,4534017,0,30736,4503281
7/6/22,Thailand,15.870032,100.992541,4536445,0,30758,4505687
7/7/22,Thailand,15.870032,100.992541,4538811,0,30778,4508033
7/8/22,Thailand,15.870032,100.992541,4540955,0,30798,4510157
7/9/22,Thailand,15.870032,100.992541,4543039,0,30813,4512226
7/10/22,Thailand,15.870032,100.992541,4545043,0,30835,4514208
7/11/22,Thailand,15.870032,100.992541,4548533,0,30882,4517651
7/12/22,Thailand,15.870032,100.992541,4550924,0,30907,4520017
7/13/22,Thailand,15.870032,100.992541,4553181,0,30935,4522246
7/14/22,Thailand,15.870032,100.992541,4554976,0,30958,4524018
7/15/22,Thailand,15.870032,100.992541,4554976,0,30958,4524018
7/16/22,Thailand,15.870032,100.992541,4559029,0,30996,4528033
7/17/22,Thailand,15.870032,100.992541,4560843,0,31013,4529830
7/18/22,Thailand,15.870032,100.992541,4562968,0,31031,4531937
7/19/22,Thailand,15.870032,100.992541,4565854,0,31050,4534804
7/20/22,Thailand,15.870032,100.992541,4565854,0,31050,4534804
7/21/22,Thailand,15.870032,100.992541,4570885,0,31098,4539787
7/22/22,Thailand,15.870032,100.992541,4573463,0,31127,4542336
7/23/22,Thailand,15.870032,100.992541,4575853,0,31157,4544696
7/24/22,Thailand,15.870032,100.992541,4577593,0,31189,4546404
7/25/22,Thailand,15.870032,100.992541,4577593,0,31189,4546404
7/26/22,Thailand,15.870032,100.992541,4582168,0,31258,4550910
7/27/22,Thailand,15.870032,100.992541,4584070,0,31290,4552780
7/28/22,Thailand,15.870032,100.992541,4586550,0,31327,4555223
7/29/22,Thailand,15.870032,100.992541,4588512,0,31359,4557153
7/30/22,Thailand,15.870032,100.992541,4590176,0,31385,4558791
7/31/22,Thailand,15.870032,100.992541,4592284,0,31404,4560880
8/1/22,Thailand,15.870032,100.992541,4594127,0,31431,4562696
8/2/22,Thailand,15.870032,100.992541,4596559,0,31463,4565096
8/3/22,Thailand,15.870032,100.992541,4598725,0,31492,4567233
8/4/22,Thailand,15.870032,100.992541,4600978,0,31526,4569452
8/5/22,Thailand,15.870032,100.992541,4603359,0,31561,4571798
8/6/22,Thailand,15.870032,100.992541,4605609,0,31596,4574013
8/7/22,Thailand,15.870032,100.992541,4607451,0,31630,4575821
8/8/22,Thailand,15.870032,100.992541,4609406,0,31663,4577743
8/9/22,Thailand,15.870032,100.992541,4611741,0,31695,4580046
8/10/22,Thailand,15.870032,100.992541,4614057,0,31730,4582327
8/11/22,Thailand,15.870032,100.992541,4616512,0,31763,4584749
8/12/22,Thailand,15.870032,100.992541,4618652,0,31798,4586854
8/13/22,Thailand,15.870032,100.992541,4620425,0,31828,4588597
8/14/22,Thailand,15.870032,100.992541,4622088,0,31858,4590230
8/15/22,Thailand,15.870032,100.992541,4623596,0,31887,4591709
8/16/22,Thailand,15.870032,100.992541,4626057,0,31915,4594142
8/17/22,Thailand,15.870032,100.992541,4628200,0,31944,4596256
8/18/22,Thailand,15.870032,100.992541,4630310,0,31971,4598339
8/19/22,Thailand,15.870032,100.992541,4632212,0,32000,4600212
8/20/22,Thailand,15.870032,100.992541,4634180,0,32027,4602153
8/21/22,Thailand,15.870032,100.992541,4635711,0,32055,4603656
8/22/22,Thailand,15.870032,100.992541,4637199,0,32081,4605118
8/23/22,Thailand,15.870032,100.992541,4639261,0,32109,4607152
8/24/22,Thailand,15.870032,100.992541,4641263,0,32138,4609125
8/25/22,Thailand,15.870032,100.992541,4643012,0,32166,4610846
8/26/22,Thailand,15.870032,100.992541,4644643,0,32195,4612448
8/27/22,Thailand,15.870032,100.992541,4646412,0,32222,4614190
8/28/22,Thailand,15.870032,100.992541,4647685,0,32248,4615437
8/29/22,Thailand,15.870032,100.992541,4648679,0,32275,4616404
8/30/22,Thailand,15.870032,100.992541,4650919,0,32303,4618616
8/31/22,Thailand,15.870032,100.992541,4652923,0,32328,4620595
9/1/22,Thailand,15.870032,100.992541,4654969,0,32352,4622617
9/2/22,Thailand,15.870032,100.992541,4656911,0,32375,4624536
9/3/22,Thailand,15.870032,100.992541,4658542,0,32400,4626142
9/4/22,Thailand,15.870032,100.992541,4659902,0,32422,4627480
9/5/22,Thailand,15.870032,100.992541,4660964,0,32444,4628520
9/6/22,Thailand,15.870032,100.992541,4662569,0,32464,4630105
9/7/22,Thailand,15.870032,100.992541,4664156,0,32483,4631673
9/8/22,Thailand,15.870032,100.992541,4665347,0,32503,4632844
9/9/22,Thailand,15.870032,100.992541,4666453,0,32520,4633933
9/10/22,Thailand,15.870032,100.992541,4667546,0,32539,4635007
9/11/22,Thailand,15.870032,100.992541,4668244,0,32554,4635690
9/12/22,Thailand,15.870032,100.992541,4668863,0,32564,4636299
9/13/22,Thailand,15.870032,100.992541,4670184,0,32578,4637606
9/14/22,Thailand,15.870032,100.992541,4671309,0,32591,4638718
9/15/22,Thailand,15.870032,100.992541,4672146,0,32603,4639543
9/16/22,Thailand,15.870032,100.992541,4672910,0,32617,4640293
9/17/22,Thailand,15.870032,100.992541,4673387,0,32629,4640758
9/18/22,Thailand,15.870032,100.992541,4673629,0,32640,4640989
9/19/22,Thailand,15.870032,100.992541,4674403,0,32655,4641748
9/20/22,Thailand,15.870032,100.992541,4675532,0,32668,4642864
9/21/22,Thailand,15.870032,100.992541,4675532,0,32683,4642849
9/22/22,Thailand,15.870032,100.992541,4677090,0,32692,4644398
9/23/22,Thailand,15.870032,100.992541,4677697,0,32706,4644991
9/24/22,Thailand,15.870032,100.992541,4678352,0,32718,4645634
9/25/22,Thailand,15.870032,100.992541,4678671,0,32726,4645945
9/26/22,Thailand,15.870032,100.992541,4679022,0,32736,4646286
9/27/22,Thailand,15.870032,100.992541,4679022,0,32736,4646286
9/28/22,Thailand,15.870032,100.992541,4680470,0,32755,4647715
9/29/22,Thailand,15.870032,100.992541,4681309,0,32764,4648545
9/30/22,Thailand,15.870032,100.992541,4682132,0,32771,4649361
10/1/22,Thailand,15.870032,100.992541,4682132,0,32771,4649361
10/2/22,Thailand,15.870032,100.992541,4682132,0,32771,4649361
10/3/22,Thailand,15.870032,100.992541,4682132,0,32771,4649361
10/4/22,Thailand,15.870032,100.992541,4682132,0,32771,4649361
10/5/22,Thailand,15.870032,100.992541,4682132,0,32771,4649361
10/6/22,Thailand,15.870032,100.992541,4682132,0,32771,4649361
10/7/22,Thailand,15.870032,100.992541,4682132,0,32771,4649361
10/8/22,Thailand,15.870032,100.992541,4682132,0,32771,4649361
10/9/22,Thailand,15.870032,100.992541,4682132,0,32771,4649361
10/10/22,Thailand,15.870032,100.992541,4685047,0,32829,4652218
10/11/22,Thailand,15.870032,100.992541,4685047,0,32829,4652218
10/12/22,Thailand,15.870032,100.992541,4685047,0,32829,4652218
10/13/22,Thailand,15.870032,100.992541,4685047,0,32829,4652218
10/14/22,Thailand,15.870032,100.992541,4685047,0,32829,4652218
10/15/22,Thailand,15.870032,100.992541,4687281,0,32882,4654399
10/16/22,Thailand,15.870032,100.992541,4687281,0,32882,4654399
10/17/22,Thailand,15.870032,100.992541,4687281,0,32882,4654399
10/18/22,Thailand,15.870032,100.992541,4687281,0,32882,4654399
10/19/22,Thailand,15.870032,100.992541,4687281,0,32882,4654399
10/20/22,Thailand,15.870032,100.992541,4687281,0,32882,4654399
10/21/22,Thailand,15.870032,100.992541,4687281,0,32882,4654399
10/22/22,Thailand,15.870032,100.992541,4687281,0,32882,4654399
10/23/22,Thailand,15.870032,100.992541,4689897,0,32922,4656975
10/24/22,Thailand,15.870032,100.992541,4689897,0,32922,4656975
10/25/22,Thailand,15.870032,100.992541,4689897,0,32922,4656975
10/26/22,Thailand,15.870032,100.992541,4689897,0,32922,4656975
10/27/22,Thailand,15.870032,100.992541,4689897,0,32922,4656975
10/28/22,Thailand,15.870032,100.992541,4689897,0,32922,4656975
10/29/22,Thailand,15.870032,100.992541,4689897,0,32922,4656975
10/30/22,Thailand,15.870032,100.992541,4692448,0,32955,4659493
10/31/22,Thailand,15.870032,100.992541,4692448,0,32955,4659493
11/1/22,Thailand,15.870032,100.992541,4692448,0,32955,4659493
11/2/22,Thailand,15.870032,100.992541,4692448,0,32955,4659493
11/3/22,Thailand,15.870032,100.992541,4692448,0,32955,4659493
11/4/22,Thailand,15.870032,100.992541,4692448,0,32955,4659493
11/5/22,Thailand,15.870032,100.992541,4692448,0,32955,4659493
11/6/22,Thailand,15.870032,100.992541,4695207,0,32995,4662212
11/7/22,Thailand,15.870032,100.992541,4695207,0,32995,4662212
11/8/22,Thailand,15.870032,100.992541,4695207,0,32995,4662212
11/9/22,Thailand,15.870032,100.992541,4695207,0,32995,4662212
11/10/22,Thailand,15.870032,100.992541,4695207,0,32995,4662212
11/11/22,Thailand,15.870032,100.992541,4695207,0,32995,4662212
11/12/22,Thailand,15.870032,100.992541,4695207,0,32995,4662212
11/13/22,Thailand,15.870032,100.992541,4698373,0,33037,4665336
11/14/22,Thailand,15.870032,100.992541,4698373,0,33037,4665336
11/15/22,Thailand,15.870032,100.992541,4698373,0,33037,4665336
11/16/22,Thailand,15.870032,100.992541,4698373,0,33037,4665336
11/17/22,Thailand,15.870032,100.992541,4698373,0,33037,4665336
11/18/22,Thailand,15.870032,100.992541,4698373,0,33037,4665336
11/19/22,Thailand,15.870032,100.992541,4698373,0,33037,4665336
11/20/22,Thailand,15.870032,100.992541,4702330,0,33106,4669224
11/21/22,Thailand,15.870032,100.992541,4702330,0,33106,4669224
11/22/22,Thailand,15.870032,100.992541,4702330,0,33106,4669224
11/23/22,Thailand,15.870032,100.992541,4702330,0,33106,4669224
11/24/22,Thailand,15.870032,100.992541,4702330,0,33106,4669224
11/25/22,Thailand,15.870032,100.992541,4702330,0,33106,4669224
11/26/22,Thailand,15.870032,100.992541,4702330,0,33106,4669224
11/27/22,Thailand,15.870032,100.992541,4707244,0,33180,4674064
11/28/22,Thailand,15.870032,100.992541,4707244,0,33180,4674064
11/29/22,Thailand,15.870032,100.992541,4707244,0,33180,4674064
11/30/22,Thailand,15.870032,100.992541,4707244,0,33180,4674064
12/1/22,Thailand,15.870032,100.992541,4707244,0,33180,4674064
12/2/22,Thailand,15.870032,100.992541,4707244,0,33180,4674064
12/3/22,Thailand,15.870032,100.992541,4707244,0,33180,4674064
12/4/22,Thailand,15.870032,100.992541,4711528,0,33285,4678243
12/5/22,Thailand,15.870032,100.992541,4711528,0,33285,4678243
12/6/22,Thailand,15.870032,100.992541,4711528,0,33285,4678243
12/7/22,Thailand,15.870032,100.992541,4711528,0,33285,4678243
12/8/22,Thailand,15.870032,100.992541,4711528,0,33285,4678243
12/9/22,Thailand,15.870032,100.992541,4711528,0,33285,4678243
12/10/22,Thailand,15.870032,100.992541,4711528,0,33285,4678243
12/11/22,Thailand,15.870032,100.992541,4715489,0,33392,4682097
12/12/22,Thailand,15.870032,100.992541,4715489,0,33392,4682097
12/13/22,Thailand,15.870032,100.992541,4715489,0,33392,4682097
12/14/22,Thailand,15.870032,100.992541,4715489,0,33392,4682097
12/15/22,Thailand,15.870032,100.992541,4715489,0,33392,4682097
12/16/22,Thailand,15.870032,100.992541,4715489,0,33392,4682097
12/17/22,Thailand,15.870032,100.992541,4715489,0,33392,4682097
1/1/22,Timor-Leste,-8.8742,125.7275,19839,0,122,19717
1/2/22,Timor-Leste,-8.8742,125.7275,19839,0,122,19717
1/3/22,Timor-Leste,-8.8742,125.7275,19842,0,122,19720
1/4/22,Timor-Leste,-8.8742,125.7275,19842,0,122,19720
1/5/22,Timor-Leste,-8.8742,125.7275,19842,0,122,19720
1/6/22,Timor-Leste,-8.8742,125.7275,19844,0,122,19722
1/7/22,Timor-Leste,-8.8742,125.7275,19855,0,122,19733
1/8/22,Timor-Leste,-8.8742,125.7275,19855,0,122,19733
1/9/22,Timor-Leste,-8.8742,125.7275,19856,0,122,19734
1/10/22,Timor-Leste,-8.8742,125.7275,19858,0,122,19736
1/11/22,Timor-Leste,-8.8742,125.7275,19860,0,122,19738
1/12/22,Timor-Leste,-8.8742,125.7275,19860,0,122,19738
1/13/22,Timor-Leste,-8.8742,125.7275,19860,0,122,19738
1/14/22,Timor-Leste,-8.8742,125.7275,19861,0,122,19739
1/15/22,Timor-Leste,-8.8742,125.7275,19861,0,122,19739
1/16/22,Timor-Leste,-8.8742,125.7275,19863,0,122,19741
1/17/22,Timor-Leste,-8.8742,125.7275,19863,0,122,19741
1/18/22,Timor-Leste,-8.8742,125.7275,19865,0,122,19743
1/19/22,Timor-Leste,-8.8742,125.7275,19866,0,122,19744
1/20/22,Timor-Leste,-8.8742,125.7275,19866,0,122,19744
1/21/22,Timor-Leste,-8.8742,125.7275,19866,0,122,19744
1/22/22,Timor-Leste,-8.8742,125.7275,19866,0,122,19744
1/23/22,Timor-Leste,-8.8742,125.7275,19868,0,122,19746
1/24/22,Timor-Leste,-8.8742,125.7275,19869,0,122,19747
1/25/22,Timor-Leste,-8.8742,125.7275,19871,0,122,19749
1/26/22,Timor-Leste,-8.8742,125.7275,19879,0,122,19757
1/27/22,Timor-Leste,-8.8742,125.7275,19894,0,122,19772
1/28/22,Timor-Leste,-8.8742,125.7275,19894,0,122,19772
1/29/22,Timor-Leste,-8.8742,125.7275,19908,0,122,19786
1/30/22,Timor-Leste,-8.8742,125.7275,19908,0,122,19786
1/31/22,Timor-Leste,-8.8742,125.7275,19946,0,122,19824
2/1/22,Timor-Leste,-8.8742,125.7275,20105,0,122,19983
2/2/22,Timor-Leste,-8.8742,125.7275,20136,0,122,20014
2/3/22,Timor-Leste,-8.8742,125.7275,20177,0,122,20055
2/4/22,Timor-Leste,-8.8742,125.7275,20240,0,122,20118
2/5/22,Timor-Leste,-8.8742,125.7275,20328,0,122,20206
2/6/22,Timor-Leste,-8.8742,125.7275,20403,0,122,20281
2/7/22,Timor-Leste,-8.8742,125.7275,20501,0,122,20379
2/8/22,Timor-Leste,-8.8742,125.7275,20748,0,122,20626
2/9/22,Timor-Leste,-8.8742,125.7275,20942,0,122,20820
2/10/22,Timor-Leste,-8.8742,125.7275,21158,0,122,21036
2/11/22,Timor-Leste,-8.8742,125.7275,21401,0,123,21278
2/12/22,Timor-Leste,-8.8742,125.7275,21556,0,123,21433
2/13/22,Timor-Leste,-8.8742,125.7275,21631,0,124,21507
2/14/22,Timor-Leste,-8.8742,125.7275,21748,0,124,21624
2/15/22,Timor-Leste,-8.8742,125.7275,21877,0,124,21753
2/16/22,Timor-Leste,-8.8742,125.7275,22047,0,124,21923
2/17/22,Timor-Leste,-8.8742,125.7275,22138,0,125,22013
2/18/22,Timor-Leste,-8.8742,125.7275,22261,0,125,22136
2/19/22,Timor-Leste,-8.8742,125.7275,22314,0,125,22189
2/20/22,Timor-Leste,-8.8742,125.7275,22358,0,125,22233
2/21/22,Timor-Leste,-8.8742,125.7275,22406,0,125,22281
2/22/22,Timor-Leste,-8.8742,125.7275,22485,0,125,22360
2/23/22,Timor-Leste,-8.8742,125.7275,22485,0,125,22360
2/24/22,Timor-Leste,-8.8742,125.7275,22584,0,126,22458
2/25/22,Timor-Leste,-8.8742,125.7275,22584,0,126,22458
2/26/22,Timor-Leste,-8.8742,125.7275,22649,0,128,22521
2/27/22,Timor-Leste,-8.8742,125.7275,22668,0,128,22540
2/28/22,Timor-Leste,-8.8742,125.7275,22693,0,128,22565
3/1/22,Timor-Leste,-8.8742,125.7275,22693,0,128,22565
3/2/22,Timor-Leste,-8.8742,125.7275,22732,0,129,22603
3/3/22,Timor-Leste,-8.8742,125.7275,22736,0,129,22607
3/4/22,Timor-Leste,-8.8742,125.7275,22741,0,129,22612
3/5/22,Timor-Leste,-8.8742,125.7275,22741,0,129,22612
3/6/22,Timor-Leste,-8.8742,125.7275,22759,0,129,22630
3/7/22,Timor-Leste,-8.8742,125.7275,22762,0,129,22633
3/8/22,Timor-Leste,-8.8742,125.7275,22768,0,129,22639
3/9/22,Timor-Leste,-8.8742,125.7275,22777,0,129,22648
3/10/22,Timor-Leste,-8.8742,125.7275,22784,0,129,22655
3/11/22,Timor-Leste,-8.8742,125.7275,22784,0,129,22655
3/12/22,Timor-Leste,-8.8742,125.7275,22789,0,129,22660
3/13/22,Timor-Leste,-8.8742,125.7275,22789,0,129,22660
3/14/22,Timor-Leste,-8.8742,125.7275,22789,0,129,22660
3/15/22,Timor-Leste,-8.8742,125.7275,22789,0,129,22660
3/16/22,Timor-Leste,-8.8742,125.7275,22789,0,129,22660
3/17/22,Timor-Leste,-8.8742,125.7275,22801,0,129,22672
3/18/22,Timor-Leste,-8.8742,125.7275,22801,0,129,22672
3/19/22,Timor-Leste,-8.8742,125.7275,22801,0,129,22672
3/20/22,Timor-Leste,-8.8742,125.7275,22801,0,129,22672
3/21/22,Timor-Leste,-8.8742,125.7275,22805,0,130,22675
3/22/22,Timor-Leste,-8.8742,125.7275,22815,0,130,22685
3/23/22,Timor-Leste,-8.8742,125.7275,22818,0,130,22688
3/24/22,Timor-Leste,-8.8742,125.7275,22813,0,130,22683
3/25/22,Timor-Leste,-8.8742,125.7275,22817,0,130,22687
3/26/22,Timor-Leste,-8.8742,125.7275,22821,0,130,22691
3/27/22,Timor-Leste,-8.8742,125.7275,22821,0,130,22691
3/28/22,Timor-Leste,-8.8742,125.7275,22822,0,130,22692
3/29/22,Timor-Leste,-8.8742,125.7275,22827,0,130,22697
3/30/22,Timor-Leste,-8.8742,125.7275,22830,0,130,22700
3/31/22,Timor-Leste,-8.8742,125.7275,22830,0,130,22700
4/1/22,Timor-Leste,-8.8742,125.7275,22832,0,130,22702
4/2/22,Timor-Leste,-8.8742,125.7275,22832,0,130,22702
4/3/22,Timor-Leste,-8.8742,125.7275,22832,0,130,22702
4/4/22,Timor-Leste,-8.8742,125.7275,22832,0,130,22702
4/5/22,Timor-Leste,-8.8742,125.7275,22836,0,130,22706
4/6/22,Timor-Leste,-8.8742,125.7275,22836,0,130,22706
4/7/22,Timor-Leste,-8.8742,125.7275,22842,0,130,22712
4/8/22,Timor-Leste,-8.8742,125.7275,22842,0,130,22712
4/9/22,Timor-Leste,-8.8742,125.7275,22842,0,130,22712
4/10/22,Timor-Leste,-8.8742,125.7275,22842,0,130,22712
4/11/22,Timor-Leste,-8.8742,125.7275,22842,0,130,22712
4/12/22,Timor-Leste,-8.8742,125.7275,22844,0,130,22714
4/13/22,Timor-Leste,-8.8742,125.7275,22848,0,130,22718
4/14/22,Timor-Leste,-8.8742,125.7275,22851,0,130,22721
4/15/22,Timor-Leste,-8.8742,125.7275,22853,0,130,22723
4/16/22,Timor-Leste,-8.8742,125.7275,22853,0,130,22723
4/17/22,Timor-Leste,-8.8742,125.7275,22853,0,130,22723
4/18/22,Timor-Leste,-8.8742,125.7275,22853,0,130,22723
4/19/22,Timor-Leste,-8.8742,125.7275,22853,0,130,22723
4/20/22,Timor-Leste,-8.8742,125.7275,22854,0,130,22724
4/21/22,Timor-Leste,-8.8742,125.7275,22857,0,130,22727
4/22/22,Timor-Leste,-8.8742,125.7275,22860,0,130,22730
4/23/22,Timor-Leste,-8.8742,125.7275,22860,0,130,22730
4/24/22,Timor-Leste,-8.8742,125.7275,22860,0,130,22730
4/25/22,Timor-Leste,-8.8742,125.7275,22860,0,130,22730
4/26/22,Timor-Leste,-8.8742,125.7275,22861,0,130,22731
4/27/22,Timor-Leste,-8.8742,125.7275,22862,0,130,22732
4/28/22,Timor-Leste,-8.8742,125.7275,22863,0,130,22733
4/29/22,Timor-Leste,-8.8742,125.7275,22865,0,130,22735
4/30/22,Timor-Leste,-8.8742,125.7275,22865,0,130,22735
5/1/22,Timor-Leste,-8.8742,125.7275,22871,0,130,22741
5/2/22,Timor-Leste,-8.8742,125.7275,22874,0,130,22744
5/3/22,Timor-Leste,-8.8742,125.7275,22875,0,130,22745
5/4/22,Timor-Leste,-8.8742,125.7275,22879,0,130,22749
5/5/22,Timor-Leste,-8.8742,125.7275,22883,0,130,22753
5/6/22,Timor-Leste,-8.8742,125.7275,22884,0,130,22754
5/7/22,Timor-Leste,-8.8742,125.7275,22885,0,130,22755
5/8/22,Timor-Leste,-8.8742,125.7275,22885,0,130,22755
5/9/22,Timor-Leste,-8.8742,125.7275,22885,0,130,22755
5/10/22,Timor-Leste,-8.8742,125.7275,22886,0,130,22756
5/11/22,Timor-Leste,-8.8742,125.7275,22888,0,130,22758
5/12/22,Timor-Leste,-8.8742,125.7275,22888,0,130,22758
5/13/22,Timor-Leste,-8.8742,125.7275,22888,0,131,22757
5/14/22,Timor-Leste,-8.8742,125.7275,22889,0,131,22758
5/15/22,Timor-Leste,-8.8742,125.7275,22889,0,131,22758
5/16/22,Timor-Leste,-8.8742,125.7275,22889,0,131,22758
5/17/22,Timor-Leste,-8.8742,125.7275,22890,0,131,22759
5/18/22,Timor-Leste,-8.8742,125.7275,22890,0,131,22759
5/19/22,Timor-Leste,-8.8742,125.7275,22890,0,131,22759
5/20/22,Timor-Leste,-8.8742,125.7275,22893,0,131,22762
5/21/22,Timor-Leste,-8.8742,125.7275,22893,0,131,22762
5/22/22,Timor-Leste,-8.8742,125.7275,22893,0,131,22762
5/23/22,Timor-Leste,-8.8742,125.7275,22896,0,131,22765
5/24/22,Timor-Leste,-8.8742,125.7275,22896,0,131,22765
5/25/22,Timor-Leste,-8.8742,125.7275,22897,0,131,22766
5/26/22,Timor-Leste,-8.8742,125.7275,22904,0,131,22773
5/27/22,Timor-Leste,-8.8742,125.7275,22909,0,131,22778
5/28/22,Timor-Leste,-8.8742,125.7275,22912,0,131,22781
5/29/22,Timor-Leste,-8.8742,125.7275,22912,0,131,22781
5/30/22,Timor-Leste,-8.8742,125.7275,22913,0,131,22782
5/31/22,Timor-Leste,-8.8742,125.7275,22915,0,131,22784
6/1/22,Timor-Leste,-8.8742,125.7275,22916,0,131,22785
6/2/22,Timor-Leste,-8.8742,125.7275,22917,0,131,22786
6/3/22,Timor-Leste,-8.8742,125.7275,22921,0,131,22790
6/4/22,Timor-Leste,-8.8742,125.7275,22921,0,131,22790
6/5/22,Timor-Leste,-8.8742,125.7275,22925,0,131,22794
6/6/22,Timor-Leste,-8.8742,125.7275,22927,0,132,22795
6/7/22,Timor-Leste,-8.8742,125.7275,22928,0,133,22795
6/8/22,Timor-Leste,-8.8742,125.7275,22929,0,133,22796
6/9/22,Timor-Leste,-8.8742,125.7275,22931,0,133,22798
6/10/22,Timor-Leste,-8.8742,125.7275,22931,0,133,22798
6/11/22,Timor-Leste,-8.8742,125.7275,22931,0,133,22798
6/12/22,Timor-Leste,-8.8742,125.7275,22931,0,133,22798
6/13/22,Timor-Leste,-8.8742,125.7275,22933,0,133,22800
6/14/22,Timor-Leste,-8.8742,125.7275,22940,0,133,22807
6/15/22,Timor-Leste,-8.8742,125.7275,22944,0,133,22811
6/16/22,Timor-Leste,-8.8742,125.7275,22944,0,133,22811
6/17/22,Timor-Leste,-8.8742,125.7275,22944,0,133,22811
6/18/22,Timor-Leste,-8.8742,125.7275,22944,0,133,22811
6/19/22,Timor-Leste,-8.8742,125.7275,22944,0,133,22811
6/20/22,Timor-Leste,-8.8742,125.7275,22944,0,133,22811
6/21/22,Timor-Leste,-8.8742,125.7275,22945,0,133,22812
6/22/22,Timor-Leste,-8.8742,125.7275,22945,0,133,22812
6/23/22,Timor-Leste,-8.8742,125.7275,22947,0,133,22814
6/24/22,Timor-Leste,-8.8742,125.7275,22949,0,133,22816
6/25/22,Timor-Leste,-8.8742,125.7275,22950,0,133,22817
6/26/22,Timor-Leste,-8.8742,125.7275,22950,0,133,22817
6/27/22,Timor-Leste,-8.8742,125.7275,22951,0,133,22818
6/28/22,Timor-Leste,-8.8742,125.7275,22954,0,133,22821
6/29/22,Timor-Leste,-8.8742,125.7275,22957,0,133,22824
6/30/22,Timor-Leste,-8.8742,125.7275,22957,0,133,22824
7/1/22,Timor-Leste,-8.8742,125.7275,22958,0,133,22825
7/2/22,Timor-Leste,-8.8742,125.7275,22958,0,133,22825
7/3/22,Timor-Leste,-8.8742,125.7275,22958,0,133,22825
7/4/22,Timor-Leste,-8.8742,125.7275,22959,0,133,22826
7/5/22,Timor-Leste,-8.8742,125.7275,22961,0,133,22828
7/6/22,Timor-Leste,-8.8742,125.7275,22964,0,133,22831
7/7/22,Timor-Leste,-8.8742,125.7275,22965,0,133,22832
7/8/22,Timor-Leste,-8.8742,125.7275,22969,0,133,22836
7/9/22,Timor-Leste,-8.8742,125.7275,22969,0,133,22836
7/10/22,Timor-Leste,-8.8742,125.7275,22969,0,133,22836
7/11/22,Timor-Leste,-8.8742,125.7275,22972,0,133,22839
7/12/22,Timor-Leste,-8.8742,125.7275,22972,0,133,22839
7/13/22,Timor-Leste,-8.8742,125.7275,22974,0,133,22841
7/14/22,Timor-Leste,-8.8742,125.7275,22975,0,133,22842
7/15/22,Timor-Leste,-8.8742,125.7275,22976,0,133,22843
7/16/22,Timor-Leste,-8.8742,125.7275,22976,0,133,22843
7/17/22,Timor-Leste,-8.8742,125.7275,22976,0,133,22843
7/18/22,Timor-Leste,-8.8742,125.7275,22978,0,133,22845
7/19/22,Timor-Leste,-8.8742,125.7275,22980,0,133,22847
7/20/22,Timor-Leste,-8.8742,125.7275,22984,0,133,22851
7/21/22,Timor-Leste,-8.8742,125.7275,22984,0,133,22851
7/22/22,Timor-Leste,-8.8742,125.7275,22985,0,133,22852
7/23/22,Timor-Leste,-8.8742,125.7275,22985,0,133,22852
7/24/22,Timor-Leste,-8.8742,125.7275,22985,0,133,22852
7/25/22,Timor-Leste,-8.8742,125.7275,22986,0,133,22853
7/26/22,Timor-Leste,-8.8742,125.7275,22991,0,133,22858
7/27/22,Timor-Leste,-8.8742,125.7275,22991,0,133,22858
7/28/22,Timor-Leste,-8.8742,125.7275,22996,0,133,22863
7/29/22,Timor-Leste,-8.8742,125.7275,22999,0,133,22866
7/30/22,Timor-Leste,-8.8742,125.7275,22999,0,133,22866
7/31/22,Timor-Leste,-8.8742,125.7275,22999,0,133,22866
8/1/22,Timor-Leste,-8.8742,125.7275,22999,0,133,22866
8/2/22,Timor-Leste,-8.8742,125.7275,23019,0,133,22886
8/3/22,Timor-Leste,-8.8742,125.7275,23024,0,133,22891
8/4/22,Timor-Leste,-8.8742,125.7275,23027,0,133,22894
8/5/22,Timor-Leste,-8.8742,125.7275,23036,0,134,22902
8/6/22,Timor-Leste,-8.8742,125.7275,23036,0,134,22902
8/7/22,Timor-Leste,-8.8742,125.7275,23036,0,134,22902
8/8/22,Timor-Leste,-8.8742,125.7275,23042,0,134,22908
8/9/22,Timor-Leste,-8.8742,125.7275,23055,0,134,22921
8/10/22,Timor-Leste,-8.8742,125.7275,23064,0,135,22929
8/11/22,Timor-Leste,-8.8742,125.7275,23072,0,135,22937
8/12/22,Timor-Leste,-8.8742,125.7275,23074,0,135,22939
8/13/22,Timor-Leste,-8.8742,125.7275,23074,0,135,22939
8/14/22,Timor-Leste,-8.8742,125.7275,23074,0,135,22939
8/15/22,Timor-Leste,-8.8742,125.7275,23086,0,135,22951
8/16/22,Timor-Leste,-8.8742,125.7275,23095,0,135,22960
8/17/22,Timor-Leste,-8.8742,125.7275,23100,0,135,22965
8/18/22,Timor-Leste,-8.8742,125.7275,23108,0,135,22973
8/19/22,Timor-Leste,-8.8742,125.7275,23114,0,135,22979
8/20/22,Timor-Leste,-8.8742,125.7275,23114,0,135,22979
8/21/22,Timor-Leste,-8.8742,125.7275,23114,0,135,22979
8/22/22,Timor-Leste,-8.8742,125.7275,23120,0,135,22985
8/23/22,Timor-Leste,-8.8742,125.7275,23134,0,135,22999
8/24/22,Timor-Leste,-8.8742,125.7275,23140,0,135,23005
8/25/22,Timor-Leste,-8.8742,125.7275,23144,0,136,23008
8/26/22,Timor-Leste,-8.8742,125.7275,23152,0,137,23015
8/27/22,Timor-Leste,-8.8742,125.7275,23152,0,137,23015
8/28/22,Timor-Leste,-8.8742,125.7275,23158,0,137,23021
8/29/22,Timor-Leste,-8.8742,125.7275,23161,0,138,23023
8/30/22,Timor-Leste,-8.8742,125.7275,23163,0,138,23025
8/31/22,Timor-Leste,-8.8742,125.7275,23170,0,138,23032
9/1/22,Timor-Leste,-8.8742,125.7275,23176,0,138,23038
9/2/22,Timor-Leste,-8.8742,125.7275,23179,0,138,23041
9/3/22,Timor-Leste,-8.8742,125.7275,23179,0,138,23041
9/4/22,Timor-Leste,-8.8742,125.7275,23179,0,138,23041
9/5/22,Timor-Leste,-8.8742,125.7275,23189,0,138,23051
9/6/22,Timor-Leste,-8.8742,125.7275,23195,0,138,23057
9/7/22,Timor-Leste,-8.8742,125.7275,23204,0,138,23066
9/8/22,Timor-Leste,-8.8742,125.7275,23204,0,138,23066
9/9/22,Timor-Leste,-8.8742,125.7275,23204,0,138,23066
9/10/22,Timor-Leste,-8.8742,125.7275,23217,0,138,23079
9/11/22,Timor-Leste,-8.8742,125.7275,23217,0,138,23079
9/12/22,Timor-Leste,-8.8742,125.7275,23220,0,138,23082
9/13/22,Timor-Leste,-8.8742,125.7275,23227,0,138,23089
9/14/22,Timor-Leste,-8.8742,125.7275,23232,0,138,23094
9/15/22,Timor-Leste,-8.8742,125.7275,23237,0,138,23099
9/16/22,Timor-Leste,-8.8742,125.7275,23239,0,138,23101
9/17/22,Timor-Leste,-8.8742,125.7275,23239,0,138,23101
9/18/22,Timor-Leste,-8.8742,125.7275,23239,0,138,23101
9/19/22,Timor-Leste,-8.8742,125.7275,23242,0,138,23104
9/20/22,Timor-Leste,-8.8742,125.7275,23245,0,138,23107
9/21/22,Timor-Leste,-8.8742,125.7275,23247,0,138,23109
9/22/22,Timor-Leste,-8.8742,125.7275,23247,0,138,23109
9/23/22,Timor-Leste,-8.8742,125.7275,23248,0,138,23110
9/24/22,Timor-Leste,-8.8742,125.7275,23248,0,138,23110
9/25/22,Timor-Leste,-8.8742,125.7275,23248,0,138,23110
9/26/22,Timor-Leste,-8.8742,125.7275,23253,0,138,23115
9/27/22,Timor-Leste,-8.8742,125.7275,23253,0,138,23115
9/28/22,Timor-Leste,-8.8742,125.7275,23253,0,138,23115
9/29/22,Timor-Leste,-8.8742,125.7275,23253,0,138,23115
9/30/22,Timor-Leste,-8.8742,125.7275,23257,0,138,23119
10/1/22,Timor-Leste,-8.8742,125.7275,23257,0,138,23119
10/2/22,Timor-Leste,-8.8742,125.7275,23257,0,138,23119
10/3/22,Timor-Leste,-8.8742,125.7275,23257,0,138,23119
10/4/22,Timor-Leste,-8.8742,125.7275,23257,0,138,23119
10/5/22,Timor-Leste,-8.8742,125.7275,23257,0,138,23119
10/6/22,Timor-Leste,-8.8742,125.7275,23266,0,138,23128
10/7/22,Timor-Leste,-8.8742,125.7275,23268,0,138,23130
10/8/22,Timor-Leste,-8.8742,125.7275,23268,0,138,23130
10/9/22,Timor-Leste,-8.8742,125.7275,23268,0,138,23130
10/10/22,Timor-Leste,-8.8742,125.7275,23272,0,138,23134
10/11/22,Timor-Leste,-8.8742,125.7275,23272,0,138,23134
10/12/22,Timor-Leste,-8.8742,125.7275,23275,0,138,23137
10/13/22,Timor-Leste,-8.8742,125.7275,23275,0,138,23137
10/14/22,Timor-Leste,-8.8742,125.7275,23276,0,138,23138
10/15/22,Timor-Leste,-8.8742,125.7275,23276,0,138,23138
10/16/22,Timor-Leste,-8.8742,125.7275,23276,0,138,23138
10/17/22,Timor-Leste,-8.8742,125.7275,23288,0,138,23150
10/18/22,Timor-Leste,-8.8742,125.7275,23288,0,138,23150
10/19/22,Timor-Leste,-8.8742,125.7275,23291,0,138,23153
10/20/22,Timor-Leste,-8.8742,125.7275,23292,0,138,23154
10/21/22,Timor-Leste,-8.8742,125.7275,23297,0,138,23159
10/22/22,Timor-Leste,-8.8742,125.7275,23297,0,138,23159
10/23/22,Timor-Leste,-8.8742,125.7275,23297,0,138,23159
10/24/22,Timor-Leste,-8.8742,125.7275,23300,0,138,23162
10/25/22,Timor-Leste,-8.8742,125.7275,23300,0,138,23162
10/26/22,Timor-Leste,-8.8742,125.7275,23300,0,138,23162
10/27/22,Timor-Leste,-8.8742,125.7275,23300,0,138,23162
10/28/22,Timor-Leste,-8.8742,125.7275,23300,0,138,23162
10/29/22,Timor-Leste,-8.8742,125.7275,23300,0,138,23162
10/30/22,Timor-Leste,-8.8742,125.7275,23300,0,138,23162
10/31/22,Timor-Leste,-8.8742,125.7275,23301,0,138,23163
11/1/22,Timor-Leste,-8.8742,125.7275,23301,0,138,23163
11/2/22,Timor-Leste,-8.8742,125.7275,23303,0,138,23165
11/3/22,Timor-Leste,-8.8742,125.7275,23303,0,138,23165
11/4/22,Timor-Leste,-8.8742,125.7275,23303,0,138,23165
11/5/22,Timor-Leste,-8.8742,125.7275,23303,0,138,23165
11/6/22,Timor-Leste,-8.8742,125.7275,23303,0,138,23165
11/7/22,Timor-Leste,-8.8742,125.7275,23305,0,138,23167
11/8/22,Timor-Leste,-8.8742,125.7275,23310,0,138,23172
11/9/22,Timor-Leste,-8.8742,125.7275,23312,0,138,23174
11/10/22,Timor-Leste,-8.8742,125.7275,23312,0,138,23174
11/11/22,Timor-Leste,-8.8742,125.7275,23312,0,138,23174
11/12/22,Timor-Leste,-8.8742,125.7275,23312,0,138,23174
11/13/22,Timor-Leste,-8.8742,125.7275,23312,0,138,23174
11/14/22,Timor-Leste,-8.8742,125.7275,23315,0,138,23177
11/15/22,Timor-Leste,-8.8742,125.7275,23317,0,138,23179
11/16/22,Timor-Leste,-8.8742,125.7275,23318,0,138,23180
11/17/22,Timor-Leste,-8.8742,125.7275,23320,0,138,23182
11/18/22,Timor-Leste,-8.8742,125.7275,23323,0,138,23185
11/19/22,Timor-Leste,-8.8742,125.7275,23323,0,138,23185
11/20/22,Timor-Leste,-8.8742,125.7275,23323,0,138,23185
11/21/22,Timor-Leste,-8.8742,125.7275,23327,0,138,23189
11/22/22,Timor-Leste,-8.8742,125.7275,23327,0,138,23189
11/23/22,Timor-Leste,-8.8742,125.7275,23335,0,138,23197
11/24/22,Timor-Leste,-8.8742,125.7275,23336,0,138,23198
11/25/22,Timor-Leste,-8.8742,125.7275,23337,0,138,23199
11/26/22,Timor-Leste,-8.8742,125.7275,23337,0,138,23199
11/27/22,Timor-Leste,-8.8742,125.7275,23337,0,138,23199
11/28/22,Timor-Leste,-8.8742,125.7275,23337,0,138,23199
11/29/22,Timor-Leste,-8.8742,125.7275,23338,0,138,23200
11/30/22,Timor-Leste,-8.8742,125.7275,23343,0,138,23205
12/1/22,Timor-Leste,-8.8742,125.7275,23354,0,138,23216
12/2/22,Timor-Leste,-8.8742,125.7275,23354,0,138,23216
12/3/22,Timor-Leste,-8.8742,125.7275,23354,0,138,23216
12/4/22,Timor-Leste,-8.8742,125.7275,23354,0,138,23216
12/5/22,Timor-Leste,-8.8742,125.7275,23355,0,138,23217
12/6/22,Timor-Leste,-8.8742,125.7275,23355,0,138,23217
12/7/22,Timor-Leste,-8.8742,125.7275,23360,0,138,23222
12/8/22,Timor-Leste,-8.8742,125.7275,23360,0,138,23222
12/9/22,Timor-Leste,-8.8742,125.7275,23364,0,138,23226
12/10/22,Timor-Leste,-8.8742,125.7275,23364,0,138,23226
12/11/22,Timor-Leste,-8.8742,125.7275,23364,0,138,23226
12/12/22,Timor-Leste,-8.8742,125.7275,23372,0,138,23234
12/13/22,Timor-Leste,-8.8742,125.7275,23375,0,138,23237
12/14/22,Timor-Leste,-8.8742,125.7275,23376,0,138,23238
12/15/22,Timor-Leste,-8.8742,125.7275,23379,0,138,23241
12/16/22,Timor-Leste,-8.8742,125.7275,23379,0,138,23241
12/17/22,Timor-Leste,-8.8742,125.7275,23379,0,138,23241
1/1/22,Togo,8.6195,0.8248,30163,0,248,29915
1/2/22,Togo,8.6195,0.8248,31165,0,248,30917
1/3/22,Togo,8.6195,0.8248,31390,0,250,31140
1/4/22,Togo,8.6195,0.8248,31691,0,251,31440
1/5/22,Togo,8.6195,0.8248,32515,0,251,32264
1/6/22,Togo,8.6195,0.8248,33031,0,252,32779
1/7/22,Togo,8.6195,0.8248,33553,0,252,33301
1/8/22,Togo,8.6195,0.8248,33915,0,253,33662
1/9/22,Togo,8.6195,0.8248,33915,0,253,33662
1/10/22,Togo,8.6195,0.8248,34385,0,254,34131
1/11/22,Togo,8.6195,0.8248,34658,0,258,34400
1/12/22,Togo,8.6195,0.8248,35097,0,260,34837
1/13/22,Togo,8.6195,0.8248,35425,0,261,35164
1/14/22,Togo,8.6195,0.8248,35665,0,261,35404
1/15/22,Togo,8.6195,0.8248,35665,0,261,35404
1/16/22,Togo,8.6195,0.8248,35950,0,261,35689
1/17/22,Togo,8.6195,0.8248,35950,0,261,35689
1/18/22,Togo,8.6195,0.8248,36056,0,263,35793
1/19/22,Togo,8.6195,0.8248,36056,0,263,35793
1/20/22,Togo,8.6195,0.8248,36176,0,266,35910
1/21/22,Togo,8.6195,0.8248,36176,0,266,35910
1/22/22,Togo,8.6195,0.8248,36280,0,266,36014
1/23/22,Togo,8.6195,0.8248,36313,0,266,36047
1/24/22,Togo,8.6195,0.8248,36323,0,267,36056
1/25/22,Togo,8.6195,0.8248,36372,0,267,36105
1/26/22,Togo,8.6195,0.8248,36421,0,267,36154
1/27/22,Togo,8.6195,0.8248,36452,0,267,36185
1/28/22,Togo,8.6195,0.8248,36469,0,267,36202
1/29/22,Togo,8.6195,0.8248,36469,0,267,36202
1/30/22,Togo,8.6195,0.8248,36491,0,268,36223
1/31/22,Togo,8.6195,0.8248,36491,0,268,36223
2/1/22,Togo,8.6195,0.8248,36509,0,268,36241
2/2/22,Togo,8.6195,0.8248,36538,0,268,36270
2/3/22,Togo,8.6195,0.8248,36550,0,268,36282
2/4/22,Togo,8.6195,0.8248,36550,0,268,36282
2/5/22,Togo,8.6195,0.8248,36557,0,268,36289
2/6/22,Togo,8.6195,0.8248,36593,0,268,36325
2/7/22,Togo,8.6195,0.8248,36605,0,269,36336
2/8/22,Togo,8.6195,0.8248,36612,0,270,36342
2/9/22,Togo,8.6195,0.8248,36612,0,270,36342
2/10/22,Togo,8.6195,0.8248,36620,0,270,36350
2/11/22,Togo,8.6195,0.8248,36630,0,270,36360
2/12/22,Togo,8.6195,0.8248,36634,0,270,36364
2/13/22,Togo,8.6195,0.8248,36650,0,271,36379
2/14/22,Togo,8.6195,0.8248,36660,0,271,36389
2/15/22,Togo,8.6195,0.8248,36693,0,271,36422
2/16/22,Togo,8.6195,0.8248,36704,0,271,36433
2/17/22,Togo,8.6195,0.8248,36710,0,271,36439
2/18/22,Togo,8.6195,0.8248,36710,0,271,36439
2/19/22,Togo,8.6195,0.8248,36724,0,271,36453
2/20/22,Togo,8.6195,0.8248,36738,0,271,36467
2/21/22,Togo,8.6195,0.8248,36747,0,271,36476
2/22/22,Togo,8.6195,0.8248,36755,0,272,36483
2/23/22,Togo,8.6195,0.8248,36764,0,272,36492
2/24/22,Togo,8.6195,0.8248,36777,0,272,36505
2/25/22,Togo,8.6195,0.8248,36782,0,272,36510
2/26/22,Togo,8.6195,0.8248,36798,0,272,36526
2/27/22,Togo,8.6195,0.8248,36798,0,272,36526
2/28/22,Togo,8.6195,0.8248,36798,0,272,36526
3/1/22,Togo,8.6195,0.8248,36806,0,272,36534
3/2/22,Togo,8.6195,0.8248,36808,0,272,36536
3/3/22,Togo,8.6195,0.8248,36812,0,272,36540
3/4/22,Togo,8.6195,0.8248,36815,0,272,36543
3/5/22,Togo,8.6195,0.8248,36815,0,272,36543
3/6/22,Togo,8.6195,0.8248,36821,0,272,36549
3/7/22,Togo,8.6195,0.8248,36833,0,272,36561
3/8/22,Togo,8.6195,0.8248,36838,0,272,36566
3/9/22,Togo,8.6195,0.8248,36843,0,272,36571
3/10/22,Togo,8.6195,0.8248,36843,0,272,36571
3/11/22,Togo,8.6195,0.8248,36848,0,272,36576
3/12/22,Togo,8.6195,0.8248,36850,0,272,36578
3/13/22,Togo,8.6195,0.8248,36854,0,272,36582
3/14/22,Togo,8.6195,0.8248,36860,0,272,36588
3/15/22,Togo,8.6195,0.8248,36860,0,272,36588
3/16/22,Togo,8.6195,0.8248,36870,0,272,36598
3/17/22,Togo,8.6195,0.8248,36871,0,272,36599
3/18/22,Togo,8.6195,0.8248,36871,0,272,36599
3/19/22,Togo,8.6195,0.8248,36876,0,272,36604
3/20/22,Togo,8.6195,0.8248,36878,0,272,36606
3/21/22,Togo,8.6195,0.8248,36882,0,272,36610
3/22/22,Togo,8.6195,0.8248,36896,0,272,36624
3/23/22,Togo,8.6195,0.8248,36902,0,272,36630
3/24/22,Togo,8.6195,0.8248,36907,0,272,36635
3/25/22,Togo,8.6195,0.8248,36907,0,272,36635
3/26/22,Togo,8.6195,0.8248,36911,0,272,36639
3/27/22,Togo,8.6195,0.8248,36917,0,272,36645
3/28/22,Togo,8.6195,0.8248,36921,0,272,36649
3/29/22,Togo,8.6195,0.8248,36924,0,272,36652
3/30/22,Togo,8.6195,0.8248,36930,0,272,36658
3/31/22,Togo,8.6195,0.8248,36939,0,272,36667
4/1/22,Togo,8.6195,0.8248,36943,0,272,36671
4/2/22,Togo,8.6195,0.8248,36943,0,272,36671
4/3/22,Togo,8.6195,0.8248,36944,0,272,36672
4/4/22,Togo,8.6195,0.8248,36945,0,272,36673
4/5/22,Togo,8.6195,0.8248,36946,0,272,36674
4/6/22,Togo,8.6195,0.8248,36950,0,272,36678
4/7/22,Togo,8.6195,0.8248,36955,0,272,36683
4/8/22,Togo,8.6195,0.8248,36955,0,272,36683
4/9/22,Togo,8.6195,0.8248,36956,0,272,36684
4/10/22,Togo,8.6195,0.8248,36957,0,272,36685
4/11/22,Togo,8.6195,0.8248,36957,0,272,36685
4/12/22,Togo,8.6195,0.8248,36957,0,272,36685
4/13/22,Togo,8.6195,0.8248,36957,0,272,36685
4/14/22,Togo,8.6195,0.8248,36960,0,272,36688
4/15/22,Togo,8.6195,0.8248,36962,0,272,36690
4/16/22,Togo,8.6195,0.8248,36962,0,273,36689
4/17/22,Togo,8.6195,0.8248,36963,0,273,36690
4/18/22,Togo,8.6195,0.8248,36967,0,273,36694
4/19/22,Togo,8.6195,0.8248,36969,0,273,36696
4/20/22,Togo,8.6195,0.8248,36971,0,273,36698
4/21/22,Togo,8.6195,0.8248,36973,0,273,36700
4/22/22,Togo,8.6195,0.8248,36973,0,273,36700
4/23/22,Togo,8.6195,0.8248,36977,0,273,36704
4/24/22,Togo,8.6195,0.8248,36977,0,273,36704
4/25/22,Togo,8.6195,0.8248,36979,0,273,36706
4/26/22,Togo,8.6195,0.8248,36981,0,273,36708
4/27/22,Togo,8.6195,0.8248,36981,0,273,36708
4/28/22,Togo,8.6195,0.8248,36985,0,273,36712
4/29/22,Togo,8.6195,0.8248,36985,0,273,36712
4/30/22,Togo,8.6195,0.8248,36985,0,273,36712
5/1/22,Togo,8.6195,0.8248,36989,0,273,36716
5/2/22,Togo,8.6195,0.8248,36991,0,273,36718
5/3/22,Togo,8.6195,0.8248,36993,0,273,36720
5/4/22,Togo,8.6195,0.8248,36995,0,273,36722
5/5/22,Togo,8.6195,0.8248,36996,0,273,36723
5/6/22,Togo,8.6195,0.8248,37000,0,273,36727
5/7/22,Togo,8.6195,0.8248,37000,0,273,36727
5/8/22,Togo,8.6195,0.8248,37002,0,273,36729
5/9/22,Togo,8.6195,0.8248,37006,0,273,36733
5/10/22,Togo,8.6195,0.8248,37009,0,273,36736
5/11/22,Togo,8.6195,0.8248,37012,0,273,36739
5/12/22,Togo,8.6195,0.8248,37013,0,273,36740
5/13/22,Togo,8.6195,0.8248,37017,0,273,36744
5/14/22,Togo,8.6195,0.8248,37020,0,273,36747
5/15/22,Togo,8.6195,0.8248,37023,0,273,36750
5/16/22,Togo,8.6195,0.8248,37023,0,273,36750
5/17/22,Togo,8.6195,0.8248,37026,0,273,36753
5/18/22,Togo,8.6195,0.8248,37029,0,273,36756
5/19/22,Togo,8.6195,0.8248,37034,0,273,36761
5/20/22,Togo,8.6195,0.8248,37039,0,273,36766
5/21/22,Togo,8.6195,0.8248,37044,0,273,36771
5/22/22,Togo,8.6195,0.8248,37046,0,273,36773
5/23/22,Togo,8.6195,0.8248,37049,0,273,36776
5/24/22,Togo,8.6195,0.8248,37062,0,273,36789
5/25/22,Togo,8.6195,0.8248,37065,0,273,36792
5/26/22,Togo,8.6195,0.8248,37069,0,273,36796
5/27/22,Togo,8.6195,0.8248,37072,0,273,36799
5/28/22,Togo,8.6195,0.8248,37079,0,273,36806
5/29/22,Togo,8.6195,0.8248,37085,0,273,36812
5/30/22,Togo,8.6195,0.8248,37085,0,273,36812
5/31/22,Togo,8.6195,0.8248,37095,0,273,36822
6/1/22,Togo,8.6195,0.8248,37097,0,273,36824
6/2/22,Togo,8.6195,0.8248,37110,0,273,36837
6/3/22,Togo,8.6195,0.8248,37116,0,273,36843
6/4/22,Togo,8.6195,0.8248,37116,0,273,36843
6/5/22,Togo,8.6195,0.8248,37131,0,273,36858
6/6/22,Togo,8.6195,0.8248,37131,0,273,36858
6/7/22,Togo,8.6195,0.8248,37142,0,273,36869
6/8/22,Togo,8.6195,0.8248,37154,0,273,36881
6/9/22,Togo,8.6195,0.8248,37166,0,273,36893
6/10/22,Togo,8.6195,0.8248,37176,0,273,36903
6/11/22,Togo,8.6195,0.8248,37176,0,273,36903
6/12/22,Togo,8.6195,0.8248,37196,0,273,36923
6/13/22,Togo,8.6195,0.8248,37200,0,273,36927
6/14/22,Togo,8.6195,0.8248,37210,0,273,36937
6/15/22,Togo,8.6195,0.8248,37220,0,273,36947
6/16/22,Togo,8.6195,0.8248,37220,0,273,36947
6/17/22,Togo,8.6195,0.8248,37231,0,273,36958
6/18/22,Togo,8.6195,0.8248,37242,0,273,36969
6/19/22,Togo,8.6195,0.8248,37247,0,273,36974
6/20/22,Togo,8.6195,0.8248,37263,0,273,36990
6/21/22,Togo,8.6195,0.8248,37263,0,273,36990
6/22/22,Togo,8.6195,0.8248,37282,0,273,37009
6/23/22,Togo,8.6195,0.8248,37299,0,274,37025
6/24/22,Togo,8.6195,0.8248,37299,0,274,37025
6/25/22,Togo,8.6195,0.8248,37328,0,275,37053
6/26/22,Togo,8.6195,0.8248,37348,0,275,37073
6/27/22,Togo,8.6195,0.8248,37361,0,275,37086
6/28/22,Togo,8.6195,0.8248,37361,0,275,37086
6/29/22,Togo,8.6195,0.8248,37382,0,275,37107
6/30/22,Togo,8.6195,0.8248,37403,0,275,37128
7/1/22,Togo,8.6195,0.8248,37448,0,275,37173
7/2/22,Togo,8.6195,0.8248,37448,0,275,37173
7/3/22,Togo,8.6195,0.8248,37468,0,275,37193
7/4/22,Togo,8.6195,0.8248,37482,0,275,37207
7/5/22,Togo,8.6195,0.8248,37493,0,275,37218
7/6/22,Togo,8.6195,0.8248,37514,0,275,37239
7/7/22,Togo,8.6195,0.8248,37540,0,275,37265
7/8/22,Togo,8.6195,0.8248,37554,0,275,37279
7/9/22,Togo,8.6195,0.8248,37554,0,275,37279
7/10/22,Togo,8.6195,0.8248,37608,0,275,37333
7/11/22,Togo,8.6195,0.8248,37624,0,275,37349
7/12/22,Togo,8.6195,0.8248,37636,0,275,37361
7/13/22,Togo,8.6195,0.8248,37671,0,275,37396
7/14/22,Togo,8.6195,0.8248,37718,0,275,37443
7/15/22,Togo,8.6195,0.8248,37745,0,275,37470
7/16/22,Togo,8.6195,0.8248,37776,0,275,37501
7/17/22,Togo,8.6195,0.8248,37798,0,275,37523
7/18/22,Togo,8.6195,0.8248,37821,0,275,37546
7/19/22,Togo,8.6195,0.8248,37850,0,275,37575
7/20/22,Togo,8.6195,0.8248,37850,0,276,37574
7/21/22,Togo,8.6195,0.8248,37909,0,276,37633
7/22/22,Togo,8.6195,0.8248,37909,0,276,37633
7/23/22,Togo,8.6195,0.8248,37929,0,276,37653
7/24/22,Togo,8.6195,0.8248,37965,0,277,37688
7/25/22,Togo,8.6195,0.8248,37973,0,277,37696
7/26/22,Togo,8.6195,0.8248,37998,0,278,37720
7/27/22,Togo,8.6195,0.8248,37998,0,278,37720
7/28/22,Togo,8.6195,0.8248,37998,0,278,37720
7/29/22,Togo,8.6195,0.8248,38064,0,279,37785
7/30/22,Togo,8.6195,0.8248,38064,0,279,37785
7/31/22,Togo,8.6195,0.8248,38084,0,279,37805
8/1/22,Togo,8.6195,0.8248,38092,0,279,37813
8/2/22,Togo,8.6195,0.8248,38104,0,280,37824
8/3/22,Togo,8.6195,0.8248,38125,0,280,37845
8/4/22,Togo,8.6195,0.8248,38145,0,280,37865
8/5/22,Togo,8.6195,0.8248,38158,0,280,37878
8/6/22,Togo,8.6195,0.8248,38176,0,281,37895
8/7/22,Togo,8.6195,0.8248,38192,0,281,37911
8/8/22,Togo,8.6195,0.8248,38201,0,281,37920
8/9/22,Togo,8.6195,0.8248,38211,0,281,37930
8/10/22,Togo,8.6195,0.8248,38221,0,281,37940
8/11/22,Togo,8.6195,0.8248,38236,0,281,37955
8/12/22,Togo,8.6195,0.8248,38273,0,281,37992
8/13/22,Togo,8.6195,0.8248,38273,0,281,37992
8/14/22,Togo,8.6195,0.8248,38285,0,281,38004
8/15/22,Togo,8.6195,0.8248,38295,0,281,38014
8/16/22,Togo,8.6195,0.8248,38303,0,281,38022
8/17/22,Togo,8.6195,0.8248,38330,0,281,38049
8/18/22,Togo,8.6195,0.8248,38337,0,281,38056
8/19/22,Togo,8.6195,0.8248,38348,0,281,38067
8/20/22,Togo,8.6195,0.8248,38355,0,282,38073
8/21/22,Togo,8.6195,0.8248,38367,0,282,38085
8/22/22,Togo,8.6195,0.8248,38367,0,282,38085
8/23/22,Togo,8.6195,0.8248,38386,0,282,38104
8/24/22,Togo,8.6195,0.8248,38394,0,282,38112
8/25/22,Togo,8.6195,0.8248,38394,0,282,38112
8/26/22,Togo,8.6195,0.8248,38410,0,282,38128
8/27/22,Togo,8.6195,0.8248,38419,0,282,38137
8/28/22,Togo,8.6195,0.8248,38419,0,282,38137
8/29/22,Togo,8.6195,0.8248,38451,0,282,38169
8/30/22,Togo,8.6195,0.8248,38465,0,282,38183
8/31/22,Togo,8.6195,0.8248,38491,0,282,38209
9/1/22,Togo,8.6195,0.8248,38500,0,283,38217
9/2/22,Togo,8.6195,0.8248,38517,0,283,38234
9/3/22,Togo,8.6195,0.8248,38530,0,283,38247
9/4/22,Togo,8.6195,0.8248,38546,0,283,38263
9/5/22,Togo,8.6195,0.8248,38546,0,283,38263
9/6/22,Togo,8.6195,0.8248,38564,0,283,38281
9/7/22,Togo,8.6195,0.8248,38564,0,283,38281
9/8/22,Togo,8.6195,0.8248,38581,0,284,38297
9/9/22,Togo,8.6195,0.8248,38590,0,284,38306
9/10/22,Togo,8.6195,0.8248,38614,0,284,38330
9/11/22,Togo,8.6195,0.8248,38639,0,284,38355
9/12/22,Togo,8.6195,0.8248,38649,0,284,38365
9/13/22,Togo,8.6195,0.8248,38657,0,284,38373
9/14/22,Togo,8.6195,0.8248,38678,0,284,38394
9/15/22,Togo,8.6195,0.8248,38678,0,284,38394
9/16/22,Togo,8.6195,0.8248,38703,0,284,38419
9/17/22,Togo,8.6195,0.8248,38741,0,284,38457
9/18/22,Togo,8.6195,0.8248,38741,0,284,38457
9/19/22,Togo,8.6195,0.8248,38780,0,284,38496
9/20/22,Togo,8.6195,0.8248,38804,0,284,38520
9/21/22,Togo,8.6195,0.8248,38864,0,284,38580
9/22/22,Togo,8.6195,0.8248,38864,0,284,38580
9/23/22,Togo,8.6195,0.8248,38901,0,284,38617
9/24/22,Togo,8.6195,0.8248,38925,0,284,38641
9/25/22,Togo,8.6195,0.8248,38963,0,284,38679
9/26/22,Togo,8.6195,0.8248,38987,0,284,38703
9/27/22,Togo,8.6195,0.8248,38987,0,284,38703
9/28/22,Togo,8.6195,0.8248,39007,0,285,38722
9/29/22,Togo,8.6195,0.8248,39034,0,285,38749
9/30/22,Togo,8.6195,0.8248,39053,0,285,38768
10/1/22,Togo,8.6195,0.8248,39060,0,285,38775
10/2/22,Togo,8.6195,0.8248,39086,0,285,38801
10/3/22,Togo,8.6195,0.8248,39105,0,285,38820
10/4/22,Togo,8.6195,0.8248,39116,0,285,38831
10/5/22,Togo,8.6195,0.8248,39159,0,286,38873
10/6/22,Togo,8.6195,0.8248,39159,0,286,38873
10/7/22,Togo,8.6195,0.8248,39169,0,286,38883
10/8/22,Togo,8.6195,0.8248,39169,0,286,38883
10/9/22,Togo,8.6195,0.8248,39189,0,286,38903
10/10/22,Togo,8.6195,0.8248,39199,0,286,38913
10/11/22,Togo,8.6195,0.8248,39219,0,287,38932
10/12/22,Togo,8.6195,0.8248,39219,0,287,38932
10/13/22,Togo,8.6195,0.8248,39230,0,287,38943
10/14/22,Togo,8.6195,0.8248,39235,0,287,38948
10/15/22,Togo,8.6195,0.8248,39243,0,287,38956
10/16/22,Togo,8.6195,0.8248,39252,0,287,38965
10/17/22,Togo,8.6195,0.8248,39256,0,287,38969
10/18/22,Togo,8.6195,0.8248,39261,0,288,38973
10/19/22,Togo,8.6195,0.8248,39261,0,288,38973
10/20/22,Togo,8.6195,0.8248,39261,0,288,38973
10/21/22,Togo,8.6195,0.8248,39275,0,289,38986
10/22/22,Togo,8.6195,0.8248,39278,0,289,38989
10/23/22,Togo,8.6195,0.8248,39284,0,289,38995
10/24/22,Togo,8.6195,0.8248,39284,0,289,38995
10/25/22,Togo,8.6195,0.8248,39289,0,289,39000
10/26/22,Togo,8.6195,0.8248,39293,0,290,39003
10/27/22,Togo,8.6195,0.8248,39293,0,290,39003
10/28/22,Togo,8.6195,0.8248,39294,0,290,39004
10/29/22,Togo,8.6195,0.8248,39295,0,290,39005
10/30/22,Togo,8.6195,0.8248,39298,0,290,39008
10/31/22,Togo,8.6195,0.8248,39299,0,290,39009
11/1/22,Togo,8.6195,0.8248,39300,0,290,39010
11/2/22,Togo,8.6195,0.8248,39304,0,290,39014
11/3/22,Togo,8.6195,0.8248,39304,0,290,39014
11/4/22,Togo,8.6195,0.8248,39310,0,290,39020
11/5/22,Togo,8.6195,0.8248,39310,0,290,39020
11/6/22,Togo,8.6195,0.8248,39311,0,290,39021
11/7/22,Togo,8.6195,0.8248,39312,0,290,39022
11/8/22,Togo,8.6195,0.8248,39314,0,290,39024
11/9/22,Togo,8.6195,0.8248,39314,0,290,39024
11/10/22,Togo,8.6195,0.8248,39316,0,290,39026
11/11/22,Togo,8.6195,0.8248,39317,0,290,39027
11/12/22,Togo,8.6195,0.8248,39319,0,290,39029
11/13/22,Togo,8.6195,0.8248,39319,0,290,39029
11/14/22,Togo,8.6195,0.8248,39320,0,290,39030
11/15/22,Togo,8.6195,0.8248,39320,0,290,39030
11/16/22,Togo,8.6195,0.8248,39321,0,290,39031
11/17/22,Togo,8.6195,0.8248,39321,0,290,39031
11/18/22,Togo,8.6195,0.8248,39321,0,290,39031
11/19/22,Togo,8.6195,0.8248,39321,0,290,39031
11/20/22,Togo,8.6195,0.8248,39323,0,290,39033
11/21/22,Togo,8.6195,0.8248,39323,0,290,39033
11/22/22,Togo,8.6195,0.8248,39323,0,290,39033
11/23/22,Togo,8.6195,0.8248,39323,0,290,39033
11/24/22,Togo,8.6195,0.8248,39326,0,290,39036
11/25/22,Togo,8.6195,0.8248,39326,0,290,39036
11/26/22,Togo,8.6195,0.8248,39326,0,290,39036
11/27/22,Togo,8.6195,0.8248,39328,0,290,39038
11/28/22,Togo,8.6195,0.8248,39328,0,290,39038
11/29/22,Togo,8.6195,0.8248,39328,0,290,39038
11/30/22,Togo,8.6195,0.8248,39328,0,290,39038
12/1/22,Togo,8.6195,0.8248,39330,0,290,39040
12/2/22,Togo,8.6195,0.8248,39331,0,290,39041
12/3/22,Togo,8.6195,0.8248,39332,0,290,39042
12/4/22,Togo,8.6195,0.8248,39332,0,290,39042
12/5/22,Togo,8.6195,0.8248,39332,0,290,39042
12/6/22,Togo,8.6195,0.8248,39332,0,290,39042
12/7/22,Togo,8.6195,0.8248,39334,0,290,39044
12/8/22,Togo,8.6195,0.8248,39334,0,290,39044
12/9/22,Togo,8.6195,0.8248,39336,0,290,39046
12/10/22,Togo,8.6195,0.8248,39336,0,290,39046
12/11/22,Togo,8.6195,0.8248,39337,0,290,39047
12/12/22,Togo,8.6195,0.8248,39337,0,290,39047
12/13/22,Togo,8.6195,0.8248,39337,0,290,39047
12/14/22,Togo,8.6195,0.8248,39337,0,290,39047
12/15/22,Togo,8.6195,0.8248,39339,0,290,39049
12/16/22,Togo,8.6195,0.8248,39339,0,290,39049
12/17/22,Togo,8.6195,0.8248,39339,0,290,39049
1/1/22,Tonga,-21.179,-175.1982,1,0,0,1
1/2/22,Tonga,-21.179,-175.1982,1,0,0,1
1/3/22,Tonga,-21.179,-175.1982,1,0,0,1
1/4/22,Tonga,-21.179,-175.1982,1,0,0,1
1/5/22,Tonga,-21.179,-175.1982,1,0,0,1
1/6/22,Tonga,-21.179,-175.1982,1,0,0,1
1/7/22,Tonga,-21.179,-175.1982,1,0,0,1
1/8/22,Tonga,-21.179,-175.1982,1,0,0,1
1/9/22,Tonga,-21.179,-175.1982,1,0,0,1
1/10/22,Tonga,-21.179,-175.1982,1,0,0,1
1/11/22,Tonga,-21.179,-175.1982,1,0,0,1
1/12/22,Tonga,-21.179,-175.1982,1,0,0,1
1/13/22,Tonga,-21.179,-175.1982,1,0,0,1
1/14/22,Tonga,-21.179,-175.1982,1,0,0,1
1/15/22,Tonga,-21.179,-175.1982,1,0,0,1
1/16/22,Tonga,-21.179,-175.1982,1,0,0,1
1/17/22,Tonga,-21.179,-175.1982,1,0,0,1
1/18/22,Tonga,-21.179,-175.1982,1,0,0,1
1/19/22,Tonga,-21.179,-175.1982,1,0,0,1
1/20/22,Tonga,-21.179,-175.1982,1,0,0,1
1/21/22,Tonga,-21.179,-175.1982,1,0,0,1
1/22/22,Tonga,-21.179,-175.1982,1,0,0,1
1/23/22,Tonga,-21.179,-175.1982,1,0,0,1
1/24/22,Tonga,-21.179,-175.1982,1,0,0,1
1/25/22,Tonga,-21.179,-175.1982,1,0,0,1
1/26/22,Tonga,-21.179,-175.1982,1,0,0,1
1/27/22,Tonga,-21.179,-175.1982,1,0,0,1
1/28/22,Tonga,-21.179,-175.1982,1,0,0,1
1/29/22,Tonga,-21.179,-175.1982,1,0,0,1
1/30/22,Tonga,-21.179,-175.1982,1,0,0,1
1/31/22,Tonga,-21.179,-175.1982,1,0,0,1
2/1/22,Tonga,-21.179,-175.1982,1,0,0,1
2/2/22,Tonga,-21.179,-175.1982,5,0,0,5
2/3/22,Tonga,-21.179,-175.1982,6,0,0,6
2/4/22,Tonga,-21.179,-175.1982,7,0,0,7
2/5/22,Tonga,-21.179,-175.1982,7,0,0,7
2/6/22,Tonga,-21.179,-175.1982,7,0,0,7
2/7/22,Tonga,-21.179,-175.1982,9,0,0,9
2/8/22,Tonga,-21.179,-175.1982,15,0,0,15
2/9/22,Tonga,-21.179,-175.1982,35,0,0,35
2/10/22,Tonga,-21.179,-175.1982,66,0,0,66
2/11/22,Tonga,-21.179,-175.1982,73,0,0,73
2/12/22,Tonga,-21.179,-175.1982,73,0,0,73
2/13/22,Tonga,-21.179,-175.1982,141,0,0,141
2/14/22,Tonga,-21.179,-175.1982,141,0,0,141
2/15/22,Tonga,-21.179,-175.1982,141,0,0,141
2/16/22,Tonga,-21.179,-175.1982,141,0,0,141
2/17/22,Tonga,-21.179,-175.1982,210,0,0,210
2/18/22,Tonga,-21.179,-175.1982,234,0,0,234
2/19/22,Tonga,-21.179,-175.1982,234,0,0,234
2/20/22,Tonga,-21.179,-175.1982,234,0,0,234
2/21/22,Tonga,-21.179,-175.1982,234,0,0,234
2/22/22,Tonga,-21.179,-175.1982,254,0,0,254
2/23/22,Tonga,-21.179,-175.1982,289,0,0,289
2/24/22,Tonga,-21.179,-175.1982,289,0,0,289
2/25/22,Tonga,-21.179,-175.1982,355,0,1,354
2/26/22,Tonga,-21.179,-175.1982,355,0,1,354
2/27/22,Tonga,-21.179,-175.1982,355,0,1,354
2/28/22,Tonga,-21.179,-175.1982,355,0,0,355
3/1/22,Tonga,-21.179,-175.1982,355,0,0,355
3/2/22,Tonga,-21.179,-175.1982,355,0,0,355
3/3/22,Tonga,-21.179,-175.1982,645,0,0,645
3/4/22,Tonga,-21.179,-175.1982,715,0,0,715
3/5/22,Tonga,-21.179,-175.1982,898,0,0,898
3/6/22,Tonga,-21.179,-175.1982,898,0,0,898
3/7/22,Tonga,-21.179,-175.1982,1059,0,0,1059
3/8/22,Tonga,-21.179,-175.1982,1059,0,0,1059
3/9/22,Tonga,-21.179,-175.1982,1220,0,0,1220
3/10/22,Tonga,-21.179,-175.1982,1320,0,0,1320
3/11/22,Tonga,-21.179,-175.1982,1320,0,0,1320
3/12/22,Tonga,-21.179,-175.1982,1513,0,2,1511
3/13/22,Tonga,-21.179,-175.1982,1708,0,2,1706
3/14/22,Tonga,-21.179,-175.1982,1875,0,2,1873
3/15/22,Tonga,-21.179,-175.1982,2072,0,2,2070
3/16/22,Tonga,-21.179,-175.1982,2072,0,2,2070
3/17/22,Tonga,-21.179,-175.1982,2530,0,2,2528
3/18/22,Tonga,-21.179,-175.1982,2788,0,2,2786
3/19/22,Tonga,-21.179,-175.1982,2788,0,2,2786
3/20/22,Tonga,-21.179,-175.1982,3232,0,2,3230
3/21/22,Tonga,-21.179,-175.1982,3418,0,2,3416
3/22/22,Tonga,-21.179,-175.1982,3784,0,2,3782
3/23/22,Tonga,-21.179,-175.1982,3784,0,2,3782
3/24/22,Tonga,-21.179,-175.1982,4537,0,2,4535
3/25/22,Tonga,-21.179,-175.1982,4872,0,2,4870
3/26/22,Tonga,-21.179,-175.1982,5332,0,2,5330
3/27/22,Tonga,-21.179,-175.1982,5591,0,2,5589
3/28/22,Tonga,-21.179,-175.1982,5591,0,2,5589
3/29/22,Tonga,-21.179,-175.1982,5591,0,2,5589
3/30/22,Tonga,-21.179,-175.1982,6423,0,6,6417
3/31/22,Tonga,-21.179,-175.1982,6423,0,6,6417
4/1/22,Tonga,-21.179,-175.1982,6546,0,6,6540
4/2/22,Tonga,-21.179,-175.1982,6996,0,9,6987
4/3/22,Tonga,-21.179,-175.1982,7127,0,9,7118
4/4/22,Tonga,-21.179,-175.1982,7234,0,9,7225
4/5/22,Tonga,-21.179,-175.1982,7385,0,9,7376
4/6/22,Tonga,-21.179,-175.1982,7528,0,9,7519
4/7/22,Tonga,-21.179,-175.1982,7665,0,9,7656
4/8/22,Tonga,-21.179,-175.1982,7931,0,9,7922
4/9/22,Tonga,-21.179,-175.1982,7931,0,9,7922
4/10/22,Tonga,-21.179,-175.1982,7931,0,9,7922
4/11/22,Tonga,-21.179,-175.1982,8444,0,9,8435
4/12/22,Tonga,-21.179,-175.1982,8559,0,11,8548
4/13/22,Tonga,-21.179,-175.1982,8761,0,11,8750
4/14/22,Tonga,-21.179,-175.1982,8842,0,11,8831
4/15/22,Tonga,-21.179,-175.1982,8842,0,11,8831
4/16/22,Tonga,-21.179,-175.1982,8922,0,11,8911
4/17/22,Tonga,-21.179,-175.1982,9025,0,11,9014
4/18/22,Tonga,-21.179,-175.1982,9025,0,11,9014
4/19/22,Tonga,-21.179,-175.1982,9106,0,11,9095
4/20/22,Tonga,-21.179,-175.1982,9220,0,11,9209
4/21/22,Tonga,-21.179,-175.1982,9468,0,11,9457
4/22/22,Tonga,-21.179,-175.1982,9553,0,11,9542
4/23/22,Tonga,-21.179,-175.1982,9553,0,11,9542
4/24/22,Tonga,-21.179,-175.1982,9553,0,11,9542
4/25/22,Tonga,-21.179,-175.1982,9697,0,11,9686
4/26/22,Tonga,-21.179,-175.1982,9838,0,11,9827
4/27/22,Tonga,-21.179,-175.1982,9838,0,11,9827
4/28/22,Tonga,-21.179,-175.1982,10065,0,11,10054
4/29/22,Tonga,-21.179,-175.1982,10196,0,11,10185
4/30/22,Tonga,-21.179,-175.1982,10196,0,11,10185
5/1/22,Tonga,-21.179,-175.1982,10196,0,11,10185
5/2/22,Tonga,-21.179,-175.1982,10452,0,11,10441
5/3/22,Tonga,-21.179,-175.1982,10494,0,11,10483
5/4/22,Tonga,-21.179,-175.1982,10494,0,11,10483
5/5/22,Tonga,-21.179,-175.1982,10494,0,11,10483
5/6/22,Tonga,-21.179,-175.1982,10765,0,11,10754
5/7/22,Tonga,-21.179,-175.1982,10765,0,11,10754
5/8/22,Tonga,-21.179,-175.1982,10765,0,11,10754
5/9/22,Tonga,-21.179,-175.1982,10765,0,11,10754
5/10/22,Tonga,-21.179,-175.1982,10826,0,11,10815
5/11/22,Tonga,-21.179,-175.1982,10950,0,11,10939
5/12/22,Tonga,-21.179,-175.1982,11049,0,11,11038
5/13/22,Tonga,-21.179,-175.1982,11049,0,11,11038
5/14/22,Tonga,-21.179,-175.1982,11049,0,11,11038
5/15/22,Tonga,-21.179,-175.1982,11190,0,11,11179
5/16/22,Tonga,-21.179,-175.1982,11280,0,11,11269
5/17/22,Tonga,-21.179,-175.1982,11280,0,11,11269
5/18/22,Tonga,-21.179,-175.1982,11394,0,11,11383
5/19/22,Tonga,-21.179,-175.1982,11394,0,11,11383
5/20/22,Tonga,-21.179,-175.1982,11394,0,11,11383
5/21/22,Tonga,-21.179,-175.1982,11500,0,11,11489
5/22/22,Tonga,-21.179,-175.1982,11500,0,11,11489
5/23/22,Tonga,-21.179,-175.1982,11500,0,11,11489
5/24/22,Tonga,-21.179,-175.1982,11500,0,11,11489
5/25/22,Tonga,-21.179,-175.1982,11500,0,11,11489
5/26/22,Tonga,-21.179,-175.1982,11500,0,11,11489
5/27/22,Tonga,-21.179,-175.1982,11566,0,11,11555
5/28/22,Tonga,-21.179,-175.1982,11636,0,11,11625
5/29/22,Tonga,-21.179,-175.1982,11636,0,11,11625
5/30/22,Tonga,-21.179,-175.1982,11644,0,12,11632
5/31/22,Tonga,-21.179,-175.1982,11644,0,12,11632
6/1/22,Tonga,-21.179,-175.1982,11742,0,12,11730
6/2/22,Tonga,-21.179,-175.1982,11742,0,12,11730
6/3/22,Tonga,-21.179,-175.1982,11769,0,12,11757
6/4/22,Tonga,-21.179,-175.1982,11769,0,12,11757
6/5/22,Tonga,-21.179,-175.1982,11769,0,12,11757
6/6/22,Tonga,-21.179,-175.1982,11769,0,12,11757
6/7/22,Tonga,-21.179,-175.1982,11890,0,12,11878
6/8/22,Tonga,-21.179,-175.1982,11909,0,12,11897
6/9/22,Tonga,-21.179,-175.1982,11909,0,12,11897
6/10/22,Tonga,-21.179,-175.1982,11909,0,12,11897
6/11/22,Tonga,-21.179,-175.1982,11909,0,12,11897
6/12/22,Tonga,-21.179,-175.1982,11909,0,12,11897
6/13/22,Tonga,-21.179,-175.1982,11909,0,12,11897
6/14/22,Tonga,-21.179,-175.1982,11909,0,12,11897
6/15/22,Tonga,-21.179,-175.1982,11909,0,12,11897
6/16/22,Tonga,-21.179,-175.1982,11909,0,12,11897
6/17/22,Tonga,-21.179,-175.1982,12079,0,12,12067
6/18/22,Tonga,-21.179,-175.1982,12079,0,12,12067
6/19/22,Tonga,-21.179,-175.1982,12079,0,12,12067
6/20/22,Tonga,-21.179,-175.1982,12079,0,12,12067
6/21/22,Tonga,-21.179,-175.1982,12079,0,12,12067
6/22/22,Tonga,-21.179,-175.1982,12079,0,12,12067
6/23/22,Tonga,-21.179,-175.1982,12079,0,12,12067
6/24/22,Tonga,-21.179,-175.1982,12079,0,12,12067
6/25/22,Tonga,-21.179,-175.1982,12079,0,12,12067
6/26/22,Tonga,-21.179,-175.1982,12079,0,12,12067
6/27/22,Tonga,-21.179,-175.1982,12301,0,12,12289
6/28/22,Tonga,-21.179,-175.1982,12301,0,12,12289
6/29/22,Tonga,-21.179,-175.1982,12301,0,12,12289
6/30/22,Tonga,-21.179,-175.1982,12301,0,12,12289
7/1/22,Tonga,-21.179,-175.1982,12301,0,12,12289
7/2/22,Tonga,-21.179,-175.1982,12301,0,12,12289
7/3/22,Tonga,-21.179,-175.1982,12301,0,12,12289
7/4/22,Tonga,-21.179,-175.1982,12301,0,12,12289
7/5/22,Tonga,-21.179,-175.1982,12301,0,12,12289
7/6/22,Tonga,-21.179,-175.1982,12301,0,12,12289
7/7/22,Tonga,-21.179,-175.1982,12301,0,12,12289
7/8/22,Tonga,-21.179,-175.1982,12382,0,12,12370
7/9/22,Tonga,-21.179,-175.1982,12382,0,12,12370
7/10/22,Tonga,-21.179,-175.1982,12382,0,12,12370
7/11/22,Tonga,-21.179,-175.1982,12382,0,12,12370
7/12/22,Tonga,-21.179,-175.1982,12382,0,12,12370
7/13/22,Tonga,-21.179,-175.1982,12382,0,12,12370
7/14/22,Tonga,-21.179,-175.1982,12382,0,12,12370
7/15/22,Tonga,-21.179,-175.1982,12382,0,12,12370
7/16/22,Tonga,-21.179,-175.1982,12382,0,12,12370
7/17/22,Tonga,-21.179,-175.1982,12439,0,12,12427
7/18/22,Tonga,-21.179,-175.1982,12439,0,12,12427
7/19/22,Tonga,-21.179,-175.1982,12439,0,12,12427
7/20/22,Tonga,-21.179,-175.1982,12439,0,12,12427
7/21/22,Tonga,-21.179,-175.1982,12493,0,12,12481
7/22/22,Tonga,-21.179,-175.1982,12493,0,12,12481
7/23/22,Tonga,-21.179,-175.1982,12515,0,12,12503
7/24/22,Tonga,-21.179,-175.1982,12515,0,12,12503
7/25/22,Tonga,-21.179,-175.1982,12515,0,12,12503
7/26/22,Tonga,-21.179,-175.1982,12539,0,12,12527
7/27/22,Tonga,-21.179,-175.1982,12539,0,12,12527
7/28/22,Tonga,-21.179,-175.1982,12539,0,12,12527
7/29/22,Tonga,-21.179,-175.1982,12554,0,12,12542
7/30/22,Tonga,-21.179,-175.1982,12554,0,12,12542
7/31/22,Tonga,-21.179,-175.1982,12554,0,12,12542
8/1/22,Tonga,-21.179,-175.1982,12554,0,12,12542
8/2/22,Tonga,-21.179,-175.1982,12554,0,12,12542
8/3/22,Tonga,-21.179,-175.1982,12554,0,12,12542
8/4/22,Tonga,-21.179,-175.1982,12554,0,12,12542
8/5/22,Tonga,-21.179,-175.1982,12554,0,12,12542
8/6/22,Tonga,-21.179,-175.1982,12554,0,12,12542
8/7/22,Tonga,-21.179,-175.1982,12836,0,12,12824
8/8/22,Tonga,-21.179,-175.1982,12836,0,12,12824
8/9/22,Tonga,-21.179,-175.1982,12836,0,12,12824
8/10/22,Tonga,-21.179,-175.1982,12836,0,12,12824
8/11/22,Tonga,-21.179,-175.1982,13405,0,12,13393
8/12/22,Tonga,-21.179,-175.1982,13405,0,12,13393
8/13/22,Tonga,-21.179,-175.1982,13405,0,12,13393
8/14/22,Tonga,-21.179,-175.1982,13405,0,12,13393
8/15/22,Tonga,-21.179,-175.1982,13405,0,12,13393
8/16/22,Tonga,-21.179,-175.1982,14135,0,12,14123
8/17/22,Tonga,-21.179,-175.1982,14135,0,12,14123
8/18/22,Tonga,-21.179,-175.1982,14135,0,12,14123
8/19/22,Tonga,-21.179,-175.1982,14135,0,12,14123
8/20/22,Tonga,-21.179,-175.1982,14135,0,12,14123
8/21/22,Tonga,-21.179,-175.1982,14135,0,12,14123
8/22/22,Tonga,-21.179,-175.1982,14135,0,12,14123
8/23/22,Tonga,-21.179,-175.1982,14135,0,12,14123
8/24/22,Tonga,-21.179,-175.1982,14135,0,12,14123
8/25/22,Tonga,-21.179,-175.1982,14741,0,12,14729
8/26/22,Tonga,-21.179,-175.1982,15235,0,12,15223
8/27/22,Tonga,-21.179,-175.1982,15235,0,12,15223
8/28/22,Tonga,-21.179,-175.1982,15235,0,12,15223
8/29/22,Tonga,-21.179,-175.1982,15235,0,12,15223
8/30/22,Tonga,-21.179,-175.1982,15235,0,12,15223
8/31/22,Tonga,-21.179,-175.1982,15235,0,12,15223
9/1/22,Tonga,-21.179,-175.1982,15235,0,12,15223
9/2/22,Tonga,-21.179,-175.1982,15805,0,12,15793
9/3/22,Tonga,-21.179,-175.1982,15805,0,12,15793
9/4/22,Tonga,-21.179,-175.1982,15805,0,12,15793
9/5/22,Tonga,-21.179,-175.1982,16182,0,12,16170
9/6/22,Tonga,-21.179,-175.1982,16182,0,12,16170
9/7/22,Tonga,-21.179,-175.1982,16182,0,12,16170
9/8/22,Tonga,-21.179,-175.1982,16182,0,12,16170
9/9/22,Tonga,-21.179,-175.1982,16182,0,12,16170
9/10/22,Tonga,-21.179,-175.1982,16182,0,12,16170
9/11/22,Tonga,-21.179,-175.1982,16182,0,12,16170
9/12/22,Tonga,-21.179,-175.1982,16182,0,12,16170
9/13/22,Tonga,-21.179,-175.1982,16182,0,12,16170
9/14/22,Tonga,-21.179,-175.1982,16182,0,12,16170
9/15/22,Tonga,-21.179,-175.1982,16182,0,12,16170
9/16/22,Tonga,-21.179,-175.1982,16182,0,12,16170
9/17/22,Tonga,-21.179,-175.1982,16182,0,12,16170
9/18/22,Tonga,-21.179,-175.1982,16182,0,12,16170
9/19/22,Tonga,-21.179,-175.1982,16182,0,12,16170
9/20/22,Tonga,-21.179,-175.1982,16182,0,12,16170
9/21/22,Tonga,-21.179,-175.1982,16182,0,12,16170
9/22/22,Tonga,-21.179,-175.1982,16182,0,12,16170
9/23/22,Tonga,-21.179,-175.1982,16182,0,12,16170
9/24/22,Tonga,-21.179,-175.1982,16182,0,12,16170
9/25/22,Tonga,-21.179,-175.1982,16182,0,12,16170
9/26/22,Tonga,-21.179,-175.1982,16182,0,12,16170
9/27/22,Tonga,-21.179,-175.1982,16182,0,12,16170
9/28/22,Tonga,-21.179,-175.1982,16182,0,12,16170
9/29/22,Tonga,-21.179,-175.1982,16182,0,12,16170
9/30/22,Tonga,-21.179,-175.1982,16182,0,12,16170
10/1/22,Tonga,-21.179,-175.1982,16182,0,12,16170
10/2/22,Tonga,-21.179,-175.1982,16182,0,12,16170
10/3/22,Tonga,-21.179,-175.1982,16182,0,12,16170
10/4/22,Tonga,-21.179,-175.1982,16182,0,12,16170
10/5/22,Tonga,-21.179,-175.1982,16182,0,12,16170
10/6/22,Tonga,-21.179,-175.1982,16182,0,12,16170
10/7/22,Tonga,-21.179,-175.1982,16182,0,12,16170
10/8/22,Tonga,-21.179,-175.1982,16182,0,12,16170
10/9/22,Tonga,-21.179,-175.1982,16182,0,12,16170
10/10/22,Tonga,-21.179,-175.1982,16182,0,12,16170
10/11/22,Tonga,-21.179,-175.1982,16182,0,12,16170
10/12/22,Tonga,-21.179,-175.1982,16182,0,12,16170
10/13/22,Tonga,-21.179,-175.1982,16182,0,12,16170
10/14/22,Tonga,-21.179,-175.1982,16182,0,12,16170
10/15/22,Tonga,-21.179,-175.1982,16182,0,12,16170
10/16/22,Tonga,-21.179,-175.1982,16182,0,12,16170
10/17/22,Tonga,-21.179,-175.1982,16182,0,12,16170
10/18/22,Tonga,-21.179,-175.1982,16182,0,12,16170
10/19/22,Tonga,-21.179,-175.1982,16182,0,12,16170
10/20/22,Tonga,-21.179,-175.1982,16182,0,12,16170
10/21/22,Tonga,-21.179,-175.1982,16182,0,12,16170
10/22/22,Tonga,-21.179,-175.1982,16182,0,12,16170
10/23/22,Tonga,-21.179,-175.1982,16182,0,12,16170
10/24/22,Tonga,-21.179,-175.1982,16182,0,12,16170
10/25/22,Tonga,-21.179,-175.1982,16182,0,12,16170
10/26/22,Tonga,-21.179,-175.1982,16182,0,12,16170
10/27/22,Tonga,-21.179,-175.1982,16182,0,12,16170
10/28/22,Tonga,-21.179,-175.1982,16182,0,12,16170
10/29/22,Tonga,-21.179,-175.1982,16182,0,12,16170
10/30/22,Tonga,-21.179,-175.1982,16182,0,12,16170
10/31/22,Tonga,-21.179,-175.1982,16182,0,12,16170
11/1/22,Tonga,-21.179,-175.1982,16182,0,12,16170
11/2/22,Tonga,-21.179,-175.1982,16182,0,12,16170
11/3/22,Tonga,-21.179,-175.1982,16182,0,12,16170
11/4/22,Tonga,-21.179,-175.1982,16182,0,12,16170
11/5/22,Tonga,-21.179,-175.1982,16182,0,12,16170
11/6/22,Tonga,-21.179,-175.1982,16182,0,12,16170
11/7/22,Tonga,-21.179,-175.1982,16182,0,12,16170
11/8/22,Tonga,-21.179,-175.1982,16182,0,12,16170
11/9/22,Tonga,-21.179,-175.1982,16182,0,12,16170
11/10/22,Tonga,-21.179,-175.1982,16182,0,12,16170
11/11/22,Tonga,-21.179,-175.1982,16182,0,12,16170
11/12/22,Tonga,-21.179,-175.1982,16182,0,12,16170
11/13/22,Tonga,-21.179,-175.1982,16182,0,12,16170
11/14/22,Tonga,-21.179,-175.1982,16182,0,12,16170
11/15/22,Tonga,-21.179,-175.1982,16182,0,12,16170
11/16/22,Tonga,-21.179,-175.1982,16182,0,12,16170
11/17/22,Tonga,-21.179,-175.1982,16182,0,12,16170
11/18/22,Tonga,-21.179,-175.1982,16182,0,12,16170
11/19/22,Tonga,-21.179,-175.1982,16182,0,12,16170
11/20/22,Tonga,-21.179,-175.1982,16182,0,12,16170
11/21/22,Tonga,-21.179,-175.1982,16182,0,12,16170
11/22/22,Tonga,-21.179,-175.1982,16182,0,12,16170
11/23/22,Tonga,-21.179,-175.1982,16182,0,12,16170
11/24/22,Tonga,-21.179,-175.1982,16182,0,12,16170
11/25/22,Tonga,-21.179,-175.1982,16182,0,12,16170
11/26/22,Tonga,-21.179,-175.1982,16182,0,12,16170
11/27/22,Tonga,-21.179,-175.1982,16182,0,12,16170
11/28/22,Tonga,-21.179,-175.1982,16182,0,12,16170
11/29/22,Tonga,-21.179,-175.1982,16182,0,12,16170
11/30/22,Tonga,-21.179,-175.1982,16182,0,12,16170
12/1/22,Tonga,-21.179,-175.1982,16182,0,12,16170
12/2/22,Tonga,-21.179,-175.1982,16182,0,12,16170
12/3/22,Tonga,-21.179,-175.1982,16182,0,12,16170
12/4/22,Tonga,-21.179,-175.1982,16182,0,12,16170
12/5/22,Tonga,-21.179,-175.1982,16182,0,12,16170
12/6/22,Tonga,-21.179,-175.1982,16182,0,12,16170
12/7/22,Tonga,-21.179,-175.1982,16182,0,12,16170
12/8/22,Tonga,-21.179,-175.1982,16182,0,12,16170
12/9/22,Tonga,-21.179,-175.1982,16182,0,12,16170
12/10/22,Tonga,-21.179,-175.1982,16182,0,12,16170
12/11/22,Tonga,-21.179,-175.1982,16182,0,12,16170
12/12/22,Tonga,-21.179,-175.1982,16182,0,12,16170
12/13/22,Tonga,-21.179,-175.1982,16182,0,12,16170
12/14/22,Tonga,-21.179,-175.1982,16182,0,12,16170
12/15/22,Tonga,-21.179,-175.1982,16182,0,12,16170
12/16/22,Tonga,-21.179,-175.1982,16182,0,12,16170
12/17/22,Tonga,-21.179,-175.1982,16182,0,12,16170
1/1/22,Trinidad and Tobago,10.6918,-61.2225,92201,0,2883,89318
1/2/22,Trinidad and Tobago,10.6918,-61.2225,92659,0,2914,89745
1/3/22,Trinidad and Tobago,10.6918,-61.2225,92997,0,2936,90061
1/4/22,Trinidad and Tobago,10.6918,-61.2225,93634,0,2951,90683
1/5/22,Trinidad and Tobago,10.6918,-61.2225,94213,0,2973,91240
1/6/22,Trinidad and Tobago,10.6918,-61.2225,95096,0,2992,92104
1/7/22,Trinidad and Tobago,10.6918,-61.2225,96070,0,3010,93060
1/8/22,Trinidad and Tobago,10.6918,-61.2225,96555,0,3047,93508
1/9/22,Trinidad and Tobago,10.6918,-61.2225,96952,0,3066,93886
1/10/22,Trinidad and Tobago,10.6918,-61.2225,97354,0,3082,94272
1/11/22,Trinidad and Tobago,10.6918,-61.2225,97897,0,3102,94795
1/12/22,Trinidad and Tobago,10.6918,-61.2225,98474,0,3119,95355
1/13/22,Trinidad and Tobago,10.6918,-61.2225,98927,0,3134,95793
1/14/22,Trinidad and Tobago,10.6918,-61.2225,99780,0,3156,96624
1/15/22,Trinidad and Tobago,10.6918,-61.2225,100590,0,3180,97410
1/16/22,Trinidad and Tobago,10.6918,-61.2225,100994,0,3197,97797
1/17/22,Trinidad and Tobago,10.6918,-61.2225,101376,0,3208,98168
1/18/22,Trinidad and Tobago,10.6918,-61.2225,102024,0,3224,98800
1/19/22,Trinidad and Tobago,10.6918,-61.2225,102942,0,3238,99704
1/20/22,Trinidad and Tobago,10.6918,-61.2225,104005,0,3256,100749
1/21/22,Trinidad and Tobago,10.6918,-61.2225,105264,0,3278,101986
1/22/22,Trinidad and Tobago,10.6918,-61.2225,105969,0,3286,102683
1/23/22,Trinidad and Tobago,10.6918,-61.2225,106417,0,3302,103115
1/24/22,Trinidad and Tobago,10.6918,-61.2225,106806,0,3320,103486
1/25/22,Trinidad and Tobago,10.6918,-61.2225,107408,0,3335,104073
1/26/22,Trinidad and Tobago,10.6918,-61.2225,108088,0,3347,104741
1/27/22,Trinidad and Tobago,10.6918,-61.2225,108892,0,3358,105534
1/28/22,Trinidad and Tobago,10.6918,-61.2225,109660,0,3372,106288
1/29/22,Trinidad and Tobago,10.6918,-61.2225,110741,0,3381,107360
1/30/22,Trinidad and Tobago,10.6918,-61.2225,111190,0,3395,107795
1/31/22,Trinidad and Tobago,10.6918,-61.2225,111549,0,3404,108145
2/1/22,Trinidad and Tobago,10.6918,-61.2225,112019,0,3412,108607
2/2/22,Trinidad and Tobago,10.6918,-61.2225,112679,0,3423,109256
2/3/22,Trinidad and Tobago,10.6918,-61.2225,113317,0,3433,109884
2/4/22,Trinidad and Tobago,10.6918,-61.2225,113898,0,3448,110450
2/5/22,Trinidad and Tobago,10.6918,-61.2225,114765,0,3454,111311
2/6/22,Trinidad and Tobago,10.6918,-61.2225,115270,0,3460,111810
2/7/22,Trinidad and Tobago,10.6918,-61.2225,115843,0,3467,112376
2/8/22,Trinidad and Tobago,10.6918,-61.2225,116769,0,3486,113283
2/9/22,Trinidad and Tobago,10.6918,-61.2225,117525,0,3495,114030
2/10/22,Trinidad and Tobago,10.6918,-61.2225,118263,0,3501,114762
2/11/22,Trinidad and Tobago,10.6918,-61.2225,119226,0,3507,115719
2/12/22,Trinidad and Tobago,10.6918,-61.2225,120003,0,3519,116484
2/13/22,Trinidad and Tobago,10.6918,-61.2225,120385,0,3526,116859
2/14/22,Trinidad and Tobago,10.6918,-61.2225,120895,0,3531,117364
2/15/22,Trinidad and Tobago,10.6918,-61.2225,121271,0,3535,117736
2/16/22,Trinidad and Tobago,10.6918,-61.2225,121271,0,3535,117736
2/17/22,Trinidad and Tobago,10.6918,-61.2225,122093,0,3549,118544
2/18/22,Trinidad and Tobago,10.6918,-61.2225,122717,0,3553,119164
2/19/22,Trinidad and Tobago,10.6918,-61.2225,123157,0,3562,119595
2/20/22,Trinidad and Tobago,10.6918,-61.2225,123721,0,3567,120154
2/21/22,Trinidad and Tobago,10.6918,-61.2225,124076,0,3574,120502
2/22/22,Trinidad and Tobago,10.6918,-61.2225,124488,0,3582,120906
2/23/22,Trinidad and Tobago,10.6918,-61.2225,125210,0,3596,121614
2/24/22,Trinidad and Tobago,10.6918,-61.2225,125864,0,3603,122261
2/25/22,Trinidad and Tobago,10.6918,-61.2225,126502,0,3608,122894
2/26/22,Trinidad and Tobago,10.6918,-61.2225,126934,0,3617,123317
2/27/22,Trinidad and Tobago,10.6918,-61.2225,127404,0,3622,123782
2/28/22,Trinidad and Tobago,10.6918,-61.2225,127767,0,3628,124139
3/1/22,Trinidad and Tobago,10.6918,-61.2225,128145,0,3632,124513
3/2/22,Trinidad and Tobago,10.6918,-61.2225,128691,0,3637,125054
3/3/22,Trinidad and Tobago,10.6918,-61.2225,128976,0,3642,125334
3/4/22,Trinidad and Tobago,10.6918,-61.2225,129321,0,3649,125672
3/5/22,Trinidad and Tobago,10.6918,-61.2225,129963,0,3652,126311
3/6/22,Trinidad and Tobago,10.6918,-61.2225,130400,0,3659,126741
3/7/22,Trinidad and Tobago,10.6918,-61.2225,130532,0,3665,126867
3/8/22,Trinidad and Tobago,10.6918,-61.2225,130964,0,3667,127297
3/9/22,Trinidad and Tobago,10.6918,-61.2225,131378,0,3669,127709
3/10/22,Trinidad and Tobago,10.6918,-61.2225,131840,0,3673,128167
3/11/22,Trinidad and Tobago,10.6918,-61.2225,132383,0,3676,128707
3/12/22,Trinidad and Tobago,10.6918,-61.2225,132708,0,3681,129027
3/13/22,Trinidad and Tobago,10.6918,-61.2225,132933,0,3684,129249
3/14/22,Trinidad and Tobago,10.6918,-61.2225,133151,0,3686,129465
3/15/22,Trinidad and Tobago,10.6918,-61.2225,133393,0,3690,129703
3/16/22,Trinidad and Tobago,10.6918,-61.2225,133788,0,3695,130093
3/17/22,Trinidad and Tobago,10.6918,-61.2225,134272,0,3700,130572
3/18/22,Trinidad and Tobago,10.6918,-61.2225,134445,0,3704,130741
3/19/22,Trinidad and Tobago,10.6918,-61.2225,134878,0,3708,131170
3/20/22,Trinidad and Tobago,10.6918,-61.2225,135097,0,3712,131385
3/21/22,Trinidad and Tobago,10.6918,-61.2225,135328,0,3716,131612
3/22/22,Trinidad and Tobago,10.6918,-61.2225,135579,0,3719,131860
3/23/22,Trinidad and Tobago,10.6918,-61.2225,135854,0,3722,132132
3/24/22,Trinidad and Tobago,10.6918,-61.2225,136220,0,3727,132493
3/25/22,Trinidad and Tobago,10.6918,-61.2225,136561,0,3729,132832
3/26/22,Trinidad and Tobago,10.6918,-61.2225,136561,0,3729,132832
3/27/22,Trinidad and Tobago,10.6918,-61.2225,136828,0,3734,133094
3/28/22,Trinidad and Tobago,10.6918,-61.2225,137248,0,3738,133510
3/29/22,Trinidad and Tobago,10.6918,-61.2225,137496,0,3741,133755
3/30/22,Trinidad and Tobago,10.6918,-61.2225,137757,0,3746,134011
3/31/22,Trinidad and Tobago,10.6918,-61.2225,137860,0,3750,134110
4/1/22,Trinidad and Tobago,10.6918,-61.2225,138159,0,3754,134405
4/2/22,Trinidad and Tobago,10.6918,-61.2225,138159,0,3754,134405
4/3/22,Trinidad and Tobago,10.6918,-61.2225,138425,0,3756,134669
4/4/22,Trinidad and Tobago,10.6918,-61.2225,138793,0,3763,135030
4/5/22,Trinidad and Tobago,10.6918,-61.2225,139114,0,3766,135348
4/6/22,Trinidad and Tobago,10.6918,-61.2225,139397,0,3770,135627
4/7/22,Trinidad and Tobago,10.6918,-61.2225,139595,0,3773,135822
4/8/22,Trinidad and Tobago,10.6918,-61.2225,139973,0,3774,136199
4/9/22,Trinidad and Tobago,10.6918,-61.2225,139973,0,3774,136199
4/10/22,Trinidad and Tobago,10.6918,-61.2225,140332,0,3780,136552
4/11/22,Trinidad and Tobago,10.6918,-61.2225,140457,0,3783,136674
4/12/22,Trinidad and Tobago,10.6918,-61.2225,140781,0,3787,136994
4/13/22,Trinidad and Tobago,10.6918,-61.2225,141155,0,3792,137363
4/14/22,Trinidad and Tobago,10.6918,-61.2225,141604,0,3794,137810
4/15/22,Trinidad and Tobago,10.6918,-61.2225,141853,0,3798,138055
4/16/22,Trinidad and Tobago,10.6918,-61.2225,142076,0,3800,138276
4/17/22,Trinidad and Tobago,10.6918,-61.2225,142222,0,3800,138422
4/18/22,Trinidad and Tobago,10.6918,-61.2225,142422,0,3803,138619
4/19/22,Trinidad and Tobago,10.6918,-61.2225,142514,0,3806,138708
4/20/22,Trinidad and Tobago,10.6918,-61.2225,142919,0,3807,139112
4/21/22,Trinidad and Tobago,10.6918,-61.2225,143465,0,3808,139657
4/22/22,Trinidad and Tobago,10.6918,-61.2225,143884,0,3811,140073
4/23/22,Trinidad and Tobago,10.6918,-61.2225,144359,0,3812,140547
4/24/22,Trinidad and Tobago,10.6918,-61.2225,144563,0,3813,140750
4/25/22,Trinidad and Tobago,10.6918,-61.2225,145021,0,3816,141205
4/26/22,Trinidad and Tobago,10.6918,-61.2225,145597,0,3817,141780
4/27/22,Trinidad and Tobago,10.6918,-61.2225,146140,0,3819,142321
4/28/22,Trinidad and Tobago,10.6918,-61.2225,146942,0,3821,143121
4/29/22,Trinidad and Tobago,10.6918,-61.2225,147450,0,3824,143626
4/30/22,Trinidad and Tobago,10.6918,-61.2225,147867,0,3829,144038
5/1/22,Trinidad and Tobago,10.6918,-61.2225,148335,0,3831,144504
5/2/22,Trinidad and Tobago,10.6918,-61.2225,148630,0,3833,144797
5/3/22,Trinidad and Tobago,10.6918,-61.2225,148977,0,3838,145139
5/4/22,Trinidad and Tobago,10.6918,-61.2225,149532,0,3843,145689
5/5/22,Trinidad and Tobago,10.6918,-61.2225,149950,0,3845,146105
5/6/22,Trinidad and Tobago,10.6918,-61.2225,150481,0,3845,146636
5/7/22,Trinidad and Tobago,10.6918,-61.2225,151235,0,3847,147388
5/8/22,Trinidad and Tobago,10.6918,-61.2225,151592,0,3852,147740
5/9/22,Trinidad and Tobago,10.6918,-61.2225,151806,0,3856,147950
5/10/22,Trinidad and Tobago,10.6918,-61.2225,152380,0,3861,148519
5/11/22,Trinidad and Tobago,10.6918,-61.2225,152964,0,3863,149101
5/12/22,Trinidad and Tobago,10.6918,-61.2225,153471,0,3866,149605
5/13/22,Trinidad and Tobago,10.6918,-61.2225,153471,0,3866,149605
5/14/22,Trinidad and Tobago,10.6918,-61.2225,154643,0,3871,150772
5/15/22,Trinidad and Tobago,10.6918,-61.2225,155147,0,3871,151276
5/16/22,Trinidad and Tobago,10.6918,-61.2225,155384,0,3878,151506
5/17/22,Trinidad and Tobago,10.6918,-61.2225,155893,0,3881,152012
5/18/22,Trinidad and Tobago,10.6918,-61.2225,156327,0,3883,152444
5/19/22,Trinidad and Tobago,10.6918,-61.2225,156940,0,3886,153054
5/20/22,Trinidad and Tobago,10.6918,-61.2225,157363,0,3890,153473
5/21/22,Trinidad and Tobago,10.6918,-61.2225,157880,0,3890,153990
5/22/22,Trinidad and Tobago,10.6918,-61.2225,158225,0,3893,154332
5/23/22,Trinidad and Tobago,10.6918,-61.2225,158668,0,3895,154773
5/24/22,Trinidad and Tobago,10.6918,-61.2225,159344,0,3896,155448
5/25/22,Trinidad and Tobago,10.6918,-61.2225,159719,0,3899,155820
5/26/22,Trinidad and Tobago,10.6918,-61.2225,160158,0,3902,156256
5/27/22,Trinidad and Tobago,10.6918,-61.2225,160493,0,3903,156590
5/28/22,Trinidad and Tobago,10.6918,-61.2225,160886,0,3909,156977
5/29/22,Trinidad and Tobago,10.6918,-61.2225,161208,0,3912,157296
5/30/22,Trinidad and Tobago,10.6918,-61.2225,161435,0,3916,157519
5/31/22,Trinidad and Tobago,10.6918,-61.2225,161584,0,3917,157667
6/1/22,Trinidad and Tobago,10.6918,-61.2225,161790,0,3919,157871
6/2/22,Trinidad and Tobago,10.6918,-61.2225,162187,0,3922,158265
6/3/22,Trinidad and Tobago,10.6918,-61.2225,162441,0,3927,158514
6/4/22,Trinidad and Tobago,10.6918,-61.2225,162756,0,3932,158824
6/5/22,Trinidad and Tobago,10.6918,-61.2225,162849,0,3938,158911
6/6/22,Trinidad and Tobago,10.6918,-61.2225,162945,0,3943,159002
6/7/22,Trinidad and Tobago,10.6918,-61.2225,163178,0,3947,159231
6/8/22,Trinidad and Tobago,10.6918,-61.2225,163507,0,3950,159557
6/9/22,Trinidad and Tobago,10.6918,-61.2225,163885,0,3952,159933
6/10/22,Trinidad and Tobago,10.6918,-61.2225,164315,0,3956,160359
6/11/22,Trinidad and Tobago,10.6918,-61.2225,164506,0,3959,160547
6/12/22,Trinidad and Tobago,10.6918,-61.2225,164723,0,3963,160760
6/13/22,Trinidad and Tobago,10.6918,-61.2225,164829,0,3965,160864
6/14/22,Trinidad and Tobago,10.6918,-61.2225,164950,0,3967,160983
6/15/22,Trinidad and Tobago,10.6918,-61.2225,165144,0,3968,161176
6/16/22,Trinidad and Tobago,10.6918,-61.2225,165468,0,3968,161500
6/17/22,Trinidad and Tobago,10.6918,-61.2225,165600,0,3973,161627
6/18/22,Trinidad and Tobago,10.6918,-61.2225,165706,0,3977,161729
6/19/22,Trinidad and Tobago,10.6918,-61.2225,165807,0,3979,161828
6/20/22,Trinidad and Tobago,10.6918,-61.2225,165908,0,3984,161924
6/21/22,Trinidad and Tobago,10.6918,-61.2225,166053,0,3987,162066
6/22/22,Trinidad and Tobago,10.6918,-61.2225,166290,0,3990,162300
6/23/22,Trinidad and Tobago,10.6918,-61.2225,166420,0,3994,162426
6/24/22,Trinidad and Tobago,10.6918,-61.2225,166576,0,3997,162579
6/25/22,Trinidad and Tobago,10.6918,-61.2225,166682,0,4000,162682
6/26/22,Trinidad and Tobago,10.6918,-61.2225,166712,0,4002,162710
6/27/22,Trinidad and Tobago,10.6918,-61.2225,166712,0,4002,162710
6/28/22,Trinidad and Tobago,10.6918,-61.2225,166900,0,4005,162895
6/29/22,Trinidad and Tobago,10.6918,-61.2225,166979,0,4009,162970
6/30/22,Trinidad and Tobago,10.6918,-61.2225,167097,0,4011,163086
7/1/22,Trinidad and Tobago,10.6918,-61.2225,167300,0,4012,163288
7/2/22,Trinidad and Tobago,10.6918,-61.2225,167440,0,4013,163427
7/3/22,Trinidad and Tobago,10.6918,-61.2225,167495,0,4013,163482
7/4/22,Trinidad and Tobago,10.6918,-61.2225,167495,0,4013,163482
7/5/22,Trinidad and Tobago,10.6918,-61.2225,167585,0,4016,163569
7/6/22,Trinidad and Tobago,10.6918,-61.2225,167780,0,4020,163760
7/7/22,Trinidad and Tobago,10.6918,-61.2225,167896,0,4021,163875
7/8/22,Trinidad and Tobago,10.6918,-61.2225,167896,0,4021,163875
7/9/22,Trinidad and Tobago,10.6918,-61.2225,168156,0,4027,164129
7/10/22,Trinidad and Tobago,10.6918,-61.2225,168237,0,4027,164210
7/11/22,Trinidad and Tobago,10.6918,-61.2225,168322,0,4028,164294
7/12/22,Trinidad and Tobago,10.6918,-61.2225,168427,0,4031,164396
7/13/22,Trinidad and Tobago,10.6918,-61.2225,168617,0,4033,164584
7/14/22,Trinidad and Tobago,10.6918,-61.2225,168808,0,4034,164774
7/15/22,Trinidad and Tobago,10.6918,-61.2225,169028,0,4036,164992
7/16/22,Trinidad and Tobago,10.6918,-61.2225,169137,0,4038,165099
7/17/22,Trinidad and Tobago,10.6918,-61.2225,169180,0,4038,165142
7/18/22,Trinidad and Tobago,10.6918,-61.2225,169227,0,4039,165188
7/19/22,Trinidad and Tobago,10.6918,-61.2225,169428,0,4039,165389
7/20/22,Trinidad and Tobago,10.6918,-61.2225,169581,0,4039,165542
7/21/22,Trinidad and Tobago,10.6918,-61.2225,169805,0,4041,165764
7/22/22,Trinidad and Tobago,10.6918,-61.2225,169930,0,4041,165889
7/23/22,Trinidad and Tobago,10.6918,-61.2225,170063,0,4042,166021
7/24/22,Trinidad and Tobago,10.6918,-61.2225,170063,0,4042,166021
7/25/22,Trinidad and Tobago,10.6918,-61.2225,170100,0,4045,166055
7/26/22,Trinidad and Tobago,10.6918,-61.2225,170459,0,4046,166413
7/27/22,Trinidad and Tobago,10.6918,-61.2225,170710,0,4046,166664
7/28/22,Trinidad and Tobago,10.6918,-61.2225,170710,0,4046,166664
7/29/22,Trinidad and Tobago,10.6918,-61.2225,171172,0,4048,167124
7/30/22,Trinidad and Tobago,10.6918,-61.2225,171334,0,4051,167283
7/31/22,Trinidad and Tobago,10.6918,-61.2225,171510,0,4053,167457
8/1/22,Trinidad and Tobago,10.6918,-61.2225,171590,0,4053,167537
8/2/22,Trinidad and Tobago,10.6918,-61.2225,171590,0,4053,167537
8/3/22,Trinidad and Tobago,10.6918,-61.2225,171906,0,4057,167849
8/4/22,Trinidad and Tobago,10.6918,-61.2225,172267,0,4061,168206
8/5/22,Trinidad and Tobago,10.6918,-61.2225,172576,0,4065,168511
8/6/22,Trinidad and Tobago,10.6918,-61.2225,172889,0,4067,168822
8/7/22,Trinidad and Tobago,10.6918,-61.2225,173006,0,4068,168938
8/8/22,Trinidad and Tobago,10.6918,-61.2225,173208,0,4070,169138
8/9/22,Trinidad and Tobago,10.6918,-61.2225,173535,0,4070,169465
8/10/22,Trinidad and Tobago,10.6918,-61.2225,173843,0,4070,169773
8/11/22,Trinidad and Tobago,10.6918,-61.2225,174159,0,4070,170089
8/12/22,Trinidad and Tobago,10.6918,-61.2225,174552,0,4071,170481
8/13/22,Trinidad and Tobago,10.6918,-61.2225,174896,0,4075,170821
8/14/22,Trinidad and Tobago,10.6918,-61.2225,175098,0,4079,171019
8/15/22,Trinidad and Tobago,10.6918,-61.2225,175273,0,4079,171194
8/16/22,Trinidad and Tobago,10.6918,-61.2225,175494,0,4080,171414
8/17/22,Trinidad and Tobago,10.6918,-61.2225,175856,0,4084,171772
8/18/22,Trinidad and Tobago,10.6918,-61.2225,176107,0,4089,172018
8/19/22,Trinidad and Tobago,10.6918,-61.2225,176468,0,4092,172376
8/20/22,Trinidad and Tobago,10.6918,-61.2225,176821,0,4095,172726
8/21/22,Trinidad and Tobago,10.6918,-61.2225,177008,0,4100,172908
8/22/22,Trinidad and Tobago,10.6918,-61.2225,177113,0,4105,173008
8/23/22,Trinidad and Tobago,10.6918,-61.2225,177408,0,4108,173300
8/24/22,Trinidad and Tobago,10.6918,-61.2225,177583,0,4113,173470
8/25/22,Trinidad and Tobago,10.6918,-61.2225,177824,0,4119,173705
8/26/22,Trinidad and Tobago,10.6918,-61.2225,178111,0,4123,173988
8/27/22,Trinidad and Tobago,10.6918,-61.2225,178532,0,4128,174404
8/28/22,Trinidad and Tobago,10.6918,-61.2225,178687,0,4132,174555
8/29/22,Trinidad and Tobago,10.6918,-61.2225,178841,0,4134,174707
8/30/22,Trinidad and Tobago,10.6918,-61.2225,178964,0,4139,174825
8/31/22,Trinidad and Tobago,10.6918,-61.2225,179146,0,4144,175002
9/1/22,Trinidad and Tobago,10.6918,-61.2225,179248,0,4148,175100
9/2/22,Trinidad and Tobago,10.6918,-61.2225,179457,0,4150,175307
9/3/22,Trinidad and Tobago,10.6918,-61.2225,179683,0,4154,175529
9/4/22,Trinidad and Tobago,10.6918,-61.2225,179886,0,4158,175728
9/5/22,Trinidad and Tobago,10.6918,-61.2225,180008,0,4161,175847
9/6/22,Trinidad and Tobago,10.6918,-61.2225,180310,0,4162,176148
9/7/22,Trinidad and Tobago,10.6918,-61.2225,180549,0,4166,176383
9/8/22,Trinidad and Tobago,10.6918,-61.2225,180549,0,4166,176383
9/9/22,Trinidad and Tobago,10.6918,-61.2225,180972,0,4166,176806
9/10/22,Trinidad and Tobago,10.6918,-61.2225,181206,0,4168,177038
9/11/22,Trinidad and Tobago,10.6918,-61.2225,181320,0,4171,177149
9/12/22,Trinidad and Tobago,10.6918,-61.2225,181421,0,4174,177247
9/13/22,Trinidad and Tobago,10.6918,-61.2225,181567,0,4176,177391
9/14/22,Trinidad and Tobago,10.6918,-61.2225,181749,0,4180,177569
9/15/22,Trinidad and Tobago,10.6918,-61.2225,181903,0,4183,177720
9/16/22,Trinidad and Tobago,10.6918,-61.2225,182043,0,4184,177859
9/17/22,Trinidad and Tobago,10.6918,-61.2225,182144,0,4189,177955
9/18/22,Trinidad and Tobago,10.6918,-61.2225,182247,0,4191,178056
9/19/22,Trinidad and Tobago,10.6918,-61.2225,182306,0,4194,178112
9/20/22,Trinidad and Tobago,10.6918,-61.2225,182480,0,4194,178286
9/21/22,Trinidad and Tobago,10.6918,-61.2225,182597,0,4195,178402
9/22/22,Trinidad and Tobago,10.6918,-61.2225,182597,0,4195,178402
9/23/22,Trinidad and Tobago,10.6918,-61.2225,182597,0,4195,178402
9/24/22,Trinidad and Tobago,10.6918,-61.2225,182597,0,4195,178402
9/25/22,Trinidad and Tobago,10.6918,-61.2225,182597,0,4195,178402
9/26/22,Trinidad and Tobago,10.6918,-61.2225,182597,0,4195,178402
9/27/22,Trinidad and Tobago,10.6918,-61.2225,182597,0,4195,178402
9/28/22,Trinidad and Tobago,10.6918,-61.2225,182597,0,4195,178402
9/29/22,Trinidad and Tobago,10.6918,-61.2225,183181,0,4207,178974
9/30/22,Trinidad and Tobago,10.6918,-61.2225,183181,0,4207,178974
10/1/22,Trinidad and Tobago,10.6918,-61.2225,183181,0,4207,178974
10/2/22,Trinidad and Tobago,10.6918,-61.2225,183181,0,4207,178974
10/3/22,Trinidad and Tobago,10.6918,-61.2225,183181,0,4207,178974
10/4/22,Trinidad and Tobago,10.6918,-61.2225,183181,0,4207,178974
10/5/22,Trinidad and Tobago,10.6918,-61.2225,183181,0,4207,178974
10/6/22,Trinidad and Tobago,10.6918,-61.2225,183824,0,4224,179600
10/7/22,Trinidad and Tobago,10.6918,-61.2225,183824,0,4224,179600
10/8/22,Trinidad and Tobago,10.6918,-61.2225,183824,0,4224,179600
10/9/22,Trinidad and Tobago,10.6918,-61.2225,183824,0,4224,179600
10/10/22,Trinidad and Tobago,10.6918,-61.2225,183824,0,4224,179600
10/11/22,Trinidad and Tobago,10.6918,-61.2225,183824,0,4224,179600
10/12/22,Trinidad and Tobago,10.6918,-61.2225,183824,0,4224,179600
10/13/22,Trinidad and Tobago,10.6918,-61.2225,184261,0,4235,180026
10/14/22,Trinidad and Tobago,10.6918,-61.2225,184261,0,4235,180026
10/15/22,Trinidad and Tobago,10.6918,-61.2225,184261,0,4235,180026
10/16/22,Trinidad and Tobago,10.6918,-61.2225,184261,0,4235,180026
10/17/22,Trinidad and Tobago,10.6918,-61.2225,184261,0,4235,180026
10/18/22,Trinidad and Tobago,10.6918,-61.2225,184261,0,4235,180026
10/19/22,Trinidad and Tobago,10.6918,-61.2225,184524,0,4241,180283
10/20/22,Trinidad and Tobago,10.6918,-61.2225,184524,0,4241,180283
10/21/22,Trinidad and Tobago,10.6918,-61.2225,184524,0,4241,180283
10/22/22,Trinidad and Tobago,10.6918,-61.2225,184524,0,4241,180283
10/23/22,Trinidad and Tobago,10.6918,-61.2225,184524,0,4241,180283
10/24/22,Trinidad and Tobago,10.6918,-61.2225,184524,0,4241,180283
10/25/22,Trinidad and Tobago,10.6918,-61.2225,184713,0,4249,180464
10/26/22,Trinidad and Tobago,10.6918,-61.2225,184713,0,4249,180464
10/27/22,Trinidad and Tobago,10.6918,-61.2225,184713,0,4249,180464
10/28/22,Trinidad and Tobago,10.6918,-61.2225,184713,0,4249,180464
10/29/22,Trinidad and Tobago,10.6918,-61.2225,184713,0,4249,180464
10/30/22,Trinidad and Tobago,10.6918,-61.2225,184713,0,4249,180464
10/31/22,Trinidad and Tobago,10.6918,-61.2225,184713,0,4249,180464
11/1/22,Trinidad and Tobago,10.6918,-61.2225,184854,0,4255,180599
11/2/22,Trinidad and Tobago,10.6918,-61.2225,184854,0,4255,180599
11/3/22,Trinidad and Tobago,10.6918,-61.2225,184854,0,4255,180599
11/4/22,Trinidad and Tobago,10.6918,-61.2225,184854,0,4255,180599
11/5/22,Trinidad and Tobago,10.6918,-61.2225,184854,0,4255,180599
11/6/22,Trinidad and Tobago,10.6918,-61.2225,184854,0,4255,180599
11/7/22,Trinidad and Tobago,10.6918,-61.2225,184854,0,4255,180599
11/8/22,Trinidad and Tobago,10.6918,-61.2225,184949,0,4257,180692
11/9/22,Trinidad and Tobago,10.6918,-61.2225,184949,0,4257,180692
11/10/22,Trinidad and Tobago,10.6918,-61.2225,184949,0,4257,180692
11/11/22,Trinidad and Tobago,10.6918,-61.2225,184949,0,4257,180692
11/12/22,Trinidad and Tobago,10.6918,-61.2225,184949,0,4257,180692
11/13/22,Trinidad and Tobago,10.6918,-61.2225,184949,0,4257,180692
11/14/22,Trinidad and Tobago,10.6918,-61.2225,184949,0,4257,180692
11/15/22,Trinidad and Tobago,10.6918,-61.2225,185094,0,4263,180831
11/16/22,Trinidad and Tobago,10.6918,-61.2225,185094,0,4263,180831
11/17/22,Trinidad and Tobago,10.6918,-61.2225,185094,0,4263,180831
11/18/22,Trinidad and Tobago,10.6918,-61.2225,185094,0,4263,180831
11/19/22,Trinidad and Tobago,10.6918,-61.2225,185094,0,4263,180831
11/20/22,Trinidad and Tobago,10.6918,-61.2225,185094,0,4263,180831
11/21/22,Trinidad and Tobago,10.6918,-61.2225,185094,0,4263,180831
11/22/22,Trinidad and Tobago,10.6918,-61.2225,185237,0,4266,180971
11/23/22,Trinidad and Tobago,10.6918,-61.2225,185237,0,4266,180971
11/24/22,Trinidad and Tobago,10.6918,-61.2225,185237,0,4266,180971
11/25/22,Trinidad and Tobago,10.6918,-61.2225,185237,0,4266,180971
11/26/22,Trinidad and Tobago,10.6918,-61.2225,185237,0,4266,180971
11/27/22,Trinidad and Tobago,10.6918,-61.2225,185237,0,4266,180971
11/28/22,Trinidad and Tobago,10.6918,-61.2225,185237,0,4266,180971
11/29/22,Trinidad and Tobago,10.6918,-61.2225,185377,0,4267,181110
11/30/22,Trinidad and Tobago,10.6918,-61.2225,185377,0,4267,181110
12/1/22,Trinidad and Tobago,10.6918,-61.2225,185377,0,4267,181110
12/2/22,Trinidad and Tobago,10.6918,-61.2225,185377,0,4267,181110
12/3/22,Trinidad and Tobago,10.6918,-61.2225,185377,0,4267,181110
12/4/22,Trinidad and Tobago,10.6918,-61.2225,185377,0,4267,181110
12/5/22,Trinidad and Tobago,10.6918,-61.2225,185377,0,4267,181110
12/6/22,Trinidad and Tobago,10.6918,-61.2225,185528,0,4268,181260
12/7/22,Trinidad and Tobago,10.6918,-61.2225,185528,0,4268,181260
12/8/22,Trinidad and Tobago,10.6918,-61.2225,185528,0,4268,181260
12/9/22,Trinidad and Tobago,10.6918,-61.2225,185528,0,4268,181260
12/10/22,Trinidad and Tobago,10.6918,-61.2225,185528,0,4268,181260
12/11/22,Trinidad and Tobago,10.6918,-61.2225,185528,0,4268,181260
12/12/22,Trinidad and Tobago,10.6918,-61.2225,185528,0,4268,181260
12/13/22,Trinidad and Tobago,10.6918,-61.2225,185708,0,4271,181437
12/14/22,Trinidad and Tobago,10.6918,-61.2225,185708,0,4271,181437
12/15/22,Trinidad and Tobago,10.6918,-61.2225,185708,0,4271,181437
12/16/22,Trinidad and Tobago,10.6918,-61.2225,185708,0,4271,181437
12/17/22,Trinidad and Tobago,10.6918,-61.2225,185708,0,4271,181437
1/1/22,Tunisia,33.886917,9.537499,727843,0,25576,702267
1/2/22,Tunisia,33.886917,9.537499,728260,0,25586,702674
1/3/22,Tunisia,33.886917,9.537499,728802,0,25588,703214
1/4/22,Tunisia,33.886917,9.537499,731077,0,25606,705471
1/5/22,Tunisia,33.886917,9.537499,733379,0,25617,707762
1/6/22,Tunisia,33.886917,9.537499,735973,0,25630,710343
1/7/22,Tunisia,33.886917,9.537499,738442,0,25643,712799
1/8/22,Tunisia,33.886917,9.537499,741259,0,25655,715604
1/9/22,Tunisia,33.886917,9.537499,743838,0,25665,718173
1/10/22,Tunisia,33.886917,9.537499,744967,0,25670,719297
1/11/22,Tunisia,33.886917,9.537499,749832,0,25707,724125
1/12/22,Tunisia,33.886917,9.537499,756155,0,25731,730424
1/13/22,Tunisia,33.886917,9.537499,762717,0,25744,736973
1/14/22,Tunisia,33.886917,9.537499,771177,0,25755,745422
1/15/22,Tunisia,33.886917,9.537499,780746,0,25777,754969
1/16/22,Tunisia,33.886917,9.537499,780746,0,25777,754969
1/17/22,Tunisia,33.886917,9.537499,788012,0,25803,762209
1/18/22,Tunisia,33.886917,9.537499,791917,0,25817,766100
1/19/22,Tunisia,33.886917,9.537499,804353,0,25846,778507
1/20/22,Tunisia,33.886917,9.537499,817051,0,25881,791170
1/21/22,Tunisia,33.886917,9.537499,826838,0,25912,800926
1/22/22,Tunisia,33.886917,9.537499,846761,0,25954,820807
1/23/22,Tunisia,33.886917,9.537499,846761,0,25954,820807
1/24/22,Tunisia,33.886917,9.537499,853905,0,25988,827917
1/25/22,Tunisia,33.886917,9.537499,856739,0,25999,830740
1/26/22,Tunisia,33.886917,9.537499,866445,0,26051,840394
1/27/22,Tunisia,33.886917,9.537499,876245,0,26096,850149
1/28/22,Tunisia,33.886917,9.537499,884588,0,26132,858456
1/29/22,Tunisia,33.886917,9.537499,901107,0,26229,874878
1/30/22,Tunisia,33.886917,9.537499,901107,0,26229,874878
1/31/22,Tunisia,33.886917,9.537499,909813,0,26288,883525
2/1/22,Tunisia,33.886917,9.537499,917814,0,26362,891452
2/2/22,Tunisia,33.886917,9.537499,917814,0,26362,891452
2/3/22,Tunisia,33.886917,9.537499,930090,0,26496,903594
2/4/22,Tunisia,33.886917,9.537499,934712,0,26548,908164
2/5/22,Tunisia,33.886917,9.537499,940223,0,26612,913611
2/6/22,Tunisia,33.886917,9.537499,944175,0,26679,917496
2/7/22,Tunisia,33.886917,9.537499,945453,0,26693,918760
2/8/22,Tunisia,33.886917,9.537499,950575,0,26824,923751
2/9/22,Tunisia,33.886917,9.537499,954726,0,26889,927837
2/10/22,Tunisia,33.886917,9.537499,958549,0,26941,931608
2/11/22,Tunisia,33.886917,9.537499,961877,0,27004,934873
2/12/22,Tunisia,33.886917,9.537499,964957,0,27065,937892
2/13/22,Tunisia,33.886917,9.537499,967052,0,27119,939933
2/14/22,Tunisia,33.886917,9.537499,967052,0,27119,939933
2/15/22,Tunisia,33.886917,9.537499,968393,0,27145,941248
2/16/22,Tunisia,33.886917,9.537499,971460,0,27233,944227
2/17/22,Tunisia,33.886917,9.537499,974214,0,27295,946919
2/18/22,Tunisia,33.886917,9.537499,979612,0,27375,952237
2/19/22,Tunisia,33.886917,9.537499,979612,0,27375,952237
2/20/22,Tunisia,33.886917,9.537499,986336,0,27448,958888
2/21/22,Tunisia,33.886917,9.537499,987256,0,27486,959770
2/22/22,Tunisia,33.886917,9.537499,988329,0,27512,960817
2/23/22,Tunisia,33.886917,9.537499,990483,0,27592,962891
2/24/22,Tunisia,33.886917,9.537499,992574,0,27640,964934
2/25/22,Tunisia,33.886917,9.537499,994543,0,27668,966875
2/26/22,Tunisia,33.886917,9.537499,995713,0,27702,968011
2/27/22,Tunisia,33.886917,9.537499,997754,0,27773,969981
2/28/22,Tunisia,33.886917,9.537499,998230,0,27784,970446
3/1/22,Tunisia,33.886917,9.537499,998230,0,27784,970446
3/2/22,Tunisia,33.886917,9.537499,999441,0,27824,971617
3/3/22,Tunisia,33.886917,9.537499,1000518,0,27857,972661
3/4/22,Tunisia,33.886917,9.537499,1001754,0,27874,973880
3/5/22,Tunisia,33.886917,9.537499,1005167,0,27922,977245
3/6/22,Tunisia,33.886917,9.537499,1005167,0,27922,977245
3/7/22,Tunisia,33.886917,9.537499,1005804,0,27943,977861
3/8/22,Tunisia,33.886917,9.537499,1016894,0,27959,988935
3/9/22,Tunisia,33.886917,9.537499,1017907,0,27989,989918
3/10/22,Tunisia,33.886917,9.537499,1018447,0,28009,990438
3/11/22,Tunisia,33.886917,9.537499,1020546,0,28018,992528
3/12/22,Tunisia,33.886917,9.537499,1028717,0,28031,1000686
3/13/22,Tunisia,33.886917,9.537499,1029228,0,28046,1001182
3/14/22,Tunisia,33.886917,9.537499,1029596,0,28062,1001534
3/15/22,Tunisia,33.886917,9.537499,1029762,0,28065,1001697
3/16/22,Tunisia,33.886917,9.537499,1029762,0,28065,1001697
3/17/22,Tunisia,33.886917,9.537499,1029762,0,28065,1001697
3/18/22,Tunisia,33.886917,9.537499,1029762,0,28065,1001697
3/19/22,Tunisia,33.886917,9.537499,1029762,0,28065,1001697
3/20/22,Tunisia,33.886917,9.537499,1029762,0,28065,1001697
3/21/22,Tunisia,33.886917,9.537499,1029762,0,28065,1001697
3/22/22,Tunisia,33.886917,9.537499,1033731,0,28165,1005566
3/23/22,Tunisia,33.886917,9.537499,1033731,0,28165,1005566
3/24/22,Tunisia,33.886917,9.537499,1033731,0,28165,1005566
3/25/22,Tunisia,33.886917,9.537499,1033731,0,28165,1005566
3/26/22,Tunisia,33.886917,9.537499,1033731,0,28165,1005566
3/27/22,Tunisia,33.886917,9.537499,1033731,0,28165,1005566
3/28/22,Tunisia,33.886917,9.537499,1033731,0,28165,1005566
3/29/22,Tunisia,33.886917,9.537499,1035884,0,28323,1007561
3/30/22,Tunisia,33.886917,9.537499,1035884,0,28323,1007561
3/31/22,Tunisia,33.886917,9.537499,1035884,0,28323,1007561
4/1/22,Tunisia,33.886917,9.537499,1035884,0,28323,1007561
4/2/22,Tunisia,33.886917,9.537499,1035884,0,28323,1007561
4/3/22,Tunisia,33.886917,9.537499,1035884,0,28323,1007561
4/4/22,Tunisia,33.886917,9.537499,1035884,0,28323,1007561
4/5/22,Tunisia,33.886917,9.537499,1037358,0,28425,1008933
4/6/22,Tunisia,33.886917,9.537499,1037358,0,28425,1008933
4/7/22,Tunisia,33.886917,9.537499,1037358,0,28425,1008933
4/8/22,Tunisia,33.886917,9.537499,1037358,0,28425,1008933
4/9/22,Tunisia,33.886917,9.537499,1037358,0,28425,1008933
4/10/22,Tunisia,33.886917,9.537499,1037358,0,28425,1008933
4/11/22,Tunisia,33.886917,9.537499,1037358,0,28425,1008933
4/12/22,Tunisia,33.886917,9.537499,1038668,0,28509,1010159
4/13/22,Tunisia,33.886917,9.537499,1038668,0,28509,1010159
4/14/22,Tunisia,33.886917,9.537499,1038668,0,28509,1010159
4/15/22,Tunisia,33.886917,9.537499,1038668,0,28509,1010159
4/16/22,Tunisia,33.886917,9.537499,1038668,0,28509,1010159
4/17/22,Tunisia,33.886917,9.537499,1038668,0,28509,1010159
4/18/22,Tunisia,33.886917,9.537499,1038668,0,28509,1010159
4/19/22,Tunisia,33.886917,9.537499,1039532,0,28533,1010999
4/20/22,Tunisia,33.886917,9.537499,1039532,0,28533,1010999
4/21/22,Tunisia,33.886917,9.537499,1039532,0,28533,1010999
4/22/22,Tunisia,33.886917,9.537499,1039532,0,28533,1010999
4/23/22,Tunisia,33.886917,9.537499,1039532,0,28533,1010999
4/24/22,Tunisia,33.886917,9.537499,1039532,0,28533,1010999
4/25/22,Tunisia,33.886917,9.537499,1039532,0,28533,1010999
4/26/22,Tunisia,33.886917,9.537499,1040193,0,28550,1011643
4/27/22,Tunisia,33.886917,9.537499,1040193,0,28550,1011643
4/28/22,Tunisia,33.886917,9.537499,1040193,0,28550,1011643
4/29/22,Tunisia,33.886917,9.537499,1040193,0,28550,1011643
4/30/22,Tunisia,33.886917,9.537499,1040193,0,28550,1011643
5/1/22,Tunisia,33.886917,9.537499,1040193,0,28550,1011643
5/2/22,Tunisia,33.886917,9.537499,1040193,0,28550,1011643
5/3/22,Tunisia,33.886917,9.537499,1040193,0,28550,1011643
5/4/22,Tunisia,33.886917,9.537499,1040712,0,28566,1012146
5/5/22,Tunisia,33.886917,9.537499,1040712,0,28566,1012146
5/6/22,Tunisia,33.886917,9.537499,1040712,0,28566,1012146
5/7/22,Tunisia,33.886917,9.537499,1040712,0,28566,1012146
5/8/22,Tunisia,33.886917,9.537499,1040712,0,28566,1012146
5/9/22,Tunisia,33.886917,9.537499,1040712,0,28566,1012146
5/10/22,Tunisia,33.886917,9.537499,1041197,0,28575,1012622
5/11/22,Tunisia,33.886917,9.537499,1041197,0,28575,1012622
5/12/22,Tunisia,33.886917,9.537499,1041197,0,28575,1012622
5/13/22,Tunisia,33.886917,9.537499,1041197,0,28575,1012622
5/14/22,Tunisia,33.886917,9.537499,1041197,0,28575,1012622
5/15/22,Tunisia,33.886917,9.537499,1041197,0,28575,1012622
5/16/22,Tunisia,33.886917,9.537499,1041197,0,28575,1012622
5/17/22,Tunisia,33.886917,9.537499,1041197,0,28575,1012622
5/18/22,Tunisia,33.886917,9.537499,1041789,0,28628,1013161
5/19/22,Tunisia,33.886917,9.537499,1041789,0,28628,1013161
5/20/22,Tunisia,33.886917,9.537499,1041789,0,28628,1013161
5/21/22,Tunisia,33.886917,9.537499,1041789,0,28628,1013161
5/22/22,Tunisia,33.886917,9.537499,1041789,0,28628,1013161
5/23/22,Tunisia,33.886917,9.537499,1041789,0,28628,1013161
5/24/22,Tunisia,33.886917,9.537499,1042362,0,28632,1013730
5/25/22,Tunisia,33.886917,9.537499,1042935,0,28636,1014299
5/26/22,Tunisia,33.886917,9.537499,1042362,0,28632,1013730
5/27/22,Tunisia,33.886917,9.537499,1042362,0,28632,1013730
5/28/22,Tunisia,33.886917,9.537499,1042362,0,28632,1013730
5/29/22,Tunisia,33.886917,9.537499,1042362,0,28632,1013730
5/30/22,Tunisia,33.886917,9.537499,1042362,0,28632,1013730
5/31/22,Tunisia,33.886917,9.537499,1042872,0,28641,1014231
6/1/22,Tunisia,33.886917,9.537499,1042872,0,28641,1014231
6/2/22,Tunisia,33.886917,9.537499,1042872,0,28641,1014231
6/3/22,Tunisia,33.886917,9.537499,1042872,0,28641,1014231
6/4/22,Tunisia,33.886917,9.537499,1042872,0,28641,1014231
6/5/22,Tunisia,33.886917,9.537499,1042872,0,28641,1014231
6/6/22,Tunisia,33.886917,9.537499,1042872,0,28641,1014231
6/7/22,Tunisia,33.886917,9.537499,1043540,0,28648,1014892
6/8/22,Tunisia,33.886917,9.537499,1043540,0,28648,1014892
6/9/22,Tunisia,33.886917,9.537499,1043540,0,28648,1014892
6/10/22,Tunisia,33.886917,9.537499,1043540,0,28648,1014892
6/11/22,Tunisia,33.886917,9.537499,1043540,0,28648,1014892
6/12/22,Tunisia,33.886917,9.537499,1043540,0,28648,1014892
6/13/22,Tunisia,33.886917,9.537499,1043540,0,28648,1014892
6/14/22,Tunisia,33.886917,9.537499,1044426,0,28655,1015771
6/15/22,Tunisia,33.886917,9.537499,1044426,0,28655,1015771
6/16/22,Tunisia,33.886917,9.537499,1044426,0,28655,1015771
6/17/22,Tunisia,33.886917,9.537499,1044426,0,28655,1015771
6/18/22,Tunisia,33.886917,9.537499,1044426,0,28655,1015771
6/19/22,Tunisia,33.886917,9.537499,1044426,0,28655,1015771
6/20/22,Tunisia,33.886917,9.537499,1044426,0,28655,1015771
6/21/22,Tunisia,33.886917,9.537499,1046703,0,28670,1018033
6/22/22,Tunisia,33.886917,9.537499,1046703,0,28670,1018033
6/23/22,Tunisia,33.886917,9.537499,1046703,0,28670,1018033
6/24/22,Tunisia,33.886917,9.537499,1046703,0,28670,1018033
6/25/22,Tunisia,33.886917,9.537499,1046703,0,28670,1018033
6/26/22,Tunisia,33.886917,9.537499,1046703,0,28670,1018033
6/27/22,Tunisia,33.886917,9.537499,1046703,0,28670,1018033
6/28/22,Tunisia,33.886917,9.537499,1046703,0,28670,1018033
6/29/22,Tunisia,33.886917,9.537499,1052180,0,28691,1023489
6/30/22,Tunisia,33.886917,9.537499,1052180,0,28691,1023489
7/1/22,Tunisia,33.886917,9.537499,1052180,0,28691,1023489
7/2/22,Tunisia,33.886917,9.537499,1052180,0,28691,1023489
7/3/22,Tunisia,33.886917,9.537499,1052180,0,28691,1023489
7/4/22,Tunisia,33.886917,9.537499,1052180,0,28691,1023489
7/5/22,Tunisia,33.886917,9.537499,1052180,0,28691,1023489
7/6/22,Tunisia,33.886917,9.537499,1066127,0,28748,1037379
7/7/22,Tunisia,33.886917,9.537499,1066127,0,28748,1037379
7/8/22,Tunisia,33.886917,9.537499,1066127,0,28748,1037379
7/9/22,Tunisia,33.886917,9.537499,1066127,0,28748,1037379
7/10/22,Tunisia,33.886917,9.537499,1066127,0,28748,1037379
7/11/22,Tunisia,33.886917,9.537499,1066127,0,28748,1037379
7/12/22,Tunisia,33.886917,9.537499,1087030,0,28823,1058207
7/13/22,Tunisia,33.886917,9.537499,1087030,0,28823,1058207
7/14/22,Tunisia,33.886917,9.537499,1087030,0,28823,1058207
7/15/22,Tunisia,33.886917,9.537499,1087030,0,28823,1058207
7/16/22,Tunisia,33.886917,9.537499,1087030,0,28823,1058207
7/17/22,Tunisia,33.886917,9.537499,1087030,0,28823,1058207
7/18/22,Tunisia,33.886917,9.537499,1087030,0,28823,1058207
7/19/22,Tunisia,33.886917,9.537499,1114370,0,28942,1085428
7/20/22,Tunisia,33.886917,9.537499,1114370,0,28942,1085428
7/21/22,Tunisia,33.886917,9.537499,1114370,0,28942,1085428
7/22/22,Tunisia,33.886917,9.537499,1114370,0,28942,1085428
7/23/22,Tunisia,33.886917,9.537499,1114370,0,28942,1085428
7/24/22,Tunisia,33.886917,9.537499,1114370,0,28942,1085428
7/25/22,Tunisia,33.886917,9.537499,1114370,0,28942,1085428
7/26/22,Tunisia,33.886917,9.537499,1128693,0,29041,1099652
7/27/22,Tunisia,33.886917,9.537499,1128693,0,29041,1099652
7/28/22,Tunisia,33.886917,9.537499,1128693,0,29041,1099652
7/29/22,Tunisia,33.886917,9.537499,1128693,0,29041,1099652
7/30/22,Tunisia,33.886917,9.537499,1128693,0,29041,1099652
7/31/22,Tunisia,33.886917,9.537499,1128693,0,29041,1099652
8/1/22,Tunisia,33.886917,9.537499,1128693,0,29041,1099652
8/2/22,Tunisia,33.886917,9.537499,1128693,0,29041,1099652
8/3/22,Tunisia,33.886917,9.537499,1134660,0,29105,1105555
8/4/22,Tunisia,33.886917,9.537499,1134660,0,29105,1105555
8/5/22,Tunisia,33.886917,9.537499,1134660,0,29105,1105555
8/6/22,Tunisia,33.886917,9.537499,1134660,0,29105,1105555
8/7/22,Tunisia,33.886917,9.537499,1134660,0,29105,1105555
8/8/22,Tunisia,33.886917,9.537499,1134660,0,29105,1105555
8/9/22,Tunisia,33.886917,9.537499,1134660,0,29105,1105555
8/10/22,Tunisia,33.886917,9.537499,1139241,0,29153,1110088
8/11/22,Tunisia,33.886917,9.537499,1139241,0,29153,1110088
8/12/22,Tunisia,33.886917,9.537499,1139241,0,29153,1110088
8/13/22,Tunisia,33.886917,9.537499,1139241,0,29153,1110088
8/14/22,Tunisia,33.886917,9.537499,1139241,0,29153,1110088
8/15/22,Tunisia,33.886917,9.537499,1139241,0,29153,1110088
8/16/22,Tunisia,33.886917,9.537499,1141135,0,29189,1111946
8/17/22,Tunisia,33.886917,9.537499,1141334,0,29202,1112132
8/18/22,Tunisia,33.886917,9.537499,1141487,0,29206,1112281
8/19/22,Tunisia,33.886917,9.537499,1141773,0,29209,1112564
8/20/22,Tunisia,33.886917,9.537499,1141773,0,29209,1112564
8/21/22,Tunisia,33.886917,9.537499,1141773,0,29209,1112564
8/22/22,Tunisia,33.886917,9.537499,1141773,0,29209,1112564
8/23/22,Tunisia,33.886917,9.537499,1141773,0,29209,1112564
8/24/22,Tunisia,33.886917,9.537499,1142527,0,29221,1113306
8/25/22,Tunisia,33.886917,9.537499,1142793,0,29229,1113564
8/26/22,Tunisia,33.886917,9.537499,1143167,0,29233,1113934
8/27/22,Tunisia,33.886917,9.537499,1143167,0,29233,1113934
8/28/22,Tunisia,33.886917,9.537499,1143167,0,29233,1113934
8/29/22,Tunisia,33.886917,9.537499,1143167,0,29233,1113934
8/30/22,Tunisia,33.886917,9.537499,1143788,0,29234,1114554
8/31/22,Tunisia,33.886917,9.537499,1143862,0,29234,1114628
9/1/22,Tunisia,33.886917,9.537499,1143862,0,29234,1114628
9/2/22,Tunisia,33.886917,9.537499,1143862,0,29234,1114628
9/3/22,Tunisia,33.886917,9.537499,1143862,0,29234,1114628
9/4/22,Tunisia,33.886917,9.537499,1143862,0,29234,1114628
9/5/22,Tunisia,33.886917,9.537499,1143862,0,29234,1114628
9/6/22,Tunisia,33.886917,9.537499,1144824,0,29238,1115586
9/7/22,Tunisia,33.886917,9.537499,1144824,0,29238,1115586
9/8/22,Tunisia,33.886917,9.537499,1144824,0,29238,1115586
9/9/22,Tunisia,33.886917,9.537499,1144824,0,29238,1115586
9/10/22,Tunisia,33.886917,9.537499,1144824,0,29238,1115586
9/11/22,Tunisia,33.886917,9.537499,1144824,0,29238,1115586
9/12/22,Tunisia,33.886917,9.537499,1144824,0,29238,1115586
9/13/22,Tunisia,33.886917,9.537499,1145163,0,29243,1115920
9/14/22,Tunisia,33.886917,9.537499,1145163,0,29243,1115920
9/15/22,Tunisia,33.886917,9.537499,1145163,0,29243,1115920
9/16/22,Tunisia,33.886917,9.537499,1145163,0,29243,1115920
9/17/22,Tunisia,33.886917,9.537499,1145163,0,29243,1115920
9/18/22,Tunisia,33.886917,9.537499,1145163,0,29243,1115920
9/19/22,Tunisia,33.886917,9.537499,1145163,0,29243,1115920
9/20/22,Tunisia,33.886917,9.537499,1145345,0,29246,1116099
9/21/22,Tunisia,33.886917,9.537499,1145345,0,29246,1116099
9/22/22,Tunisia,33.886917,9.537499,1145345,0,29246,1116099
9/23/22,Tunisia,33.886917,9.537499,1145345,0,29246,1116099
9/24/22,Tunisia,33.886917,9.537499,1145345,0,29246,1116099
9/25/22,Tunisia,33.886917,9.537499,1145345,0,29246,1116099
9/26/22,Tunisia,33.886917,9.537499,1145345,0,29246,1116099
9/27/22,Tunisia,33.886917,9.537499,1145686,0,29249,1116437
9/28/22,Tunisia,33.886917,9.537499,1145686,0,29249,1116437
9/29/22,Tunisia,33.886917,9.537499,1145686,0,29249,1116437
9/30/22,Tunisia,33.886917,9.537499,1145686,0,29249,1116437
10/1/22,Tunisia,33.886917,9.537499,1145686,0,29249,1116437
10/2/22,Tunisia,33.886917,9.537499,1145686,0,29249,1116437
10/3/22,Tunisia,33.886917,9.537499,1145686,0,29249,1116437
10/4/22,Tunisia,33.886917,9.537499,1145829,0,29254,1116575
10/5/22,Tunisia,33.886917,9.537499,1145829,0,29254,1116575
10/6/22,Tunisia,33.886917,9.537499,1145829,0,29254,1116575
10/7/22,Tunisia,33.886917,9.537499,1145829,0,29254,1116575
10/8/22,Tunisia,33.886917,9.537499,1145829,0,29254,1116575
10/9/22,Tunisia,33.886917,9.537499,1145829,0,29254,1116575
10/10/22,Tunisia,33.886917,9.537499,1145829,0,29254,1116575
10/11/22,Tunisia,33.886917,9.537499,1145930,0,29254,1116676
10/12/22,Tunisia,33.886917,9.537499,1145930,0,29254,1116676
10/13/22,Tunisia,33.886917,9.537499,1145930,0,29254,1116676
10/14/22,Tunisia,33.886917,9.537499,1145930,0,29254,1116676
10/15/22,Tunisia,33.886917,9.537499,1145930,0,29254,1116676
10/16/22,Tunisia,33.886917,9.537499,1145930,0,29254,1116676
10/17/22,Tunisia,33.886917,9.537499,1145930,0,29254,1116676
10/18/22,Tunisia,33.886917,9.537499,1146044,0,29257,1116787
10/19/22,Tunisia,33.886917,9.537499,1146044,0,29257,1116787
10/20/22,Tunisia,33.886917,9.537499,1146044,0,29257,1116787
10/21/22,Tunisia,33.886917,9.537499,1146044,0,29257,1116787
10/22/22,Tunisia,33.886917,9.537499,1146044,0,29257,1116787
10/23/22,Tunisia,33.886917,9.537499,1146044,0,29257,1116787
10/24/22,Tunisia,33.886917,9.537499,1146044,0,29257,1116787
10/25/22,Tunisia,33.886917,9.537499,1146152,0,29257,1116895
10/26/22,Tunisia,33.886917,9.537499,1146152,0,29257,1116895
10/27/22,Tunisia,33.886917,9.537499,1146152,0,29257,1116895
10/28/22,Tunisia,33.886917,9.537499,1146152,0,29257,1116895
10/29/22,Tunisia,33.886917,9.537499,1146152,0,29257,1116895
10/30/22,Tunisia,33.886917,9.537499,1146152,0,29257,1116895
10/31/22,Tunisia,33.886917,9.537499,1146152,0,29257,1116895
11/1/22,Tunisia,33.886917,9.537499,1146593,0,29259,1117334
11/2/22,Tunisia,33.886917,9.537499,1146593,0,29259,1117334
11/3/22,Tunisia,33.886917,9.537499,1146593,0,29259,1117334
11/4/22,Tunisia,33.886917,9.537499,1146593,0,29259,1117334
11/5/22,Tunisia,33.886917,9.537499,1146593,0,29259,1117334
11/6/22,Tunisia,33.886917,9.537499,1146593,0,29259,1117334
11/7/22,Tunisia,33.886917,9.537499,1146593,0,29259,1117334
11/8/22,Tunisia,33.886917,9.537499,1146702,0,29263,1117439
11/9/22,Tunisia,33.886917,9.537499,1146702,0,29263,1117439
11/10/22,Tunisia,33.886917,9.537499,1146702,0,29263,1117439
11/11/22,Tunisia,33.886917,9.537499,1146702,0,29263,1117439
11/12/22,Tunisia,33.886917,9.537499,1146702,0,29263,1117439
11/13/22,Tunisia,33.886917,9.537499,1146702,0,29263,1117439
11/14/22,Tunisia,33.886917,9.537499,1146702,0,29263,1117439
11/15/22,Tunisia,33.886917,9.537499,1146799,0,29266,1117533
11/16/22,Tunisia,33.886917,9.537499,1146799,0,29266,1117533
11/17/22,Tunisia,33.886917,9.537499,1146799,0,29266,1117533
11/18/22,Tunisia,33.886917,9.537499,1146799,0,29266,1117533
11/19/22,Tunisia,33.886917,9.537499,1146799,0,29266,1117533
11/20/22,Tunisia,33.886917,9.537499,1146799,0,29266,1117533
11/21/22,Tunisia,33.886917,9.537499,1146799,0,29266,1117533
11/22/22,Tunisia,33.886917,9.537499,1146991,0,29268,1117723
11/23/22,Tunisia,33.886917,9.537499,1146991,0,29268,1117723
11/24/22,Tunisia,33.886917,9.537499,1146991,0,29268,1117723
11/25/22,Tunisia,33.886917,9.537499,1146991,0,29268,1117723
11/26/22,Tunisia,33.886917,9.537499,1146991,0,29268,1117723
11/27/22,Tunisia,33.886917,9.537499,1146991,0,29268,1117723
11/28/22,Tunisia,33.886917,9.537499,1146991,0,29268,1117723
11/29/22,Tunisia,33.886917,9.537499,1147072,0,29268,1117804
11/30/22,Tunisia,33.886917,9.537499,1147072,0,29268,1117804
12/1/22,Tunisia,33.886917,9.537499,1147072,0,29268,1117804
12/2/22,Tunisia,33.886917,9.537499,1147072,0,29268,1117804
12/3/22,Tunisia,33.886917,9.537499,1147072,0,29268,1117804
12/4/22,Tunisia,33.886917,9.537499,1147072,0,29268,1117804
12/5/22,Tunisia,33.886917,9.537499,1147072,0,29268,1117804
12/6/22,Tunisia,33.886917,9.537499,1147145,0,29269,1117876
12/7/22,Tunisia,33.886917,9.537499,1147145,0,29269,1117876
12/8/22,Tunisia,33.886917,9.537499,1147145,0,29269,1117876
12/9/22,Tunisia,33.886917,9.537499,1147145,0,29269,1117876
12/10/22,Tunisia,33.886917,9.537499,1147145,0,29269,1117876
12/11/22,Tunisia,33.886917,9.537499,1147145,0,29269,1117876
12/12/22,Tunisia,33.886917,9.537499,1147145,0,29269,1117876
12/13/22,Tunisia,33.886917,9.537499,1147282,0,29272,1118010
12/14/22,Tunisia,33.886917,9.537499,1147282,0,29272,1118010
12/15/22,Tunisia,33.886917,9.537499,1147282,0,29272,1118010
12/16/22,Tunisia,33.886917,9.537499,1147282,0,29272,1118010
12/17/22,Tunisia,33.886917,9.537499,1147282,0,29272,1118010
1/1/22,Turkey,38.9637,35.2433,9519281,0,82506,9436775
1/2/22,Turkey,38.9637,35.2433,9552801,0,82635,9470166
1/3/22,Turkey,38.9637,35.2433,9597670,0,82795,9514875
1/4/22,Turkey,38.9637,35.2433,9652394,0,82932,9569462
1/5/22,Turkey,38.9637,35.2433,9718861,0,83075,9635786
1/6/22,Turkey,38.9637,35.2433,9787274,0,83231,9704043
1/7/22,Turkey,38.9637,35.2433,9850488,0,83388,9767100
1/8/22,Turkey,38.9637,35.2433,9916725,0,83529,9833196
1/9/22,Turkey,38.9637,35.2433,9978452,0,83702,9894750
1/10/22,Turkey,38.9637,35.2433,10043688,0,83843,9959845
1/11/22,Turkey,38.9637,35.2433,10117954,0,83980,10033974
1/12/22,Turkey,38.9637,35.2433,10195676,0,84125,10111551
1/13/22,Turkey,38.9637,35.2433,10271240,0,84278,10186962
1/14/22,Turkey,38.9637,35.2433,10339097,0,84278,10254819
1/15/22,Turkey,38.9637,35.2433,10403064,0,84622,10318442
1/16/22,Turkey,38.9637,35.2433,10457164,0,84758,10372406
1/17/22,Turkey,38.9637,35.2433,10522099,0,84920,10437179
1/18/22,Turkey,38.9637,35.2433,10591757,0,85077,10506680
1/19/22,Turkey,38.9637,35.2433,10664372,0,85253,10579119
1/20/22,Turkey,38.9637,35.2433,10736215,0,85419,10650796
1/21/22,Turkey,38.9637,35.2433,10808770,0,85600,10723170
1/22/22,Turkey,38.9637,35.2433,10881626,0,85784,10795842
1/23/22,Turkey,38.9637,35.2433,10947129,0,85969,10861160
1/24/22,Turkey,38.9637,35.2433,11014152,0,86125,10928027
1/25/22,Turkey,38.9637,35.2433,11090493,0,86299,11004194
1/26/22,Turkey,38.9637,35.2433,11167927,0,86487,11081440
1/27/22,Turkey,38.9637,35.2433,11250107,0,86661,11163446
1/28/22,Turkey,38.9637,35.2433,11343693,0,86871,11256822
1/29/22,Turkey,38.9637,35.2433,11438476,0,87045,11351431
1/30/22,Turkey,38.9637,35.2433,11526621,0,87234,11439387
1/31/22,Turkey,38.9637,35.2433,11619882,0,87416,11532466
2/1/22,Turkey,38.9637,35.2433,11722483,0,87614,11634869
2/2/22,Turkey,38.9637,35.2433,11833165,0,87831,11745334
2/3/22,Turkey,38.9637,35.2433,11940695,0,88064,11852631
2/4/22,Turkey,38.9637,35.2433,12051852,0,88312,11963540
2/5/22,Turkey,38.9637,35.2433,12150567,0,88533,12062034
2/6/22,Turkey,38.9637,35.2433,12238501,0,88734,12149767
2/7/22,Turkey,38.9637,35.2433,12335015,0,88970,12246045
2/8/22,Turkey,38.9637,35.2433,12446111,0,89211,12356900
2/9/22,Turkey,38.9637,35.2433,12554674,0,89477,12465197
2/10/22,Turkey,38.9637,35.2433,12653276,0,89741,12563535
2/11/22,Turkey,38.9637,35.2433,12748341,0,89994,12658347
2/12/22,Turkey,38.9637,35.2433,12834534,0,90266,12744268
2/13/22,Turkey,38.9637,35.2433,12908321,0,90542,12817779
2/14/22,Turkey,38.9637,35.2433,12984953,0,90808,12894145
2/15/22,Turkey,38.9637,35.2433,13079683,0,91117,12988566
2/16/22,Turkey,38.9637,35.2433,13173859,0,91388,13082471
2/17/22,Turkey,38.9637,35.2433,13266265,0,91646,13174619
2/18/22,Turkey,38.9637,35.2433,13353676,0,91910,13261766
2/19/22,Turkey,38.9637,35.2433,13434130,0,92188,13341942
2/20/22,Turkey,38.9637,35.2433,13504485,0,92451,13412034
2/21/22,Turkey,38.9637,35.2433,13589511,0,92719,13496792
2/22/22,Turkey,38.9637,35.2433,13675581,0,92990,13582591
2/23/22,Turkey,38.9637,35.2433,13762181,0,93258,13668923
2/24/22,Turkey,38.9637,35.2433,13841889,0,93539,13748350
2/25/22,Turkey,38.9637,35.2433,13913625,0,93805,13819820
2/26/22,Turkey,38.9637,35.2433,13975389,0,94026,13881363
2/27/22,Turkey,38.9637,35.2433,14025181,0,94232,13930949
2/28/22,Turkey,38.9637,35.2433,14089456,0,94445,13995011
3/1/22,Turkey,38.9637,35.2433,14149341,0,94648,14054693
3/2/22,Turkey,38.9637,35.2433,14206121,0,94837,14111284
3/3/22,Turkey,38.9637,35.2433,14255545,0,95025,14160520
3/4/22,Turkey,38.9637,35.2433,14293828,0,95205,14198623
3/5/22,Turkey,38.9637,35.2433,14326217,0,95379,14230838
3/6/22,Turkey,38.9637,35.2433,14353888,0,95549,14258339
3/7/22,Turkey,38.9637,35.2433,14388231,0,95681,14292550
3/8/22,Turkey,38.9637,35.2433,14425638,0,95811,14329827
3/9/22,Turkey,38.9637,35.2433,14458881,0,95954,14362927
3/10/22,Turkey,38.9637,35.2433,14488373,0,96094,14392279
3/11/22,Turkey,38.9637,35.2433,14513774,0,96217,14417557
3/12/22,Turkey,38.9637,35.2433,14534239,0,96349,14437890
3/13/22,Turkey,38.9637,35.2433,14551665,0,96487,14455178
3/14/22,Turkey,38.9637,35.2433,14576069,0,96620,14479449
3/15/22,Turkey,38.9637,35.2433,14600683,0,96735,14503948
3/16/22,Turkey,38.9637,35.2433,14623028,0,96853,14526175
3/17/22,Turkey,38.9637,35.2433,14644382,0,96954,14547428
3/18/22,Turkey,38.9637,35.2433,14663508,0,97077,14566431
3/19/22,Turkey,38.9637,35.2433,14680836,0,97182,14583654
3/20/22,Turkey,38.9637,35.2433,14693917,0,97267,14596650
3/21/22,Turkey,38.9637,35.2433,14708850,0,97347,14611503
3/22/22,Turkey,38.9637,35.2433,14726276,0,97437,14628839
3/23/22,Turkey,38.9637,35.2433,14743437,0,97521,14645916
3/24/22,Turkey,38.9637,35.2433,14760331,0,97598,14662733
3/25/22,Turkey,38.9637,35.2433,14775634,0,97666,14677968
3/26/22,Turkey,38.9637,35.2433,14789483,0,97736,14691747
3/27/22,Turkey,38.9637,35.2433,14800677,0,97800,14702877
3/28/22,Turkey,38.9637,35.2433,14815041,0,97861,14717180
3/29/22,Turkey,38.9637,35.2433,14831231,0,97924,14733307
3/30/22,Turkey,38.9637,35.2433,14846224,0,97977,14748247
3/31/22,Turkey,38.9637,35.2433,14860560,0,98033,14762527
4/1/22,Turkey,38.9637,35.2433,14873927,0,98078,14775849
4/2/22,Turkey,38.9637,35.2433,14885710,0,98119,14787591
4/3/22,Turkey,38.9637,35.2433,14894731,0,98157,14796574
4/4/22,Turkey,38.9637,35.2433,14907378,0,98197,14809181
4/5/22,Turkey,38.9637,35.2433,14919591,0,98234,14821357
4/6/22,Turkey,38.9637,35.2433,14929905,0,98275,14831630
4/7/22,Turkey,38.9637,35.2433,14939259,0,98311,14840948
4/8/22,Turkey,38.9637,35.2433,14946379,0,98342,14848037
4/9/22,Turkey,38.9637,35.2433,14953365,0,98377,14854988
4/10/22,Turkey,38.9637,35.2433,14958974,0,98409,14860565
4/11/22,Turkey,38.9637,35.2433,14965867,0,98437,14867430
4/12/22,Turkey,38.9637,35.2433,14972502,0,98462,14874040
4/13/22,Turkey,38.9637,35.2433,14978031,0,98493,14879538
4/14/22,Turkey,38.9637,35.2433,14983158,0,98514,14884644
4/15/22,Turkey,38.9637,35.2433,14987583,0,98532,14889051
4/16/22,Turkey,38.9637,35.2433,14991669,0,98551,14893118
4/17/22,Turkey,38.9637,35.2433,14994937,0,98568,14896369
4/18/22,Turkey,38.9637,35.2433,14999479,0,98587,14900892
4/19/22,Turkey,38.9637,35.2433,15003696,0,98610,14905086
4/20/22,Turkey,38.9637,35.2433,15007364,0,98628,14908736
4/21/22,Turkey,38.9637,35.2433,15010718,0,98645,14912073
4/22/22,Turkey,38.9637,35.2433,15013616,0,98660,14914956
4/23/22,Turkey,38.9637,35.2433,15016270,0,98676,14917594
4/24/22,Turkey,38.9637,35.2433,15018547,0,98691,14919856
4/25/22,Turkey,38.9637,35.2433,15021151,0,98706,14922445
4/26/22,Turkey,38.9637,35.2433,15023662,0,98720,14924942
4/27/22,Turkey,38.9637,35.2433,15026141,0,98736,14927405
4/28/22,Turkey,38.9637,35.2433,15028397,0,98751,14929646
4/29/22,Turkey,38.9637,35.2433,15030321,0,98760,14931561
4/30/22,Turkey,38.9637,35.2433,15032093,0,98771,14933322
5/1/22,Turkey,38.9637,35.2433,15033573,0,98783,14934790
5/2/22,Turkey,38.9637,35.2433,15034917,0,98791,14936126
5/3/22,Turkey,38.9637,35.2433,15036110,0,98801,14937309
5/4/22,Turkey,38.9637,35.2433,15037242,0,98808,14938434
5/5/22,Turkey,38.9637,35.2433,15038495,0,98819,14939676
5/6/22,Turkey,38.9637,35.2433,15040238,0,98826,14941412
5/7/22,Turkey,38.9637,35.2433,15041899,0,98837,14943062
5/8/22,Turkey,38.9637,35.2433,15043379,0,98846,14944533
5/9/22,Turkey,38.9637,35.2433,15044921,0,98854,14946067
5/10/22,Turkey,38.9637,35.2433,15046779,0,98861,14947918
5/11/22,Turkey,38.9637,35.2433,15048449,0,98870,14949579
5/12/22,Turkey,38.9637,35.2433,15050227,0,98878,14951349
5/13/22,Turkey,38.9637,35.2433,15051761,0,98885,14952876
5/14/22,Turkey,38.9637,35.2433,15053168,0,98890,14954278
5/15/22,Turkey,38.9637,35.2433,15054322,0,98900,14955422
5/16/22,Turkey,38.9637,35.2433,15055576,0,98904,14956672
5/17/22,Turkey,38.9637,35.2433,15057184,0,98911,14958273
5/18/22,Turkey,38.9637,35.2433,15058627,0,98914,14959713
5/19/22,Turkey,38.9637,35.2433,15060112,0,98918,14961194
5/20/22,Turkey,38.9637,35.2433,15060112,0,98918,14961194
5/21/22,Turkey,38.9637,35.2433,15062393,0,98925,14963468
5/22/22,Turkey,38.9637,35.2433,15063298,0,98930,14964368
5/23/22,Turkey,38.9637,35.2433,15064220,0,98933,14965287
5/24/22,Turkey,38.9637,35.2433,15065524,0,98939,14966585
5/25/22,Turkey,38.9637,35.2433,15066784,0,98943,14967841
5/26/22,Turkey,38.9637,35.2433,15068094,0,98948,14969146
5/27/22,Turkey,38.9637,35.2433,15069034,0,98952,14970082
5/28/22,Turkey,38.9637,35.2433,15070000,0,98955,14971045
5/29/22,Turkey,38.9637,35.2433,15070864,0,98957,14971907
5/30/22,Turkey,38.9637,35.2433,15071772,0,98961,14972811
5/31/22,Turkey,38.9637,35.2433,15072747,0,98965,14973782
6/1/22,Turkey,38.9637,35.2433,15072747,0,98965,14973782
6/2/22,Turkey,38.9637,35.2433,15072747,0,98965,14973782
6/3/22,Turkey,38.9637,35.2433,15072747,0,98965,14973782
6/4/22,Turkey,38.9637,35.2433,15072747,0,98965,14973782
6/5/22,Turkey,38.9637,35.2433,15078186,0,98976,14979210
6/6/22,Turkey,38.9637,35.2433,15078186,0,98976,14979210
6/7/22,Turkey,38.9637,35.2433,15078186,0,98976,14979210
6/8/22,Turkey,38.9637,35.2433,15078186,0,98976,14979210
6/9/22,Turkey,38.9637,35.2433,15078186,0,98976,14979210
6/10/22,Turkey,38.9637,35.2433,15078186,0,98976,14979210
6/11/22,Turkey,38.9637,35.2433,15078186,0,98976,14979210
6/12/22,Turkey,38.9637,35.2433,15078186,0,98976,14979210
6/13/22,Turkey,38.9637,35.2433,15078186,0,98976,14979210
6/14/22,Turkey,38.9637,35.2433,15085742,0,98996,14986746
6/15/22,Turkey,38.9637,35.2433,15085742,0,98996,14986746
6/16/22,Turkey,38.9637,35.2433,15085742,0,98996,14986746
6/17/22,Turkey,38.9637,35.2433,15085742,0,98996,14986746
6/18/22,Turkey,38.9637,35.2433,15085742,0,98996,14986746
6/19/22,Turkey,38.9637,35.2433,15085742,0,98996,14986746
6/20/22,Turkey,38.9637,35.2433,15085742,0,98996,14986746
6/21/22,Turkey,38.9637,35.2433,15085742,0,98996,14986746
6/22/22,Turkey,38.9637,35.2433,15085742,0,98996,14986746
6/23/22,Turkey,38.9637,35.2433,15085742,0,98996,14986746
6/24/22,Turkey,38.9637,35.2433,15085742,0,98996,14986746
6/25/22,Turkey,38.9637,35.2433,15085742,0,98996,14986746
6/26/22,Turkey,38.9637,35.2433,15085742,0,98996,14986746
6/27/22,Turkey,38.9637,35.2433,15096696,0,99015,14997681
6/28/22,Turkey,38.9637,35.2433,15096696,0,99015,14997681
6/29/22,Turkey,38.9637,35.2433,15123331,0,99032,15024299
6/30/22,Turkey,38.9637,35.2433,15123331,0,99032,15024299
7/1/22,Turkey,38.9637,35.2433,15123331,0,99032,15024299
7/2/22,Turkey,38.9637,35.2433,15123331,0,99032,15024299
7/3/22,Turkey,38.9637,35.2433,15123331,0,99032,15024299
7/4/22,Turkey,38.9637,35.2433,15180444,0,99057,15081387
7/5/22,Turkey,38.9637,35.2433,15180444,0,99057,15081387
7/6/22,Turkey,38.9637,35.2433,15180444,0,99057,15081387
7/7/22,Turkey,38.9637,35.2433,15180444,0,99057,15081387
7/8/22,Turkey,38.9637,35.2433,15180444,0,99057,15081387
7/9/22,Turkey,38.9637,35.2433,15180444,0,99057,15081387
7/10/22,Turkey,38.9637,35.2433,15180444,0,99057,15081387
7/11/22,Turkey,38.9637,35.2433,15180444,0,99057,15081387
7/12/22,Turkey,38.9637,35.2433,15180444,0,99057,15081387
7/13/22,Turkey,38.9637,35.2433,15297539,0,99088,15198451
7/14/22,Turkey,38.9637,35.2433,15297539,0,99088,15198451
7/15/22,Turkey,38.9637,35.2433,15297539,0,99088,15198451
7/16/22,Turkey,38.9637,35.2433,15297539,0,99088,15198451
7/17/22,Turkey,38.9637,35.2433,15297539,0,99088,15198451
7/18/22,Turkey,38.9637,35.2433,15297539,0,99088,15198451
7/19/22,Turkey,38.9637,35.2433,15297539,0,99088,15198451
7/20/22,Turkey,38.9637,35.2433,15524071,0,99184,15424887
7/21/22,Turkey,38.9637,35.2433,15524071,0,99184,15424887
7/22/22,Turkey,38.9637,35.2433,15524071,0,99184,15424887
7/23/22,Turkey,38.9637,35.2433,15524071,0,99184,15424887
7/24/22,Turkey,38.9637,35.2433,15524071,0,99184,15424887
7/25/22,Turkey,38.9637,35.2433,15524071,0,99184,15424887
7/26/22,Turkey,38.9637,35.2433,15524071,0,99184,15424887
7/27/22,Turkey,38.9637,35.2433,15524071,0,99184,15424887
7/28/22,Turkey,38.9637,35.2433,15524071,0,99184,15424887
7/29/22,Turkey,38.9637,35.2433,15889495,0,99341,15790154
7/30/22,Turkey,38.9637,35.2433,15889495,0,99341,15790154
7/31/22,Turkey,38.9637,35.2433,15889495,0,99341,15790154
8/1/22,Turkey,38.9637,35.2433,15889495,0,99341,15790154
8/2/22,Turkey,38.9637,35.2433,15889495,0,99341,15790154
8/3/22,Turkey,38.9637,35.2433,15889495,0,99341,15790154
8/4/22,Turkey,38.9637,35.2433,15889495,0,99341,15790154
8/5/22,Turkey,38.9637,35.2433,15889495,0,99341,15790154
8/6/22,Turkey,38.9637,35.2433,16295817,0,99678,16196139
8/7/22,Turkey,38.9637,35.2433,16295817,0,99678,16196139
8/8/22,Turkey,38.9637,35.2433,16295817,0,99678,16196139
8/9/22,Turkey,38.9637,35.2433,16295817,0,99678,16196139
8/10/22,Turkey,38.9637,35.2433,16295817,0,99678,16196139
8/11/22,Turkey,38.9637,35.2433,16295817,0,99678,16196139
8/12/22,Turkey,38.9637,35.2433,16295817,0,99678,16196139
8/13/22,Turkey,38.9637,35.2433,16295817,0,99678,16196139
8/14/22,Turkey,38.9637,35.2433,16295817,0,99678,16196139
8/15/22,Turkey,38.9637,35.2433,16528070,0,100058,16428012
8/16/22,Turkey,38.9637,35.2433,16671848,0,100400,16571448
8/17/22,Turkey,38.9637,35.2433,16671848,0,100400,16571448
8/18/22,Turkey,38.9637,35.2433,16671848,0,100400,16571448
8/19/22,Turkey,38.9637,35.2433,16671848,0,100400,16571448
8/20/22,Turkey,38.9637,35.2433,16671848,0,100400,16571448
8/21/22,Turkey,38.9637,35.2433,16671848,0,100400,16571448
8/22/22,Turkey,38.9637,35.2433,16671848,0,100400,16571448
8/23/22,Turkey,38.9637,35.2433,16671848,0,100400,16571448
8/24/22,Turkey,38.9637,35.2433,16671848,0,100400,16571448
8/25/22,Turkey,38.9637,35.2433,16671848,0,100400,16571448
8/26/22,Turkey,38.9637,35.2433,16671848,0,100400,16571448
8/27/22,Turkey,38.9637,35.2433,16671848,0,100400,16571448
8/28/22,Turkey,38.9637,35.2433,16671848,0,100400,16571448
8/29/22,Turkey,38.9637,35.2433,16671848,0,100400,16571448
8/30/22,Turkey,38.9637,35.2433,16671848,0,100400,16571448
8/31/22,Turkey,38.9637,35.2433,16671848,0,100400,16571448
9/1/22,Turkey,38.9637,35.2433,16671848,0,100400,16571448
9/2/22,Turkey,38.9637,35.2433,16751868,0,100631,16651237
9/3/22,Turkey,38.9637,35.2433,16751868,0,100631,16651237
9/4/22,Turkey,38.9637,35.2433,16797750,0,100840,16696910
9/5/22,Turkey,38.9637,35.2433,16797750,0,100840,16696910
9/6/22,Turkey,38.9637,35.2433,16797750,0,100840,16696910
9/7/22,Turkey,38.9637,35.2433,16797750,0,100840,16696910
9/8/22,Turkey,38.9637,35.2433,16797750,0,100840,16696910
9/9/22,Turkey,38.9637,35.2433,16797750,0,100840,16696910
9/10/22,Turkey,38.9637,35.2433,16797750,0,100840,16696910
9/11/22,Turkey,38.9637,35.2433,16829941,0,100979,16728962
9/12/22,Turkey,38.9637,35.2433,16852382,0,101068,16751314
9/13/22,Turkey,38.9637,35.2433,16852382,0,101068,16751314
9/14/22,Turkey,38.9637,35.2433,16852382,0,101068,16751314
9/15/22,Turkey,38.9637,35.2433,16852382,0,101068,16751314
9/16/22,Turkey,38.9637,35.2433,16852382,0,101068,16751314
9/17/22,Turkey,38.9637,35.2433,16852382,0,101068,16751314
9/18/22,Turkey,38.9637,35.2433,16852382,0,101068,16751314
9/19/22,Turkey,38.9637,35.2433,16852382,0,101068,16751314
9/20/22,Turkey,38.9637,35.2433,16852382,0,101068,16751314
9/21/22,Turkey,38.9637,35.2433,16852382,0,101068,16751314
9/22/22,Turkey,38.9637,35.2433,16852382,0,101068,16751314
9/23/22,Turkey,38.9637,35.2433,16852382,0,101068,16751314
9/24/22,Turkey,38.9637,35.2433,16873793,0,101139,16772654
9/25/22,Turkey,38.9637,35.2433,16873793,0,101139,16772654
9/26/22,Turkey,38.9637,35.2433,16873793,0,101139,16772654
9/27/22,Turkey,38.9637,35.2433,16873793,0,101139,16772654
9/28/22,Turkey,38.9637,35.2433,16873793,0,101139,16772654
9/29/22,Turkey,38.9637,35.2433,16873793,0,101139,16772654
9/30/22,Turkey,38.9637,35.2433,16873793,0,101139,16772654
10/1/22,Turkey,38.9637,35.2433,16873793,0,101139,16772654
10/2/22,Turkey,38.9637,35.2433,16873793,0,101139,16772654
10/3/22,Turkey,38.9637,35.2433,16873793,0,101139,16772654
10/4/22,Turkey,38.9637,35.2433,16873793,0,101139,16772654
10/5/22,Turkey,38.9637,35.2433,16873793,0,101139,16772654
10/6/22,Turkey,38.9637,35.2433,16873793,0,101139,16772654
10/7/22,Turkey,38.9637,35.2433,16873793,0,101139,16772654
10/8/22,Turkey,38.9637,35.2433,16873793,0,101139,16772654
10/9/22,Turkey,38.9637,35.2433,16896522,0,101179,16795343
10/10/22,Turkey,38.9637,35.2433,16919638,0,101203,16818435
10/11/22,Turkey,38.9637,35.2433,16919638,0,101203,16818435
10/12/22,Turkey,38.9637,35.2433,16919638,0,101203,16818435
10/13/22,Turkey,38.9637,35.2433,16919638,0,101203,16818435
10/14/22,Turkey,38.9637,35.2433,16919638,0,101203,16818435
10/15/22,Turkey,38.9637,35.2433,16919638,0,101203,16818435
10/16/22,Turkey,38.9637,35.2433,16919638,0,101203,16818435
10/17/22,Turkey,38.9637,35.2433,16919638,0,101203,16818435
10/18/22,Turkey,38.9637,35.2433,16919638,0,101203,16818435
10/19/22,Turkey,38.9637,35.2433,16919638,0,101203,16818435
10/20/22,Turkey,38.9637,35.2433,16919638,0,101203,16818435
10/21/22,Turkey,38.9637,35.2433,16919638,0,101203,16818435
10/22/22,Turkey,38.9637,35.2433,16919638,0,101203,16818435
10/23/22,Turkey,38.9637,35.2433,16919638,0,101203,16818435
10/24/22,Turkey,38.9637,35.2433,16919638,0,101203,16818435
10/25/22,Turkey,38.9637,35.2433,16919638,0,101203,16818435
10/26/22,Turkey,38.9637,35.2433,16919638,0,101203,16818435
10/27/22,Turkey,38.9637,35.2433,16919638,0,101203,16818435
10/28/22,Turkey,38.9637,35.2433,16919638,0,101203,16818435
10/29/22,Turkey,38.9637,35.2433,16919638,0,101203,16818435
10/30/22,Turkey,38.9637,35.2433,16919638,0,101203,16818435
10/31/22,Turkey,38.9637,35.2433,16919638,0,101203,16818435
11/1/22,Turkey,38.9637,35.2433,16919638,0,101203,16818435
11/2/22,Turkey,38.9637,35.2433,16919638,0,101203,16818435
11/3/22,Turkey,38.9637,35.2433,16919638,0,101203,16818435
11/4/22,Turkey,38.9637,35.2433,16919638,0,101203,16818435
11/5/22,Turkey,38.9637,35.2433,16919638,0,101203,16818435
11/6/22,Turkey,38.9637,35.2433,16919638,0,101203,16818435
11/7/22,Turkey,38.9637,35.2433,16919638,0,101203,16818435
11/8/22,Turkey,38.9637,35.2433,16919638,0,101203,16818435
11/9/22,Turkey,38.9637,35.2433,16919638,0,101203,16818435
11/10/22,Turkey,38.9637,35.2433,16919638,0,101203,16818435
11/11/22,Turkey,38.9637,35.2433,16919638,0,101203,16818435
11/12/22,Turkey,38.9637,35.2433,16919638,0,101203,16818435
11/13/22,Turkey,38.9637,35.2433,16919638,0,101203,16818435
11/14/22,Turkey,38.9637,35.2433,16919638,0,101203,16818435
11/15/22,Turkey,38.9637,35.2433,16919638,0,101203,16818435
11/16/22,Turkey,38.9637,35.2433,16919638,0,101203,16818435
11/17/22,Turkey,38.9637,35.2433,16919638,0,101203,16818435
11/18/22,Turkey,38.9637,35.2433,16919638,0,101203,16818435
11/19/22,Turkey,38.9637,35.2433,16919638,0,101203,16818435
11/20/22,Turkey,38.9637,35.2433,16919638,0,101203,16818435
11/21/22,Turkey,38.9637,35.2433,16919638,0,101203,16818435
11/22/22,Turkey,38.9637,35.2433,16919638,0,101203,16818435
11/23/22,Turkey,38.9637,35.2433,16919638,0,101203,16818435
11/24/22,Turkey,38.9637,35.2433,16919638,0,101203,16818435
11/25/22,Turkey,38.9637,35.2433,16919638,0,101203,16818435
11/26/22,Turkey,38.9637,35.2433,16919638,0,101203,16818435
11/27/22,Turkey,38.9637,35.2433,16919638,0,101203,16818435
11/28/22,Turkey,38.9637,35.2433,16919638,0,101203,16818435
11/29/22,Turkey,38.9637,35.2433,16919638,0,101203,16818435
11/30/22,Turkey,38.9637,35.2433,16919638,0,101203,16818435
12/1/22,Turkey,38.9637,35.2433,16919638,0,101203,16818435
12/2/22,Turkey,38.9637,35.2433,16919638,0,101203,16818435
12/3/22,Turkey,38.9637,35.2433,16919638,0,101203,16818435
12/4/22,Turkey,38.9637,35.2433,16919638,0,101203,16818435
12/5/22,Turkey,38.9637,35.2433,16919638,0,101203,16818435
12/6/22,Turkey,38.9637,35.2433,16919638,0,101203,16818435
12/7/22,Turkey,38.9637,35.2433,16919638,0,101203,16818435
12/8/22,Turkey,38.9637,35.2433,16919638,0,101203,16818435
12/9/22,Turkey,38.9637,35.2433,16919638,0,101203,16818435
12/10/22,Turkey,38.9637,35.2433,16919638,0,101203,16818435
12/11/22,Turkey,38.9637,35.2433,16919638,0,101203,16818435
12/12/22,Turkey,38.9637,35.2433,16919638,0,101203,16818435
12/13/22,Turkey,38.9637,35.2433,16919638,0,101203,16818435
12/14/22,Turkey,38.9637,35.2433,16919638,0,101203,16818435
12/15/22,Turkey,38.9637,35.2433,16919638,0,101203,16818435
12/16/22,Turkey,38.9637,35.2433,16919638,0,101203,16818435
12/17/22,Turkey,38.9637,35.2433,16919638,0,101203,16818435
1/1/22,Tuvalu,-7.1095,177.6493,0,0,0,0
1/2/22,Tuvalu,-7.1095,177.6493,0,0,0,0
1/3/22,Tuvalu,-7.1095,177.6493,0,0,0,0
1/4/22,Tuvalu,-7.1095,177.6493,0,0,0,0
1/5/22,Tuvalu,-7.1095,177.6493,0,0,0,0
1/6/22,Tuvalu,-7.1095,177.6493,0,0,0,0
1/7/22,Tuvalu,-7.1095,177.6493,0,0,0,0
1/8/22,Tuvalu,-7.1095,177.6493,0,0,0,0
1/9/22,Tuvalu,-7.1095,177.6493,0,0,0,0
1/10/22,Tuvalu,-7.1095,177.6493,0,0,0,0
1/11/22,Tuvalu,-7.1095,177.6493,0,0,0,0
1/12/22,Tuvalu,-7.1095,177.6493,0,0,0,0
1/13/22,Tuvalu,-7.1095,177.6493,0,0,0,0
1/14/22,Tuvalu,-7.1095,177.6493,0,0,0,0
1/15/22,Tuvalu,-7.1095,177.6493,0,0,0,0
1/16/22,Tuvalu,-7.1095,177.6493,0,0,0,0
1/17/22,Tuvalu,-7.1095,177.6493,0,0,0,0
1/18/22,Tuvalu,-7.1095,177.6493,0,0,0,0
1/19/22,Tuvalu,-7.1095,177.6493,0,0,0,0
1/20/22,Tuvalu,-7.1095,177.6493,0,0,0,0
1/21/22,Tuvalu,-7.1095,177.6493,0,0,0,0
1/22/22,Tuvalu,-7.1095,177.6493,0,0,0,0
1/23/22,Tuvalu,-7.1095,177.6493,0,0,0,0
1/24/22,Tuvalu,-7.1095,177.6493,0,0,0,0
1/25/22,Tuvalu,-7.1095,177.6493,0,0,0,0
1/26/22,Tuvalu,-7.1095,177.6493,0,0,0,0
1/27/22,Tuvalu,-7.1095,177.6493,0,0,0,0
1/28/22,Tuvalu,-7.1095,177.6493,0,0,0,0
1/29/22,Tuvalu,-7.1095,177.6493,0,0,0,0
1/30/22,Tuvalu,-7.1095,177.6493,0,0,0,0
1/31/22,Tuvalu,-7.1095,177.6493,0,0,0,0
2/1/22,Tuvalu,-7.1095,177.6493,0,0,0,0
2/2/22,Tuvalu,-7.1095,177.6493,0,0,0,0
2/3/22,Tuvalu,-7.1095,177.6493,0,0,0,0
2/4/22,Tuvalu,-7.1095,177.6493,0,0,0,0
2/5/22,Tuvalu,-7.1095,177.6493,0,0,0,0
2/6/22,Tuvalu,-7.1095,177.6493,0,0,0,0
2/7/22,Tuvalu,-7.1095,177.6493,0,0,0,0
2/8/22,Tuvalu,-7.1095,177.6493,0,0,0,0
2/9/22,Tuvalu,-7.1095,177.6493,0,0,0,0
2/10/22,Tuvalu,-7.1095,177.6493,0,0,0,0
2/11/22,Tuvalu,-7.1095,177.6493,0,0,0,0
2/12/22,Tuvalu,-7.1095,177.6493,0,0,0,0
2/13/22,Tuvalu,-7.1095,177.6493,0,0,0,0
2/14/22,Tuvalu,-7.1095,177.6493,0,0,0,0
2/15/22,Tuvalu,-7.1095,177.6493,0,0,0,0
2/16/22,Tuvalu,-7.1095,177.6493,0,0,0,0
2/17/22,Tuvalu,-7.1095,177.6493,0,0,0,0
2/18/22,Tuvalu,-7.1095,177.6493,0,0,0,0
2/19/22,Tuvalu,-7.1095,177.6493,0,0,0,0
2/20/22,Tuvalu,-7.1095,177.6493,0,0,0,0
2/21/22,Tuvalu,-7.1095,177.6493,0,0,0,0
2/22/22,Tuvalu,-7.1095,177.6493,0,0,0,0
2/23/22,Tuvalu,-7.1095,177.6493,0,0,0,0
2/24/22,Tuvalu,-7.1095,177.6493,0,0,0,0
2/25/22,Tuvalu,-7.1095,177.6493,0,0,0,0
2/26/22,Tuvalu,-7.1095,177.6493,0,0,0,0
2/27/22,Tuvalu,-7.1095,177.6493,0,0,0,0
2/28/22,Tuvalu,-7.1095,177.6493,0,0,0,0
3/1/22,Tuvalu,-7.1095,177.6493,0,0,0,0
3/2/22,Tuvalu,-7.1095,177.6493,0,0,0,0
3/3/22,Tuvalu,-7.1095,177.6493,0,0,0,0
3/4/22,Tuvalu,-7.1095,177.6493,0,0,0,0
3/5/22,Tuvalu,-7.1095,177.6493,0,0,0,0
3/6/22,Tuvalu,-7.1095,177.6493,0,0,0,0
3/7/22,Tuvalu,-7.1095,177.6493,0,0,0,0
3/8/22,Tuvalu,-7.1095,177.6493,0,0,0,0
3/9/22,Tuvalu,-7.1095,177.6493,0,0,0,0
3/10/22,Tuvalu,-7.1095,177.6493,0,0,0,0
3/11/22,Tuvalu,-7.1095,177.6493,0,0,0,0
3/12/22,Tuvalu,-7.1095,177.6493,0,0,0,0
3/13/22,Tuvalu,-7.1095,177.6493,0,0,0,0
3/14/22,Tuvalu,-7.1095,177.6493,0,0,0,0
3/15/22,Tuvalu,-7.1095,177.6493,0,0,0,0
3/16/22,Tuvalu,-7.1095,177.6493,0,0,0,0
3/17/22,Tuvalu,-7.1095,177.6493,0,0,0,0
3/18/22,Tuvalu,-7.1095,177.6493,0,0,0,0
3/19/22,Tuvalu,-7.1095,177.6493,0,0,0,0
3/20/22,Tuvalu,-7.1095,177.6493,0,0,0,0
3/21/22,Tuvalu,-7.1095,177.6493,0,0,0,0
3/22/22,Tuvalu,-7.1095,177.6493,0,0,0,0
3/23/22,Tuvalu,-7.1095,177.6493,0,0,0,0
3/24/22,Tuvalu,-7.1095,177.6493,0,0,0,0
3/25/22,Tuvalu,-7.1095,177.6493,0,0,0,0
3/26/22,Tuvalu,-7.1095,177.6493,0,0,0,0
3/27/22,Tuvalu,-7.1095,177.6493,0,0,0,0
3/28/22,Tuvalu,-7.1095,177.6493,0,0,0,0
3/29/22,Tuvalu,-7.1095,177.6493,0,0,0,0
3/30/22,Tuvalu,-7.1095,177.6493,0,0,0,0
3/31/22,Tuvalu,-7.1095,177.6493,0,0,0,0
4/1/22,Tuvalu,-7.1095,177.6493,0,0,0,0
4/2/22,Tuvalu,-7.1095,177.6493,0,0,0,0
4/3/22,Tuvalu,-7.1095,177.6493,0,0,0,0
4/4/22,Tuvalu,-7.1095,177.6493,0,0,0,0
4/5/22,Tuvalu,-7.1095,177.6493,0,0,0,0
4/6/22,Tuvalu,-7.1095,177.6493,0,0,0,0
4/7/22,Tuvalu,-7.1095,177.6493,0,0,0,0
4/8/22,Tuvalu,-7.1095,177.6493,0,0,0,0
4/9/22,Tuvalu,-7.1095,177.6493,0,0,0,0
4/10/22,Tuvalu,-7.1095,177.6493,0,0,0,0
4/11/22,Tuvalu,-7.1095,177.6493,0,0,0,0
4/12/22,Tuvalu,-7.1095,177.6493,0,0,0,0
4/13/22,Tuvalu,-7.1095,177.6493,0,0,0,0
4/14/22,Tuvalu,-7.1095,177.6493,0,0,0,0
4/15/22,Tuvalu,-7.1095,177.6493,0,0,0,0
4/16/22,Tuvalu,-7.1095,177.6493,0,0,0,0
4/17/22,Tuvalu,-7.1095,177.6493,0,0,0,0
4/18/22,Tuvalu,-7.1095,177.6493,0,0,0,0
4/19/22,Tuvalu,-7.1095,177.6493,0,0,0,0
4/20/22,Tuvalu,-7.1095,177.6493,0,0,0,0
4/21/22,Tuvalu,-7.1095,177.6493,0,0,0,0
4/22/22,Tuvalu,-7.1095,177.6493,0,0,0,0
4/23/22,Tuvalu,-7.1095,177.6493,0,0,0,0
4/24/22,Tuvalu,-7.1095,177.6493,0,0,0,0
4/25/22,Tuvalu,-7.1095,177.6493,0,0,0,0
4/26/22,Tuvalu,-7.1095,177.6493,0,0,0,0
4/27/22,Tuvalu,-7.1095,177.6493,0,0,0,0
4/28/22,Tuvalu,-7.1095,177.6493,0,0,0,0
4/29/22,Tuvalu,-7.1095,177.6493,0,0,0,0
4/30/22,Tuvalu,-7.1095,177.6493,0,0,0,0
5/1/22,Tuvalu,-7.1095,177.6493,0,0,0,0
5/2/22,Tuvalu,-7.1095,177.6493,0,0,0,0
5/3/22,Tuvalu,-7.1095,177.6493,0,0,0,0
5/4/22,Tuvalu,-7.1095,177.6493,0,0,0,0
5/5/22,Tuvalu,-7.1095,177.6493,0,0,0,0
5/6/22,Tuvalu,-7.1095,177.6493,0,0,0,0
5/7/22,Tuvalu,-7.1095,177.6493,0,0,0,0
5/8/22,Tuvalu,-7.1095,177.6493,0,0,0,0
5/9/22,Tuvalu,-7.1095,177.6493,0,0,0,0
5/10/22,Tuvalu,-7.1095,177.6493,0,0,0,0
5/11/22,Tuvalu,-7.1095,177.6493,0,0,0,0
5/12/22,Tuvalu,-7.1095,177.6493,0,0,0,0
5/13/22,Tuvalu,-7.1095,177.6493,0,0,0,0
5/14/22,Tuvalu,-7.1095,177.6493,0,0,0,0
5/15/22,Tuvalu,-7.1095,177.6493,0,0,0,0
5/16/22,Tuvalu,-7.1095,177.6493,0,0,0,0
5/17/22,Tuvalu,-7.1095,177.6493,0,0,0,0
5/18/22,Tuvalu,-7.1095,177.6493,0,0,0,0
5/19/22,Tuvalu,-7.1095,177.6493,0,0,0,0
5/20/22,Tuvalu,-7.1095,177.6493,0,0,0,0
5/21/22,Tuvalu,-7.1095,177.6493,0,0,0,0
5/22/22,Tuvalu,-7.1095,177.6493,0,0,0,0
5/23/22,Tuvalu,-7.1095,177.6493,3,0,0,3
5/24/22,Tuvalu,-7.1095,177.6493,3,0,0,3
5/25/22,Tuvalu,-7.1095,177.6493,3,0,0,3
5/26/22,Tuvalu,-7.1095,177.6493,3,0,0,3
5/27/22,Tuvalu,-7.1095,177.6493,3,0,0,3
5/28/22,Tuvalu,-7.1095,177.6493,3,0,0,3
5/29/22,Tuvalu,-7.1095,177.6493,3,0,0,3
5/30/22,Tuvalu,-7.1095,177.6493,3,0,0,3
5/31/22,Tuvalu,-7.1095,177.6493,3,0,0,3
6/1/22,Tuvalu,-7.1095,177.6493,3,0,0,3
6/2/22,Tuvalu,-7.1095,177.6493,3,0,0,3
6/3/22,Tuvalu,-7.1095,177.6493,3,0,0,3
6/4/22,Tuvalu,-7.1095,177.6493,3,0,0,3
6/5/22,Tuvalu,-7.1095,177.6493,3,0,0,3
6/6/22,Tuvalu,-7.1095,177.6493,3,0,0,3
6/7/22,Tuvalu,-7.1095,177.6493,3,0,0,3
6/8/22,Tuvalu,-7.1095,177.6493,3,0,0,3
6/9/22,Tuvalu,-7.1095,177.6493,3,0,0,3
6/10/22,Tuvalu,-7.1095,177.6493,3,0,0,3
6/11/22,Tuvalu,-7.1095,177.6493,3,0,0,3
6/12/22,Tuvalu,-7.1095,177.6493,3,0,0,3
6/13/22,Tuvalu,-7.1095,177.6493,3,0,0,3
6/14/22,Tuvalu,-7.1095,177.6493,3,0,0,3
6/15/22,Tuvalu,-7.1095,177.6493,3,0,0,3
6/16/22,Tuvalu,-7.1095,177.6493,3,0,0,3
6/17/22,Tuvalu,-7.1095,177.6493,3,0,0,3
6/18/22,Tuvalu,-7.1095,177.6493,3,0,0,3
6/19/22,Tuvalu,-7.1095,177.6493,3,0,0,3
6/20/22,Tuvalu,-7.1095,177.6493,3,0,0,3
6/21/22,Tuvalu,-7.1095,177.6493,3,0,0,3
6/22/22,Tuvalu,-7.1095,177.6493,3,0,0,3
6/23/22,Tuvalu,-7.1095,177.6493,3,0,0,3
6/24/22,Tuvalu,-7.1095,177.6493,3,0,0,3
6/25/22,Tuvalu,-7.1095,177.6493,3,0,0,3
6/26/22,Tuvalu,-7.1095,177.6493,3,0,0,3
6/27/22,Tuvalu,-7.1095,177.6493,3,0,0,3
6/28/22,Tuvalu,-7.1095,177.6493,3,0,0,3
6/29/22,Tuvalu,-7.1095,177.6493,3,0,0,3
6/30/22,Tuvalu,-7.1095,177.6493,3,0,0,3
7/1/22,Tuvalu,-7.1095,177.6493,3,0,0,3
7/2/22,Tuvalu,-7.1095,177.6493,3,0,0,3
7/3/22,Tuvalu,-7.1095,177.6493,3,0,0,3
7/4/22,Tuvalu,-7.1095,177.6493,3,0,0,3
7/5/22,Tuvalu,-7.1095,177.6493,3,0,0,3
7/6/22,Tuvalu,-7.1095,177.6493,3,0,0,3
7/7/22,Tuvalu,-7.1095,177.6493,3,0,0,3
7/8/22,Tuvalu,-7.1095,177.6493,8,0,0,8
7/9/22,Tuvalu,-7.1095,177.6493,8,0,0,8
7/10/22,Tuvalu,-7.1095,177.6493,8,0,0,8
7/11/22,Tuvalu,-7.1095,177.6493,8,0,0,8
7/12/22,Tuvalu,-7.1095,177.6493,8,0,0,8
7/13/22,Tuvalu,-7.1095,177.6493,8,0,0,8
7/14/22,Tuvalu,-7.1095,177.6493,8,0,0,8
7/15/22,Tuvalu,-7.1095,177.6493,8,0,0,8
7/16/22,Tuvalu,-7.1095,177.6493,8,0,0,8
7/17/22,Tuvalu,-7.1095,177.6493,8,0,0,8
7/18/22,Tuvalu,-7.1095,177.6493,8,0,0,8
7/19/22,Tuvalu,-7.1095,177.6493,8,0,0,8
7/20/22,Tuvalu,-7.1095,177.6493,8,0,0,8
7/21/22,Tuvalu,-7.1095,177.6493,8,0,0,8
7/22/22,Tuvalu,-7.1095,177.6493,8,0,0,8
7/23/22,Tuvalu,-7.1095,177.6493,8,0,0,8
7/24/22,Tuvalu,-7.1095,177.6493,8,0,0,8
7/25/22,Tuvalu,-7.1095,177.6493,8,0,0,8
7/26/22,Tuvalu,-7.1095,177.6493,8,0,0,8
7/27/22,Tuvalu,-7.1095,177.6493,8,0,0,8
7/28/22,Tuvalu,-7.1095,177.6493,8,0,0,8
7/29/22,Tuvalu,-7.1095,177.6493,8,0,0,8
7/30/22,Tuvalu,-7.1095,177.6493,8,0,0,8
7/31/22,Tuvalu,-7.1095,177.6493,8,0,0,8
8/1/22,Tuvalu,-7.1095,177.6493,8,0,0,8
8/2/22,Tuvalu,-7.1095,177.6493,8,0,0,8
8/3/22,Tuvalu,-7.1095,177.6493,8,0,0,8
8/4/22,Tuvalu,-7.1095,177.6493,8,0,0,8
8/5/22,Tuvalu,-7.1095,177.6493,8,0,0,8
8/6/22,Tuvalu,-7.1095,177.6493,8,0,0,8
8/7/22,Tuvalu,-7.1095,177.6493,8,0,0,8
8/8/22,Tuvalu,-7.1095,177.6493,8,0,0,8
8/9/22,Tuvalu,-7.1095,177.6493,8,0,0,8
8/10/22,Tuvalu,-7.1095,177.6493,8,0,0,8
8/11/22,Tuvalu,-7.1095,177.6493,8,0,0,8
8/12/22,Tuvalu,-7.1095,177.6493,8,0,0,8
8/13/22,Tuvalu,-7.1095,177.6493,8,0,0,8
8/14/22,Tuvalu,-7.1095,177.6493,8,0,0,8
8/15/22,Tuvalu,-7.1095,177.6493,8,0,0,8
8/16/22,Tuvalu,-7.1095,177.6493,8,0,0,8
8/17/22,Tuvalu,-7.1095,177.6493,8,0,0,8
8/18/22,Tuvalu,-7.1095,177.6493,8,0,0,8
8/19/22,Tuvalu,-7.1095,177.6493,8,0,0,8
8/20/22,Tuvalu,-7.1095,177.6493,8,0,0,8
8/21/22,Tuvalu,-7.1095,177.6493,8,0,0,8
8/22/22,Tuvalu,-7.1095,177.6493,8,0,0,8
8/23/22,Tuvalu,-7.1095,177.6493,20,0,0,20
8/24/22,Tuvalu,-7.1095,177.6493,20,0,0,20
8/25/22,Tuvalu,-7.1095,177.6493,20,0,0,20
8/26/22,Tuvalu,-7.1095,177.6493,20,0,0,20
8/27/22,Tuvalu,-7.1095,177.6493,20,0,0,20
8/28/22,Tuvalu,-7.1095,177.6493,20,0,0,20
8/29/22,Tuvalu,-7.1095,177.6493,20,0,0,20
8/30/22,Tuvalu,-7.1095,177.6493,20,0,0,20
8/31/22,Tuvalu,-7.1095,177.6493,20,0,0,20
9/1/22,Tuvalu,-7.1095,177.6493,20,0,0,20
9/2/22,Tuvalu,-7.1095,177.6493,20,0,0,20
9/3/22,Tuvalu,-7.1095,177.6493,20,0,0,20
9/4/22,Tuvalu,-7.1095,177.6493,20,0,0,20
9/5/22,Tuvalu,-7.1095,177.6493,20,0,0,20
9/6/22,Tuvalu,-7.1095,177.6493,20,0,0,20
9/7/22,Tuvalu,-7.1095,177.6493,20,0,0,20
9/8/22,Tuvalu,-7.1095,177.6493,20,0,0,20
9/9/22,Tuvalu,-7.1095,177.6493,20,0,0,20
9/10/22,Tuvalu,-7.1095,177.6493,20,0,0,20
9/11/22,Tuvalu,-7.1095,177.6493,20,0,0,20
9/12/22,Tuvalu,-7.1095,177.6493,20,0,0,20
9/13/22,Tuvalu,-7.1095,177.6493,20,0,0,20
9/14/22,Tuvalu,-7.1095,177.6493,20,0,0,20
9/15/22,Tuvalu,-7.1095,177.6493,20,0,0,20
9/16/22,Tuvalu,-7.1095,177.6493,20,0,0,20
9/17/22,Tuvalu,-7.1095,177.6493,20,0,0,20
9/18/22,Tuvalu,-7.1095,177.6493,20,0,0,20
9/19/22,Tuvalu,-7.1095,177.6493,20,0,0,20
9/20/22,Tuvalu,-7.1095,177.6493,20,0,0,20
9/21/22,Tuvalu,-7.1095,177.6493,20,0,0,20
9/22/22,Tuvalu,-7.1095,177.6493,20,0,0,20
9/23/22,Tuvalu,-7.1095,177.6493,20,0,0,20
9/24/22,Tuvalu,-7.1095,177.6493,20,0,0,20
9/25/22,Tuvalu,-7.1095,177.6493,20,0,0,20
9/26/22,Tuvalu,-7.1095,177.6493,20,0,0,20
9/27/22,Tuvalu,-7.1095,177.6493,20,0,0,20
9/28/22,Tuvalu,-7.1095,177.6493,20,0,0,20
9/29/22,Tuvalu,-7.1095,177.6493,20,0,0,20
9/30/22,Tuvalu,-7.1095,177.6493,20,0,0,20
10/1/22,Tuvalu,-7.1095,177.6493,20,0,0,20
10/2/22,Tuvalu,-7.1095,177.6493,20,0,0,20
10/3/22,Tuvalu,-7.1095,177.6493,20,0,0,20
10/4/22,Tuvalu,-7.1095,177.6493,20,0,0,20
10/5/22,Tuvalu,-7.1095,177.6493,20,0,0,20
10/6/22,Tuvalu,-7.1095,177.6493,20,0,0,20
10/7/22,Tuvalu,-7.1095,177.6493,20,0,0,20
10/8/22,Tuvalu,-7.1095,177.6493,20,0,0,20
10/9/22,Tuvalu,-7.1095,177.6493,20,0,0,20
10/10/22,Tuvalu,-7.1095,177.6493,20,0,0,20
10/11/22,Tuvalu,-7.1095,177.6493,20,0,0,20
10/12/22,Tuvalu,-7.1095,177.6493,20,0,0,20
10/13/22,Tuvalu,-7.1095,177.6493,20,0,0,20
10/14/22,Tuvalu,-7.1095,177.6493,20,0,0,20
10/15/22,Tuvalu,-7.1095,177.6493,20,0,0,20
10/16/22,Tuvalu,-7.1095,177.6493,20,0,0,20
10/17/22,Tuvalu,-7.1095,177.6493,20,0,0,20
10/18/22,Tuvalu,-7.1095,177.6493,20,0,0,20
10/19/22,Tuvalu,-7.1095,177.6493,20,0,0,20
10/20/22,Tuvalu,-7.1095,177.6493,20,0,0,20
10/21/22,Tuvalu,-7.1095,177.6493,20,0,0,20
10/22/22,Tuvalu,-7.1095,177.6493,20,0,0,20
10/23/22,Tuvalu,-7.1095,177.6493,20,0,0,20
10/24/22,Tuvalu,-7.1095,177.6493,23,0,0,23
10/25/22,Tuvalu,-7.1095,177.6493,23,0,0,23
10/26/22,Tuvalu,-7.1095,177.6493,23,0,0,23
10/27/22,Tuvalu,-7.1095,177.6493,23,0,0,23
10/28/22,Tuvalu,-7.1095,177.6493,23,0,0,23
10/29/22,Tuvalu,-7.1095,177.6493,23,0,0,23
10/30/22,Tuvalu,-7.1095,177.6493,23,0,0,23
10/31/22,Tuvalu,-7.1095,177.6493,23,0,0,23
11/1/22,Tuvalu,-7.1095,177.6493,23,0,0,23
11/2/22,Tuvalu,-7.1095,177.6493,23,0,0,23
11/3/22,Tuvalu,-7.1095,177.6493,23,0,0,23
11/4/22,Tuvalu,-7.1095,177.6493,23,0,0,23
11/5/22,Tuvalu,-7.1095,177.6493,163,0,0,163
11/6/22,Tuvalu,-7.1095,177.6493,163,0,0,163
11/7/22,Tuvalu,-7.1095,177.6493,163,0,0,163
11/8/22,Tuvalu,-7.1095,177.6493,163,0,0,163
11/9/22,Tuvalu,-7.1095,177.6493,466,0,0,466
11/10/22,Tuvalu,-7.1095,177.6493,466,0,0,466
11/11/22,Tuvalu,-7.1095,177.6493,466,0,0,466
11/12/22,Tuvalu,-7.1095,177.6493,466,0,0,466
11/13/22,Tuvalu,-7.1095,177.6493,1259,0,0,1259
11/14/22,Tuvalu,-7.1095,177.6493,1259,0,0,1259
11/15/22,Tuvalu,-7.1095,177.6493,1259,0,0,1259
11/16/22,Tuvalu,-7.1095,177.6493,1532,0,0,1532
11/17/22,Tuvalu,-7.1095,177.6493,1555,0,0,1555
11/18/22,Tuvalu,-7.1095,177.6493,2019,0,0,2019
11/19/22,Tuvalu,-7.1095,177.6493,2019,0,0,2019
11/20/22,Tuvalu,-7.1095,177.6493,2019,0,0,2019
11/21/22,Tuvalu,-7.1095,177.6493,2387,0,0,2387
11/22/22,Tuvalu,-7.1095,177.6493,2805,0,0,2805
11/23/22,Tuvalu,-7.1095,177.6493,2828,0,0,2828
11/24/22,Tuvalu,-7.1095,177.6493,2828,0,0,2828
11/25/22,Tuvalu,-7.1095,177.6493,2828,0,0,2828
11/26/22,Tuvalu,-7.1095,177.6493,2828,0,0,2828
11/27/22,Tuvalu,-7.1095,177.6493,2828,0,0,2828
11/28/22,Tuvalu,-7.1095,177.6493,2805,0,0,2805
11/29/22,Tuvalu,-7.1095,177.6493,2805,0,0,2805
11/30/22,Tuvalu,-7.1095,177.6493,2805,0,0,2805
12/1/22,Tuvalu,-7.1095,177.6493,2805,0,0,2805
12/2/22,Tuvalu,-7.1095,177.6493,2805,0,0,2805
12/3/22,Tuvalu,-7.1095,177.6493,2805,0,0,2805
12/4/22,Tuvalu,-7.1095,177.6493,2805,0,0,2805
12/5/22,Tuvalu,-7.1095,177.6493,2805,0,0,2805
12/6/22,Tuvalu,-7.1095,177.6493,2805,0,0,2805
12/7/22,Tuvalu,-7.1095,177.6493,2805,0,0,2805
12/8/22,Tuvalu,-7.1095,177.6493,2805,0,0,2805
12/9/22,Tuvalu,-7.1095,177.6493,2805,0,0,2805
12/10/22,Tuvalu,-7.1095,177.6493,2805,0,0,2805
12/11/22,Tuvalu,-7.1095,177.6493,2805,0,0,2805
12/12/22,Tuvalu,-7.1095,177.6493,2805,0,0,2805
12/13/22,Tuvalu,-7.1095,177.6493,2805,0,0,2805
12/14/22,Tuvalu,-7.1095,177.6493,2805,0,0,2805
12/15/22,Tuvalu,-7.1095,177.6493,2805,0,0,2805
12/16/22,Tuvalu,-7.1095,177.6493,2805,0,0,2805
12/17/22,Tuvalu,-7.1095,177.6493,2805,0,0,2805
1/1/22,Uganda,1.373333,32.290275,142604,0,3297,139307
1/2/22,Uganda,1.373333,32.290275,144540,0,3302,141238
1/3/22,Uganda,1.373333,32.290275,145963,0,3306,142657
1/4/22,Uganda,1.373333,32.290275,146843,0,3312,143531
1/5/22,Uganda,1.373333,32.290275,148609,0,3313,145296
1/6/22,Uganda,1.373333,32.290275,150368,0,3325,147043
1/7/22,Uganda,1.373333,32.290275,150368,0,3325,147043
1/8/22,Uganda,1.373333,32.290275,152778,0,3337,149441
1/9/22,Uganda,1.373333,32.290275,153762,0,3339,150423
1/10/22,Uganda,1.373333,32.290275,154578,0,3357,151221
1/11/22,Uganda,1.373333,32.290275,155443,0,3361,152082
1/12/22,Uganda,1.373333,32.290275,156113,0,3370,152743
1/13/22,Uganda,1.373333,32.290275,156704,0,3378,153326
1/14/22,Uganda,1.373333,32.290275,157227,0,3385,153842
1/15/22,Uganda,1.373333,32.290275,157754,0,3394,154360
1/16/22,Uganda,1.373333,32.290275,158238,0,3411,154827
1/17/22,Uganda,1.373333,32.290275,158743,0,3424,155319
1/18/22,Uganda,1.373333,32.290275,158933,0,3437,155496
1/19/22,Uganda,1.373333,32.290275,159270,0,3449,155821
1/20/22,Uganda,1.373333,32.290275,159521,0,3459,156062
1/21/22,Uganda,1.373333,32.290275,159807,0,3463,156344
1/22/22,Uganda,1.373333,32.290275,160146,0,3465,156681
1/23/22,Uganda,1.373333,32.290275,160352,0,3474,156878
1/24/22,Uganda,1.373333,32.290275,160572,0,3483,157089
1/25/22,Uganda,1.373333,32.290275,160778,0,3497,157281
1/26/22,Uganda,1.373333,32.290275,160974,0,3507,157467
1/27/22,Uganda,1.373333,32.290275,161259,0,3515,157744
1/28/22,Uganda,1.373333,32.290275,161421,0,3522,157899
1/29/22,Uganda,1.373333,32.290275,161503,0,3523,157980
1/30/22,Uganda,1.373333,32.290275,161693,0,3527,158166
1/31/22,Uganda,1.373333,32.290275,161839,0,3533,158306
2/1/22,Uganda,1.373333,32.290275,161929,0,3538,158391
2/2/22,Uganda,1.373333,32.290275,162007,0,3545,158462
2/3/22,Uganda,1.373333,32.290275,162049,0,3545,158504
2/4/22,Uganda,1.373333,32.290275,162136,0,3549,158587
2/5/22,Uganda,1.373333,32.290275,162203,0,3552,158651
2/6/22,Uganda,1.373333,32.290275,162273,0,3557,158716
2/7/22,Uganda,1.373333,32.290275,162375,0,3566,158809
2/8/22,Uganda,1.373333,32.290275,162442,0,3568,158874
2/9/22,Uganda,1.373333,32.290275,162510,0,3570,158940
2/10/22,Uganda,1.373333,32.290275,162559,0,3572,158987
2/11/22,Uganda,1.373333,32.290275,162639,0,3575,159064
2/12/22,Uganda,1.373333,32.290275,162639,0,3575,159064
2/13/22,Uganda,1.373333,32.290275,162696,0,3575,159121
2/14/22,Uganda,1.373333,32.290275,162822,0,3579,159243
2/15/22,Uganda,1.373333,32.290275,162869,0,3580,159289
2/16/22,Uganda,1.373333,32.290275,162932,0,3582,159350
2/17/22,Uganda,1.373333,32.290275,162932,0,3582,159350
2/18/22,Uganda,1.373333,32.290275,162973,0,3582,159391
2/19/22,Uganda,1.373333,32.290275,163004,0,3582,159422
2/20/22,Uganda,1.373333,32.290275,163032,0,3582,159450
2/21/22,Uganda,1.373333,32.290275,163116,0,3585,159531
2/22/22,Uganda,1.373333,32.290275,163138,0,3585,159553
2/23/22,Uganda,1.373333,32.290275,163152,0,3585,159567
2/24/22,Uganda,1.373333,32.290275,163179,0,3585,159594
2/25/22,Uganda,1.373333,32.290275,163231,0,3585,159646
2/26/22,Uganda,1.373333,32.290275,163231,0,3585,159646
2/27/22,Uganda,1.373333,32.290275,163250,0,3588,159662
2/28/22,Uganda,1.373333,32.290275,163307,0,3588,159719
3/1/22,Uganda,1.373333,32.290275,163342,0,3588,159754
3/2/22,Uganda,1.373333,32.290275,163342,0,3588,159754
3/3/22,Uganda,1.373333,32.290275,163383,0,3588,159795
3/4/22,Uganda,1.373333,32.290275,163383,0,3590,159793
3/5/22,Uganda,1.373333,32.290275,163383,0,3590,159793
3/6/22,Uganda,1.373333,32.290275,163383,0,3590,159793
3/7/22,Uganda,1.373333,32.290275,163402,0,3592,159810
3/8/22,Uganda,1.373333,32.290275,163416,0,3592,159824
3/9/22,Uganda,1.373333,32.290275,163454,0,3593,159861
3/10/22,Uganda,1.373333,32.290275,163513,0,3593,159920
3/11/22,Uganda,1.373333,32.290275,163529,0,3594,159935
3/12/22,Uganda,1.373333,32.290275,163529,0,3594,159935
3/13/22,Uganda,1.373333,32.290275,163529,0,3594,159935
3/14/22,Uganda,1.373333,32.290275,163541,0,3594,159947
3/15/22,Uganda,1.373333,32.290275,163597,0,3594,160003
3/16/22,Uganda,1.373333,32.290275,163609,0,3594,160015
3/17/22,Uganda,1.373333,32.290275,163627,0,3595,160032
3/18/22,Uganda,1.373333,32.290275,163634,0,3595,160039
3/19/22,Uganda,1.373333,32.290275,163635,0,3595,160040
3/20/22,Uganda,1.373333,32.290275,163688,0,3595,160093
3/21/22,Uganda,1.373333,32.290275,163768,0,3595,160173
3/22/22,Uganda,1.373333,32.290275,163768,0,3595,160173
3/23/22,Uganda,1.373333,32.290275,163775,0,3595,160180
3/24/22,Uganda,1.373333,32.290275,163817,0,3595,160222
3/25/22,Uganda,1.373333,32.290275,163830,0,3595,160235
3/26/22,Uganda,1.373333,32.290275,163843,0,3595,160248
3/27/22,Uganda,1.373333,32.290275,163862,0,3595,160267
3/28/22,Uganda,1.373333,32.290275,163869,0,3596,160273
3/29/22,Uganda,1.373333,32.290275,163878,0,3596,160282
3/30/22,Uganda,1.373333,32.290275,163892,0,3596,160296
3/31/22,Uganda,1.373333,32.290275,163905,0,3596,160309
4/1/22,Uganda,1.373333,32.290275,163919,0,3596,160323
4/2/22,Uganda,1.373333,32.290275,163932,0,3596,160336
4/3/22,Uganda,1.373333,32.290275,163936,0,3596,160340
4/4/22,Uganda,1.373333,32.290275,163949,0,3596,160353
4/5/22,Uganda,1.373333,32.290275,163951,0,3596,160355
4/6/22,Uganda,1.373333,32.290275,163954,0,3596,160358
4/7/22,Uganda,1.373333,32.290275,163954,0,3596,160358
4/8/22,Uganda,1.373333,32.290275,163972,0,3596,160376
4/9/22,Uganda,1.373333,32.290275,163985,0,3596,160389
4/10/22,Uganda,1.373333,32.290275,163993,0,3596,160397
4/11/22,Uganda,1.373333,32.290275,163996,0,3596,160400
4/12/22,Uganda,1.373333,32.290275,164012,0,3596,160416
4/13/22,Uganda,1.373333,32.290275,164024,0,3596,160428
4/14/22,Uganda,1.373333,32.290275,164035,0,3597,160438
4/15/22,Uganda,1.373333,32.290275,164042,0,3597,160445
4/16/22,Uganda,1.373333,32.290275,164051,0,3597,160454
4/17/22,Uganda,1.373333,32.290275,164051,0,3597,160454
4/18/22,Uganda,1.373333,32.290275,164055,0,3597,160458
4/19/22,Uganda,1.373333,32.290275,164058,0,3597,160461
4/20/22,Uganda,1.373333,32.290275,164069,0,3597,160472
4/21/22,Uganda,1.373333,32.290275,164069,0,3597,160472
4/22/22,Uganda,1.373333,32.290275,164069,0,3597,160472
4/23/22,Uganda,1.373333,32.290275,164069,0,3597,160472
4/24/22,Uganda,1.373333,32.290275,164069,0,3597,160472
4/25/22,Uganda,1.373333,32.290275,164069,0,3597,160472
4/26/22,Uganda,1.373333,32.290275,164069,0,3597,160472
4/27/22,Uganda,1.373333,32.290275,164069,0,3597,160472
4/28/22,Uganda,1.373333,32.290275,164069,0,3597,160472
4/29/22,Uganda,1.373333,32.290275,164084,0,3597,160487
4/30/22,Uganda,1.373333,32.290275,164084,0,3597,160487
5/1/22,Uganda,1.373333,32.290275,164084,0,3597,160487
5/2/22,Uganda,1.373333,32.290275,164104,0,3597,160507
5/3/22,Uganda,1.373333,32.290275,164104,0,3597,160507
5/4/22,Uganda,1.373333,32.290275,164104,0,3597,160507
5/5/22,Uganda,1.373333,32.290275,164104,0,3597,160507
5/6/22,Uganda,1.373333,32.290275,164118,0,3598,160520
5/7/22,Uganda,1.373333,32.290275,164118,0,3598,160520
5/8/22,Uganda,1.373333,32.290275,164118,0,3598,160520
5/9/22,Uganda,1.373333,32.290275,164149,0,3598,160551
5/10/22,Uganda,1.373333,32.290275,164153,0,3598,160555
5/11/22,Uganda,1.373333,32.290275,164153,0,3598,160555
5/12/22,Uganda,1.373333,32.290275,164153,0,3598,160555
5/13/22,Uganda,1.373333,32.290275,164153,0,3598,160555
5/14/22,Uganda,1.373333,32.290275,164153,0,3598,160555
5/15/22,Uganda,1.373333,32.290275,164153,0,3598,160555
5/16/22,Uganda,1.373333,32.290275,164153,0,3598,160555
5/17/22,Uganda,1.373333,32.290275,164153,0,3598,160555
5/18/22,Uganda,1.373333,32.290275,164153,0,3598,160555
5/19/22,Uganda,1.373333,32.290275,164153,0,3598,160555
5/20/22,Uganda,1.373333,32.290275,164153,0,3598,160555
5/21/22,Uganda,1.373333,32.290275,164153,0,3598,160555
5/22/22,Uganda,1.373333,32.290275,164153,0,3598,160555
5/23/22,Uganda,1.373333,32.290275,164153,0,3598,160555
5/24/22,Uganda,1.373333,32.290275,164331,0,3600,160731
5/25/22,Uganda,1.373333,32.290275,164331,0,3600,160731
5/26/22,Uganda,1.373333,32.290275,164331,0,3600,160731
5/27/22,Uganda,1.373333,32.290275,164366,0,3602,160764
5/28/22,Uganda,1.373333,32.290275,164366,0,3602,160764
5/29/22,Uganda,1.373333,32.290275,164366,0,3602,160764
5/30/22,Uganda,1.373333,32.290275,164366,0,3602,160764
5/31/22,Uganda,1.373333,32.290275,164366,0,3602,160764
6/1/22,Uganda,1.373333,32.290275,164366,0,3602,160764
6/2/22,Uganda,1.373333,32.290275,164366,0,3602,160764
6/3/22,Uganda,1.373333,32.290275,164366,0,3602,160764
6/4/22,Uganda,1.373333,32.290275,164366,0,3602,160764
6/5/22,Uganda,1.373333,32.290275,164366,0,3602,160764
6/6/22,Uganda,1.373333,32.290275,165700,0,3602,162098
6/7/22,Uganda,1.373333,32.290275,165734,0,3602,162132
6/8/22,Uganda,1.373333,32.290275,165803,0,3602,162201
6/9/22,Uganda,1.373333,32.290275,165927,0,3602,162325
6/10/22,Uganda,1.373333,32.290275,166046,0,3602,162444
6/11/22,Uganda,1.373333,32.290275,166121,0,3602,162519
6/12/22,Uganda,1.373333,32.290275,166237,0,3602,162635
6/13/22,Uganda,1.373333,32.290275,166319,0,3602,162717
6/14/22,Uganda,1.373333,32.290275,166378,0,3605,162773
6/15/22,Uganda,1.373333,32.290275,166497,0,3605,162892
6/16/22,Uganda,1.373333,32.290275,166593,0,3613,162980
6/17/22,Uganda,1.373333,32.290275,166725,0,3613,163112
6/18/22,Uganda,1.373333,32.290275,166809,0,3614,163195
6/19/22,Uganda,1.373333,32.290275,166920,0,3615,163305
6/20/22,Uganda,1.373333,32.290275,166954,0,3615,163339
6/21/22,Uganda,1.373333,32.290275,166996,0,3618,163378
6/22/22,Uganda,1.373333,32.290275,167122,0,3618,163504
6/23/22,Uganda,1.373333,32.290275,167217,0,3618,163599
6/24/22,Uganda,1.373333,32.290275,167301,0,3618,163683
6/25/22,Uganda,1.373333,32.290275,167367,0,3620,163747
6/26/22,Uganda,1.373333,32.290275,167452,0,3621,163831
6/27/22,Uganda,1.373333,32.290275,167511,0,3621,163890
6/28/22,Uganda,1.373333,32.290275,167511,0,3621,163890
6/29/22,Uganda,1.373333,32.290275,167646,0,3621,164025
6/30/22,Uganda,1.373333,32.290275,167719,0,3621,164098
7/1/22,Uganda,1.373333,32.290275,167806,0,3621,164185
7/2/22,Uganda,1.373333,32.290275,167876,0,3621,164255
7/3/22,Uganda,1.373333,32.290275,167935,0,3621,164314
7/4/22,Uganda,1.373333,32.290275,167979,0,3621,164358
7/5/22,Uganda,1.373333,32.290275,167979,0,3621,164358
7/6/22,Uganda,1.373333,32.290275,168009,0,3621,164388
7/7/22,Uganda,1.373333,32.290275,168169,0,3622,164547
7/8/22,Uganda,1.373333,32.290275,168227,0,3622,164605
7/9/22,Uganda,1.373333,32.290275,168291,0,3622,164669
7/10/22,Uganda,1.373333,32.290275,168360,0,3627,164733
7/11/22,Uganda,1.373333,32.290275,168394,0,3627,164767
7/12/22,Uganda,1.373333,32.290275,168440,0,3627,164813
7/13/22,Uganda,1.373333,32.290275,168497,0,3627,164870
7/14/22,Uganda,1.373333,32.290275,168569,0,3627,164942
7/15/22,Uganda,1.373333,32.290275,168629,0,3627,165002
7/16/22,Uganda,1.373333,32.290275,168724,0,3627,165097
7/17/22,Uganda,1.373333,32.290275,168763,0,3627,165136
7/18/22,Uganda,1.373333,32.290275,168776,0,3627,165149
7/19/22,Uganda,1.373333,32.290275,168802,0,3627,165175
7/20/22,Uganda,1.373333,32.290275,168845,0,3627,165218
7/21/22,Uganda,1.373333,32.290275,168887,0,3627,165260
7/22/22,Uganda,1.373333,32.290275,168887,0,3627,165260
7/23/22,Uganda,1.373333,32.290275,168919,0,3627,165292
7/24/22,Uganda,1.373333,32.290275,168978,0,3628,165350
7/25/22,Uganda,1.373333,32.290275,169015,0,3628,165387
7/26/22,Uganda,1.373333,32.290275,169124,0,3628,165496
7/27/22,Uganda,1.373333,32.290275,169162,0,3628,165534
7/28/22,Uganda,1.373333,32.290275,169189,0,3628,165561
7/29/22,Uganda,1.373333,32.290275,169230,0,3628,165602
7/30/22,Uganda,1.373333,32.290275,169230,0,3628,165602
7/31/22,Uganda,1.373333,32.290275,169230,0,3628,165602
8/1/22,Uganda,1.373333,32.290275,169250,0,3628,165622
8/2/22,Uganda,1.373333,32.290275,169340,0,3628,165712
8/3/22,Uganda,1.373333,32.290275,169340,0,3628,165712
8/4/22,Uganda,1.373333,32.290275,169396,0,3628,165768
8/5/22,Uganda,1.373333,32.290275,169396,0,3628,165768
8/6/22,Uganda,1.373333,32.290275,169396,0,3628,165768
8/7/22,Uganda,1.373333,32.290275,169396,0,3628,165768
8/8/22,Uganda,1.373333,32.290275,169396,0,3628,165768
8/9/22,Uganda,1.373333,32.290275,169396,0,3628,165768
8/10/22,Uganda,1.373333,32.290275,169396,0,3628,165768
8/11/22,Uganda,1.373333,32.290275,169396,0,3628,165768
8/12/22,Uganda,1.373333,32.290275,169396,0,3628,165768
8/13/22,Uganda,1.373333,32.290275,169396,0,3628,165768
8/14/22,Uganda,1.373333,32.290275,169396,0,3628,165768
8/15/22,Uganda,1.373333,32.290275,169396,0,3628,165768
8/16/22,Uganda,1.373333,32.290275,169396,0,3628,165768
8/17/22,Uganda,1.373333,32.290275,169396,0,3628,165768
8/18/22,Uganda,1.373333,32.290275,169396,0,3628,165768
8/19/22,Uganda,1.373333,32.290275,169396,0,3628,165768
8/20/22,Uganda,1.373333,32.290275,169396,0,3628,165768
8/21/22,Uganda,1.373333,32.290275,169396,0,3628,165768
8/22/22,Uganda,1.373333,32.290275,169396,0,3628,165768
8/23/22,Uganda,1.373333,32.290275,169396,0,3628,165768
8/24/22,Uganda,1.373333,32.290275,169396,0,3628,165768
8/25/22,Uganda,1.373333,32.290275,169396,0,3628,165768
8/26/22,Uganda,1.373333,32.290275,169396,0,3628,165768
8/27/22,Uganda,1.373333,32.290275,169396,0,3628,165768
8/28/22,Uganda,1.373333,32.290275,169396,0,3628,165768
8/29/22,Uganda,1.373333,32.290275,169396,0,3628,165768
8/30/22,Uganda,1.373333,32.290275,169396,0,3628,165768
8/31/22,Uganda,1.373333,32.290275,169396,0,3628,165768
9/1/22,Uganda,1.373333,32.290275,169396,0,3628,165768
9/2/22,Uganda,1.373333,32.290275,169396,0,3628,165768
9/3/22,Uganda,1.373333,32.290275,169396,0,3628,165768
9/4/22,Uganda,1.373333,32.290275,169396,0,3628,165768
9/5/22,Uganda,1.373333,32.290275,169396,0,3628,165768
9/6/22,Uganda,1.373333,32.290275,169396,0,3628,165768
9/7/22,Uganda,1.373333,32.290275,169396,0,3628,165768
9/8/22,Uganda,1.373333,32.290275,169396,0,3628,165768
9/9/22,Uganda,1.373333,32.290275,169396,0,3628,165768
9/10/22,Uganda,1.373333,32.290275,169396,0,3628,165768
9/11/22,Uganda,1.373333,32.290275,169396,0,3628,165768
9/12/22,Uganda,1.373333,32.290275,169396,0,3628,165768
9/13/22,Uganda,1.373333,32.290275,169396,0,3628,165768
9/14/22,Uganda,1.373333,32.290275,169396,0,3628,165768
9/15/22,Uganda,1.373333,32.290275,169396,0,3628,165768
9/16/22,Uganda,1.373333,32.290275,169396,0,3628,165768
9/17/22,Uganda,1.373333,32.290275,169396,0,3628,165768
9/18/22,Uganda,1.373333,32.290275,169396,0,3628,165768
9/19/22,Uganda,1.373333,32.290275,169396,0,3628,165768
9/20/22,Uganda,1.373333,32.290275,169396,0,3630,165766
9/21/22,Uganda,1.373333,32.290275,169396,0,3630,165766
9/22/22,Uganda,1.373333,32.290275,169396,0,3630,165766
9/23/22,Uganda,1.373333,32.290275,169396,0,3630,165766
9/24/22,Uganda,1.373333,32.290275,169396,0,3630,165766
9/25/22,Uganda,1.373333,32.290275,169396,0,3630,165766
9/26/22,Uganda,1.373333,32.290275,169396,0,3630,165766
9/27/22,Uganda,1.373333,32.290275,169396,0,3630,165766
9/28/22,Uganda,1.373333,32.290275,169396,0,3630,165766
9/29/22,Uganda,1.373333,32.290275,169396,0,3630,165766
9/30/22,Uganda,1.373333,32.290275,169396,0,3630,165766
10/1/22,Uganda,1.373333,32.290275,169396,0,3630,165766
10/2/22,Uganda,1.373333,32.290275,169396,0,3630,165766
10/3/22,Uganda,1.373333,32.290275,169396,0,3630,165766
10/4/22,Uganda,1.373333,32.290275,169396,0,3630,165766
10/5/22,Uganda,1.373333,32.290275,169396,0,3630,165766
10/6/22,Uganda,1.373333,32.290275,169396,0,3630,165766
10/7/22,Uganda,1.373333,32.290275,169396,0,3630,165766
10/8/22,Uganda,1.373333,32.290275,169396,0,3630,165766
10/9/22,Uganda,1.373333,32.290275,169396,0,3630,165766
10/10/22,Uganda,1.373333,32.290275,169396,0,3630,165766
10/11/22,Uganda,1.373333,32.290275,169396,0,3630,165766
10/12/22,Uganda,1.373333,32.290275,169396,0,3630,165766
10/13/22,Uganda,1.373333,32.290275,169396,0,3630,165766
10/14/22,Uganda,1.373333,32.290275,169396,0,3630,165766
10/15/22,Uganda,1.373333,32.290275,169396,0,3630,165766
10/16/22,Uganda,1.373333,32.290275,169396,0,3630,165766
10/17/22,Uganda,1.373333,32.290275,169396,0,3630,165766
10/18/22,Uganda,1.373333,32.290275,169396,0,3630,165766
10/19/22,Uganda,1.373333,32.290275,169396,0,3630,165766
10/20/22,Uganda,1.373333,32.290275,169396,0,3630,165766
10/21/22,Uganda,1.373333,32.290275,169396,0,3630,165766
10/22/22,Uganda,1.373333,32.290275,169396,0,3630,165766
10/23/22,Uganda,1.373333,32.290275,169396,0,3630,165766
10/24/22,Uganda,1.373333,32.290275,169396,0,3630,165766
10/25/22,Uganda,1.373333,32.290275,169396,0,3630,165766
10/26/22,Uganda,1.373333,32.290275,169396,0,3630,165766
10/27/22,Uganda,1.373333,32.290275,169396,0,3630,165766
10/28/22,Uganda,1.373333,32.290275,169396,0,3630,165766
10/29/22,Uganda,1.373333,32.290275,169396,0,3630,165766
10/30/22,Uganda,1.373333,32.290275,169396,0,3630,165766
10/31/22,Uganda,1.373333,32.290275,169473,0,3630,165843
11/1/22,Uganda,1.373333,32.290275,169473,0,3630,165843
11/2/22,Uganda,1.373333,32.290275,169473,0,3630,165843
11/3/22,Uganda,1.373333,32.290275,169473,0,3630,165843
11/4/22,Uganda,1.373333,32.290275,169473,0,3630,165843
11/5/22,Uganda,1.373333,32.290275,169473,0,3630,165843
11/6/22,Uganda,1.373333,32.290275,169473,0,3630,165843
11/7/22,Uganda,1.373333,32.290275,169473,0,3630,165843
11/8/22,Uganda,1.373333,32.290275,169473,0,3630,165843
11/9/22,Uganda,1.373333,32.290275,169473,0,3630,165843
11/10/22,Uganda,1.373333,32.290275,169473,0,3630,165843
11/11/22,Uganda,1.373333,32.290275,169473,0,3630,165843
11/12/22,Uganda,1.373333,32.290275,169473,0,3630,165843
11/13/22,Uganda,1.373333,32.290275,169473,0,3630,165843
11/14/22,Uganda,1.373333,32.290275,169581,0,3630,165951
11/15/22,Uganda,1.373333,32.290275,169663,0,3630,166033
11/16/22,Uganda,1.373333,32.290275,169663,0,3630,166033
11/17/22,Uganda,1.373333,32.290275,169663,0,3630,166033
11/18/22,Uganda,1.373333,32.290275,169663,0,3630,166033
11/19/22,Uganda,1.373333,32.290275,169663,0,3630,166033
11/20/22,Uganda,1.373333,32.290275,169663,0,3630,166033
11/21/22,Uganda,1.373333,32.290275,169663,0,3630,166033
11/22/22,Uganda,1.373333,32.290275,169663,0,3630,166033
11/23/22,Uganda,1.373333,32.290275,169663,0,3630,166033
11/24/22,Uganda,1.373333,32.290275,169663,0,3630,166033
11/25/22,Uganda,1.373333,32.290275,169663,0,3630,166033
11/26/22,Uganda,1.373333,32.290275,169663,0,3630,166033
11/27/22,Uganda,1.373333,32.290275,169663,0,3630,166033
11/28/22,Uganda,1.373333,32.290275,169663,0,3630,166033
11/29/22,Uganda,1.373333,32.290275,169733,0,3630,166103
11/30/22,Uganda,1.373333,32.290275,169733,0,3630,166103
12/1/22,Uganda,1.373333,32.290275,169733,0,3630,166103
12/2/22,Uganda,1.373333,32.290275,169733,0,3630,166103
12/3/22,Uganda,1.373333,32.290275,169733,0,3630,166103
12/4/22,Uganda,1.373333,32.290275,169733,0,3630,166103
12/5/22,Uganda,1.373333,32.290275,169810,0,3630,166180
12/6/22,Uganda,1.373333,32.290275,169810,0,3630,166180
12/7/22,Uganda,1.373333,32.290275,169810,0,3630,166180
12/8/22,Uganda,1.373333,32.290275,169810,0,3630,166180
12/9/22,Uganda,1.373333,32.290275,169810,0,3630,166180
12/10/22,Uganda,1.373333,32.290275,169810,0,3630,166180
12/11/22,Uganda,1.373333,32.290275,169810,0,3630,166180
12/12/22,Uganda,1.373333,32.290275,169810,0,3630,166180
12/13/22,Uganda,1.373333,32.290275,169810,0,3630,166180
12/14/22,Uganda,1.373333,32.290275,169810,0,3630,166180
12/15/22,Uganda,1.373333,32.290275,169810,0,3630,166180
12/16/22,Uganda,1.373333,32.290275,169810,0,3630,166180
12/17/22,Uganda,1.373333,32.290275,169810,0,3630,166180
1/1/22,Ukraine,48.3794,31.1656,3852397,0,102300,3750097
1/2/22,Ukraine,48.3794,31.1656,3854405,0,102421,3751984
1/3/22,Ukraine,48.3794,31.1656,3856359,0,102558,3753801
1/4/22,Ukraine,48.3794,31.1656,3858248,0,102717,3755531
1/5/22,Ukraine,48.3794,31.1656,3862959,0,103014,3759945
1/6/22,Ukraine,48.3794,31.1656,3869728,0,103225,3766503
1/7/22,Ukraine,48.3794,31.1656,3877032,0,103434,3773598
1/8/22,Ukraine,48.3794,31.1656,3880371,0,103523,3776848
1/9/22,Ukraine,48.3794,31.1656,3883316,0,103615,3779701
1/10/22,Ukraine,48.3794,31.1656,3885416,0,103716,3781700
1/11/22,Ukraine,48.3794,31.1656,3890974,0,103950,3787024
1/12/22,Ukraine,48.3794,31.1656,3898240,0,104159,3794081
1/13/22,Ukraine,48.3794,31.1656,3908469,0,104367,3804102
1/14/22,Ukraine,48.3794,31.1656,3919151,0,104521,3814630
1/15/22,Ukraine,48.3794,31.1656,3929950,0,104663,3825287
1/16/22,Ukraine,48.3794,31.1656,3936582,0,104765,3831817
1/17/22,Ukraine,48.3794,31.1656,3941923,0,104856,3837067
1/18/22,Ukraine,48.3794,31.1656,3950774,0,105059,3845715
1/19/22,Ukraine,48.3794,31.1656,3963917,0,105236,3858681
1/20/22,Ukraine,48.3794,31.1656,3982738,0,105380,3877358
1/21/22,Ukraine,48.3794,31.1656,4003280,0,105545,3897735
1/22/22,Ukraine,48.3794,31.1656,4026198,0,105693,3920505
1/23/22,Ukraine,48.3794,31.1656,4042152,0,105791,3936361
1/24/22,Ukraine,48.3794,31.1656,4055643,0,105871,3949772
1/25/22,Ukraine,48.3794,31.1656,4075351,0,106047,3969304
1/26/22,Ukraine,48.3794,31.1656,4100292,0,106205,3994087
1/27/22,Ukraine,48.3794,31.1656,4133396,0,106373,4027023
1/28/22,Ukraine,48.3794,31.1656,4168560,0,106529,4062031
1/29/22,Ukraine,48.3794,31.1656,4206731,0,106690,4100041
1/30/22,Ukraine,48.3794,31.1656,4232143,0,106793,4125350
1/31/22,Ukraine,48.3794,31.1656,4255206,0,106880,4148326
2/1/22,Ukraine,48.3794,31.1656,4287117,0,107086,4180031
2/2/22,Ukraine,48.3794,31.1656,4323009,0,107303,4215706
2/3/22,Ukraine,48.3794,31.1656,4363754,0,107524,4256230
2/4/22,Ukraine,48.3794,31.1656,4408776,0,107712,4301064
2/5/22,Ukraine,48.3794,31.1656,4452612,0,107907,4344705
2/6/22,Ukraine,48.3794,31.1656,4481918,0,108027,4373891
2/7/22,Ukraine,48.3794,31.1656,4506669,0,108151,4398518
2/8/22,Ukraine,48.3794,31.1656,4542568,0,108417,4434151
2/9/22,Ukraine,48.3794,31.1656,4582137,0,108668,4473469
2/10/22,Ukraine,48.3794,31.1656,4625614,0,108958,4516656
2/11/22,Ukraine,48.3794,31.1656,4668581,0,109206,4559375
2/12/22,Ukraine,48.3794,31.1656,4708604,0,109483,4599121
2/13/22,Ukraine,48.3794,31.1656,4735258,0,109635,4625623
2/14/22,Ukraine,48.3794,31.1656,4753922,0,109788,4644134
2/15/22,Ukraine,48.3794,31.1656,4785138,0,110105,4675033
2/16/22,Ukraine,48.3794,31.1656,4818112,0,110427,4707685
2/17/22,Ukraine,48.3794,31.1656,4853339,0,110698,4742641
2/18/22,Ukraine,48.3794,31.1656,4890332,0,110989,4779343
2/19/22,Ukraine,48.3794,31.1656,4923680,0,111261,4812419
2/20/22,Ukraine,48.3794,31.1656,4943428,0,111423,4832005
2/21/22,Ukraine,48.3794,31.1656,4959461,0,111561,4847900
2/22/22,Ukraine,48.3794,31.1656,4986161,0,111862,4874299
2/23/22,Ukraine,48.3794,31.1656,5012980,0,112173,4900807
2/24/22,Ukraine,48.3794,31.1656,5040518,0,112459,4928059
2/25/22,Ukraine,48.3794,31.1656,5052182,0,112618,4939564
2/26/22,Ukraine,48.3794,31.1656,5057946,0,112740,4945206
2/27/22,Ukraine,48.3794,31.1656,5062889,0,112835,4950054
2/28/22,Ukraine,48.3794,31.1656,5066370,0,112902,4953468
3/1/22,Ukraine,48.3794,31.1656,5073037,0,113083,4959954
3/2/22,Ukraine,48.3794,31.1656,5079916,0,113193,4966723
3/3/22,Ukraine,48.3794,31.1656,5086452,0,113326,4973126
3/4/22,Ukraine,48.3794,31.1656,5093353,0,113439,4979914
3/5/22,Ukraine,48.3794,31.1656,5099723,0,113537,4986186
3/6/22,Ukraine,48.3794,31.1656,5103154,0,113593,4989561
3/7/22,Ukraine,48.3794,31.1656,5105901,0,113633,4992268
3/8/22,Ukraine,48.3794,31.1656,5110233,0,113693,4996540
3/9/22,Ukraine,48.3794,31.1656,5113255,0,113738,4999517
3/10/22,Ukraine,48.3794,31.1656,5119367,0,113853,5005514
3/11/22,Ukraine,48.3794,31.1656,5125225,0,113939,5011286
3/12/22,Ukraine,48.3794,31.1656,5131059,0,114038,5017021
3/13/22,Ukraine,48.3794,31.1656,5135046,0,114104,5020942
3/14/22,Ukraine,48.3794,31.1656,5137302,0,114138,5023164
3/15/22,Ukraine,48.3794,31.1656,5143422,0,114223,5029199
3/16/22,Ukraine,48.3794,31.1656,5148651,0,114294,5034357
3/17/22,Ukraine,48.3794,31.1656,5153795,0,114366,5039429
3/18/22,Ukraine,48.3794,31.1656,5158926,0,114431,5044495
3/19/22,Ukraine,48.3794,31.1656,5163689,0,114492,5049197
3/20/22,Ukraine,48.3794,31.1656,5165928,0,114525,5051403
3/21/22,Ukraine,48.3794,31.1656,5167659,0,114551,5053108
3/22/22,Ukraine,48.3794,31.1656,5172101,0,114614,5057487
3/23/22,Ukraine,48.3794,31.1656,5176322,0,114678,5061644
3/24/22,Ukraine,48.3794,31.1656,5180177,0,114733,5065444
3/25/22,Ukraine,48.3794,31.1656,5183807,0,114765,5069042
3/26/22,Ukraine,48.3794,31.1656,5187213,0,114793,5072420
3/27/22,Ukraine,48.3794,31.1656,5188740,0,114804,5073936
3/28/22,Ukraine,48.3794,31.1656,5189976,0,114815,5075161
3/29/22,Ukraine,48.3794,31.1656,5192611,0,114848,5077763
3/30/22,Ukraine,48.3794,31.1656,5195136,0,114872,5080264
3/31/22,Ukraine,48.3794,31.1656,5197694,0,114911,5082783
4/1/22,Ukraine,48.3794,31.1656,5199775,0,114934,5084841
4/2/22,Ukraine,48.3794,31.1656,5202690,0,114961,5087729
4/3/22,Ukraine,48.3794,31.1656,5203875,0,114969,5088906
4/4/22,Ukraine,48.3794,31.1656,5204632,0,114973,5089659
4/5/22,Ukraine,48.3794,31.1656,5206731,0,114995,5091736
4/6/22,Ukraine,48.3794,31.1656,5208892,0,115030,5093862
4/7/22,Ukraine,48.3794,31.1656,5211118,0,115052,5096066
4/8/22,Ukraine,48.3794,31.1656,5213143,0,115072,5098071
4/9/22,Ukraine,48.3794,31.1656,5215360,0,115086,5100274
4/10/22,Ukraine,48.3794,31.1656,5215627,0,115089,5100538
4/11/22,Ukraine,48.3794,31.1656,5216044,0,115093,5100951
4/12/22,Ukraine,48.3794,31.1656,5218179,0,115121,5103058
4/13/22,Ukraine,48.3794,31.1656,5219784,0,115148,5104636
4/14/22,Ukraine,48.3794,31.1656,5221359,0,115174,5106185
4/15/22,Ukraine,48.3794,31.1656,5222493,0,115190,5107303
4/16/22,Ukraine,48.3794,31.1656,5223367,0,115201,5108166
4/17/22,Ukraine,48.3794,31.1656,5223754,0,115207,5108547
4/18/22,Ukraine,48.3794,31.1656,5224058,0,115210,5108848
4/19/22,Ukraine,48.3794,31.1656,5225140,0,115222,5109918
4/20/22,Ukraine,48.3794,31.1656,5226284,0,115240,5111044
4/21/22,Ukraine,48.3794,31.1656,5227305,0,115250,5112055
4/22/22,Ukraine,48.3794,31.1656,5228118,0,115260,5112858
4/23/22,Ukraine,48.3794,31.1656,5228886,0,115272,5113614
4/24/22,Ukraine,48.3794,31.1656,5229187,0,115280,5113907
4/25/22,Ukraine,48.3794,31.1656,5229411,0,115283,5114128
4/26/22,Ukraine,48.3794,31.1656,5230066,0,115297,5114769
4/27/22,Ukraine,48.3794,31.1656,5230878,0,115313,5115565
4/28/22,Ukraine,48.3794,31.1656,5231933,0,115334,5116599
4/29/22,Ukraine,48.3794,31.1656,5232613,0,115345,5117268
4/30/22,Ukraine,48.3794,31.1656,5233265,0,115361,5117904
5/1/22,Ukraine,48.3794,31.1656,5233564,0,115364,5118200
5/2/22,Ukraine,48.3794,31.1656,5233764,0,115365,5118399
5/3/22,Ukraine,48.3794,31.1656,5233764,0,115365,5118399
5/4/22,Ukraine,48.3794,31.1656,5233764,0,115365,5118399
5/5/22,Ukraine,48.3794,31.1656,5233764,0,115365,5118399
5/6/22,Ukraine,48.3794,31.1656,5233764,0,115365,5118399
5/7/22,Ukraine,48.3794,31.1656,5233764,0,115365,5118399
5/8/22,Ukraine,48.3794,31.1656,5233764,0,115365,5118399
5/9/22,Ukraine,48.3794,31.1656,5237354,0,115403,5121951
5/10/22,Ukraine,48.3794,31.1656,5237354,0,115403,5121951
5/11/22,Ukraine,48.3794,31.1656,5237354,0,115403,5121951
5/12/22,Ukraine,48.3794,31.1656,5237354,0,115403,5121951
5/13/22,Ukraine,48.3794,31.1656,5237354,0,115403,5121951
5/14/22,Ukraine,48.3794,31.1656,5237354,0,115403,5121951
5/15/22,Ukraine,48.3794,31.1656,5237354,0,115403,5121951
5/16/22,Ukraine,48.3794,31.1656,5240195,0,115451,5124744
5/17/22,Ukraine,48.3794,31.1656,5240195,0,115451,5124744
5/18/22,Ukraine,48.3794,31.1656,5240195,0,115451,5124744
5/19/22,Ukraine,48.3794,31.1656,5240195,0,115451,5124744
5/20/22,Ukraine,48.3794,31.1656,5240195,0,115451,5124744
5/21/22,Ukraine,48.3794,31.1656,5240195,0,115451,5124744
5/22/22,Ukraine,48.3794,31.1656,5240195,0,115451,5124744
5/23/22,Ukraine,48.3794,31.1656,5242327,0,115492,5126835
5/24/22,Ukraine,48.3794,31.1656,5242327,0,115492,5126835
5/25/22,Ukraine,48.3794,31.1656,5242327,0,115492,5126835
5/26/22,Ukraine,48.3794,31.1656,5242327,0,115492,5126835
5/27/22,Ukraine,48.3794,31.1656,5242327,0,115492,5126835
5/28/22,Ukraine,48.3794,31.1656,5242327,0,115492,5126835
5/29/22,Ukraine,48.3794,31.1656,5242327,0,115492,5126835
5/30/22,Ukraine,48.3794,31.1656,5244223,0,115523,5128700
5/31/22,Ukraine,48.3794,31.1656,5244223,0,115523,5128700
6/1/22,Ukraine,48.3794,31.1656,5244223,0,115523,5128700
6/2/22,Ukraine,48.3794,31.1656,5244223,0,115523,5128700
6/3/22,Ukraine,48.3794,31.1656,5244223,0,115523,5128700
6/4/22,Ukraine,48.3794,31.1656,5244223,0,115523,5128700
6/5/22,Ukraine,48.3794,31.1656,5244223,0,115523,5128700
6/6/22,Ukraine,48.3794,31.1656,5245823,0,115559,5130264
6/7/22,Ukraine,48.3794,31.1656,5245823,0,115559,5130264
6/8/22,Ukraine,48.3794,31.1656,5245823,0,115559,5130264
6/9/22,Ukraine,48.3794,31.1656,5245823,0,115559,5130264
6/10/22,Ukraine,48.3794,31.1656,5245823,0,115559,5130264
6/11/22,Ukraine,48.3794,31.1656,5245823,0,115559,5130264
6/12/22,Ukraine,48.3794,31.1656,5245823,0,115559,5130264
6/13/22,Ukraine,48.3794,31.1656,5284337,0,116306,5168031
6/14/22,Ukraine,48.3794,31.1656,5284385,0,116307,5168078
6/15/22,Ukraine,48.3794,31.1656,5284420,0,116310,5168110
6/16/22,Ukraine,48.3794,31.1656,5284484,0,116313,5168171
6/17/22,Ukraine,48.3794,31.1656,5284534,0,116313,5168221
6/18/22,Ukraine,48.3794,31.1656,5284597,0,116316,5168281
6/19/22,Ukraine,48.3794,31.1656,5284629,0,116316,5168313
6/20/22,Ukraine,48.3794,31.1656,5285704,0,116334,5169370
6/21/22,Ukraine,48.3794,31.1656,5285730,0,116335,5169395
6/22/22,Ukraine,48.3794,31.1656,5285764,0,116338,5169426
6/23/22,Ukraine,48.3794,31.1656,5285796,0,116339,5169457
6/24/22,Ukraine,48.3794,31.1656,5285836,0,116339,5169497
6/25/22,Ukraine,48.3794,31.1656,5285871,0,116341,5169530
6/26/22,Ukraine,48.3794,31.1656,5285909,0,116341,5169568
6/27/22,Ukraine,48.3794,31.1656,5286931,0,116359,5170572
6/28/22,Ukraine,48.3794,31.1656,5286959,0,116361,5170598
6/29/22,Ukraine,48.3794,31.1656,5286989,0,116363,5170626
6/30/22,Ukraine,48.3794,31.1656,5287020,0,116364,5170656
7/1/22,Ukraine,48.3794,31.1656,5287065,0,116365,5170700
7/2/22,Ukraine,48.3794,31.1656,5287095,0,116367,5170728
7/3/22,Ukraine,48.3794,31.1656,5287122,0,116367,5170755
7/4/22,Ukraine,48.3794,31.1656,5288270,0,116382,5171888
7/5/22,Ukraine,48.3794,31.1656,5288294,0,116385,5171909
7/6/22,Ukraine,48.3794,31.1656,5288322,0,116386,5171936
7/7/22,Ukraine,48.3794,31.1656,5288357,0,116389,5171968
7/8/22,Ukraine,48.3794,31.1656,5288404,0,116391,5172013
7/9/22,Ukraine,48.3794,31.1656,5288439,0,116394,5172045
7/10/22,Ukraine,48.3794,31.1656,5288473,0,116395,5172078
7/11/22,Ukraine,48.3794,31.1656,5288509,0,116396,5172113
7/12/22,Ukraine,48.3794,31.1656,5288545,0,116398,5172147
7/13/22,Ukraine,48.3794,31.1656,5288579,0,116399,5172180
7/14/22,Ukraine,48.3794,31.1656,5288620,0,116401,5172219
7/15/22,Ukraine,48.3794,31.1656,5289732,0,116422,5173310
7/16/22,Ukraine,48.3794,31.1656,5289787,0,116423,5173364
7/17/22,Ukraine,48.3794,31.1656,5289844,0,116424,5173420
7/18/22,Ukraine,48.3794,31.1656,5289923,0,116424,5173499
7/19/22,Ukraine,48.3794,31.1656,5289986,0,116427,5173559
7/20/22,Ukraine,48.3794,31.1656,5290040,0,116428,5173612
7/21/22,Ukraine,48.3794,31.1656,5290117,0,116431,5173686
7/22/22,Ukraine,48.3794,31.1656,5291621,0,116441,5175180
7/23/22,Ukraine,48.3794,31.1656,5291700,0,116443,5175257
7/24/22,Ukraine,48.3794,31.1656,5291779,0,116443,5175336
7/25/22,Ukraine,48.3794,31.1656,5291868,0,116444,5175424
7/26/22,Ukraine,48.3794,31.1656,5291947,0,116445,5175502
7/27/22,Ukraine,48.3794,31.1656,5292020,0,116448,5175572
7/28/22,Ukraine,48.3794,31.1656,5292128,0,116449,5175679
7/29/22,Ukraine,48.3794,31.1656,5294357,0,116463,5177894
7/30/22,Ukraine,48.3794,31.1656,5294486,0,116463,5178023
7/31/22,Ukraine,48.3794,31.1656,5294643,0,116463,5178180
8/1/22,Ukraine,48.3794,31.1656,5294794,0,116463,5178331
8/2/22,Ukraine,48.3794,31.1656,5294949,0,116465,5178484
8/3/22,Ukraine,48.3794,31.1656,5295103,0,116466,5178637
8/4/22,Ukraine,48.3794,31.1656,5295299,0,116468,5178831
8/5/22,Ukraine,48.3794,31.1656,5298325,0,116483,5181842
8/6/22,Ukraine,48.3794,31.1656,5298604,0,116484,5182120
8/7/22,Ukraine,48.3794,31.1656,5298881,0,116485,5182396
8/8/22,Ukraine,48.3794,31.1656,5299165,0,116486,5182679
8/9/22,Ukraine,48.3794,31.1656,5299442,0,116488,5182954
8/10/22,Ukraine,48.3794,31.1656,5299664,0,116489,5183175
8/11/22,Ukraine,48.3794,31.1656,5303833,0,116505,5187328
8/12/22,Ukraine,48.3794,31.1656,5304149,0,116506,5187643
8/13/22,Ukraine,48.3794,31.1656,5304634,0,116508,5188126
8/14/22,Ukraine,48.3794,31.1656,5305063,0,116508,5188555
8/15/22,Ukraine,48.3794,31.1656,5305455,0,116508,5188947
8/16/22,Ukraine,48.3794,31.1656,5305875,0,116510,5189365
8/17/22,Ukraine,48.3794,31.1656,5306219,0,116511,5189708
8/18/22,Ukraine,48.3794,31.1656,5306713,0,116511,5190202
8/19/22,Ukraine,48.3794,31.1656,5312730,0,116549,5196181
8/20/22,Ukraine,48.3794,31.1656,5313322,0,116551,5196771
8/21/22,Ukraine,48.3794,31.1656,5313939,0,116552,5197387
8/22/22,Ukraine,48.3794,31.1656,5314531,0,116552,5197979
8/23/22,Ukraine,48.3794,31.1656,5315071,0,116554,5198517
8/24/22,Ukraine,48.3794,31.1656,5315613,0,116555,5199058
8/25/22,Ukraine,48.3794,31.1656,5325288,0,116580,5208708
8/26/22,Ukraine,48.3794,31.1656,5325948,0,116582,5209366
8/27/22,Ukraine,48.3794,31.1656,5326639,0,116584,5210055
8/28/22,Ukraine,48.3794,31.1656,5327363,0,116585,5210778
8/29/22,Ukraine,48.3794,31.1656,5328138,0,116586,5211552
8/30/22,Ukraine,48.3794,31.1656,5328726,0,116588,5212138
8/31/22,Ukraine,48.3794,31.1656,5329263,0,116591,5212672
9/1/22,Ukraine,48.3794,31.1656,5341445,0,116629,5224816
9/2/22,Ukraine,48.3794,31.1656,5342118,0,116630,5225488
9/3/22,Ukraine,48.3794,31.1656,5342895,0,116633,5226262
9/4/22,Ukraine,48.3794,31.1656,5343674,0,116634,5227040
9/5/22,Ukraine,48.3794,31.1656,5344324,0,116634,5227690
9/6/22,Ukraine,48.3794,31.1656,5360956,0,116679,5244277
9/7/22,Ukraine,48.3794,31.1656,5361560,0,116681,5244879
9/8/22,Ukraine,48.3794,31.1656,5362294,0,116681,5245613
9/9/22,Ukraine,48.3794,31.1656,5362980,0,116682,5246298
9/10/22,Ukraine,48.3794,31.1656,5363758,0,116685,5247073
9/11/22,Ukraine,48.3794,31.1656,5364432,0,116685,5247747
9/12/22,Ukraine,48.3794,31.1656,5365009,0,116685,5248324
9/13/22,Ukraine,48.3794,31.1656,5365512,0,116687,5248825
9/14/22,Ukraine,48.3794,31.1656,5366011,0,116690,5249321
9/15/22,Ukraine,48.3794,31.1656,5390574,0,116761,5273813
9/16/22,Ukraine,48.3794,31.1656,5391216,0,116763,5274453
9/17/22,Ukraine,48.3794,31.1656,5391762,0,116765,5274997
9/18/22,Ukraine,48.3794,31.1656,5392365,0,116766,5275599
9/19/22,Ukraine,48.3794,31.1656,5392816,0,116767,5276049
9/20/22,Ukraine,48.3794,31.1656,5393218,0,116770,5276448
9/21/22,Ukraine,48.3794,31.1656,5393630,0,116772,5276858
9/22/22,Ukraine,48.3794,31.1656,5394128,0,116774,5277354
9/23/22,Ukraine,48.3794,31.1656,5431208,0,116866,5314342
9/24/22,Ukraine,48.3794,31.1656,5431736,0,116867,5314869
9/25/22,Ukraine,48.3794,31.1656,5432271,0,116867,5315404
9/26/22,Ukraine,48.3794,31.1656,5432591,0,116868,5315723
9/27/22,Ukraine,48.3794,31.1656,5432840,0,116868,5315972
9/28/22,Ukraine,48.3794,31.1656,5433127,0,116872,5316255
9/29/22,Ukraine,48.3794,31.1656,5477614,0,117035,5360579
9/30/22,Ukraine,48.3794,31.1656,5478025,0,117037,5360988
10/1/22,Ukraine,48.3794,31.1656,5478336,0,117039,5361297
10/2/22,Ukraine,48.3794,31.1656,5478645,0,117039,5361606
10/3/22,Ukraine,48.3794,31.1656,5478864,0,117040,5361824
10/4/22,Ukraine,48.3794,31.1656,5479048,0,117043,5362005
10/5/22,Ukraine,48.3794,31.1656,5479206,0,117044,5362162
10/6/22,Ukraine,48.3794,31.1656,5479387,0,117045,5362342
10/7/22,Ukraine,48.3794,31.1656,5479598,0,117046,5362552
10/8/22,Ukraine,48.3794,31.1656,5479793,0,117048,5362745
10/9/22,Ukraine,48.3794,31.1656,5479938,0,117049,5362889
10/10/22,Ukraine,48.3794,31.1656,5480098,0,117050,5363048
10/11/22,Ukraine,48.3794,31.1656,5480251,0,117054,5363197
10/12/22,Ukraine,48.3794,31.1656,5480392,0,117057,5363335
10/13/22,Ukraine,48.3794,31.1656,5480495,0,117059,5363436
10/14/22,Ukraine,48.3794,31.1656,5480652,0,117061,5363591
10/15/22,Ukraine,48.3794,31.1656,5480779,0,117063,5363716
10/16/22,Ukraine,48.3794,31.1656,5480863,0,117064,5363799
10/17/22,Ukraine,48.3794,31.1656,5560188,0,117475,5442713
10/18/22,Ukraine,48.3794,31.1656,5583170,0,117679,5465491
10/19/22,Ukraine,48.3794,31.1656,5583231,0,117681,5465550
10/20/22,Ukraine,48.3794,31.1656,5583316,0,117683,5465633
10/21/22,Ukraine,48.3794,31.1656,5583411,0,117684,5465727
10/22/22,Ukraine,48.3794,31.1656,5583518,0,117686,5465832
10/23/22,Ukraine,48.3794,31.1656,5583603,0,117686,5465917
10/24/22,Ukraine,48.3794,31.1656,5583709,0,117687,5466022
10/25/22,Ukraine,48.3794,31.1656,5600684,0,117877,5482807
10/26/22,Ukraine,48.3794,31.1656,5600741,0,117878,5482863
10/27/22,Ukraine,48.3794,31.1656,5600801,0,117878,5482923
10/28/22,Ukraine,48.3794,31.1656,5600890,0,117879,5483011
10/29/22,Ukraine,48.3794,31.1656,5600960,0,117880,5483080
10/30/22,Ukraine,48.3794,31.1656,5601042,0,117881,5483161
10/31/22,Ukraine,48.3794,31.1656,5601102,0,117881,5483221
11/1/22,Ukraine,48.3794,31.1656,5601163,0,117883,5483280
11/2/22,Ukraine,48.3794,31.1656,5601211,0,117885,5483326
11/3/22,Ukraine,48.3794,31.1656,5617643,0,118064,5499579
11/4/22,Ukraine,48.3794,31.1656,5617701,0,118067,5499634
11/5/22,Ukraine,48.3794,31.1656,5617767,0,118068,5499699
11/6/22,Ukraine,48.3794,31.1656,5617810,0,118069,5499741
11/7/22,Ukraine,48.3794,31.1656,5617842,0,118070,5499772
11/8/22,Ukraine,48.3794,31.1656,5617870,0,118070,5499800
11/9/22,Ukraine,48.3794,31.1656,5617906,0,118070,5499836
11/10/22,Ukraine,48.3794,31.1656,5617950,0,118072,5499878
11/11/22,Ukraine,48.3794,31.1656,5618015,0,118074,5499941
11/12/22,Ukraine,48.3794,31.1656,5618081,0,118075,5500006
11/13/22,Ukraine,48.3794,31.1656,5618142,0,118076,5500066
11/14/22,Ukraine,48.3794,31.1656,5627788,0,118190,5509598
11/15/22,Ukraine,48.3794,31.1656,5627819,0,118191,5509628
11/16/22,Ukraine,48.3794,31.1656,5635182,0,118295,5516887
11/17/22,Ukraine,48.3794,31.1656,5635218,0,118295,5516923
11/18/22,Ukraine,48.3794,31.1656,5635276,0,118295,5516981
11/19/22,Ukraine,48.3794,31.1656,5635334,0,118295,5517039
11/20/22,Ukraine,48.3794,31.1656,5635398,0,118295,5517103
11/21/22,Ukraine,48.3794,31.1656,5635439,0,118295,5517144
11/22/22,Ukraine,48.3794,31.1656,5635487,0,118295,5517192
11/23/22,Ukraine,48.3794,31.1656,5642284,0,118399,5523885
11/24/22,Ukraine,48.3794,31.1656,5642326,0,118400,5523926
11/25/22,Ukraine,48.3794,31.1656,5642382,0,118400,5523982
11/26/22,Ukraine,48.3794,31.1656,5642444,0,118402,5524042
11/27/22,Ukraine,48.3794,31.1656,5642496,0,118402,5524094
11/28/22,Ukraine,48.3794,31.1656,5642564,0,118402,5524162
11/29/22,Ukraine,48.3794,31.1656,5642600,0,118404,5524196
11/30/22,Ukraine,48.3794,31.1656,5642645,0,118404,5524241
12/1/22,Ukraine,48.3794,31.1656,5642692,0,118406,5524286
12/2/22,Ukraine,48.3794,31.1656,5647735,0,118488,5529247
12/3/22,Ukraine,48.3794,31.1656,5647790,0,118490,5529300
12/4/22,Ukraine,48.3794,31.1656,5647838,0,118490,5529348
12/5/22,Ukraine,48.3794,31.1656,5647889,0,118490,5529399
12/6/22,Ukraine,48.3794,31.1656,5647945,0,118491,5529454
12/7/22,Ukraine,48.3794,31.1656,5647980,0,118492,5529488
12/8/22,Ukraine,48.3794,31.1656,5652840,0,118548,5534292
12/9/22,Ukraine,48.3794,31.1656,5652911,0,118549,5534362
12/10/22,Ukraine,48.3794,31.1656,5652954,0,118550,5534404
12/11/22,Ukraine,48.3794,31.1656,5653011,0,118551,5534460
12/12/22,Ukraine,48.3794,31.1656,5653051,0,118552,5534499
12/13/22,Ukraine,48.3794,31.1656,5653110,0,118553,5534557
12/14/22,Ukraine,48.3794,31.1656,5657443,0,118610,5538833
12/15/22,Ukraine,48.3794,31.1656,5657504,0,118612,5538892
12/16/22,Ukraine,48.3794,31.1656,5657579,0,118613,5538966
12/17/22,Ukraine,48.3794,31.1656,5657646,0,118613,5539033
1/1/22,United Arab Emirates,23.424076,53.847818,764493,0,2165,762328
1/2/22,United Arab Emirates,23.424076,53.847818,767093,0,2168,764925
1/3/22,United Arab Emirates,23.424076,53.847818,769608,0,2169,767439
1/4/22,United Arab Emirates,23.424076,53.847818,772189,0,2170,770019
1/5/22,United Arab Emirates,23.424076,53.847818,774897,0,2170,772727
1/6/22,United Arab Emirates,23.424076,53.847818,777584,0,2170,775414
1/7/22,United Arab Emirates,23.424076,53.847818,780211,0,2170,778041
1/8/22,United Arab Emirates,23.424076,53.847818,782866,0,2173,780693
1/9/22,United Arab Emirates,23.424076,53.847818,785625,0,2174,783451
1/10/22,United Arab Emirates,23.424076,53.847818,788187,0,2174,786013
1/11/22,United Arab Emirates,23.424076,53.847818,790698,0,2177,788521
1/12/22,United Arab Emirates,23.424076,53.847818,793314,0,2181,791133
1/13/22,United Arab Emirates,23.424076,53.847818,795997,0,2182,793815
1/14/22,United Arab Emirates,23.424076,53.847818,799065,0,2185,796880
1/15/22,United Arab Emirates,23.424076,53.847818,802181,0,2188,799993
1/16/22,United Arab Emirates,23.424076,53.847818,805248,0,2191,803057
1/17/22,United Arab Emirates,23.424076,53.847818,808237,0,2195,806042
1/18/22,United Arab Emirates,23.424076,53.847818,811029,0,2198,808831
1/19/22,United Arab Emirates,23.424076,53.847818,813931,0,2200,811731
1/20/22,United Arab Emirates,23.424076,53.847818,816945,0,2204,814741
1/21/22,United Arab Emirates,23.424076,53.847818,819866,0,2207,817659
1/22/22,United Arab Emirates,23.424076,53.847818,822886,0,2211,820675
1/23/22,United Arab Emirates,23.424076,53.847818,825699,0,2214,823485
1/24/22,United Arab Emirates,23.424076,53.847818,828328,0,2219,826109
1/25/22,United Arab Emirates,23.424076,53.847818,830832,0,2224,828608
1/26/22,United Arab Emirates,23.424076,53.847818,833201,0,2228,830973
1/27/22,United Arab Emirates,23.424076,53.847818,835839,0,2232,833607
1/28/22,United Arab Emirates,23.424076,53.847818,838384,0,2234,836150
1/29/22,United Arab Emirates,23.424076,53.847818,840739,0,2239,838500
1/30/22,United Arab Emirates,23.424076,53.847818,843030,0,2240,840790
1/31/22,United Arab Emirates,23.424076,53.847818,845058,0,2243,842815
2/1/22,United Arab Emirates,23.424076,53.847818,847142,0,2248,844894
2/2/22,United Arab Emirates,23.424076,53.847818,849305,0,2251,847054
2/3/22,United Arab Emirates,23.424076,53.847818,851537,0,2253,849284
2/4/22,United Arab Emirates,23.424076,53.847818,853651,0,2258,851393
2/5/22,United Arab Emirates,23.424076,53.847818,855642,0,2262,853380
2/6/22,United Arab Emirates,23.424076,53.847818,857657,0,2264,855393
2/7/22,United Arab Emirates,23.424076,53.847818,859361,0,2265,857096
2/8/22,United Arab Emirates,23.424076,53.847818,860976,0,2269,858707
2/9/22,United Arab Emirates,23.424076,53.847818,862514,0,2273,860241
2/10/22,United Arab Emirates,23.424076,53.847818,864102,0,2278,861824
2/11/22,United Arab Emirates,23.424076,53.847818,865576,0,2283,863293
2/12/22,United Arab Emirates,23.424076,53.847818,866971,0,2284,864687
2/13/22,United Arab Emirates,23.424076,53.847818,868237,0,2285,865952
2/14/22,United Arab Emirates,23.424076,53.847818,869428,0,2287,867141
2/15/22,United Arab Emirates,23.424076,53.847818,870358,0,2288,868070
2/16/22,United Arab Emirates,23.424076,53.847818,871315,0,2289,869026
2/17/22,United Arab Emirates,23.424076,53.847818,872210,0,2290,869920
2/18/22,United Arab Emirates,23.424076,53.847818,873092,0,2292,870800
2/19/22,United Arab Emirates,23.424076,53.847818,873882,0,2293,871589
2/20/22,United Arab Emirates,23.424076,53.847818,874607,0,2294,872313
2/21/22,United Arab Emirates,23.424076,53.847818,875258,0,2296,872962
2/22/22,United Arab Emirates,23.424076,53.847818,875884,0,2297,873587
2/23/22,United Arab Emirates,23.424076,53.847818,876624,0,2298,874326
2/24/22,United Arab Emirates,23.424076,53.847818,877406,0,2299,875107
2/25/22,United Arab Emirates,23.424076,53.847818,878102,0,2300,875802
2/26/22,United Arab Emirates,23.424076,53.847818,878746,0,2301,876445
2/27/22,United Arab Emirates,23.424076,53.847818,879368,0,2301,877067
2/28/22,United Arab Emirates,23.424076,53.847818,879973,0,2301,877672
3/1/22,United Arab Emirates,23.424076,53.847818,880451,0,2301,878150
3/2/22,United Arab Emirates,23.424076,53.847818,880970,0,2301,878669
3/3/22,United Arab Emirates,23.424076,53.847818,881472,0,2301,879171
3/4/22,United Arab Emirates,23.424076,53.847818,881919,0,2301,879618
3/5/22,United Arab Emirates,23.424076,53.847818,882477,0,2301,880176
3/6/22,United Arab Emirates,23.424076,53.847818,882884,0,2301,880583
3/7/22,United Arab Emirates,23.424076,53.847818,883270,0,2302,880968
3/8/22,United Arab Emirates,23.424076,53.847818,883593,0,2302,881291
3/9/22,United Arab Emirates,23.424076,53.847818,883985,0,2302,881683
3/10/22,United Arab Emirates,23.424076,53.847818,884354,0,2302,882052
3/11/22,United Arab Emirates,23.424076,53.847818,884736,0,2302,882434
3/12/22,United Arab Emirates,23.424076,53.847818,885089,0,2302,882787
3/13/22,United Arab Emirates,23.424076,53.847818,885407,0,2302,883105
3/14/22,United Arab Emirates,23.424076,53.847818,885703,0,2302,883401
3/15/22,United Arab Emirates,23.424076,53.847818,885983,0,2302,883681
3/16/22,United Arab Emirates,23.424076,53.847818,886301,0,2302,883999
3/17/22,United Arab Emirates,23.424076,53.847818,886687,0,2302,884385
3/18/22,United Arab Emirates,23.424076,53.847818,887018,0,2302,884716
3/19/22,United Arab Emirates,23.424076,53.847818,887385,0,2302,885083
3/20/22,United Arab Emirates,23.424076,53.847818,887732,0,2302,885430
3/21/22,United Arab Emirates,23.424076,53.847818,888070,0,2302,885768
3/22/22,United Arab Emirates,23.424076,53.847818,888386,0,2302,886084
3/23/22,United Arab Emirates,23.424076,53.847818,888718,0,2302,886416
3/24/22,United Arab Emirates,23.424076,53.847818,889108,0,2302,886806
3/25/22,United Arab Emirates,23.424076,53.847818,889456,0,2302,887154
3/26/22,United Arab Emirates,23.424076,53.847818,889797,0,2302,887495
3/27/22,United Arab Emirates,23.424076,53.847818,890112,0,2302,887810
3/28/22,United Arab Emirates,23.424076,53.847818,890398,0,2302,888096
3/29/22,United Arab Emirates,23.424076,53.847818,890699,0,2302,888397
3/30/22,United Arab Emirates,23.424076,53.847818,890987,0,2302,888685
3/31/22,United Arab Emirates,23.424076,53.847818,891300,0,2302,888998
4/1/22,United Arab Emirates,23.424076,53.847818,891588,0,2302,889286
4/2/22,United Arab Emirates,23.424076,53.847818,891872,0,2302,889570
4/3/22,United Arab Emirates,23.424076,53.847818,892170,0,2302,889868
4/4/22,United Arab Emirates,23.424076,53.847818,892470,0,2302,890168
4/5/22,United Arab Emirates,23.424076,53.847818,892714,0,2302,890412
4/6/22,United Arab Emirates,23.424076,53.847818,892929,0,2302,890627
4/7/22,United Arab Emirates,23.424076,53.847818,893072,0,2302,890770
4/8/22,United Arab Emirates,23.424076,53.847818,893312,0,2302,891010
4/9/22,United Arab Emirates,23.424076,53.847818,893538,0,2302,891236
4/10/22,United Arab Emirates,23.424076,53.847818,893762,0,2302,891460
4/11/22,United Arab Emirates,23.424076,53.847818,893970,0,2302,891668
4/12/22,United Arab Emirates,23.424076,53.847818,894186,0,2302,891884
4/13/22,United Arab Emirates,23.424076,53.847818,894523,0,2302,892221
4/14/22,United Arab Emirates,23.424076,53.847818,894779,0,2302,892477
4/15/22,United Arab Emirates,23.424076,53.847818,895018,0,2302,892716
4/16/22,United Arab Emirates,23.424076,53.847818,895264,0,2302,892962
4/17/22,United Arab Emirates,23.424076,53.847818,895465,0,2302,893163
4/18/22,United Arab Emirates,23.424076,53.847818,895663,0,2302,893361
4/19/22,United Arab Emirates,23.424076,53.847818,895892,0,2302,893590
4/20/22,United Arab Emirates,23.424076,53.847818,896141,0,2302,893839
4/21/22,United Arab Emirates,23.424076,53.847818,896372,0,2302,894070
4/22/22,United Arab Emirates,23.424076,53.847818,896631,0,2302,894329
4/23/22,United Arab Emirates,23.424076,53.847818,896892,0,2302,894590
4/24/22,United Arab Emirates,23.424076,53.847818,897136,0,2302,894834
4/25/22,United Arab Emirates,23.424076,53.847818,897351,0,2302,895049
4/26/22,United Arab Emirates,23.424076,53.847818,897558,0,2302,895256
4/27/22,United Arab Emirates,23.424076,53.847818,897770,0,2302,895468
4/28/22,United Arab Emirates,23.424076,53.847818,898045,0,2302,895743
4/29/22,United Arab Emirates,23.424076,53.847818,898310,0,2302,896008
4/30/22,United Arab Emirates,23.424076,53.847818,898571,0,2302,896269
5/1/22,United Arab Emirates,23.424076,53.847818,898811,0,2302,896509
5/2/22,United Arab Emirates,23.424076,53.847818,899033,0,2302,896731
5/3/22,United Arab Emirates,23.424076,53.847818,899242,0,2302,896940
5/4/22,United Arab Emirates,23.424076,53.847818,899441,0,2302,897139
5/5/22,United Arab Emirates,23.424076,53.847818,899637,0,2302,897335
5/6/22,United Arab Emirates,23.424076,53.847818,899835,0,2302,897533
5/7/22,United Arab Emirates,23.424076,53.847818,900026,0,2302,897724
5/8/22,United Arab Emirates,23.424076,53.847818,900251,0,2302,897949
5/9/22,United Arab Emirates,23.424076,53.847818,900484,0,2302,898182
5/10/22,United Arab Emirates,23.424076,53.847818,900764,0,2302,898462
5/11/22,United Arab Emirates,23.424076,53.847818,901076,0,2302,898774
5/12/22,United Arab Emirates,23.424076,53.847818,901440,0,2302,899138
5/13/22,United Arab Emirates,23.424076,53.847818,901809,0,2302,899507
5/14/22,United Arab Emirates,23.424076,53.847818,902161,0,2302,899859
5/15/22,United Arab Emirates,23.424076,53.847818,902484,0,2302,900182
5/16/22,United Arab Emirates,23.424076,53.847818,902803,0,2302,900501
5/17/22,United Arab Emirates,23.424076,53.847818,903084,0,2302,900782
5/18/22,United Arab Emirates,23.424076,53.847818,903382,0,2302,901080
5/19/22,United Arab Emirates,23.424076,53.847818,903731,0,2302,901429
5/20/22,United Arab Emirates,23.424076,53.847818,904093,0,2302,901791
5/21/22,United Arab Emirates,23.424076,53.847818,904466,0,2302,902164
5/22/22,United Arab Emirates,23.424076,53.847818,904830,0,2302,902528
5/23/22,United Arab Emirates,23.424076,53.847818,905151,0,2302,902849
5/24/22,United Arab Emirates,23.424076,53.847818,905468,0,2302,903166
5/25/22,United Arab Emirates,23.424076,53.847818,905841,0,2302,903539
5/26/22,United Arab Emirates,23.424076,53.847818,906236,0,2302,903934
5/27/22,United Arab Emirates,23.424076,53.847818,906639,0,2302,904337
5/28/22,United Arab Emirates,23.424076,53.847818,907069,0,2302,904767
5/29/22,United Arab Emirates,23.424076,53.847818,907441,0,2304,905137
5/30/22,United Arab Emirates,23.424076,53.847818,907824,0,2305,905519
5/31/22,United Arab Emirates,23.424076,53.847818,908205,0,2305,905900
6/1/22,United Arab Emirates,23.424076,53.847818,908647,0,2305,906342
6/2/22,United Arab Emirates,23.424076,53.847818,909222,0,2305,906917
6/3/22,United Arab Emirates,23.424076,53.847818,909815,0,2305,907510
6/4/22,United Arab Emirates,23.424076,53.847818,910338,0,2305,908033
6/5/22,United Arab Emirates,23.424076,53.847818,910935,0,2305,908630
6/6/22,United Arab Emirates,23.424076,53.847818,911514,0,2305,909209
6/7/22,United Arab Emirates,23.424076,53.847818,912086,0,2305,909781
6/8/22,United Arab Emirates,23.424076,53.847818,912953,0,2305,910648
6/9/22,United Arab Emirates,23.424076,53.847818,913984,0,2305,911679
6/10/22,United Arab Emirates,23.424076,53.847818,915068,0,2305,912763
6/11/22,United Arab Emirates,23.424076,53.847818,916247,0,2305,913942
6/12/22,United Arab Emirates,23.424076,53.847818,917496,0,2305,915191
6/13/22,United Arab Emirates,23.424076,53.847818,918815,0,2305,916510
6/14/22,United Arab Emirates,23.424076,53.847818,920171,0,2305,917866
6/15/22,United Arab Emirates,23.424076,53.847818,921566,0,2305,919261
6/16/22,United Arab Emirates,23.424076,53.847818,923001,0,2306,920695
6/17/22,United Arab Emirates,23.424076,53.847818,924434,0,2306,922128
6/18/22,United Arab Emirates,23.424076,53.847818,925898,0,2308,923590
6/19/22,United Arab Emirates,23.424076,53.847818,927387,0,2309,925078
6/20/22,United Arab Emirates,23.424076,53.847818,928919,0,2309,926610
6/21/22,United Arab Emirates,23.424076,53.847818,930475,0,2309,928166
6/22/22,United Arab Emirates,23.424076,53.847818,932067,0,2309,929758
6/23/22,United Arab Emirates,23.424076,53.847818,933688,0,2309,931379
6/24/22,United Arab Emirates,23.424076,53.847818,935345,0,2310,933035
6/25/22,United Arab Emirates,23.424076,53.847818,937037,0,2311,934726
6/26/22,United Arab Emirates,23.424076,53.847818,938759,0,2311,936448
6/27/22,United Arab Emirates,23.424076,53.847818,940503,0,2313,938190
6/28/22,United Arab Emirates,23.424076,53.847818,942253,0,2313,939940
6/29/22,United Arab Emirates,23.424076,53.847818,944022,0,2315,941707
6/30/22,United Arab Emirates,23.424076,53.847818,945800,0,2316,943484
7/1/22,United Arab Emirates,23.424076,53.847818,947588,0,2317,945271
7/2/22,United Arab Emirates,23.424076,53.847818,949384,0,2317,947067
7/3/22,United Arab Emirates,23.424076,53.847818,951196,0,2319,948877
7/4/22,United Arab Emirates,23.424076,53.847818,952960,0,2319,950641
7/5/22,United Arab Emirates,23.424076,53.847818,954692,0,2319,952373
7/6/22,United Arab Emirates,23.424076,53.847818,956382,0,2322,954060
7/7/22,United Arab Emirates,23.424076,53.847818,958070,0,2322,955748
7/8/22,United Arab Emirates,23.424076,53.847818,959736,0,2322,957414
7/9/22,United Arab Emirates,23.424076,53.847818,961345,0,2323,959022
7/10/22,United Arab Emirates,23.424076,53.847818,962937,0,2324,960613
7/11/22,United Arab Emirates,23.424076,53.847818,964521,0,2324,962197
7/12/22,United Arab Emirates,23.424076,53.847818,966075,0,2324,963751
7/13/22,United Arab Emirates,23.424076,53.847818,967597,0,2325,965272
7/14/22,United Arab Emirates,23.424076,53.847818,969097,0,2325,966772
7/15/22,United Arab Emirates,23.424076,53.847818,970586,0,2325,968261
7/16/22,United Arab Emirates,23.424076,53.847818,972007,0,2325,969682
7/17/22,United Arab Emirates,23.424076,53.847818,973416,0,2325,971091
7/18/22,United Arab Emirates,23.424076,53.847818,974802,0,2325,972477
7/19/22,United Arab Emirates,23.424076,53.847818,976180,0,2327,973853
7/20/22,United Arab Emirates,23.424076,53.847818,977578,0,2328,975250
7/21/22,United Arab Emirates,23.424076,53.847818,978966,0,2329,976637
7/22/22,United Arab Emirates,23.424076,53.847818,980325,0,2330,977995
7/23/22,United Arab Emirates,23.424076,53.847818,981657,0,2331,979326
7/24/22,United Arab Emirates,23.424076,53.847818,982969,0,2332,980637
7/25/22,United Arab Emirates,23.424076,53.847818,984267,0,2332,981935
7/26/22,United Arab Emirates,23.424076,53.847818,985524,0,2332,983192
7/27/22,United Arab Emirates,23.424076,53.847818,986747,0,2334,984413
7/28/22,United Arab Emirates,23.424076,53.847818,988004,0,2334,985670
7/29/22,United Arab Emirates,23.424076,53.847818,989220,0,2334,986886
7/30/22,United Arab Emirates,23.424076,53.847818,990400,0,2334,988066
7/31/22,United Arab Emirates,23.424076,53.847818,991564,0,2335,989229
8/1/22,United Arab Emirates,23.424076,53.847818,992652,0,2335,990317
8/2/22,United Arab Emirates,23.424076,53.847818,993684,0,2335,991349
8/3/22,United Arab Emirates,23.424076,53.847818,994693,0,2335,992358
8/4/22,United Arab Emirates,23.424076,53.847818,995777,0,2335,993442
8/5/22,United Arab Emirates,23.424076,53.847818,996775,0,2337,994438
8/6/22,United Arab Emirates,23.424076,53.847818,997769,0,2337,995432
8/7/22,United Arab Emirates,23.424076,53.847818,998714,0,2337,996377
8/8/22,United Arab Emirates,23.424076,53.847818,999637,0,2337,997300
8/9/22,United Arab Emirates,23.424076,53.847818,1000556,0,2337,998219
8/10/22,United Arab Emirates,23.424076,53.847818,1001445,0,2338,999107
8/11/22,United Arab Emirates,23.424076,53.847818,1002306,0,2339,999967
8/12/22,United Arab Emirates,23.424076,53.847818,1003129,0,2339,1000790
8/13/22,United Arab Emirates,23.424076,53.847818,1003929,0,2339,1001590
8/14/22,United Arab Emirates,23.424076,53.847818,1004751,0,2339,1002412
8/15/22,United Arab Emirates,23.424076,53.847818,1005543,0,2339,1003204
8/16/22,United Arab Emirates,23.424076,53.847818,1006318,0,2339,1003979
8/17/22,United Arab Emirates,23.424076,53.847818,1007039,0,2340,1004699
8/18/22,United Arab Emirates,23.424076,53.847818,1007742,0,2341,1005401
8/19/22,United Arab Emirates,23.424076,53.847818,1008435,0,2341,1006094
8/20/22,United Arab Emirates,23.424076,53.847818,1009116,0,2341,1006775
8/21/22,United Arab Emirates,23.424076,53.847818,1009776,0,2341,1007435
8/22/22,United Arab Emirates,23.424076,53.847818,1010399,0,2341,1008058
8/23/22,United Arab Emirates,23.424076,53.847818,1011011,0,2341,1008670
8/24/22,United Arab Emirates,23.424076,53.847818,1011613,0,2341,1009272
8/25/22,United Arab Emirates,23.424076,53.847818,1012206,0,2341,1009865
8/26/22,United Arab Emirates,23.424076,53.847818,1012786,0,2341,1010445
8/27/22,United Arab Emirates,23.424076,53.847818,1013331,0,2341,1010990
8/28/22,United Arab Emirates,23.424076,53.847818,1013865,0,2341,1011524
8/29/22,United Arab Emirates,23.424076,53.847818,1014387,0,2341,1012046
8/30/22,United Arab Emirates,23.424076,53.847818,1014899,0,2341,1012558
8/31/22,United Arab Emirates,23.424076,53.847818,1015398,0,2341,1013057
9/1/22,United Arab Emirates,23.424076,53.847818,1015879,0,2341,1013538
9/2/22,United Arab Emirates,23.424076,53.847818,1016324,0,2341,1013983
9/3/22,United Arab Emirates,23.424076,53.847818,1016745,0,2341,1014404
9/4/22,United Arab Emirates,23.424076,53.847818,1017145,0,2341,1014804
9/5/22,United Arab Emirates,23.424076,53.847818,1017543,0,2341,1015202
9/6/22,United Arab Emirates,23.424076,53.847818,1017954,0,2341,1015613
9/7/22,United Arab Emirates,23.424076,53.847818,1018381,0,2342,1016039
9/8/22,United Arab Emirates,23.424076,53.847818,1018779,0,2342,1016437
9/9/22,United Arab Emirates,23.424076,53.847818,1019213,0,2342,1016871
9/10/22,United Arab Emirates,23.424076,53.847818,1019625,0,2342,1017283
9/11/22,United Arab Emirates,23.424076,53.847818,1020025,0,2342,1017683
9/12/22,United Arab Emirates,23.424076,53.847818,1020412,0,2342,1018070
9/13/22,United Arab Emirates,23.424076,53.847818,1020789,0,2342,1018447
9/14/22,United Arab Emirates,23.424076,53.847818,1021191,0,2342,1018849
9/15/22,United Arab Emirates,23.424076,53.847818,1021625,0,2342,1019283
9/16/22,United Arab Emirates,23.424076,53.847818,1022066,0,2342,1019724
9/17/22,United Arab Emirates,23.424076,53.847818,1022538,0,2342,1020196
9/18/22,United Arab Emirates,23.424076,53.847818,1022960,0,2342,1020618
9/19/22,United Arab Emirates,23.424076,53.847818,1023349,0,2342,1021007
9/20/22,United Arab Emirates,23.424076,53.847818,1023719,0,2342,1021377
9/21/22,United Arab Emirates,23.424076,53.847818,1024085,0,2342,1021743
9/22/22,United Arab Emirates,23.424076,53.847818,1024457,0,2342,1022115
9/23/22,United Arab Emirates,23.424076,53.847818,1024845,0,2342,1022503
9/24/22,United Arab Emirates,23.424076,53.847818,1025213,0,2343,1022870
9/25/22,United Arab Emirates,23.424076,53.847818,1025568,0,2343,1023225
9/26/22,United Arab Emirates,23.424076,53.847818,1025910,0,2344,1023566
9/27/22,United Arab Emirates,23.424076,53.847818,1026244,0,2345,1023899
9/28/22,United Arab Emirates,23.424076,53.847818,1026566,0,2345,1024221
9/29/22,United Arab Emirates,23.424076,53.847818,1027031,0,2345,1024686
9/30/22,United Arab Emirates,23.424076,53.847818,1027502,0,2345,1025157
10/1/22,United Arab Emirates,23.424076,53.847818,1028333,0,2345,1025988
10/2/22,United Arab Emirates,23.424076,53.847818,1028333,0,2345,1025988
10/3/22,United Arab Emirates,23.424076,53.847818,1028717,0,2345,1026372
10/4/22,United Arab Emirates,23.424076,53.847818,1029082,0,2346,1026736
10/5/22,United Arab Emirates,23.424076,53.847818,1029426,0,2346,1027080
10/6/22,United Arab Emirates,23.424076,53.847818,1029803,0,2346,1027457
10/7/22,United Arab Emirates,23.424076,53.847818,1030146,0,2346,1027800
10/8/22,United Arab Emirates,23.424076,53.847818,1030478,0,2346,1028132
10/9/22,United Arab Emirates,23.424076,53.847818,1030837,0,2346,1028491
10/10/22,United Arab Emirates,23.424076,53.847818,1031179,0,2346,1028833
10/11/22,United Arab Emirates,23.424076,53.847818,1031500,0,2346,1029154
10/12/22,United Arab Emirates,23.424076,53.847818,1031837,0,2346,1029491
10/13/22,United Arab Emirates,23.424076,53.847818,1032177,0,2346,1029831
10/14/22,United Arab Emirates,23.424076,53.847818,1032522,0,2346,1030176
10/15/22,United Arab Emirates,23.424076,53.847818,1032522,0,2346,1030176
10/16/22,United Arab Emirates,23.424076,53.847818,1032844,0,2346,1030498
10/17/22,United Arab Emirates,23.424076,53.847818,1033158,0,2347,1030811
10/18/22,United Arab Emirates,23.424076,53.847818,1033458,0,2347,1031111
10/19/22,United Arab Emirates,23.424076,53.847818,1033770,0,2347,1031423
10/20/22,United Arab Emirates,23.424076,53.847818,1034120,0,2348,1031772
10/21/22,United Arab Emirates,23.424076,53.847818,1034462,0,2348,1032114
10/22/22,United Arab Emirates,23.424076,53.847818,1034784,0,2348,1032436
10/23/22,United Arab Emirates,23.424076,53.847818,1035096,0,2348,1032748
10/24/22,United Arab Emirates,23.424076,53.847818,1035430,0,2348,1033082
10/25/22,United Arab Emirates,23.424076,53.847818,1035748,0,2348,1033400
10/26/22,United Arab Emirates,23.424076,53.847818,1036047,0,2348,1033699
10/27/22,United Arab Emirates,23.424076,53.847818,1036360,0,2348,1034012
10/28/22,United Arab Emirates,23.424076,53.847818,1036693,0,2348,1034345
10/29/22,United Arab Emirates,23.424076,53.847818,1037023,0,2348,1034675
10/30/22,United Arab Emirates,23.424076,53.847818,1037347,0,2348,1034999
10/31/22,United Arab Emirates,23.424076,53.847818,1037636,0,2348,1035288
11/1/22,United Arab Emirates,23.424076,53.847818,1037929,0,2348,1035581
11/2/22,United Arab Emirates,23.424076,53.847818,1038228,0,2348,1035880
11/3/22,United Arab Emirates,23.424076,53.847818,1038538,0,2348,1036190
11/4/22,United Arab Emirates,23.424076,53.847818,1038816,0,2348,1036468
11/5/22,United Arab Emirates,23.424076,53.847818,1039090,0,2348,1036742
11/6/22,United Arab Emirates,23.424076,53.847818,1039353,0,2348,1037005
11/7/22,United Arab Emirates,23.424076,53.847818,1039613,0,2348,1037265
11/8/22,United Arab Emirates,23.424076,53.847818,1039867,0,2348,1037519
11/9/22,United Arab Emirates,23.424076,53.847818,1040133,0,2348,1037785
11/10/22,United Arab Emirates,23.424076,53.847818,1040384,0,2348,1038036
11/11/22,United Arab Emirates,23.424076,53.847818,1040604,0,2348,1038256
11/12/22,United Arab Emirates,23.424076,53.847818,1040821,0,2348,1038473
11/13/22,United Arab Emirates,23.424076,53.847818,1041027,0,2348,1038679
11/14/22,United Arab Emirates,23.424076,53.847818,1041227,0,2348,1038879
11/15/22,United Arab Emirates,23.424076,53.847818,1041421,0,2348,1039073
11/16/22,United Arab Emirates,23.424076,53.847818,1041874,0,2348,1039526
11/17/22,United Arab Emirates,23.424076,53.847818,1041874,0,2348,1039526
11/18/22,United Arab Emirates,23.424076,53.847818,1042099,0,2348,1039751
11/19/22,United Arab Emirates,23.424076,53.847818,1042340,0,2348,1039992
11/20/22,United Arab Emirates,23.424076,53.847818,1042573,0,2348,1040225
11/21/22,United Arab Emirates,23.424076,53.847818,1042779,0,2348,1040431
11/22/22,United Arab Emirates,23.424076,53.847818,1042966,0,2348,1040618
11/23/22,United Arab Emirates,23.424076,53.847818,1043166,0,2348,1040818
11/24/22,United Arab Emirates,23.424076,53.847818,1043390,0,2348,1041042
11/25/22,United Arab Emirates,23.424076,53.847818,1043603,0,2348,1041255
11/26/22,United Arab Emirates,23.424076,53.847818,1043798,0,2348,1041450
11/27/22,United Arab Emirates,23.424076,53.847818,1043931,0,2348,1041583
11/28/22,United Arab Emirates,23.424076,53.847818,1044058,0,2348,1041710
11/29/22,United Arab Emirates,23.424076,53.847818,1044189,0,2348,1041841
11/30/22,United Arab Emirates,23.424076,53.847818,1044343,0,2348,1041995
12/1/22,United Arab Emirates,23.424076,53.847818,1044468,0,2348,1042120
12/2/22,United Arab Emirates,23.424076,53.847818,1044603,0,2348,1042255
12/3/22,United Arab Emirates,23.424076,53.847818,1044704,0,2348,1042356
12/4/22,United Arab Emirates,23.424076,53.847818,1044778,0,2348,1042430
12/5/22,United Arab Emirates,23.424076,53.847818,1044843,0,2348,1042495
12/6/22,United Arab Emirates,23.424076,53.847818,1044934,0,2348,1042586
12/7/22,United Arab Emirates,23.424076,53.847818,1045040,0,2348,1042692
12/8/22,United Arab Emirates,23.424076,53.847818,1045163,0,2348,1042815
12/9/22,United Arab Emirates,23.424076,53.847818,1045285,0,2348,1042937
12/10/22,United Arab Emirates,23.424076,53.847818,1045423,0,2348,1043075
12/11/22,United Arab Emirates,23.424076,53.847818,1045515,0,2348,1043167
12/12/22,United Arab Emirates,23.424076,53.847818,1045616,0,2348,1043268
12/13/22,United Arab Emirates,23.424076,53.847818,1045708,0,2348,1043360
12/14/22,United Arab Emirates,23.424076,53.847818,1045812,0,2348,1043464
12/15/22,United Arab Emirates,23.424076,53.847818,1045895,0,2348,1043547
12/16/22,United Arab Emirates,23.424076,53.847818,1045978,0,2348,1043630
12/17/22,United Arab Emirates,23.424076,53.847818,1046086,0,2348,1043738
1/1/22,United Kingdom,55.3781,-3.436,13174530,0,178025,12996505
1/2/22,United Kingdom,55.3781,-3.436,13310224,0,178194,13132030
1/3/22,United Kingdom,55.3781,-3.436,13498751,0,178374,13320377
1/4/22,United Kingdom,55.3781,-3.436,13722579,0,178578,13544001
1/5/22,United Kingdom,55.3781,-3.436,13917693,0,178758,13738935
1/6/22,United Kingdom,55.3781,-3.436,14099839,0,178978,13920861
1/7/22,United Kingdom,55.3781,-3.436,14280081,0,179204,14100877
1/8/22,United Kingdom,55.3781,-3.436,14422121,0,179423,14242698
1/9/22,United Kingdom,55.3781,-3.436,14564390,0,179665,14384725
1/10/22,United Kingdom,55.3781,-3.436,14708454,0,179907,14528547
1/11/22,United Kingdom,55.3781,-3.436,14825809,0,180140,14645669
1/12/22,United Kingdom,55.3781,-3.436,14957778,0,180383,14777395
1/13/22,United Kingdom,55.3781,-3.436,15064277,0,180625,14883652
1/14/22,United Kingdom,55.3781,-3.436,15164861,0,180865,14983996
1/15/22,United Kingdom,55.3781,-3.436,15246208,0,181125,15065083
1/16/22,United Kingdom,55.3781,-3.436,15316987,0,181381,15135606
1/17/22,United Kingdom,55.3781,-3.436,15406943,0,181617,15225326
1/18/22,United Kingdom,55.3781,-3.436,15501453,0,181850,15319603
1/19/22,United Kingdom,55.3781,-3.436,15609692,0,182073,15427619
1/20/22,United Kingdom,55.3781,-3.436,15717846,0,182278,15535568
1/21/22,United Kingdom,55.3781,-3.436,15814339,0,182526,15631813
1/22/22,United Kingdom,55.3781,-3.436,15891933,0,182747,15709186
1/23/22,United Kingdom,55.3781,-3.436,15967194,0,182968,15784226
1/24/22,United Kingdom,55.3781,-3.436,16062685,0,183197,15879488
1/25/22,United Kingdom,55.3781,-3.436,16157980,0,183393,15974587
1/26/22,United Kingdom,55.3781,-3.436,16260425,0,183588,16076837
1/27/22,United Kingdom,55.3781,-3.436,16357612,0,183812,16173800
1/28/22,United Kingdom,55.3781,-3.436,16446952,0,184015,16262937
1/29/22,United Kingdom,55.3781,-3.436,16519771,0,184196,16335575
1/30/22,United Kingdom,55.3781,-3.436,16582687,0,184388,16398299
1/31/22,United Kingdom,55.3781,-3.436,17430856,0,184597,17246259
2/1/22,United Kingdom,55.3781,-3.436,17543963,0,184802,17359161
2/2/22,United Kingdom,55.3781,-3.436,17631560,0,184989,17446571
2/3/22,United Kingdom,55.3781,-3.436,17727264,0,185186,17542078
2/4/22,United Kingdom,55.3781,-3.436,17809884,0,185347,17624537
2/5/22,United Kingdom,55.3781,-3.436,17870485,0,185520,17684965
2/6/22,United Kingdom,55.3781,-3.436,17924207,0,185678,17738529
2/7/22,United Kingdom,55.3781,-3.436,17988154,0,185819,17802335
2/8/22,United Kingdom,55.3781,-3.436,18054899,0,185979,17868920
2/9/22,United Kingdom,55.3781,-3.436,18122879,0,186130,17936749
2/10/22,United Kingdom,55.3781,-3.436,18287353,0,186260,18101093
2/11/22,United Kingdom,55.3781,-3.436,18346213,0,186404,18159809
2/12/22,United Kingdom,55.3781,-3.436,18392169,0,186548,18205621
2/13/22,United Kingdom,55.3781,-3.436,18433372,0,186674,18246698
2/14/22,United Kingdom,55.3781,-3.436,18475111,0,186831,18288280
2/15/22,United Kingdom,55.3781,-3.436,18521452,0,186966,18334486
2/16/22,United Kingdom,55.3781,-3.436,18575733,0,187097,18388636
2/17/22,United Kingdom,55.3781,-3.436,18628702,0,187225,18441477
2/18/22,United Kingdom,55.3781,-3.436,18676361,0,187355,18489006
2/19/22,United Kingdom,55.3781,-3.436,18715582,0,187476,18528106
2/20/22,United Kingdom,55.3781,-3.436,18746592,0,187601,18558991
2/21/22,United Kingdom,55.3781,-3.436,18785333,0,187713,18597620
2/22/22,United Kingdom,55.3781,-3.436,18826968,0,187833,18639135
2/23/22,United Kingdom,55.3781,-3.436,18867585,0,187951,18679634
2/24/22,United Kingdom,55.3781,-3.436,18906546,0,188076,18718470
2/25/22,United Kingdom,55.3781,-3.436,18938546,0,188198,18750348
2/26/22,United Kingdom,55.3781,-3.436,18938546,0,188301,18750245
2/27/22,United Kingdom,55.3781,-3.436,18938546,0,188420,18750126
2/28/22,United Kingdom,55.3781,-3.436,19021076,0,188525,18832551
3/1/22,United Kingdom,55.3781,-3.436,19120746,0,188631,18932115
3/2/22,United Kingdom,55.3781,-3.436,19166049,0,188777,18977272
3/3/22,United Kingdom,55.3781,-3.436,19211944,0,188882,19023062
3/4/22,United Kingdom,55.3781,-3.436,19256835,0,188992,19067843
3/5/22,United Kingdom,55.3781,-3.436,19256835,0,189093,19067742
3/6/22,United Kingdom,55.3781,-3.436,19256835,0,189186,19067649
3/7/22,United Kingdom,55.3781,-3.436,19383743,0,189311,19194432
3/8/22,United Kingdom,55.3781,-3.436,19446892,0,189432,19257460
3/9/22,United Kingdom,55.3781,-3.436,19515547,0,189539,19326008
3/10/22,United Kingdom,55.3781,-3.436,19600293,0,189655,19410638
3/11/22,United Kingdom,55.3781,-3.436,19673347,0,189776,19483571
3/12/22,United Kingdom,55.3781,-3.436,19673347,0,189895,19483452
3/13/22,United Kingdom,55.3781,-3.436,19673347,0,190005,19483342
3/14/22,United Kingdom,55.3781,-3.436,19845016,0,190147,19654869
3/15/22,United Kingdom,55.3781,-3.436,19965698,0,190272,19775426
3/16/22,United Kingdom,55.3781,-3.436,20059641,0,190418,19869223
3/17/22,United Kingdom,55.3781,-3.436,20150847,0,190557,19960290
3/18/22,United Kingdom,55.3781,-3.436,20243940,0,190729,20053211
3/19/22,United Kingdom,55.3781,-3.436,20243940,0,190894,20053046
3/20/22,United Kingdom,55.3781,-3.436,20243940,0,191065,20052875
3/21/22,United Kingdom,55.3781,-3.436,20470351,0,191224,20279127
3/22/22,United Kingdom,55.3781,-3.436,20566021,0,191391,20374630
3/23/22,United Kingdom,55.3781,-3.436,20669099,0,191550,20477549
3/24/22,United Kingdom,55.3781,-3.436,20770686,0,191717,20578969
3/25/22,United Kingdom,55.3781,-3.436,20848912,0,191897,20657015
3/26/22,United Kingdom,55.3781,-3.436,20848913,0,192057,20656856
3/27/22,United Kingdom,55.3781,-3.436,20848913,0,192215,20656698
3/28/22,United Kingdom,55.3781,-3.436,21064311,0,192392,20871919
3/29/22,United Kingdom,55.3781,-3.436,21145773,0,192586,20953187
3/30/22,United Kingdom,55.3781,-3.436,21234719,0,192765,21041954
3/31/22,United Kingdom,55.3781,-3.436,21309769,0,192959,21116810
4/1/22,United Kingdom,55.3781,-3.436,21379545,0,193163,21186382
4/2/22,United Kingdom,55.3781,-3.436,21379545,0,193353,21186192
4/3/22,United Kingdom,55.3781,-3.436,21379545,0,193542,21186003
4/4/22,United Kingdom,55.3781,-3.436,21522955,0,193717,21329238
4/5/22,United Kingdom,55.3781,-3.436,21573997,0,193922,21380075
4/6/22,United Kingdom,55.3781,-3.436,21625530,0,194117,21431413
4/7/22,United Kingdom,55.3781,-3.436,21674196,0,194353,21479843
4/8/22,United Kingdom,55.3781,-3.436,21716180,0,194589,21521591
4/9/22,United Kingdom,55.3781,-3.436,21716180,0,194762,21521418
4/10/22,United Kingdom,55.3781,-3.436,21716180,0,194958,21521222
4/11/22,United Kingdom,55.3781,-3.436,21807532,0,195143,21612389
4/12/22,United Kingdom,55.3781,-3.436,21846115,0,195340,21650775
4/13/22,United Kingdom,55.3781,-3.436,21883579,0,195566,21688013
4/14/22,United Kingdom,55.3781,-3.436,21916961,0,195759,21721202
4/15/22,United Kingdom,55.3781,-3.436,21916961,0,195928,21721033
4/16/22,United Kingdom,55.3781,-3.436,21916961,0,196092,21720869
4/17/22,United Kingdom,55.3781,-3.436,21916961,0,196252,21720709
4/18/22,United Kingdom,55.3781,-3.436,21916961,0,196423,21720538
4/19/22,United Kingdom,55.3781,-3.436,22033383,0,196581,21836802
4/20/22,United Kingdom,55.3781,-3.436,22060704,0,196745,21863959
4/21/22,United Kingdom,55.3781,-3.436,22082374,0,196907,21885467
4/22/22,United Kingdom,55.3781,-3.436,22106306,0,197062,21909244
4/23/22,United Kingdom,55.3781,-3.436,22106306,0,197208,21909098
4/24/22,United Kingdom,55.3781,-3.436,22106306,0,197338,21908968
4/25/22,United Kingdom,55.3781,-3.436,22151465,0,197467,21953998
4/26/22,United Kingdom,55.3781,-3.436,22168390,0,197592,21970798
4/27/22,United Kingdom,55.3781,-3.436,22186658,0,197725,21988933
4/28/22,United Kingdom,55.3781,-3.436,22201340,0,197855,22003485
4/29/22,United Kingdom,55.3781,-3.436,22213947,0,197968,22015979
4/30/22,United Kingdom,55.3781,-3.436,22213972,0,198075,22015897
5/1/22,United Kingdom,55.3781,-3.436,22214004,0,198187,22015817
5/2/22,United Kingdom,55.3781,-3.436,22214111,0,198295,22015816
5/3/22,United Kingdom,55.3781,-3.436,22249661,0,198399,22051262
5/4/22,United Kingdom,55.3781,-3.436,22267796,0,198490,22069306
5/5/22,United Kingdom,55.3781,-3.436,22280496,0,198574,22081922
5/6/22,United Kingdom,55.3781,-3.436,22292077,0,198675,22093402
5/7/22,United Kingdom,55.3781,-3.436,22292118,0,198778,22093340
5/8/22,United Kingdom,55.3781,-3.436,22292118,0,198860,22093258
5/9/22,United Kingdom,55.3781,-3.436,22318371,0,198942,22119429
5/10/22,United Kingdom,55.3781,-3.436,22329180,0,199043,22130137
5/11/22,United Kingdom,55.3781,-3.436,22338750,0,199123,22139627
5/12/22,United Kingdom,55.3781,-3.436,22354617,0,199193,22155424
5/13/22,United Kingdom,55.3781,-3.436,22361204,0,199265,22161939
5/14/22,United Kingdom,55.3781,-3.436,22361204,0,199331,22161873
5/15/22,United Kingdom,55.3781,-3.436,22361251,0,199403,22161848
5/16/22,United Kingdom,55.3781,-3.436,22385203,0,199469,22185734
5/17/22,United Kingdom,55.3781,-3.436,22393799,0,199540,22194259
5/18/22,United Kingdom,55.3781,-3.436,22402392,0,199590,22202802
5/19/22,United Kingdom,55.3781,-3.436,22416204,0,199635,22216569
5/20/22,United Kingdom,55.3781,-3.436,22422746,0,199709,22223037
5/21/22,United Kingdom,55.3781,-3.436,22422800,0,199758,22223042
5/22/22,United Kingdom,55.3781,-3.436,22422800,0,199816,22222984
5/23/22,United Kingdom,55.3781,-3.436,22448854,0,199878,22248976
5/24/22,United Kingdom,55.3781,-3.436,22455392,0,199929,22255463
5/25/22,United Kingdom,55.3781,-3.436,22462129,0,199964,22262165
5/26/22,United Kingdom,55.3781,-3.436,22458340,0,200008,22258332
5/27/22,United Kingdom,55.3781,-3.436,22463243,0,200052,22263191
5/28/22,United Kingdom,55.3781,-3.436,22463260,0,200088,22263172
5/29/22,United Kingdom,55.3781,-3.436,22463265,0,200116,22263149
5/30/22,United Kingdom,55.3781,-3.436,22481196,0,200167,22281029
5/31/22,United Kingdom,55.3781,-3.436,22486997,0,200216,22286781
6/1/22,United Kingdom,55.3781,-3.436,22492903,0,200242,22292661
6/2/22,United Kingdom,55.3781,-3.436,22493305,0,200290,22293015
6/3/22,United Kingdom,55.3781,-3.436,22493328,0,200318,22293010
6/4/22,United Kingdom,55.3781,-3.436,22493328,0,200356,22292972
6/5/22,United Kingdom,55.3781,-3.436,22493328,0,200386,22292942
6/6/22,United Kingdom,55.3781,-3.436,22526949,0,200428,22326521
6/7/22,United Kingdom,55.3781,-3.436,22537186,0,200460,22336726
6/8/22,United Kingdom,55.3781,-3.436,22551660,0,200502,22351158
6/9/22,United Kingdom,55.3781,-3.436,22562275,0,200530,22361745
6/10/22,United Kingdom,55.3781,-3.436,22571880,0,200574,22371306
6/11/22,United Kingdom,55.3781,-3.436,22571880,0,200607,22371273
6/12/22,United Kingdom,55.3781,-3.436,22571882,0,200650,22371232
6/13/22,United Kingdom,55.3781,-3.436,22600145,0,200689,22399456
6/14/22,United Kingdom,55.3781,-3.436,22612173,0,200724,22411449
6/15/22,United Kingdom,55.3781,-3.436,22638832,0,200768,22438064
6/16/22,United Kingdom,55.3781,-3.436,22651908,0,200823,22451085
6/17/22,United Kingdom,55.3781,-3.436,22664434,0,200867,22463567
6/18/22,United Kingdom,55.3781,-3.436,22664435,0,200911,22463524
6/19/22,United Kingdom,55.3781,-3.436,22664435,0,200956,22463479
6/20/22,United Kingdom,55.3781,-3.436,22701557,0,201007,22500550
6/21/22,United Kingdom,55.3781,-3.436,22717987,0,201064,22516923
6/22/22,United Kingdom,55.3781,-3.436,22751393,0,201134,22550259
6/23/22,United Kingdom,55.3781,-3.436,22769958,0,201196,22568762
6/24/22,United Kingdom,55.3781,-3.436,22786431,0,201243,22585188
6/25/22,United Kingdom,55.3781,-3.436,22786805,0,201313,22585492
6/26/22,United Kingdom,55.3781,-3.436,22786805,0,201381,22585424
6/27/22,United Kingdom,55.3781,-3.436,22834153,0,201443,22632710
6/28/22,United Kingdom,55.3781,-3.436,22855565,0,201513,22654052
6/29/22,United Kingdom,55.3781,-3.436,22895669,0,201600,22694069
6/30/22,United Kingdom,55.3781,-3.436,22918904,0,201675,22717229
7/1/22,United Kingdom,55.3781,-3.436,22941360,0,201754,22739606
7/2/22,United Kingdom,55.3781,-3.436,22941360,0,201843,22739517
7/3/22,United Kingdom,55.3781,-3.436,22941362,0,201911,22739451
7/4/22,United Kingdom,55.3781,-3.436,22941382,0,201998,22739384
7/5/22,United Kingdom,55.3781,-3.436,22942394,0,202100,22740294
7/6/22,United Kingdom,55.3781,-3.436,23086282,0,202213,22884069
7/7/22,United Kingdom,55.3781,-3.436,23086445,0,202314,22884131
7/8/22,United Kingdom,55.3781,-3.436,23088053,0,202421,22885632
7/9/22,United Kingdom,55.3781,-3.436,23088054,0,202525,22885529
7/10/22,United Kingdom,55.3781,-3.436,23088054,0,202641,22885413
7/11/22,United Kingdom,55.3781,-3.436,23088074,0,202765,22885309
7/12/22,United Kingdom,55.3781,-3.436,23088446,0,202913,22885533
7/13/22,United Kingdom,55.3781,-3.436,23280870,0,203049,23077821
7/14/22,United Kingdom,55.3781,-3.436,23280957,0,203171,23077786
7/15/22,United Kingdom,55.3781,-3.436,23282710,0,203274,23079436
7/16/22,United Kingdom,55.3781,-3.436,23282710,0,203388,23079322
7/17/22,United Kingdom,55.3781,-3.436,23282710,0,203546,23079164
7/18/22,United Kingdom,55.3781,-3.436,23282749,0,203671,23079078
7/19/22,United Kingdom,55.3781,-3.436,23282749,0,203887,23078862
7/20/22,United Kingdom,55.3781,-3.436,23421538,0,204080,23217458
7/21/22,United Kingdom,55.3781,-3.436,23421578,0,204203,23217375
7/22/22,United Kingdom,55.3781,-3.436,23422747,0,204319,23218428
7/23/22,United Kingdom,55.3781,-3.436,23422755,0,204444,23218311
7/24/22,United Kingdom,55.3781,-3.436,23422755,0,204573,23218182
7/25/22,United Kingdom,55.3781,-3.436,23422755,0,204686,23218069
7/26/22,United Kingdom,55.3781,-3.436,23422960,0,204809,23218151
7/27/22,United Kingdom,55.3781,-3.436,23515421,0,204925,23310496
7/28/22,United Kingdom,55.3781,-3.436,23515421,0,205046,23310375
7/29/22,United Kingdom,55.3781,-3.436,23515883,0,205160,23310723
7/30/22,United Kingdom,55.3781,-3.436,23515892,0,205236,23310656
7/31/22,United Kingdom,55.3781,-3.436,23515892,0,205332,23310560
8/1/22,United Kingdom,55.3781,-3.436,23515928,0,205424,23310504
8/2/22,United Kingdom,55.3781,-3.436,23516257,0,205525,23310732
8/3/22,United Kingdom,55.3781,-3.436,23581291,0,205641,23375650
8/4/22,United Kingdom,55.3781,-3.436,23581670,0,205725,23375945
8/5/22,United Kingdom,55.3781,-3.436,23581998,0,205810,23376188
8/6/22,United Kingdom,55.3781,-3.436,23582007,0,205876,23376131
8/7/22,United Kingdom,55.3781,-3.436,23582007,0,205974,23376033
8/8/22,United Kingdom,55.3781,-3.436,23582007,0,206070,23375937
8/9/22,United Kingdom,55.3781,-3.436,23582007,0,206158,23375849
8/10/22,United Kingdom,55.3781,-3.436,23634565,0,206234,23428331
8/11/22,United Kingdom,55.3781,-3.436,23634572,0,206332,23428240
8/12/22,United Kingdom,55.3781,-3.436,23634825,0,206436,23428389
8/13/22,United Kingdom,55.3781,-3.436,23634825,0,206524,23428301
8/14/22,United Kingdom,55.3781,-3.436,23634825,0,206614,23428211
8/15/22,United Kingdom,55.3781,-3.436,23634825,0,206701,23428124
8/16/22,United Kingdom,55.3781,-3.436,23634964,0,206770,23428194
8/17/22,United Kingdom,55.3781,-3.436,23675474,0,206827,23468647
8/18/22,United Kingdom,55.3781,-3.436,23675489,0,206890,23468599
8/19/22,United Kingdom,55.3781,-3.436,23675489,0,206958,23468531
8/20/22,United Kingdom,55.3781,-3.436,23675489,0,207033,23468456
8/21/22,United Kingdom,55.3781,-3.436,23675489,0,207091,23468398
8/22/22,United Kingdom,55.3781,-3.436,23675745,0,207153,23468592
8/23/22,United Kingdom,55.3781,-3.436,23675753,0,207230,23468523
8/24/22,United Kingdom,55.3781,-3.436,23676382,0,207283,23469099
8/25/22,United Kingdom,55.3781,-3.436,23708470,0,207331,23501139
8/26/22,United Kingdom,55.3781,-3.436,23708627,0,207374,23501253
8/27/22,United Kingdom,55.3781,-3.436,23708633,0,207431,23501202
8/28/22,United Kingdom,55.3781,-3.436,23708633,0,207492,23501141
8/29/22,United Kingdom,55.3781,-3.436,23708665,0,207547,23501118
8/30/22,United Kingdom,55.3781,-3.436,23708844,0,207589,23501255
8/31/22,United Kingdom,55.3781,-3.436,23738015,0,207662,23530353
9/1/22,United Kingdom,55.3781,-3.436,23738035,0,207706,23530329
9/2/22,United Kingdom,55.3781,-3.436,23738080,0,207752,23530328
9/3/22,United Kingdom,55.3781,-3.436,23738080,0,207806,23530274
9/4/22,United Kingdom,55.3781,-3.436,23738080,0,207851,23530229
9/5/22,United Kingdom,55.3781,-3.436,23738094,0,207891,23530203
9/6/22,United Kingdom,55.3781,-3.436,23738136,0,207929,23530207
9/7/22,United Kingdom,55.3781,-3.436,23738788,0,207987,23530801
9/8/22,United Kingdom,55.3781,-3.436,23771539,0,208032,23563507
9/9/22,United Kingdom,55.3781,-3.436,23771555,0,208069,23563486
9/10/22,United Kingdom,55.3781,-3.436,23771661,0,208112,23563549
9/11/22,United Kingdom,55.3781,-3.436,23771664,0,208141,23563523
9/12/22,United Kingdom,55.3781,-3.436,23771943,0,208184,23563759
9/13/22,United Kingdom,55.3781,-3.436,23771949,-1,208232,23563718
9/14/22,United Kingdom,55.3781,-3.436,23772128,-1,208275,23563854
9/15/22,United Kingdom,55.3781,-3.436,23803140,-1,208324,23594817
9/16/22,United Kingdom,55.3781,-3.436,23803434,-1,208362,23595073
9/17/22,United Kingdom,55.3781,-3.436,23803452,-1,208402,23595051
9/18/22,United Kingdom,55.3781,-3.436,23803472,-1,208440,23595033
9/19/22,United Kingdom,55.3781,-3.436,23803483,-1,208488,23594996
9/20/22,United Kingdom,55.3781,-3.436,23803528,-1,208535,23594994
9/21/22,United Kingdom,55.3781,-3.436,23804110,0,208572,23595538
9/22/22,United Kingdom,55.3781,-3.436,23840859,0,208622,23632237
9/23/22,United Kingdom,55.3781,-3.436,23841178,0,208674,23632504
9/24/22,United Kingdom,55.3781,-3.436,23842038,0,208722,23633316
9/25/22,United Kingdom,55.3781,-3.436,23842038,0,208762,23633276
9/26/22,United Kingdom,55.3781,-3.436,23842038,0,208824,23633214
9/27/22,United Kingdom,55.3781,-3.436,23842049,0,208891,23633158
9/28/22,United Kingdom,55.3781,-3.436,23842451,0,208950,23633501
9/29/22,United Kingdom,55.3781,-3.436,23893351,0,209016,23684335
9/30/22,United Kingdom,55.3781,-3.436,23893361,0,209079,23684282
10/1/22,United Kingdom,55.3781,-3.436,23893496,0,209156,23684340
10/2/22,United Kingdom,55.3781,-3.436,23893496,0,209218,23684278
10/3/22,United Kingdom,55.3781,-3.436,23893497,0,209299,23684198
10/4/22,United Kingdom,55.3781,-3.436,23893624,0,209389,23684235
10/5/22,United Kingdom,55.3781,-3.436,23894259,0,209487,23684772
10/6/22,United Kingdom,55.3781,-3.436,23956680,0,209578,23747102
10/7/22,United Kingdom,55.3781,-3.436,23957310,0,209678,23747632
10/8/22,United Kingdom,55.3781,-3.436,23957310,0,209766,23747544
10/9/22,United Kingdom,55.3781,-3.436,23957310,0,209862,23747448
10/10/22,United Kingdom,55.3781,-3.436,23957310,0,209950,23747360
10/11/22,United Kingdom,55.3781,-3.436,23957457,0,210050,23747407
10/12/22,United Kingdom,55.3781,-3.436,23957748,0,210174,23747574
10/13/22,United Kingdom,55.3781,-3.436,24021294,0,210283,23811011
10/14/22,United Kingdom,55.3781,-3.436,24021696,0,210391,23811305
10/15/22,United Kingdom,55.3781,-3.436,24021696,0,210495,23811201
10/16/22,United Kingdom,55.3781,-3.436,24021696,0,210598,23811098
10/17/22,United Kingdom,55.3781,-3.436,24021790,0,210713,23811077
10/18/22,United Kingdom,55.3781,-3.436,24021796,0,210817,23810979
10/19/22,United Kingdom,55.3781,-3.436,24021973,0,210919,23811054
10/20/22,United Kingdom,55.3781,-3.436,24078702,0,211035,23867667
10/21/22,United Kingdom,55.3781,-3.436,24079325,0,211135,23868190
10/22/22,United Kingdom,55.3781,-3.436,24079325,0,211242,23868083
10/23/22,United Kingdom,55.3781,-3.436,24079325,0,211342,23867983
10/24/22,United Kingdom,55.3781,-3.436,24079344,0,211443,23867901
10/25/22,United Kingdom,55.3781,-3.436,24079393,0,211552,23867841
10/26/22,United Kingdom,55.3781,-3.436,24079679,0,211642,23868037
10/27/22,United Kingdom,55.3781,-3.436,24122642,0,211745,23910897
10/28/22,United Kingdom,55.3781,-3.436,24122909,0,211831,23911078
10/29/22,United Kingdom,55.3781,-3.436,24122909,0,211923,23910986
10/30/22,United Kingdom,55.3781,-3.436,24122909,0,212016,23910893
10/31/22,United Kingdom,55.3781,-3.436,24122922,0,212098,23910824
11/1/22,United Kingdom,55.3781,-3.436,24122922,0,212183,23910739
11/2/22,United Kingdom,55.3781,-3.436,24123152,0,212258,23910894
11/3/22,United Kingdom,55.3781,-3.436,24154796,0,212343,23942453
11/4/22,United Kingdom,55.3781,-3.436,24155154,0,212434,23942720
11/5/22,United Kingdom,55.3781,-3.436,24155154,0,212508,23942646
11/6/22,United Kingdom,55.3781,-3.436,24155154,0,212563,23942591
11/7/22,United Kingdom,55.3781,-3.436,24155192,0,212638,23942554
11/8/22,United Kingdom,55.3781,-3.436,24155262,0,212697,23942565
11/9/22,United Kingdom,55.3781,-3.436,24155358,0,212758,23942600
11/10/22,United Kingdom,55.3781,-3.436,24179611,0,212810,23966801
11/11/22,United Kingdom,55.3781,-3.436,24179656,0,212880,23966776
11/12/22,United Kingdom,55.3781,-3.436,24179656,0,212920,23966736
11/13/22,United Kingdom,55.3781,-3.436,24179656,0,212975,23966681
11/14/22,United Kingdom,55.3781,-3.436,24179959,0,213030,23966929
11/15/22,United Kingdom,55.3781,-3.436,24180003,0,213091,23966912
11/16/22,United Kingdom,55.3781,-3.436,24180142,0,213143,23966999
11/17/22,United Kingdom,55.3781,-3.436,24203583,0,213191,23990392
11/18/22,United Kingdom,55.3781,-3.436,24203873,0,213243,23990630
11/19/22,United Kingdom,55.3781,-3.436,24203873,0,213289,23990584
11/20/22,United Kingdom,55.3781,-3.436,24203873,0,213345,23990528
11/21/22,United Kingdom,55.3781,-3.436,24203873,0,213393,23990480
11/22/22,United Kingdom,55.3781,-3.436,24203888,0,213438,23990450
11/23/22,United Kingdom,55.3781,-3.436,24203988,0,213472,23990516
11/24/22,United Kingdom,55.3781,-3.436,24224526,0,213495,24011031
11/25/22,United Kingdom,55.3781,-3.436,24224763,0,213506,24011257
11/26/22,United Kingdom,55.3781,-3.436,24224763,0,213506,24011257
11/27/22,United Kingdom,55.3781,-3.436,24224763,0,213506,24011257
11/28/22,United Kingdom,55.3781,-3.436,24224763,0,213506,24011257
11/29/22,United Kingdom,55.3781,-3.436,24224763,0,213506,24011257
11/30/22,United Kingdom,55.3781,-3.436,24225062,0,213506,24011556
12/1/22,United Kingdom,55.3781,-3.436,24251636,0,213506,24038130
12/2/22,United Kingdom,55.3781,-3.436,24251661,0,213507,24038154
12/3/22,United Kingdom,55.3781,-3.436,24251661,0,213507,24038154
12/4/22,United Kingdom,55.3781,-3.436,24251661,0,213507,24038154
12/5/22,United Kingdom,55.3781,-3.436,24252017,0,213507,24038510
12/6/22,United Kingdom,55.3781,-3.436,24252017,0,213507,24038510
12/7/22,United Kingdom,55.3781,-3.436,24252201,0,213508,24038693
12/8/22,United Kingdom,55.3781,-3.436,24281031,0,213508,24067523
12/9/22,United Kingdom,55.3781,-3.436,24281498,0,213508,24067990
12/10/22,United Kingdom,55.3781,-3.436,24281498,0,213508,24067990
12/11/22,United Kingdom,55.3781,-3.436,24281498,0,213508,24067990
12/12/22,United Kingdom,55.3781,-3.436,24281498,0,213508,24067990
12/13/22,United Kingdom,55.3781,-3.436,24281515,0,213508,24068007
12/14/22,United Kingdom,55.3781,-3.436,24281515,0,213508,24068007
12/15/22,United Kingdom,55.3781,-3.436,24317350,0,213890,24103460
12/16/22,United Kingdom,55.3781,-3.436,24318154,0,213892,24104262
12/17/22,United Kingdom,55.3781,-3.436,24318154,0,213892,24104262
1/1/22,Uruguay,-32.5228,-55.7658,414294,0,6172,408122
1/2/22,Uruguay,-32.5228,-55.7658,415249,0,6175,409074
1/3/22,Uruguay,-32.5228,-55.7658,416970,0,6177,410793
1/4/22,Uruguay,-32.5228,-55.7658,420108,0,6180,413928
1/5/22,Uruguay,-32.5228,-55.7658,425436,0,6181,419255
1/6/22,Uruguay,-32.5228,-55.7658,430958,0,6186,424772
1/7/22,Uruguay,-32.5228,-55.7658,437062,0,6188,430874
1/8/22,Uruguay,-32.5228,-55.7658,443436,0,6189,437247
1/9/22,Uruguay,-32.5228,-55.7658,449422,0,6192,443230
1/10/22,Uruguay,-32.5228,-55.7658,456179,0,6199,449980
1/11/22,Uruguay,-32.5228,-55.7658,463357,0,6202,457155
1/12/22,Uruguay,-32.5228,-55.7658,473180,0,6205,466975
1/13/22,Uruguay,-32.5228,-55.7658,483820,0,6211,477609
1/14/22,Uruguay,-32.5228,-55.7658,490626,0,6214,484412
1/15/22,Uruguay,-32.5228,-55.7658,500267,0,6225,494042
1/16/22,Uruguay,-32.5228,-55.7658,512841,0,6243,506598
1/17/22,Uruguay,-32.5228,-55.7658,520822,0,6248,514574
1/18/22,Uruguay,-32.5228,-55.7658,531452,0,6253,525199
1/19/22,Uruguay,-32.5228,-55.7658,543166,0,6258,536908
1/20/22,Uruguay,-32.5228,-55.7658,556163,0,6272,549891
1/21/22,Uruguay,-32.5228,-55.7658,569037,0,6284,562753
1/22/22,Uruguay,-32.5228,-55.7658,580066,0,6303,573763
1/23/22,Uruguay,-32.5228,-55.7658,588995,0,6308,582687
1/24/22,Uruguay,-32.5228,-55.7658,599040,0,6325,592715
1/25/22,Uruguay,-32.5228,-55.7658,609785,0,6339,603446
1/26/22,Uruguay,-32.5228,-55.7658,621453,0,6368,615085
1/27/22,Uruguay,-32.5228,-55.7658,631019,0,6389,624630
1/28/22,Uruguay,-32.5228,-55.7658,644631,0,6411,638220
1/29/22,Uruguay,-32.5228,-55.7658,653853,0,6436,647417
1/30/22,Uruguay,-32.5228,-55.7658,661441,0,6459,654982
1/31/22,Uruguay,-32.5228,-55.7658,668425,0,6479,661946
2/1/22,Uruguay,-32.5228,-55.7658,679878,0,6513,673365
2/2/22,Uruguay,-32.5228,-55.7658,690496,0,6540,683956
2/3/22,Uruguay,-32.5228,-55.7658,700511,0,6579,693932
2/4/22,Uruguay,-32.5228,-55.7658,710874,0,6606,704268
2/5/22,Uruguay,-32.5228,-55.7658,719948,0,6625,713323
2/6/22,Uruguay,-32.5228,-55.7658,726042,0,6637,719405
2/7/22,Uruguay,-32.5228,-55.7658,733010,0,6656,726354
2/8/22,Uruguay,-32.5228,-55.7658,741454,0,6676,734778
2/9/22,Uruguay,-32.5228,-55.7658,749554,0,6696,742858
2/10/22,Uruguay,-32.5228,-55.7658,758366,0,6710,751656
2/11/22,Uruguay,-32.5228,-55.7658,765960,0,6729,759231
2/12/22,Uruguay,-32.5228,-55.7658,772757,0,6744,766013
2/13/22,Uruguay,-32.5228,-55.7658,777490,0,6756,770734
2/14/22,Uruguay,-32.5228,-55.7658,782556,0,6778,775778
2/15/22,Uruguay,-32.5228,-55.7658,788676,0,6794,781882
2/16/22,Uruguay,-32.5228,-55.7658,795316,0,6820,788496
2/17/22,Uruguay,-32.5228,-55.7658,800833,0,6838,793995
2/18/22,Uruguay,-32.5228,-55.7658,808012,0,6854,801158
2/19/22,Uruguay,-32.5228,-55.7658,812367,0,6865,805502
2/20/22,Uruguay,-32.5228,-55.7658,815704,0,6879,808825
2/21/22,Uruguay,-32.5228,-55.7658,819379,0,6895,812484
2/22/22,Uruguay,-32.5228,-55.7658,823784,0,6905,816879
2/23/22,Uruguay,-32.5228,-55.7658,827814,0,6919,820895
2/24/22,Uruguay,-32.5228,-55.7658,831950,0,6932,825018
2/25/22,Uruguay,-32.5228,-55.7658,835346,0,6949,828397
2/26/22,Uruguay,-32.5228,-55.7658,838341,0,6961,831380
2/27/22,Uruguay,-32.5228,-55.7658,840511,0,6977,833534
2/28/22,Uruguay,-32.5228,-55.7658,842462,0,6985,835477
3/1/22,Uruguay,-32.5228,-55.7658,844400,0,6991,837409
3/2/22,Uruguay,-32.5228,-55.7658,846868,0,7005,839863
3/3/22,Uruguay,-32.5228,-55.7658,849050,0,7014,842036
3/4/22,Uruguay,-32.5228,-55.7658,851241,0,7031,844210
3/5/22,Uruguay,-32.5228,-55.7658,853170,0,7040,846130
3/6/22,Uruguay,-32.5228,-55.7658,854375,0,7046,847329
3/7/22,Uruguay,-32.5228,-55.7658,855883,0,7051,848832
3/8/22,Uruguay,-32.5228,-55.7658,857635,0,7059,850576
3/9/22,Uruguay,-32.5228,-55.7658,859165,0,7069,852096
3/10/22,Uruguay,-32.5228,-55.7658,860663,0,7075,853588
3/11/22,Uruguay,-32.5228,-55.7658,862153,0,7083,855070
3/12/22,Uruguay,-32.5228,-55.7658,863365,0,7090,856275
3/13/22,Uruguay,-32.5228,-55.7658,864376,0,7095,857281
3/14/22,Uruguay,-32.5228,-55.7658,865644,0,7103,858541
3/15/22,Uruguay,-32.5228,-55.7658,867282,0,7110,860172
3/16/22,Uruguay,-32.5228,-55.7658,868952,0,7116,861836
3/17/22,Uruguay,-32.5228,-55.7658,871081,0,7120,863961
3/18/22,Uruguay,-32.5228,-55.7658,872938,0,7127,865811
3/19/22,Uruguay,-32.5228,-55.7658,874404,0,7134,867270
3/20/22,Uruguay,-32.5228,-55.7658,875313,0,7138,868175
3/21/22,Uruguay,-32.5228,-55.7658,876400,0,7141,869259
3/22/22,Uruguay,-32.5228,-55.7658,877763,0,7142,870621
3/23/22,Uruguay,-32.5228,-55.7658,879618,0,7144,872474
3/24/22,Uruguay,-32.5228,-55.7658,881152,0,7147,874005
3/25/22,Uruguay,-32.5228,-55.7658,882379,0,7149,875230
3/26/22,Uruguay,-32.5228,-55.7658,883354,0,7150,876204
3/27/22,Uruguay,-32.5228,-55.7658,884081,0,7151,876930
3/28/22,Uruguay,-32.5228,-55.7658,884742,0,7154,877588
3/29/22,Uruguay,-32.5228,-55.7658,885980,0,7156,878824
3/30/22,Uruguay,-32.5228,-55.7658,887028,0,7156,879872
3/31/22,Uruguay,-32.5228,-55.7658,887935,0,7159,880776
4/1/22,Uruguay,-32.5228,-55.7658,888639,0,7161,881478
4/2/22,Uruguay,-32.5228,-55.7658,889132,0,7162,881970
4/3/22,Uruguay,-32.5228,-55.7658,889513,0,7166,882347
4/4/22,Uruguay,-32.5228,-55.7658,890140,0,7169,882971
4/5/22,Uruguay,-32.5228,-55.7658,890980,0,7171,883809
4/6/22,Uruguay,-32.5228,-55.7658,891800,0,7176,884624
4/7/22,Uruguay,-32.5228,-55.7658,892454,0,7179,885275
4/8/22,Uruguay,-32.5228,-55.7658,893009,0,7181,885828
4/9/22,Uruguay,-32.5228,-55.7658,893575,0,7181,886394
4/10/22,Uruguay,-32.5228,-55.7658,893909,0,7182,886727
4/11/22,Uruguay,-32.5228,-55.7658,894267,0,7183,887084
4/12/22,Uruguay,-32.5228,-55.7658,894630,0,7186,887444
4/13/22,Uruguay,-32.5228,-55.7658,894984,0,7188,887796
4/14/22,Uruguay,-32.5228,-55.7658,895240,0,7190,888050
4/15/22,Uruguay,-32.5228,-55.7658,895451,0,7193,888258
4/16/22,Uruguay,-32.5228,-55.7658,895592,0,7193,888399
4/17/22,Uruguay,-32.5228,-55.7658,895775,0,7197,888578
4/18/22,Uruguay,-32.5228,-55.7658,895775,0,7197,888578
4/19/22,Uruguay,-32.5228,-55.7658,895775,0,7197,888578
4/20/22,Uruguay,-32.5228,-55.7658,895775,0,7197,888578
4/21/22,Uruguay,-32.5228,-55.7658,895775,0,7197,888578
4/22/22,Uruguay,-32.5228,-55.7658,895775,0,7197,888578
4/23/22,Uruguay,-32.5228,-55.7658,895775,0,7197,888578
4/24/22,Uruguay,-32.5228,-55.7658,895775,0,7197,888578
4/25/22,Uruguay,-32.5228,-55.7658,895775,0,7197,888578
4/26/22,Uruguay,-32.5228,-55.7658,895775,0,7197,888578
4/27/22,Uruguay,-32.5228,-55.7658,895775,0,7197,888578
4/28/22,Uruguay,-32.5228,-55.7658,895775,0,7197,888578
4/29/22,Uruguay,-32.5228,-55.7658,897867,0,7203,890664
4/30/22,Uruguay,-32.5228,-55.7658,897867,0,7203,890664
5/1/22,Uruguay,-32.5228,-55.7658,897867,0,7203,890664
5/2/22,Uruguay,-32.5228,-55.7658,897867,0,7203,890664
5/3/22,Uruguay,-32.5228,-55.7658,899723,0,7210,892513
5/4/22,Uruguay,-32.5228,-55.7658,899723,0,7210,892513
5/5/22,Uruguay,-32.5228,-55.7658,899723,0,7210,892513
5/6/22,Uruguay,-32.5228,-55.7658,899723,0,7210,892513
5/7/22,Uruguay,-32.5228,-55.7658,899723,0,7210,892513
5/8/22,Uruguay,-32.5228,-55.7658,899723,0,7210,892513
5/9/22,Uruguay,-32.5228,-55.7658,899723,0,7210,892513
5/10/22,Uruguay,-32.5228,-55.7658,902540,0,7213,895327
5/11/22,Uruguay,-32.5228,-55.7658,902540,0,7213,895327
5/12/22,Uruguay,-32.5228,-55.7658,902540,0,7213,895327
5/13/22,Uruguay,-32.5228,-55.7658,902540,0,7213,895327
5/14/22,Uruguay,-32.5228,-55.7658,902540,0,7213,895327
5/15/22,Uruguay,-32.5228,-55.7658,902540,0,7213,895327
5/16/22,Uruguay,-32.5228,-55.7658,902540,0,7213,895327
5/17/22,Uruguay,-32.5228,-55.7658,908078,0,7215,900863
5/18/22,Uruguay,-32.5228,-55.7658,908078,0,7215,900863
5/19/22,Uruguay,-32.5228,-55.7658,908078,0,7215,900863
5/20/22,Uruguay,-32.5228,-55.7658,908078,0,7215,900863
5/21/22,Uruguay,-32.5228,-55.7658,908078,0,7215,900863
5/22/22,Uruguay,-32.5228,-55.7658,908078,0,7215,900863
5/23/22,Uruguay,-32.5228,-55.7658,908078,0,7215,900863
5/24/22,Uruguay,-32.5228,-55.7658,916388,0,7227,909161
5/25/22,Uruguay,-32.5228,-55.7658,916388,0,7227,909161
5/26/22,Uruguay,-32.5228,-55.7658,916388,0,7227,909161
5/27/22,Uruguay,-32.5228,-55.7658,916388,0,7227,909161
5/28/22,Uruguay,-32.5228,-55.7658,916388,0,7227,909161
5/29/22,Uruguay,-32.5228,-55.7658,916388,0,7227,909161
5/30/22,Uruguay,-32.5228,-55.7658,916388,0,7227,909161
5/31/22,Uruguay,-32.5228,-55.7658,925777,0,7238,918539
6/1/22,Uruguay,-32.5228,-55.7658,925777,0,7238,918539
6/2/22,Uruguay,-32.5228,-55.7658,925777,0,7238,918539
6/3/22,Uruguay,-32.5228,-55.7658,925777,0,7238,918539
6/4/22,Uruguay,-32.5228,-55.7658,925777,0,7238,918539
6/5/22,Uruguay,-32.5228,-55.7658,925777,0,7238,918539
6/6/22,Uruguay,-32.5228,-55.7658,925777,0,7238,918539
6/7/22,Uruguay,-32.5228,-55.7658,934961,0,7262,927699
6/8/22,Uruguay,-32.5228,-55.7658,934961,0,7262,927699
6/9/22,Uruguay,-32.5228,-55.7658,934961,0,7262,927699
6/10/22,Uruguay,-32.5228,-55.7658,934961,0,7262,927699
6/11/22,Uruguay,-32.5228,-55.7658,934961,0,7262,927699
6/12/22,Uruguay,-32.5228,-55.7658,934961,0,7262,927699
6/13/22,Uruguay,-32.5228,-55.7658,943877,0,7290,936587
6/14/22,Uruguay,-32.5228,-55.7658,943877,0,7290,936587
6/15/22,Uruguay,-32.5228,-55.7658,943877,0,7290,936587
6/16/22,Uruguay,-32.5228,-55.7658,943877,0,7290,936587
6/17/22,Uruguay,-32.5228,-55.7658,943877,0,7290,936587
6/18/22,Uruguay,-32.5228,-55.7658,943877,0,7290,936587
6/19/22,Uruguay,-32.5228,-55.7658,943877,0,7290,936587
6/20/22,Uruguay,-32.5228,-55.7658,951948,0,7312,944636
6/21/22,Uruguay,-32.5228,-55.7658,951948,0,7312,944636
6/22/22,Uruguay,-32.5228,-55.7658,951948,0,7312,944636
6/23/22,Uruguay,-32.5228,-55.7658,951948,0,7312,944636
6/24/22,Uruguay,-32.5228,-55.7658,951948,0,7312,944636
6/25/22,Uruguay,-32.5228,-55.7658,951948,0,7312,944636
6/26/22,Uruguay,-32.5228,-55.7658,951948,0,7312,944636
6/27/22,Uruguay,-32.5228,-55.7658,957629,0,7331,950298
6/28/22,Uruguay,-32.5228,-55.7658,957629,0,7331,950298
6/29/22,Uruguay,-32.5228,-55.7658,957629,0,7331,950298
6/30/22,Uruguay,-32.5228,-55.7658,957629,0,7331,950298
7/1/22,Uruguay,-32.5228,-55.7658,957629,0,7331,950298
7/2/22,Uruguay,-32.5228,-55.7658,957629,0,7331,950298
7/3/22,Uruguay,-32.5228,-55.7658,957629,0,7331,950298
7/4/22,Uruguay,-32.5228,-55.7658,957629,0,7331,950298
7/5/22,Uruguay,-32.5228,-55.7658,962251,0,7351,954900
7/6/22,Uruguay,-32.5228,-55.7658,962251,0,7351,954900
7/7/22,Uruguay,-32.5228,-55.7658,962251,0,7351,954900
7/8/22,Uruguay,-32.5228,-55.7658,962251,0,7351,954900
7/9/22,Uruguay,-32.5228,-55.7658,962251,0,7351,954900
7/10/22,Uruguay,-32.5228,-55.7658,962251,0,7351,954900
7/11/22,Uruguay,-32.5228,-55.7658,965370,0,7373,957997
7/12/22,Uruguay,-32.5228,-55.7658,965370,0,7373,957997
7/13/22,Uruguay,-32.5228,-55.7658,965370,0,7373,957997
7/14/22,Uruguay,-32.5228,-55.7658,965370,0,7373,957997
7/15/22,Uruguay,-32.5228,-55.7658,965370,0,7373,957997
7/16/22,Uruguay,-32.5228,-55.7658,965370,0,7373,957997
7/17/22,Uruguay,-32.5228,-55.7658,965370,0,7373,957997
7/18/22,Uruguay,-32.5228,-55.7658,965370,0,7373,957997
7/19/22,Uruguay,-32.5228,-55.7658,967808,0,7387,960421
7/20/22,Uruguay,-32.5228,-55.7658,967808,0,7387,960421
7/21/22,Uruguay,-32.5228,-55.7658,967808,0,7387,960421
7/22/22,Uruguay,-32.5228,-55.7658,967808,0,7387,960421
7/23/22,Uruguay,-32.5228,-55.7658,967808,0,7387,960421
7/24/22,Uruguay,-32.5228,-55.7658,967808,0,7387,960421
7/25/22,Uruguay,-32.5228,-55.7658,967808,0,7387,960421
7/26/22,Uruguay,-32.5228,-55.7658,969803,0,7403,962400
7/27/22,Uruguay,-32.5228,-55.7658,969803,0,7403,962400
7/28/22,Uruguay,-32.5228,-55.7658,969803,0,7403,962400
7/29/22,Uruguay,-32.5228,-55.7658,969803,0,7403,962400
7/30/22,Uruguay,-32.5228,-55.7658,969803,0,7403,962400
7/31/22,Uruguay,-32.5228,-55.7658,969803,0,7403,962400
8/1/22,Uruguay,-32.5228,-55.7658,971728,0,7415,964313
8/2/22,Uruguay,-32.5228,-55.7658,971728,0,7415,964313
8/3/22,Uruguay,-32.5228,-55.7658,971728,0,7415,964313
8/4/22,Uruguay,-32.5228,-55.7658,971728,0,7415,964313
8/5/22,Uruguay,-32.5228,-55.7658,971728,0,7415,964313
8/6/22,Uruguay,-32.5228,-55.7658,971728,0,7415,964313
8/7/22,Uruguay,-32.5228,-55.7658,971728,0,7415,964313
8/8/22,Uruguay,-32.5228,-55.7658,971728,0,7415,964313
8/9/22,Uruguay,-32.5228,-55.7658,973420,0,7423,965997
8/10/22,Uruguay,-32.5228,-55.7658,973420,0,7423,965997
8/11/22,Uruguay,-32.5228,-55.7658,973420,0,7423,965997
8/12/22,Uruguay,-32.5228,-55.7658,973420,0,7423,965997
8/13/22,Uruguay,-32.5228,-55.7658,973420,0,7423,965997
8/14/22,Uruguay,-32.5228,-55.7658,973420,0,7423,965997
8/15/22,Uruguay,-32.5228,-55.7658,975264,0,7429,967835
8/16/22,Uruguay,-32.5228,-55.7658,975264,0,7429,967835
8/17/22,Uruguay,-32.5228,-55.7658,975264,0,7429,967835
8/18/22,Uruguay,-32.5228,-55.7658,975264,0,7429,967835
8/19/22,Uruguay,-32.5228,-55.7658,975264,0,7429,967835
8/20/22,Uruguay,-32.5228,-55.7658,975264,0,7429,967835
8/21/22,Uruguay,-32.5228,-55.7658,975264,0,7429,967835
8/22/22,Uruguay,-32.5228,-55.7658,977305,0,7438,969867
8/23/22,Uruguay,-32.5228,-55.7658,977305,0,7438,969867
8/24/22,Uruguay,-32.5228,-55.7658,977305,0,7438,969867
8/25/22,Uruguay,-32.5228,-55.7658,977305,0,7438,969867
8/26/22,Uruguay,-32.5228,-55.7658,977305,0,7438,969867
8/27/22,Uruguay,-32.5228,-55.7658,977305,0,7438,969867
8/28/22,Uruguay,-32.5228,-55.7658,977305,0,7438,969867
8/29/22,Uruguay,-32.5228,-55.7658,979160,0,7445,971715
8/30/22,Uruguay,-32.5228,-55.7658,979160,0,7445,971715
8/31/22,Uruguay,-32.5228,-55.7658,979160,0,7445,971715
9/1/22,Uruguay,-32.5228,-55.7658,979160,0,7445,971715
9/2/22,Uruguay,-32.5228,-55.7658,979160,0,7445,971715
9/3/22,Uruguay,-32.5228,-55.7658,979160,0,7445,971715
9/4/22,Uruguay,-32.5228,-55.7658,979160,0,7445,971715
9/5/22,Uruguay,-32.5228,-55.7658,981186,0,7455,973731
9/6/22,Uruguay,-32.5228,-55.7658,981186,0,7455,973731
9/7/22,Uruguay,-32.5228,-55.7658,981186,0,7455,973731
9/8/22,Uruguay,-32.5228,-55.7658,981186,0,7455,973731
9/9/22,Uruguay,-32.5228,-55.7658,981186,0,7455,973731
9/10/22,Uruguay,-32.5228,-55.7658,981186,0,7455,973731
9/11/22,Uruguay,-32.5228,-55.7658,981186,0,7455,973731
9/12/22,Uruguay,-32.5228,-55.7658,982846,0,7462,975384
9/13/22,Uruguay,-32.5228,-55.7658,982846,0,7462,975384
9/14/22,Uruguay,-32.5228,-55.7658,982846,0,7462,975384
9/15/22,Uruguay,-32.5228,-55.7658,982846,0,7462,975384
9/16/22,Uruguay,-32.5228,-55.7658,982846,0,7462,975384
9/17/22,Uruguay,-32.5228,-55.7658,982846,0,7462,975384
9/18/22,Uruguay,-32.5228,-55.7658,982846,0,7462,975384
9/19/22,Uruguay,-32.5228,-55.7658,984152,0,7473,976679
9/20/22,Uruguay,-32.5228,-55.7658,984152,0,7473,976679
9/21/22,Uruguay,-32.5228,-55.7658,984152,0,7473,976679
9/22/22,Uruguay,-32.5228,-55.7658,984152,0,7473,976679
9/23/22,Uruguay,-32.5228,-55.7658,984152,0,7473,976679
9/24/22,Uruguay,-32.5228,-55.7658,984152,0,7473,976679
9/25/22,Uruguay,-32.5228,-55.7658,984152,0,7473,976679
9/26/22,Uruguay,-32.5228,-55.7658,985422,0,7485,977937
9/27/22,Uruguay,-32.5228,-55.7658,985422,0,7485,977937
9/28/22,Uruguay,-32.5228,-55.7658,985422,0,7485,977937
9/29/22,Uruguay,-32.5228,-55.7658,985422,0,7485,977937
9/30/22,Uruguay,-32.5228,-55.7658,985422,0,7485,977937
10/1/22,Uruguay,-32.5228,-55.7658,985422,0,7485,977937
10/2/22,Uruguay,-32.5228,-55.7658,985422,0,7485,977937
10/3/22,Uruguay,-32.5228,-55.7658,986446,0,7495,978951
10/4/22,Uruguay,-32.5228,-55.7658,986446,0,7495,978951
10/5/22,Uruguay,-32.5228,-55.7658,986446,0,7495,978951
10/6/22,Uruguay,-32.5228,-55.7658,986446,0,7495,978951
10/7/22,Uruguay,-32.5228,-55.7658,986446,0,7495,978951
10/8/22,Uruguay,-32.5228,-55.7658,986446,0,7495,978951
10/9/22,Uruguay,-32.5228,-55.7658,986446,0,7495,978951
10/10/22,Uruguay,-32.5228,-55.7658,986446,0,7495,978951
10/11/22,Uruguay,-32.5228,-55.7658,987563,0,7501,980062
10/12/22,Uruguay,-32.5228,-55.7658,987563,0,7501,980062
10/13/22,Uruguay,-32.5228,-55.7658,987563,0,7501,980062
10/14/22,Uruguay,-32.5228,-55.7658,987563,0,7501,980062
10/15/22,Uruguay,-32.5228,-55.7658,987563,0,7501,980062
10/16/22,Uruguay,-32.5228,-55.7658,987563,0,7501,980062
10/17/22,Uruguay,-32.5228,-55.7658,988527,0,7510,981017
10/18/22,Uruguay,-32.5228,-55.7658,988527,0,7510,981017
10/19/22,Uruguay,-32.5228,-55.7658,988527,0,7510,981017
10/20/22,Uruguay,-32.5228,-55.7658,988527,0,7510,981017
10/21/22,Uruguay,-32.5228,-55.7658,988527,0,7510,981017
10/22/22,Uruguay,-32.5228,-55.7658,988527,0,7510,981017
10/23/22,Uruguay,-32.5228,-55.7658,988527,0,7510,981017
10/24/22,Uruguay,-32.5228,-55.7658,989629,0,7515,982114
10/25/22,Uruguay,-32.5228,-55.7658,989629,0,7515,982114
10/26/22,Uruguay,-32.5228,-55.7658,989629,0,7515,982114
10/27/22,Uruguay,-32.5228,-55.7658,989629,0,7515,982114
10/28/22,Uruguay,-32.5228,-55.7658,989629,0,7515,982114
10/29/22,Uruguay,-32.5228,-55.7658,989629,0,7515,982114
10/30/22,Uruguay,-32.5228,-55.7658,989629,0,7515,982114
10/31/22,Uruguay,-32.5228,-55.7658,990560,0,7518,983042
11/1/22,Uruguay,-32.5228,-55.7658,990560,0,7518,983042
11/2/22,Uruguay,-32.5228,-55.7658,990560,0,7518,983042
11/3/22,Uruguay,-32.5228,-55.7658,990560,0,7518,983042
11/4/22,Uruguay,-32.5228,-55.7658,990560,0,7518,983042
11/5/22,Uruguay,-32.5228,-55.7658,990560,0,7518,983042
11/6/22,Uruguay,-32.5228,-55.7658,990560,0,7518,983042
11/7/22,Uruguay,-32.5228,-55.7658,991219,0,7526,983693
11/8/22,Uruguay,-32.5228,-55.7658,991219,0,7526,983693
11/9/22,Uruguay,-32.5228,-55.7658,991219,0,7526,983693
11/10/22,Uruguay,-32.5228,-55.7658,991219,0,7526,983693
11/11/22,Uruguay,-32.5228,-55.7658,991219,0,7526,983693
11/12/22,Uruguay,-32.5228,-55.7658,991219,0,7526,983693
11/13/22,Uruguay,-32.5228,-55.7658,991219,0,7526,983693
11/14/22,Uruguay,-32.5228,-55.7658,992035,0,7529,984506
11/15/22,Uruguay,-32.5228,-55.7658,992035,0,7529,984506
11/16/22,Uruguay,-32.5228,-55.7658,992035,0,7529,984506
11/17/22,Uruguay,-32.5228,-55.7658,992035,0,7529,984506
11/18/22,Uruguay,-32.5228,-55.7658,992035,0,7529,984506
11/19/22,Uruguay,-32.5228,-55.7658,992035,0,7529,984506
11/20/22,Uruguay,-32.5228,-55.7658,992035,0,7529,984506
11/21/22,Uruguay,-32.5228,-55.7658,992887,0,7530,985357
11/22/22,Uruguay,-32.5228,-55.7658,992887,0,7530,985357
11/23/22,Uruguay,-32.5228,-55.7658,992887,0,7530,985357
11/24/22,Uruguay,-32.5228,-55.7658,992887,0,7530,985357
11/25/22,Uruguay,-32.5228,-55.7658,992887,0,7530,985357
11/26/22,Uruguay,-32.5228,-55.7658,992887,0,7530,985357
11/27/22,Uruguay,-32.5228,-55.7658,992887,0,7530,985357
11/28/22,Uruguay,-32.5228,-55.7658,993875,0,7537,986338
11/29/22,Uruguay,-32.5228,-55.7658,993875,0,7537,986338
11/30/22,Uruguay,-32.5228,-55.7658,993875,0,7537,986338
12/1/22,Uruguay,-32.5228,-55.7658,993875,0,7537,986338
12/2/22,Uruguay,-32.5228,-55.7658,993875,0,7537,986338
12/3/22,Uruguay,-32.5228,-55.7658,993875,0,7537,986338
12/4/22,Uruguay,-32.5228,-55.7658,993875,0,7537,986338
12/5/22,Uruguay,-32.5228,-55.7658,995402,0,7541,987861
12/6/22,Uruguay,-32.5228,-55.7658,995402,0,7541,987861
12/7/22,Uruguay,-32.5228,-55.7658,995402,0,7541,987861
12/8/22,Uruguay,-32.5228,-55.7658,995402,0,7541,987861
12/9/22,Uruguay,-32.5228,-55.7658,995402,0,7541,987861
12/10/22,Uruguay,-32.5228,-55.7658,995402,0,7541,987861
12/11/22,Uruguay,-32.5228,-55.7658,995402,0,7541,987861
12/12/22,Uruguay,-32.5228,-55.7658,998047,0,7548,990499
12/13/22,Uruguay,-32.5228,-55.7658,998047,0,7548,990499
12/14/22,Uruguay,-32.5228,-55.7658,998047,0,7548,990499
12/15/22,Uruguay,-32.5228,-55.7658,998047,0,7548,990499
12/16/22,Uruguay,-32.5228,-55.7658,998047,0,7548,990499
12/17/22,Uruguay,-32.5228,-55.7658,998047,0,7548,990499
1/1/22,US,39.810489,-98.555759,55096787,0,826015,54270772
1/2/22,US,39.810489,-98.555759,55393119,0,826421,54566698
1/3/22,US,39.810489,-98.555759,56436404,0,828325,55608079
1/4/22,US,39.810489,-98.555759,57264550,0,830656,56433894
1/5/22,US,39.810489,-98.555759,57940784,0,832888,57107896
1/6/22,US,39.810489,-98.555759,58784343,0,834983,57949360
1/7/22,US,39.810489,-98.555759,59663927,0,837422,58826505
1/8/22,US,39.810489,-98.555759,60071698,0,838293,59233405
1/9/22,US,39.810489,-98.555759,60565024,0,838912,59726112
1/10/22,US,39.810489,-98.555759,61920266,0,840966,61079300
1/11/22,US,39.810489,-98.555759,62705523,0,843488,61862035
1/12/22,US,39.810489,-98.555759,63559994,0,846337,62713657
1/13/22,US,39.810489,-98.555759,64424152,0,848897,63575255
1/14/22,US,39.810489,-98.555759,65303881,0,851693,64452188
1/15/22,US,39.810489,-98.555759,65719990,0,852701,64867289
1/16/22,US,39.810489,-98.555759,66206095,0,853463,65352632
1/17/22,US,39.810489,-98.555759,66865462,0,854499,66010963
1/18/22,US,39.810489,-98.555759,67998230,0,857239,67140991
1/19/22,US,39.810489,-98.555759,68909133,0,860719,68048414
1/20/22,US,39.810489,-98.555759,69638364,0,863650,68774714
1/21/22,US,39.810489,-98.555759,70465435,0,867040,69598395
1/22/22,US,39.810489,-98.555759,70773540,0,868070,69905470
1/23/22,US,39.810489,-98.555759,71143606,0,868807,70274799
1/24/22,US,39.810489,-98.555759,72054189,0,870987,71183202
1/25/22,US,39.810489,-98.555759,72546582,0,874143,71672439
1/26/22,US,39.810489,-98.555759,73224162,0,878010,72346152
1/27/22,US,39.810489,-98.555759,73727106,0,880631,72846475
1/28/22,US,39.810489,-98.555759,74340218,0,884722,73455496
1/29/22,US,39.810489,-98.555759,74521849,0,885932,73635917
1/30/22,US,39.810489,-98.555759,74722335,0,886417,73835918
1/31/22,US,39.810489,-98.555759,75258912,0,889024,74369888
2/1/22,US,39.810489,-98.555759,75585200,0,892381,74692819
2/2/22,US,39.810489,-98.555759,75912946,0,895969,75016977
2/3/22,US,39.810489,-98.555759,76186238,0,898452,75287786
2/4/22,US,39.810489,-98.555759,76541298,0,902574,75638724
2/5/22,US,39.810489,-98.555759,76629231,0,903499,75725732
2/6/22,US,39.810489,-98.555759,76713991,0,903965,75810026
2/7/22,US,39.810489,-98.555759,77057403,0,906854,76150549
2/8/22,US,39.810489,-98.555759,77271174,0,909855,76361319
2/9/22,US,39.810489,-98.555759,77458647,0,913191,76545456
2/10/22,US,39.810489,-98.555759,77629010,0,916442,76712568
2/11/22,US,39.810489,-98.555759,77837474,0,919145,76918329
2/12/22,US,39.810489,-98.555759,77890112,0,919967,76970145
2/13/22,US,39.810489,-98.555759,77949182,0,920549,77028633
2/14/22,US,39.810489,-98.555759,78116785,0,923731,77193054
2/15/22,US,39.810489,-98.555759,78227275,0,926338,77300937
2/16/22,US,39.810489,-98.555759,78341202,0,929521,77411681
2/17/22,US,39.810489,-98.555759,78441906,0,932473,77509433
2/18/22,US,39.810489,-98.555759,78585899,0,934976,77650923
2/19/22,US,39.810489,-98.555759,78617878,0,935662,77682216
2/20/22,US,39.810489,-98.555759,78641384,0,936108,77705276
2/21/22,US,39.810489,-98.555759,78721266,0,937024,77784242
2/22/22,US,39.810489,-98.555759,78810446,0,939197,77871249
2/23/22,US,39.810489,-98.555759,78894579,0,942289,77952290
2/24/22,US,39.810489,-98.555759,78961049,0,945244,78015805
2/25/22,US,39.810489,-98.555759,79034739,0,947325,78087414
2/26/22,US,39.810489,-98.555759,79082458,0,948087,78134371
2/27/22,US,39.810489,-98.555759,79100973,0,948312,78152661
2/28/22,US,39.810489,-98.555759,79197874,0,950454,78247420
3/1/22,US,39.810489,-98.555759,79244280,0,952222,78292058
3/2/22,US,39.810489,-98.555759,79297358,0,954314,78343044
3/3/22,US,39.810489,-98.555759,79345814,0,956022,78389792
3/4/22,US,39.810489,-98.555759,79404372,0,957781,78446591
3/5/22,US,39.810489,-98.555759,79419578,0,958090,78461488
3/6/22,US,39.810489,-98.555759,79432182,0,958304,78473878
3/7/22,US,39.810489,-98.555759,79485862,0,959981,78525881
3/8/22,US,39.810489,-98.555759,79515322,0,961400,78553922
3/9/22,US,39.810489,-98.555759,79552355,0,963424,78588931
3/10/22,US,39.810489,-98.555759,79598126,0,965196,78632930
3/11/22,US,39.810489,-98.555759,79646981,0,966856,78680125
3/12/22,US,39.810489,-98.555759,79657449,0,967135,78690314
3/13/22,US,39.810489,-98.555759,79668728,0,967328,78701400
3/14/22,US,39.810489,-98.555759,79703262,0,968640,78734622
3/15/22,US,39.810489,-98.555759,79726767,0,969722,78757045
3/16/22,US,39.810489,-98.555759,79778021,0,971571,78806450
3/17/22,US,39.810489,-98.555759,79830047,0,973068,78856979
3/18/22,US,39.810489,-98.555759,79861768,0,973884,78887884
3/19/22,US,39.810489,-98.555759,79872870,0,974169,78898701
3/20/22,US,39.810489,-98.555759,79884524,0,974257,78910267
3/21/22,US,39.810489,-98.555759,79925995,0,975541,78950454
3/22/22,US,39.810489,-98.555759,79947222,0,976316,78970906
3/23/22,US,39.810489,-98.555759,79987152,0,977957,79009195
3/24/22,US,39.810489,-98.555759,80029254,0,978823,79050431
3/25/22,US,39.810489,-98.555759,80073696,0,979443,79094253
3/26/22,US,39.810489,-98.555759,80083382,0,979594,79103788
3/27/22,US,39.810489,-98.555759,80095402,0,979655,79115747
3/28/22,US,39.810489,-98.555759,80133110,0,980674,79152436
3/29/22,US,39.810489,-98.555759,80156352,0,981662,79174690
3/30/22,US,39.810489,-98.555759,80194489,0,982831,79211658
3/31/22,US,39.810489,-98.555759,80238983,0,983349,79255634
4/1/22,US,39.810489,-98.555759,80270140,0,984179,79285961
4/2/22,US,39.810489,-98.555759,80282167,0,984337,79297830
4/3/22,US,39.810489,-98.555759,80287155,0,984397,79302758
4/4/22,US,39.810489,-98.555759,80325280,0,984991,79340289
4/5/22,US,39.810489,-98.555759,80350252,0,985503,79364749
4/6/22,US,39.810489,-98.555759,80390177,0,986631,79403546
4/7/22,US,39.810489,-98.555759,80439857,0,987466,79452391
4/8/22,US,39.810489,-98.555759,80513047,0,988106,79524941
4/9/22,US,39.810489,-98.555759,80526102,0,988251,79537851
4/10/22,US,39.810489,-98.555759,80535916,0,988281,79547635
4/11/22,US,39.810489,-98.555759,80574043,0,988616,79585427
4/12/22,US,39.810489,-98.555759,80609270,0,989210,79620060
4/13/22,US,39.810489,-98.555759,80659341,0,990364,79668977
4/14/22,US,39.810489,-98.555759,80713205,0,990887,79722318
4/15/22,US,39.810489,-98.555759,80747399,0,991327,79756072
4/16/22,US,39.810489,-98.555759,80760205,0,991381,79768824
4/17/22,US,39.810489,-98.555759,80768127,0,991392,79776735
4/18/22,US,39.810489,-98.555759,80827702,0,991649,79836053
4/19/22,US,39.810489,-98.555759,80866195,0,992089,79874106
4/20/22,US,39.810489,-98.555759,80933999,0,992995,79941004
4/21/22,US,39.810489,-98.555759,80994469,0,993396,80001073
4/22/22,US,39.810489,-98.555759,81083292,0,993920,80089372
4/23/22,US,39.810489,-98.555759,81103570,0,993974,80109596
4/24/22,US,39.810489,-98.555759,81117542,0,994006,80123536
4/25/22,US,39.810489,-98.555759,81185815,0,994273,80191542
4/26/22,US,39.810489,-98.555759,81230970,0,994593,80236377
4/27/22,US,39.810489,-98.555759,81320798,0,995397,80325401
4/28/22,US,39.810489,-98.555759,81397922,0,995809,80402113
4/29/22,US,39.810489,-98.555759,81459174,0,996232,80462942
4/30/22,US,39.810489,-98.555759,81483819,0,996347,80487472
5/1/22,US,39.810489,-98.555759,81501173,0,996370,80504803
5/2/22,US,39.810489,-98.555759,81595075,0,996665,80598410
5/3/22,US,39.810489,-98.555759,81645002,0,997114,80647888
5/4/22,US,39.810489,-98.555759,81757359,0,999066,80758293
5/5/22,US,39.810489,-98.555759,81845690,0,999366,80846324
5/6/22,US,39.810489,-98.555759,81974753,0,999747,80975006
5/7/22,US,39.810489,-98.555759,82003440,0,999935,81003505
5/8/22,US,39.810489,-98.555759,82010038,0,999965,81010073
5/9/22,US,39.810489,-98.555759,82139255,0,1000220,81139035
5/10/22,US,39.810489,-98.555759,82209977,0,1000547,81209430
5/11/22,US,39.810489,-98.555759,82371018,0,1001231,81369787
5/12/22,US,39.810489,-98.555759,82476489,0,1001533,81474956
5/13/22,US,39.810489,-98.555759,82563756,0,1001740,81562016
5/14/22,US,39.810489,-98.555759,82581877,0,1001800,81580077
5/15/22,US,39.810489,-98.555759,82614998,0,1001837,81613161
5/16/22,US,39.810489,-98.555759,82791964,0,1002084,81789880
5/17/22,US,39.810489,-98.555759,82877436,0,1002481,81874955
5/18/22,US,39.810489,-98.555759,83081318,0,1003452,82077866
5/19/22,US,39.810489,-98.555759,83216792,0,1003787,82213005
5/20/22,US,39.810489,-98.555759,83365578,0,1004205,82361373
5/21/22,US,39.810489,-98.555759,83393681,0,1004281,82389400
5/22/22,US,39.810489,-98.555759,83414441,0,1004325,82410116
5/23/22,US,39.810489,-98.555759,83556093,0,1004573,82551520
5/24/22,US,39.810489,-98.555759,83639961,0,1004916,82635045
5/25/22,US,39.810489,-98.555759,83850721,0,1006003,82844718
5/26/22,US,39.810489,-98.555759,83986039,0,1006359,82979680
5/27/22,US,39.810489,-98.555759,84094040,0,1006891,83087149
5/28/22,US,39.810489,-98.555759,84108238,0,1006930,83101308
5/29/22,US,39.810489,-98.555759,84115297,0,1006947,83108350
5/30/22,US,39.810489,-98.555759,84177757,0,1006989,83170768
5/31/22,US,39.810489,-98.555759,84345092,0,1007356,83337736
6/1/22,US,39.810489,-98.555759,84574050,0,1008033,83566017
6/2/22,US,39.810489,-98.555759,84696177,0,1008360,83687817
6/3/22,US,39.810489,-98.555759,84853169,0,1008760,83844409
6/4/22,US,39.810489,-98.555759,84881225,0,1008916,83872309
6/5/22,US,39.810489,-98.555759,84897508,0,1008950,83888558
6/6/22,US,39.810489,-98.555759,85057251,0,1009234,84048017
6/7/22,US,39.810489,-98.555759,85144133,0,1009709,84134424
6/8/22,US,39.810489,-98.555759,85343051,0,1010907,84332144
6/9/22,US,39.810489,-98.555759,85474677,0,1011204,84463473
6/10/22,US,39.810489,-98.555759,85580890,0,1011571,84569319
6/11/22,US,39.810489,-98.555759,85616125,0,1011680,84604445
6/12/22,US,39.810489,-98.555759,85633887,0,1011709,84622178
6/13/22,US,39.810489,-98.555759,85785645,0,1012000,84773645
6/14/22,US,39.810489,-98.555759,85875838,0,1012364,84863474
6/15/22,US,39.810489,-98.555759,86061002,0,1013072,85047930
6/16/22,US,39.810489,-98.555759,86190740,0,1013515,85177225
6/17/22,US,39.810489,-98.555759,86329583,0,1013834,85315749
6/18/22,US,39.810489,-98.555759,86347271,0,1013875,85333396
6/19/22,US,39.810489,-98.555759,86365334,0,1013929,85351405
6/20/22,US,39.810489,-98.555759,86461347,0,1014024,85447323
6/21/22,US,39.810489,-98.555759,86572728,0,1014480,85558248
6/22/22,US,39.810489,-98.555759,86758395,0,1015335,85743060
6/23/22,US,39.810489,-98.555759,86896793,0,1015716,85881077
6/24/22,US,39.810489,-98.555759,87013958,0,1016162,85997796
6/25/22,US,39.810489,-98.555759,87054866,0,1016311,86038555
6/26/22,US,39.810489,-98.555759,87077143,0,1016333,86060810
6/27/22,US,39.810489,-98.555759,87237381,0,1016632,86220749
6/28/22,US,39.810489,-98.555759,87335277,0,1017208,86318069
6/29/22,US,39.810489,-98.555759,87525548,0,1017935,86507613
6/30/22,US,39.810489,-98.555759,87692979,0,1017660,86675319
7/1/22,US,39.810489,-98.555759,87849832,0,1018162,86831670
7/2/22,US,39.810489,-98.555759,87870178,0,1018207,86851971
7/3/22,US,39.810489,-98.555759,87878622,0,1018214,86860408
7/4/22,US,39.810489,-98.555759,87954904,0,1018293,86936611
7/5/22,US,39.810489,-98.555759,88096809,0,1018755,87078054
7/6/22,US,39.810489,-98.555759,88297542,0,1019523,87278019
7/7/22,US,39.810489,-98.555759,88436380,0,1020596,87415784
7/8/22,US,39.810489,-98.555759,88574109,0,1021127,87552982
7/9/22,US,39.810489,-98.555759,88603098,0,1021176,87581922
7/10/22,US,39.810489,-98.555759,88627631,0,1021207,87606424
7/11/22,US,39.810489,-98.555759,88828919,0,1021677,87807242
7/12/22,US,39.810489,-98.555759,88977155,0,1022243,87954912
7/13/22,US,39.810489,-98.555759,89181827,0,1023219,88158608
7/14/22,US,39.810489,-98.555759,89356987,0,1023593,88333394
7/15/22,US,39.810489,-98.555759,89510170,0,1024103,88486067
7/16/22,US,39.810489,-98.555759,89549368,0,1024156,88525212
7/17/22,US,39.810489,-98.555759,89578979,0,1024210,88554769
7/18/22,US,39.810489,-98.555759,89744253,0,1024651,88719602
7/19/22,US,39.810489,-98.555759,89861533,0,1025283,88836250
7/20/22,US,39.810489,-98.555759,90078284,0,1026185,89052099
7/21/22,US,39.810489,-98.555759,90253737,0,1026682,89227055
7/22/22,US,39.810489,-98.555759,90385129,0,1027263,89357866
7/23/22,US,39.810489,-98.555759,90411463,0,1027334,89384129
7/24/22,US,39.810489,-98.555759,90434712,0,1027366,89407346
7/25/22,US,39.810489,-98.555759,90624669,0,1027792,89596877
7/26/22,US,39.810489,-98.555759,90756879,0,1028342,89728537
7/27/22,US,39.810489,-98.555759,90997007,0,1029297,89967710
7/28/22,US,39.810489,-98.555759,91174055,0,1029699,90144356
7/29/22,US,39.810489,-98.555759,91333299,0,1030324,90302975
7/30/22,US,39.810489,-98.555759,91349316,0,1030355,90318961
7/31/22,US,39.810489,-98.555759,91362314,0,1030368,90331946
8/1/22,US,39.810489,-98.555759,91532483,0,1030942,90501541
8/2/22,US,39.810489,-98.555759,91623457,0,1031452,90592005
8/3/22,US,39.810489,-98.555759,91824170,0,1032548,90791622
8/4/22,US,39.810489,-98.555759,92011296,0,1033170,90978126
8/5/22,US,39.810489,-98.555759,92117321,0,1033887,91083434
8/6/22,US,39.810489,-98.555759,92132298,0,1033928,91098370
8/7/22,US,39.810489,-98.555759,92144901,0,1033960,91110941
8/8/22,US,39.810489,-98.555759,92300574,0,1034461,91266113
8/9/22,US,39.810489,-98.555759,92400383,0,1035107,91365276
8/10/22,US,39.810489,-98.555759,92596905,0,1036053,91560852
8/11/22,US,39.810489,-98.555759,92759615,0,1036609,91723006
8/12/22,US,39.810489,-98.555759,92856352,0,1037266,91819086
8/13/22,US,39.810489,-98.555759,92940018,0,1037312,91902706
8/14/22,US,39.810489,-98.555759,92949761,0,1037329,91912432
8/15/22,US,39.810489,-98.555759,93072905,0,1037800,92035105
8/16/22,US,39.810489,-98.555759,93164787,0,1038311,92126476
8/17/22,US,39.810489,-98.555759,93301811,0,1039420,92262391
8/18/22,US,39.810489,-98.555759,93450814,0,1040028,92410786
8/19/22,US,39.810489,-98.555759,93528449,0,1040619,92487830
8/20/22,US,39.810489,-98.555759,93539505,0,1040665,92498840
8/21/22,US,39.810489,-98.555759,93549292,0,1040691,92508601
8/22/22,US,39.810489,-98.555759,93678486,0,1041203,92637283
8/23/22,US,39.810489,-98.555759,93777827,0,1041820,92736007
8/24/22,US,39.810489,-98.555759,93929694,0,1042785,92886909
8/25/22,US,39.810489,-98.555759,94069221,0,1043400,93025821
8/26/22,US,39.810489,-98.555759,94190264,0,1044104,93146160
8/27/22,US,39.810489,-98.555759,94202073,0,1044142,93157931
8/28/22,US,39.810489,-98.555759,94210572,0,1044160,93166412
8/29/22,US,39.810489,-98.555759,94316849,0,1044642,93272207
8/30/22,US,39.810489,-98.555759,94392737,0,1045046,93347691
8/31/22,US,39.810489,-98.555759,94547208,0,1046572,93500636
9/1/22,US,39.810489,-98.555759,94677239,0,1047253,93629986
9/2/22,US,39.810489,-98.555759,94741922,0,1047733,93694189
9/3/22,US,39.810489,-98.555759,94753310,0,1047771,93705539
9/4/22,US,39.810489,-98.555759,94760730,0,1047785,93712945
9/5/22,US,39.810489,-98.555759,94794329,0,1047874,93746455
9/6/22,US,39.810489,-98.555759,94907026,0,1048480,93858546
9/7/22,US,39.810489,-98.555759,95031066,0,1049283,93981783
9/8/22,US,39.810489,-98.555759,95138186,0,1049971,94088215
9/9/22,US,39.810489,-98.555759,95239003,0,1050518,94188485
9/10/22,US,39.810489,-98.555759,95249121,0,1050556,94198565
9/11/22,US,39.810489,-98.555759,95258105,0,1050577,94207528
9/12/22,US,39.810489,-98.555759,95327632,0,1051038,94276594
9/13/22,US,39.810489,-98.555759,95407358,0,1051558,94355800
9/14/22,US,39.810489,-98.555759,95511018,0,1052532,94458486
9/15/22,US,39.810489,-98.555759,95594382,0,1053203,94541179
9/16/22,US,39.810489,-98.555759,95650623,0,1053635,94596988
9/17/22,US,39.810489,-98.555759,95659159,0,1053669,94605490
9/18/22,US,39.810489,-98.555759,95664620,0,1053691,94610929
9/19/22,US,39.810489,-98.555759,95720419,0,1054090,94666329
9/20/22,US,39.810489,-98.555759,95789712,0,1054529,94735183
9/21/22,US,39.810489,-98.555759,95888150,0,1055522,94832628
9/22/22,US,39.810489,-98.555759,95969141,0,1056185,94912956
9/23/22,US,39.810489,-98.555759,96052439,0,1056612,94995827
9/24/22,US,39.810489,-98.555759,96062166,0,1056664,95005502
9/25/22,US,39.810489,-98.555759,96068880,0,1056682,95012198
9/26/22,US,39.810489,-98.555759,96114474,0,1057054,95057420
9/27/22,US,39.810489,-98.555759,96175489,0,1057502,95117987
9/28/22,US,39.810489,-98.555759,96262330,0,1058806,95203524
9/29/22,US,39.810489,-98.555759,96346704,0,1059499,95287205
9/30/22,US,39.810489,-98.555759,96380117,0,1059817,95320300
10/1/22,US,39.810489,-98.555759,96388020,0,1059852,95328168
10/2/22,US,39.810489,-98.555759,96393791,0,1059868,95333923
10/3/22,US,39.810489,-98.555759,96435097,0,1060161,95374936
10/4/22,US,39.810489,-98.555759,96490310,0,1060665,95429645
10/5/22,US,39.810489,-98.555759,96561571,0,1061732,95499839
10/6/22,US,39.810489,-98.555759,96622334,0,1062317,95560017
10/7/22,US,39.810489,-98.555759,96680543,0,1062717,95617826
10/8/22,US,39.810489,-98.555759,96688274,0,1062768,95625506
10/9/22,US,39.810489,-98.555759,96693795,0,1062779,95631016
10/10/22,US,39.810489,-98.555759,96716747,0,1062916,95653831
10/11/22,US,39.810489,-98.555759,96777451,0,1063525,95713926
10/12/22,US,39.810489,-98.555759,96842083,0,1064295,95777788
10/13/22,US,39.810489,-98.555759,96905455,0,1064957,95840498
10/14/22,US,39.810489,-98.555759,96932383,0,1065220,95867163
10/15/22,US,39.810489,-98.555759,96938373,0,1065262,95873111
10/16/22,US,39.810489,-98.555759,96945065,0,1065273,95879792
10/17/22,US,39.810489,-98.555759,96983864,0,1065609,95918255
10/18/22,US,39.810489,-98.555759,97027393,0,1066046,95961347
10/19/22,US,39.810489,-98.555759,97088751,0,1066803,96021948
10/20/22,US,39.810489,-98.555759,97145917,0,1067361,96078556
10/21/22,US,39.810489,-98.555759,97191876,0,1067942,96123934
10/22/22,US,39.810489,-98.555759,97197260,0,1067965,96129295
10/23/22,US,39.810489,-98.555759,97205777,0,1067977,96137800
10/24/22,US,39.810489,-98.555759,97244973,0,1068187,96176786
10/25/22,US,39.810489,-98.555759,97288607,0,1068622,96219985
10/26/22,US,39.810489,-98.555759,97360087,0,1069759,96290328
10/27/22,US,39.810489,-98.555759,97419170,0,1070314,96348856
10/28/22,US,39.810489,-98.555759,97449365,0,1070506,96378859
10/29/22,US,39.810489,-98.555759,97458366,0,1070541,96387825
10/30/22,US,39.810489,-98.555759,97461651,0,1070550,96391101
10/31/22,US,39.810489,-98.555759,97506379,0,1070682,96435697
11/1/22,US,39.810489,-98.555759,97555128,0,1071126,96484002
11/2/22,US,39.810489,-98.555759,97629029,0,1071897,96557132
11/3/22,US,39.810489,-98.555759,97699494,0,1072491,96627003
11/4/22,US,39.810489,-98.555759,97737947,0,1072845,96665102
11/5/22,US,39.810489,-98.555759,97743061,0,1072877,96670184
11/6/22,US,39.810489,-98.555759,97750997,0,1072894,96678103
11/7/22,US,39.810489,-98.555759,97791328,0,1073028,96718300
11/8/22,US,39.810489,-98.555759,97822493,0,1073248,96749245
11/9/22,US,39.810489,-98.555759,97919662,0,1074216,96845446
11/10/22,US,39.810489,-98.555759,97985626,0,1074743,96910883
11/11/22,US,39.810489,-98.555759,97998566,0,1074799,96923767
11/12/22,US,39.810489,-98.555759,98003637,0,1074803,96928834
11/13/22,US,39.810489,-98.555759,98006055,0,1074815,96931240
11/14/22,US,39.810489,-98.555759,98056060,0,1075066,96980994
11/15/22,US,39.810489,-98.555759,98115563,0,1075468,97040095
11/16/22,US,39.810489,-98.555759,98199923,0,1076335,97123588
11/17/22,US,39.810489,-98.555759,98253542,0,1076795,97176747
11/18/22,US,39.810489,-98.555759,98308780,0,1077301,97231479
11/19/22,US,39.810489,-98.555759,98313484,0,1077322,97236162
11/20/22,US,39.810489,-98.555759,98317141,0,1077339,97239802
11/21/22,US,39.810489,-98.555759,98361192,0,1077547,97283645
11/22/22,US,39.810489,-98.555759,98417060,0,1078109,97338951
11/23/22,US,39.810489,-98.555759,98530013,0,1079145,97450868
11/24/22,US,39.810489,-98.555759,98545963,0,1079273,97466690
11/25/22,US,39.810489,-98.555759,98567833,0,1079421,97488412
11/26/22,US,39.810489,-98.555759,98570626,0,1079431,97491195
11/27/22,US,39.810489,-98.555759,98576054,0,1079436,97496618
11/28/22,US,39.810489,-98.555759,98637310,0,1079729,97557581
11/29/22,US,39.810489,-98.555759,98703917,0,1080141,97623776
11/30/22,US,39.810489,-98.555759,98816146,0,1080720,97735426
12/1/22,US,39.810489,-98.555759,98905731,0,1081375,97824356
12/2/22,US,39.810489,-98.555759,98969291,0,1081677,97887614
12/3/22,US,39.810489,-98.555759,98975890,0,1081701,97894189
12/4/22,US,39.810489,-98.555759,98980936,0,1081707,97899229
12/5/22,US,39.810489,-98.555759,99037670,0,1081924,97955746
12/6/22,US,39.810489,-98.555759,99131868,0,1082524,98049344
12/7/22,US,39.810489,-98.555759,99276638,0,1083582,98193056
12/8/22,US,39.810489,-98.555759,99375020,0,1084394,98290626
12/9/22,US,39.810489,-98.555759,99411342,0,1084583,98326759
12/10/22,US,39.810489,-98.555759,99418063,0,1084601,98333462
12/11/22,US,39.810489,-98.555759,99423064,0,1084601,98338463
12/12/22,US,39.810489,-98.555759,99479969,0,1084813,98395156
12/13/22,US,39.810489,-98.555759,99570977,0,1085386,98485591
12/14/22,US,39.810489,-98.555759,99717573,0,1086302,98631271
12/15/22,US,39.810489,-98.555759,99827629,0,1087013,98740616
12/16/22,US,39.810489,-98.555759,99881898,0,1087398,98794500
12/17/22,US,39.810489,-98.555759,99887614,0,1087410,98800204
1/1/22,Uzbekistan,41.377491,64.585262,199030,0,1485,197545
1/2/22,Uzbekistan,41.377491,64.585262,199118,0,1485,197633
1/3/22,Uzbekistan,41.377491,64.585262,199182,0,1485,197697
1/4/22,Uzbekistan,41.377491,64.585262,199271,0,1485,197786
1/5/22,Uzbekistan,41.377491,64.585262,199361,0,1485,197876
1/6/22,Uzbekistan,41.377491,64.585262,199507,0,1485,198022
1/7/22,Uzbekistan,41.377491,64.585262,199758,0,1488,198270
1/8/22,Uzbekistan,41.377491,64.585262,199972,0,1492,198480
1/9/22,Uzbekistan,41.377491,64.585262,200341,0,1494,198847
1/10/22,Uzbekistan,41.377491,64.585262,200730,0,1497,199233
1/11/22,Uzbekistan,41.377491,64.585262,201155,0,1501,199654
1/12/22,Uzbekistan,41.377491,64.585262,202473,0,1508,200965
1/13/22,Uzbekistan,41.377491,64.585262,202473,0,1508,200965
1/14/22,Uzbekistan,41.377491,64.585262,203297,0,1511,201786
1/15/22,Uzbekistan,41.377491,64.585262,204173,0,1513,202660
1/16/22,Uzbekistan,41.377491,64.585262,205085,0,1515,203570
1/17/22,Uzbekistan,41.377491,64.585262,206122,0,1518,204604
1/18/22,Uzbekistan,41.377491,64.585262,207057,0,1522,205535
1/19/22,Uzbekistan,41.377491,64.585262,208271,0,1525,206746
1/20/22,Uzbekistan,41.377491,64.585262,209578,0,1529,208049
1/21/22,Uzbekistan,41.377491,64.585262,210899,0,1532,209367
1/22/22,Uzbekistan,41.377491,64.585262,212289,0,1536,210753
1/23/22,Uzbekistan,41.377491,64.585262,213767,0,1540,212227
1/24/22,Uzbekistan,41.377491,64.585262,215063,0,1542,213521
1/25/22,Uzbekistan,41.377491,64.585262,216186,0,1545,214641
1/26/22,Uzbekistan,41.377491,64.585262,217360,0,1549,215811
1/27/22,Uzbekistan,41.377491,64.585262,218477,0,1551,216926
1/28/22,Uzbekistan,41.377491,64.585262,219663,0,1554,218109
1/29/22,Uzbekistan,41.377491,64.585262,220815,0,1558,219257
1/30/22,Uzbekistan,41.377491,64.585262,221919,0,1561,220358
1/31/22,Uzbekistan,41.377491,64.585262,223008,0,1564,221444
2/1/22,Uzbekistan,41.377491,64.585262,224023,0,1568,222455
2/2/22,Uzbekistan,41.377491,64.585262,225110,0,1571,223539
2/3/22,Uzbekistan,41.377491,64.585262,226036,0,1575,224461
2/4/22,Uzbekistan,41.377491,64.585262,226997,0,1579,225418
2/5/22,Uzbekistan,41.377491,64.585262,227909,0,1581,226328
2/6/22,Uzbekistan,41.377491,64.585262,228796,0,1584,227212
2/7/22,Uzbekistan,41.377491,64.585262,229628,0,1586,228042
2/8/22,Uzbekistan,41.377491,64.585262,230401,0,1588,228813
2/9/22,Uzbekistan,41.377491,64.585262,231179,0,1592,229587
2/10/22,Uzbekistan,41.377491,64.585262,231871,0,1595,230276
2/11/22,Uzbekistan,41.377491,64.585262,232496,0,1597,230899
2/12/22,Uzbekistan,41.377491,64.585262,233000,0,1599,231401
2/13/22,Uzbekistan,41.377491,64.585262,233439,0,1601,231838
2/14/22,Uzbekistan,41.377491,64.585262,233761,0,1604,232157
2/15/22,Uzbekistan,41.377491,64.585262,234063,0,1607,232456
2/16/22,Uzbekistan,41.377491,64.585262,234359,0,1609,232750
2/17/22,Uzbekistan,41.377491,64.585262,234600,0,1612,232988
2/18/22,Uzbekistan,41.377491,64.585262,234872,0,1614,233258
2/19/22,Uzbekistan,41.377491,64.585262,235063,0,1617,233446
2/20/22,Uzbekistan,41.377491,64.585262,235267,0,1619,233648
2/21/22,Uzbekistan,41.377491,64.585262,235427,0,1621,233806
2/22/22,Uzbekistan,41.377491,64.585262,235602,0,1623,233979
2/23/22,Uzbekistan,41.377491,64.585262,235740,0,1624,234116
2/24/22,Uzbekistan,41.377491,64.585262,235880,0,1626,234254
2/25/22,Uzbekistan,41.377491,64.585262,236036,0,1628,234408
2/26/22,Uzbekistan,41.377491,64.585262,236174,0,1630,234544
2/27/22,Uzbekistan,41.377491,64.585262,236299,0,1633,234666
2/28/22,Uzbekistan,41.377491,64.585262,236405,0,1635,234770
3/1/22,Uzbekistan,41.377491,64.585262,236501,0,1636,234865
3/2/22,Uzbekistan,41.377491,64.585262,236596,0,1637,234959
3/3/22,Uzbekistan,41.377491,64.585262,236687,0,1637,235050
3/4/22,Uzbekistan,41.377491,64.585262,236771,0,1637,235134
3/5/22,Uzbekistan,41.377491,64.585262,236840,0,1637,235203
3/6/22,Uzbekistan,41.377491,64.585262,236899,0,1637,235262
3/7/22,Uzbekistan,41.377491,64.585262,236967,0,1637,235330
3/8/22,Uzbekistan,41.377491,64.585262,236994,0,1637,235357
3/9/22,Uzbekistan,41.377491,64.585262,237045,0,1637,235408
3/10/22,Uzbekistan,41.377491,64.585262,237059,0,1637,235422
3/11/22,Uzbekistan,41.377491,64.585262,237129,0,1637,235492
3/12/22,Uzbekistan,41.377491,64.585262,237169,0,1637,235532
3/13/22,Uzbekistan,41.377491,64.585262,237238,0,1637,235601
3/14/22,Uzbekistan,41.377491,64.585262,237260,0,1637,235623
3/15/22,Uzbekistan,41.377491,64.585262,237281,0,1637,235644
3/16/22,Uzbekistan,41.377491,64.585262,237341,0,1637,235704
3/17/22,Uzbekistan,41.377491,64.585262,237384,0,1637,235747
3/18/22,Uzbekistan,41.377491,64.585262,237414,0,1637,235777
3/19/22,Uzbekistan,41.377491,64.585262,237438,0,1637,235801
3/20/22,Uzbekistan,41.377491,64.585262,237476,0,1637,235839
3/21/22,Uzbekistan,41.377491,64.585262,237508,0,1637,235871
3/22/22,Uzbekistan,41.377491,64.585262,237520,0,1637,235883
3/23/22,Uzbekistan,41.377491,64.585262,237527,0,1637,235890
3/24/22,Uzbekistan,41.377491,64.585262,237533,0,1637,235896
3/25/22,Uzbekistan,41.377491,64.585262,237542,0,1637,235905
3/26/22,Uzbekistan,41.377491,64.585262,237589,0,1637,235952
3/27/22,Uzbekistan,41.377491,64.585262,237641,0,1637,236004
3/28/22,Uzbekistan,41.377491,64.585262,237679,0,1637,236042
3/29/22,Uzbekistan,41.377491,64.585262,237687,0,1637,236050
3/30/22,Uzbekistan,41.377491,64.585262,237710,0,1637,236073
3/31/22,Uzbekistan,41.377491,64.585262,237749,0,1637,236112
4/1/22,Uzbekistan,41.377491,64.585262,237787,0,1637,236150
4/2/22,Uzbekistan,41.377491,64.585262,237828,0,1637,236191
4/3/22,Uzbekistan,41.377491,64.585262,237853,0,1637,236216
4/4/22,Uzbekistan,41.377491,64.585262,237888,0,1637,236251
4/5/22,Uzbekistan,41.377491,64.585262,237906,0,1637,236269
4/6/22,Uzbekistan,41.377491,64.585262,237932,0,1637,236295
4/7/22,Uzbekistan,41.377491,64.585262,237967,0,1637,236330
4/8/22,Uzbekistan,41.377491,64.585262,237994,0,1637,236357
4/9/22,Uzbekistan,41.377491,64.585262,238040,0,1637,236403
4/10/22,Uzbekistan,41.377491,64.585262,238071,0,1637,236434
4/11/22,Uzbekistan,41.377491,64.585262,238088,0,1637,236451
4/12/22,Uzbekistan,41.377491,64.585262,238098,0,1637,236461
4/13/22,Uzbekistan,41.377491,64.585262,238176,0,1637,236539
4/14/22,Uzbekistan,41.377491,64.585262,238176,0,1637,236539
4/15/22,Uzbekistan,41.377491,64.585262,238214,0,1637,236577
4/16/22,Uzbekistan,41.377491,64.585262,238252,0,1637,236615
4/17/22,Uzbekistan,41.377491,64.585262,238288,0,1637,236651
4/18/22,Uzbekistan,41.377491,64.585262,238313,0,1637,236676
4/19/22,Uzbekistan,41.377491,64.585262,238321,0,1637,236684
4/20/22,Uzbekistan,41.377491,64.585262,238367,0,1637,236730
4/21/22,Uzbekistan,41.377491,64.585262,238401,0,1637,236764
4/22/22,Uzbekistan,41.377491,64.585262,238428,0,1637,236791
4/23/22,Uzbekistan,41.377491,64.585262,238442,0,1637,236805
4/24/22,Uzbekistan,41.377491,64.585262,238469,0,1637,236832
4/25/22,Uzbekistan,41.377491,64.585262,238503,0,1637,236866
4/26/22,Uzbekistan,41.377491,64.585262,238510,0,1637,236873
4/27/22,Uzbekistan,41.377491,64.585262,238535,0,1637,236898
4/28/22,Uzbekistan,41.377491,64.585262,238556,0,1637,236919
4/29/22,Uzbekistan,41.377491,64.585262,238577,0,1637,236940
4/30/22,Uzbekistan,41.377491,64.585262,238596,0,1637,236959
5/1/22,Uzbekistan,41.377491,64.585262,238596,0,1637,236959
5/2/22,Uzbekistan,41.377491,64.585262,238627,0,1637,236990
5/3/22,Uzbekistan,41.377491,64.585262,238628,0,1637,236991
5/4/22,Uzbekistan,41.377491,64.585262,238636,0,1637,236999
5/5/22,Uzbekistan,41.377491,64.585262,238651,0,1637,237014
5/6/22,Uzbekistan,41.377491,64.585262,238660,0,1637,237023
5/7/22,Uzbekistan,41.377491,64.585262,238695,0,1637,237058
5/8/22,Uzbekistan,41.377491,64.585262,238695,0,1637,237058
5/9/22,Uzbekistan,41.377491,64.585262,238736,0,1637,237099
5/10/22,Uzbekistan,41.377491,64.585262,238743,0,1637,237106
5/11/22,Uzbekistan,41.377491,64.585262,238747,0,1637,237110
5/12/22,Uzbekistan,41.377491,64.585262,238767,0,1637,237130
5/13/22,Uzbekistan,41.377491,64.585262,238778,0,1637,237141
5/14/22,Uzbekistan,41.377491,64.585262,238788,0,1637,237151
5/15/22,Uzbekistan,41.377491,64.585262,238802,0,1637,237165
5/16/22,Uzbekistan,41.377491,64.585262,238818,0,1637,237181
5/17/22,Uzbekistan,41.377491,64.585262,238824,0,1637,237187
5/18/22,Uzbekistan,41.377491,64.585262,238842,0,1637,237205
5/19/22,Uzbekistan,41.377491,64.585262,238855,0,1637,237218
5/20/22,Uzbekistan,41.377491,64.585262,238868,0,1637,237231
5/21/22,Uzbekistan,41.377491,64.585262,238910,0,1637,237273
5/22/22,Uzbekistan,41.377491,64.585262,238929,0,1637,237292
5/23/22,Uzbekistan,41.377491,64.585262,238940,0,1637,237303
5/24/22,Uzbekistan,41.377491,64.585262,238945,0,1637,237308
5/25/22,Uzbekistan,41.377491,64.585262,238964,0,1637,237327
5/26/22,Uzbekistan,41.377491,64.585262,238975,0,1637,237338
5/27/22,Uzbekistan,41.377491,64.585262,238983,0,1637,237346
5/28/22,Uzbekistan,41.377491,64.585262,238983,0,1637,237346
5/29/22,Uzbekistan,41.377491,64.585262,238983,0,1637,237346
5/30/22,Uzbekistan,41.377491,64.585262,239025,0,1637,237388
5/31/22,Uzbekistan,41.377491,64.585262,239028,0,1637,237391
6/1/22,Uzbekistan,41.377491,64.585262,239046,0,1637,237409
6/2/22,Uzbekistan,41.377491,64.585262,239059,0,1637,237422
6/3/22,Uzbekistan,41.377491,64.585262,239077,0,1637,237440
6/4/22,Uzbekistan,41.377491,64.585262,239092,0,1637,237455
6/5/22,Uzbekistan,41.377491,64.585262,239092,0,1637,237455
6/6/22,Uzbekistan,41.377491,64.585262,239135,0,1637,237498
6/7/22,Uzbekistan,41.377491,64.585262,239141,0,1637,237504
6/8/22,Uzbekistan,41.377491,64.585262,239159,0,1637,237522
6/9/22,Uzbekistan,41.377491,64.585262,239182,0,1637,237545
6/10/22,Uzbekistan,41.377491,64.585262,239203,0,1637,237566
6/11/22,Uzbekistan,41.377491,64.585262,239236,0,1637,237599
6/12/22,Uzbekistan,41.377491,64.585262,239236,0,1637,237599
6/13/22,Uzbekistan,41.377491,64.585262,239272,0,1637,237635
6/14/22,Uzbekistan,41.377491,64.585262,239280,0,1637,237643
6/15/22,Uzbekistan,41.377491,64.585262,239319,0,1637,237682
6/16/22,Uzbekistan,41.377491,64.585262,239376,0,1637,237739
6/17/22,Uzbekistan,41.377491,64.585262,239435,0,1637,237798
6/18/22,Uzbekistan,41.377491,64.585262,239525,0,1637,237888
6/19/22,Uzbekistan,41.377491,64.585262,239525,0,1637,237888
6/20/22,Uzbekistan,41.377491,64.585262,239726,0,1637,238089
6/21/22,Uzbekistan,41.377491,64.585262,239813,0,1637,238176
6/22/22,Uzbekistan,41.377491,64.585262,239895,0,1637,238258
6/23/22,Uzbekistan,41.377491,64.585262,239993,0,1637,238356
6/24/22,Uzbekistan,41.377491,64.585262,240087,0,1637,238450
6/25/22,Uzbekistan,41.377491,64.585262,240206,0,1637,238569
6/26/22,Uzbekistan,41.377491,64.585262,240345,0,1637,238708
6/27/22,Uzbekistan,41.377491,64.585262,240478,0,1637,238841
6/28/22,Uzbekistan,41.377491,64.585262,240569,0,1637,238932
6/29/22,Uzbekistan,41.377491,64.585262,240667,0,1637,239030
6/30/22,Uzbekistan,41.377491,64.585262,240764,0,1637,239127
7/1/22,Uzbekistan,41.377491,64.585262,240856,0,1637,239219
7/2/22,Uzbekistan,41.377491,64.585262,240945,0,1637,239308
7/3/22,Uzbekistan,41.377491,64.585262,241040,0,1637,239403
7/4/22,Uzbekistan,41.377491,64.585262,241122,0,1637,239485
7/5/22,Uzbekistan,41.377491,64.585262,241196,0,1637,239559
7/6/22,Uzbekistan,41.377491,64.585262,241283,0,1637,239646
7/7/22,Uzbekistan,41.377491,64.585262,241377,0,1637,239740
7/8/22,Uzbekistan,41.377491,64.585262,241468,0,1637,239831
7/9/22,Uzbekistan,41.377491,64.585262,241566,0,1637,239929
7/10/22,Uzbekistan,41.377491,64.585262,241655,0,1637,240018
7/11/22,Uzbekistan,41.377491,64.585262,241738,0,1637,240101
7/12/22,Uzbekistan,41.377491,64.585262,241814,0,1637,240177
7/13/22,Uzbekistan,41.377491,64.585262,241882,0,1637,240245
7/14/22,Uzbekistan,41.377491,64.585262,241953,0,1637,240316
7/15/22,Uzbekistan,41.377491,64.585262,242043,0,1637,240406
7/16/22,Uzbekistan,41.377491,64.585262,242140,0,1637,240503
7/17/22,Uzbekistan,41.377491,64.585262,242140,0,1637,240503
7/18/22,Uzbekistan,41.377491,64.585262,242305,0,1637,240668
7/19/22,Uzbekistan,41.377491,64.585262,242366,0,1637,240729
7/20/22,Uzbekistan,41.377491,64.585262,242437,0,1637,240800
7/21/22,Uzbekistan,41.377491,64.585262,242502,0,1637,240865
7/22/22,Uzbekistan,41.377491,64.585262,242570,0,1637,240933
7/23/22,Uzbekistan,41.377491,64.585262,242632,0,1637,240995
7/24/22,Uzbekistan,41.377491,64.585262,242691,0,1637,241054
7/25/22,Uzbekistan,41.377491,64.585262,242747,0,1637,241110
7/26/22,Uzbekistan,41.377491,64.585262,242811,0,1637,241174
7/27/22,Uzbekistan,41.377491,64.585262,242879,0,1637,241242
7/28/22,Uzbekistan,41.377491,64.585262,242944,0,1637,241307
7/29/22,Uzbekistan,41.377491,64.585262,243002,0,1637,241365
7/30/22,Uzbekistan,41.377491,64.585262,243051,0,1637,241414
7/31/22,Uzbekistan,41.377491,64.585262,243093,0,1637,241456
8/1/22,Uzbekistan,41.377491,64.585262,243131,0,1637,241494
8/2/22,Uzbekistan,41.377491,64.585262,243162,0,1637,241525
8/3/22,Uzbekistan,41.377491,64.585262,243195,0,1637,241558
8/4/22,Uzbekistan,41.377491,64.585262,243232,0,1637,241595
8/5/22,Uzbekistan,41.377491,64.585262,243256,0,1637,241619
8/6/22,Uzbekistan,41.377491,64.585262,243294,0,1637,241657
8/7/22,Uzbekistan,41.377491,64.585262,243328,0,1637,241691
8/8/22,Uzbekistan,41.377491,64.585262,243360,0,1637,241723
8/9/22,Uzbekistan,41.377491,64.585262,243388,0,1637,241751
8/10/22,Uzbekistan,41.377491,64.585262,243423,0,1637,241786
8/11/22,Uzbekistan,41.377491,64.585262,243460,0,1637,241823
8/12/22,Uzbekistan,41.377491,64.585262,243487,0,1637,241850
8/13/22,Uzbekistan,41.377491,64.585262,243509,0,1637,241872
8/14/22,Uzbekistan,41.377491,64.585262,243537,0,1637,241900
8/15/22,Uzbekistan,41.377491,64.585262,243562,0,1637,241925
8/16/22,Uzbekistan,41.377491,64.585262,243586,0,1637,241949
8/17/22,Uzbekistan,41.377491,64.585262,243605,0,1637,241968
8/18/22,Uzbekistan,41.377491,64.585262,243623,0,1637,241986
8/19/22,Uzbekistan,41.377491,64.585262,243638,0,1637,242001
8/20/22,Uzbekistan,41.377491,64.585262,243654,0,1637,242017
8/21/22,Uzbekistan,41.377491,64.585262,243666,0,1637,242029
8/22/22,Uzbekistan,41.377491,64.585262,243677,0,1637,242040
8/23/22,Uzbekistan,41.377491,64.585262,243691,0,1637,242054
8/24/22,Uzbekistan,41.377491,64.585262,243710,0,1637,242073
8/25/22,Uzbekistan,41.377491,64.585262,243728,0,1637,242091
8/26/22,Uzbekistan,41.377491,64.585262,243743,0,1637,242106
8/27/22,Uzbekistan,41.377491,64.585262,243743,0,1637,242106
8/28/22,Uzbekistan,41.377491,64.585262,243743,0,1637,242106
8/29/22,Uzbekistan,41.377491,64.585262,243743,0,1637,242106
8/30/22,Uzbekistan,41.377491,64.585262,243784,0,1637,242147
8/31/22,Uzbekistan,41.377491,64.585262,243801,0,1637,242164
9/1/22,Uzbekistan,41.377491,64.585262,243815,0,1637,242178
9/2/22,Uzbekistan,41.377491,64.585262,243830,0,1637,242193
9/3/22,Uzbekistan,41.377491,64.585262,243830,0,1637,242193
9/4/22,Uzbekistan,41.377491,64.585262,243830,0,1637,242193
9/5/22,Uzbekistan,41.377491,64.585262,243863,0,1637,242226
9/6/22,Uzbekistan,41.377491,64.585262,243879,0,1637,242242
9/7/22,Uzbekistan,41.377491,64.585262,243893,0,1637,242256
9/8/22,Uzbekistan,41.377491,64.585262,243893,0,1637,242256
9/9/22,Uzbekistan,41.377491,64.585262,243893,0,1637,242256
9/10/22,Uzbekistan,41.377491,64.585262,243893,0,1637,242256
9/11/22,Uzbekistan,41.377491,64.585262,243893,0,1637,242256
9/12/22,Uzbekistan,41.377491,64.585262,243970,0,1637,242333
9/13/22,Uzbekistan,41.377491,64.585262,243981,0,1637,242344
9/14/22,Uzbekistan,41.377491,64.585262,243993,0,1637,242356
9/15/22,Uzbekistan,41.377491,64.585262,244006,0,1637,242369
9/16/22,Uzbekistan,41.377491,64.585262,244023,0,1637,242386
9/17/22,Uzbekistan,41.377491,64.585262,244023,0,1637,242386
9/18/22,Uzbekistan,41.377491,64.585262,244023,0,1637,242386
9/19/22,Uzbekistan,41.377491,64.585262,244060,0,1637,242423
9/20/22,Uzbekistan,41.377491,64.585262,244072,0,1637,242435
9/21/22,Uzbekistan,41.377491,64.585262,244084,0,1637,242447
9/22/22,Uzbekistan,41.377491,64.585262,244105,0,1637,242468
9/23/22,Uzbekistan,41.377491,64.585262,244120,0,1637,242483
9/24/22,Uzbekistan,41.377491,64.585262,244120,0,1637,242483
9/25/22,Uzbekistan,41.377491,64.585262,244120,0,1637,242483
9/26/22,Uzbekistan,41.377491,64.585262,244160,0,1637,242523
9/27/22,Uzbekistan,41.377491,64.585262,244173,0,1637,242536
9/28/22,Uzbekistan,41.377491,64.585262,244186,0,1637,242549
9/29/22,Uzbekistan,41.377491,64.585262,244199,0,1637,242562
9/30/22,Uzbekistan,41.377491,64.585262,244218,0,1637,242581
10/1/22,Uzbekistan,41.377491,64.585262,244218,0,1637,242581
10/2/22,Uzbekistan,41.377491,64.585262,244218,0,1637,242581
10/3/22,Uzbekistan,41.377491,64.585262,244245,0,1637,242608
10/4/22,Uzbekistan,41.377491,64.585262,244257,0,1637,242620
10/5/22,Uzbekistan,41.377491,64.585262,244275,0,1637,242638
10/6/22,Uzbekistan,41.377491,64.585262,244285,0,1637,242648
10/7/22,Uzbekistan,41.377491,64.585262,244296,0,1637,242659
10/8/22,Uzbekistan,41.377491,64.585262,244296,0,1637,242659
10/9/22,Uzbekistan,41.377491,64.585262,244296,0,1637,242659
10/10/22,Uzbekistan,41.377491,64.585262,244334,0,1637,242697
10/11/22,Uzbekistan,41.377491,64.585262,244337,0,1637,242700
10/12/22,Uzbekistan,41.377491,64.585262,244350,0,1637,242713
10/13/22,Uzbekistan,41.377491,64.585262,244361,0,1637,242724
10/14/22,Uzbekistan,41.377491,64.585262,244382,0,1637,242745
10/15/22,Uzbekistan,41.377491,64.585262,244382,0,1637,242745
10/16/22,Uzbekistan,41.377491,64.585262,244382,0,1637,242745
10/17/22,Uzbekistan,41.377491,64.585262,244421,0,1637,242784
10/18/22,Uzbekistan,41.377491,64.585262,244421,0,1637,242784
10/19/22,Uzbekistan,41.377491,64.585262,244424,0,1637,242787
10/20/22,Uzbekistan,41.377491,64.585262,244436,0,1637,242799
10/21/22,Uzbekistan,41.377491,64.585262,244450,0,1637,242813
10/22/22,Uzbekistan,41.377491,64.585262,244450,0,1637,242813
10/23/22,Uzbekistan,41.377491,64.585262,244450,0,1637,242813
10/24/22,Uzbekistan,41.377491,64.585262,244500,0,1637,242863
10/25/22,Uzbekistan,41.377491,64.585262,244504,0,1637,242867
10/26/22,Uzbekistan,41.377491,64.585262,244523,0,1637,242886
10/27/22,Uzbekistan,41.377491,64.585262,244551,0,1637,242914
10/28/22,Uzbekistan,41.377491,64.585262,244572,0,1637,242935
10/29/22,Uzbekistan,41.377491,64.585262,244572,0,1637,242935
10/30/22,Uzbekistan,41.377491,64.585262,244572,0,1637,242935
10/31/22,Uzbekistan,41.377491,64.585262,244648,0,1637,243011
11/1/22,Uzbekistan,41.377491,64.585262,244648,0,1637,243011
11/2/22,Uzbekistan,41.377491,64.585262,244664,0,1637,243027
11/3/22,Uzbekistan,41.377491,64.585262,244716,0,1637,243079
11/4/22,Uzbekistan,41.377491,64.585262,244739,0,1637,243102
11/5/22,Uzbekistan,41.377491,64.585262,244739,0,1637,243102
11/6/22,Uzbekistan,41.377491,64.585262,244739,0,1637,243102
11/7/22,Uzbekistan,41.377491,64.585262,244827,0,1637,243190
11/8/22,Uzbekistan,41.377491,64.585262,244864,0,1637,243227
11/9/22,Uzbekistan,41.377491,64.585262,244878,0,1637,243241
11/10/22,Uzbekistan,41.377491,64.585262,244878,0,1637,243241
11/11/22,Uzbekistan,41.377491,64.585262,244878,0,1637,243241
11/12/22,Uzbekistan,41.377491,64.585262,244878,0,1637,243241
11/13/22,Uzbekistan,41.377491,64.585262,244878,0,1637,243241
11/14/22,Uzbekistan,41.377491,64.585262,245047,0,1637,243410
11/15/22,Uzbekistan,41.377491,64.585262,245068,0,1637,243431
11/16/22,Uzbekistan,41.377491,64.585262,245116,0,1637,243479
11/17/22,Uzbekistan,41.377491,64.585262,245177,0,1637,243540
11/18/22,Uzbekistan,41.377491,64.585262,245246,0,1637,243609
11/19/22,Uzbekistan,41.377491,64.585262,245246,0,1637,243609
11/20/22,Uzbekistan,41.377491,64.585262,245246,0,1637,243609
11/21/22,Uzbekistan,41.377491,64.585262,245508,0,1637,243871
11/22/22,Uzbekistan,41.377491,64.585262,245569,0,1637,243932
11/23/22,Uzbekistan,41.377491,64.585262,245665,0,1637,244028
11/24/22,Uzbekistan,41.377491,64.585262,245763,0,1637,244126
11/25/22,Uzbekistan,41.377491,64.585262,245858,0,1637,244221
11/26/22,Uzbekistan,41.377491,64.585262,245858,0,1637,244221
11/27/22,Uzbekistan,41.377491,64.585262,245858,0,1637,244221
11/28/22,Uzbekistan,41.377491,64.585262,246248,0,1637,244611
11/29/22,Uzbekistan,41.377491,64.585262,246379,0,1637,244742
11/30/22,Uzbekistan,41.377491,64.585262,246520,0,1637,244883
12/1/22,Uzbekistan,41.377491,64.585262,246674,0,1637,245037
12/2/22,Uzbekistan,41.377491,64.585262,246833,0,1637,245196
12/3/22,Uzbekistan,41.377491,64.585262,246833,0,1637,245196
12/4/22,Uzbekistan,41.377491,64.585262,246833,0,1637,245196
12/5/22,Uzbekistan,41.377491,64.585262,247304,0,1637,245667
12/6/22,Uzbekistan,41.377491,64.585262,247424,0,1637,245787
12/7/22,Uzbekistan,41.377491,64.585262,247581,0,1637,245944
12/8/22,Uzbekistan,41.377491,64.585262,247716,0,1637,246079
12/9/22,Uzbekistan,41.377491,64.585262,247838,0,1637,246201
12/10/22,Uzbekistan,41.377491,64.585262,247838,0,1637,246201
12/11/22,Uzbekistan,41.377491,64.585262,247838,0,1637,246201
12/12/22,Uzbekistan,41.377491,64.585262,248210,0,1637,246573
12/13/22,Uzbekistan,41.377491,64.585262,248268,0,1637,246631
12/14/22,Uzbekistan,41.377491,64.585262,248369,0,1637,246732
12/15/22,Uzbekistan,41.377491,64.585262,248503,0,1637,246866
12/16/22,Uzbekistan,41.377491,64.585262,248625,0,1637,246988
12/17/22,Uzbekistan,41.377491,64.585262,248625,0,1637,246988
1/1/22,Vanuatu,-15.3767,166.9592,7,0,1,6
1/2/22,Vanuatu,-15.3767,166.9592,7,0,1,6
1/3/22,Vanuatu,-15.3767,166.9592,7,0,1,6
1/4/22,Vanuatu,-15.3767,166.9592,7,0,1,6
1/5/22,Vanuatu,-15.3767,166.9592,7,0,1,6
1/6/22,Vanuatu,-15.3767,166.9592,7,0,1,6
1/7/22,Vanuatu,-15.3767,166.9592,7,0,1,6
1/8/22,Vanuatu,-15.3767,166.9592,7,0,1,6
1/9/22,Vanuatu,-15.3767,166.9592,7,0,1,6
1/10/22,Vanuatu,-15.3767,166.9592,7,0,1,6
1/11/22,Vanuatu,-15.3767,166.9592,7,0,1,6
1/12/22,Vanuatu,-15.3767,166.9592,7,0,1,6
1/13/22,Vanuatu,-15.3767,166.9592,7,0,1,6
1/14/22,Vanuatu,-15.3767,166.9592,7,0,1,6
1/15/22,Vanuatu,-15.3767,166.9592,7,0,1,6
1/16/22,Vanuatu,-15.3767,166.9592,7,0,1,6
1/17/22,Vanuatu,-15.3767,166.9592,7,0,1,6
1/18/22,Vanuatu,-15.3767,166.9592,7,0,1,6
1/19/22,Vanuatu,-15.3767,166.9592,7,0,1,6
1/20/22,Vanuatu,-15.3767,166.9592,7,0,1,6
1/21/22,Vanuatu,-15.3767,166.9592,7,0,1,6
1/22/22,Vanuatu,-15.3767,166.9592,7,0,1,6
1/23/22,Vanuatu,-15.3767,166.9592,7,0,1,6
1/24/22,Vanuatu,-15.3767,166.9592,7,0,1,6
1/25/22,Vanuatu,-15.3767,166.9592,7,0,1,6
1/26/22,Vanuatu,-15.3767,166.9592,7,0,1,6
1/27/22,Vanuatu,-15.3767,166.9592,7,0,1,6
1/28/22,Vanuatu,-15.3767,166.9592,7,0,1,6
1/29/22,Vanuatu,-15.3767,166.9592,7,0,1,6
1/30/22,Vanuatu,-15.3767,166.9592,7,0,1,6
1/31/22,Vanuatu,-15.3767,166.9592,7,0,1,6
2/1/22,Vanuatu,-15.3767,166.9592,7,0,1,6
2/2/22,Vanuatu,-15.3767,166.9592,7,0,1,6
2/3/22,Vanuatu,-15.3767,166.9592,7,0,1,6
2/4/22,Vanuatu,-15.3767,166.9592,7,0,1,6
2/5/22,Vanuatu,-15.3767,166.9592,7,0,1,6
2/6/22,Vanuatu,-15.3767,166.9592,7,0,1,6
2/7/22,Vanuatu,-15.3767,166.9592,7,0,1,6
2/8/22,Vanuatu,-15.3767,166.9592,7,0,1,6
2/9/22,Vanuatu,-15.3767,166.9592,7,0,1,6
2/10/22,Vanuatu,-15.3767,166.9592,7,0,1,6
2/11/22,Vanuatu,-15.3767,166.9592,7,0,1,6
2/12/22,Vanuatu,-15.3767,166.9592,7,0,1,6
2/13/22,Vanuatu,-15.3767,166.9592,7,0,1,6
2/14/22,Vanuatu,-15.3767,166.9592,7,0,1,6
2/15/22,Vanuatu,-15.3767,166.9592,7,0,1,6
2/16/22,Vanuatu,-15.3767,166.9592,7,0,1,6
2/17/22,Vanuatu,-15.3767,166.9592,7,0,1,6
2/18/22,Vanuatu,-15.3767,166.9592,7,0,1,6
2/19/22,Vanuatu,-15.3767,166.9592,11,0,1,10
2/20/22,Vanuatu,-15.3767,166.9592,11,0,1,10
2/21/22,Vanuatu,-15.3767,166.9592,15,0,1,14
2/22/22,Vanuatu,-15.3767,166.9592,15,0,1,14
2/23/22,Vanuatu,-15.3767,166.9592,15,0,1,14
2/24/22,Vanuatu,-15.3767,166.9592,18,0,1,17
2/25/22,Vanuatu,-15.3767,166.9592,18,0,1,17
2/26/22,Vanuatu,-15.3767,166.9592,18,0,1,17
2/27/22,Vanuatu,-15.3767,166.9592,18,0,1,17
2/28/22,Vanuatu,-15.3767,166.9592,18,0,1,17
3/1/22,Vanuatu,-15.3767,166.9592,18,0,1,17
3/2/22,Vanuatu,-15.3767,166.9592,18,0,1,17
3/3/22,Vanuatu,-15.3767,166.9592,18,0,1,17
3/4/22,Vanuatu,-15.3767,166.9592,18,0,1,17
3/5/22,Vanuatu,-15.3767,166.9592,18,0,1,17
3/6/22,Vanuatu,-15.3767,166.9592,18,0,1,17
3/7/22,Vanuatu,-15.3767,166.9592,42,0,1,41
3/8/22,Vanuatu,-15.3767,166.9592,52,0,1,51
3/9/22,Vanuatu,-15.3767,166.9592,95,0,1,94
3/10/22,Vanuatu,-15.3767,166.9592,102,0,1,101
3/11/22,Vanuatu,-15.3767,166.9592,164,0,1,163
3/12/22,Vanuatu,-15.3767,166.9592,207,0,1,206
3/13/22,Vanuatu,-15.3767,166.9592,207,0,1,206
3/14/22,Vanuatu,-15.3767,166.9592,259,0,1,258
3/15/22,Vanuatu,-15.3767,166.9592,341,0,1,340
3/16/22,Vanuatu,-15.3767,166.9592,386,0,1,385
3/17/22,Vanuatu,-15.3767,166.9592,473,0,1,472
3/18/22,Vanuatu,-15.3767,166.9592,480,0,1,479
3/19/22,Vanuatu,-15.3767,166.9592,480,0,1,479
3/20/22,Vanuatu,-15.3767,166.9592,753,0,1,752
3/21/22,Vanuatu,-15.3767,166.9592,1025,0,1,1024
3/22/22,Vanuatu,-15.3767,166.9592,1117,0,1,1116
3/23/22,Vanuatu,-15.3767,166.9592,1373,0,1,1372
3/24/22,Vanuatu,-15.3767,166.9592,1704,0,1,1703
3/25/22,Vanuatu,-15.3767,166.9592,1963,0,1,1962
3/26/22,Vanuatu,-15.3767,166.9592,2204,0,1,2203
3/27/22,Vanuatu,-15.3767,166.9592,2204,0,1,2203
3/28/22,Vanuatu,-15.3767,166.9592,2633,0,1,2632
3/29/22,Vanuatu,-15.3767,166.9592,2712,0,1,2711
3/30/22,Vanuatu,-15.3767,166.9592,3128,0,2,3126
3/31/22,Vanuatu,-15.3767,166.9592,3379,0,2,3377
4/1/22,Vanuatu,-15.3767,166.9592,3710,0,2,3708
4/2/22,Vanuatu,-15.3767,166.9592,3881,0,2,3879
4/3/22,Vanuatu,-15.3767,166.9592,4237,0,2,4235
4/4/22,Vanuatu,-15.3767,166.9592,4431,0,2,4429
4/5/22,Vanuatu,-15.3767,166.9592,4438,0,2,4436
4/6/22,Vanuatu,-15.3767,166.9592,4713,0,3,4710
4/7/22,Vanuatu,-15.3767,166.9592,4915,0,3,4912
4/8/22,Vanuatu,-15.3767,166.9592,4922,0,3,4919
4/9/22,Vanuatu,-15.3767,166.9592,5125,0,4,5121
4/10/22,Vanuatu,-15.3767,166.9592,5480,0,4,5476
4/11/22,Vanuatu,-15.3767,166.9592,5487,0,4,5483
4/12/22,Vanuatu,-15.3767,166.9592,5536,0,6,5530
4/13/22,Vanuatu,-15.3767,166.9592,5543,0,6,5537
4/14/22,Vanuatu,-15.3767,166.9592,5543,0,7,5536
4/15/22,Vanuatu,-15.3767,166.9592,6109,0,7,6102
4/16/22,Vanuatu,-15.3767,166.9592,6314,0,7,6307
4/17/22,Vanuatu,-15.3767,166.9592,6332,0,7,6325
4/18/22,Vanuatu,-15.3767,166.9592,6386,0,7,6379
4/19/22,Vanuatu,-15.3767,166.9592,6401,0,7,6394
4/20/22,Vanuatu,-15.3767,166.9592,6458,0,7,6451
4/21/22,Vanuatu,-15.3767,166.9592,6465,0,7,6458
4/22/22,Vanuatu,-15.3767,166.9592,6537,0,12,6525
4/23/22,Vanuatu,-15.3767,166.9592,6793,0,12,6781
4/24/22,Vanuatu,-15.3767,166.9592,6840,0,12,6828
4/25/22,Vanuatu,-15.3767,166.9592,6860,0,13,6847
4/26/22,Vanuatu,-15.3767,166.9592,6952,0,13,6939
4/27/22,Vanuatu,-15.3767,166.9592,7054,0,13,7041
4/28/22,Vanuatu,-15.3767,166.9592,7151,0,13,7138
4/29/22,Vanuatu,-15.3767,166.9592,7330,0,13,7317
4/30/22,Vanuatu,-15.3767,166.9592,7330,0,13,7317
5/1/22,Vanuatu,-15.3767,166.9592,7507,0,13,7494
5/2/22,Vanuatu,-15.3767,166.9592,7514,0,13,7501
5/3/22,Vanuatu,-15.3767,166.9592,7533,0,13,7520
5/4/22,Vanuatu,-15.3767,166.9592,7622,0,14,7608
5/5/22,Vanuatu,-15.3767,166.9592,7699,0,14,7685
5/6/22,Vanuatu,-15.3767,166.9592,7734,0,14,7720
5/7/22,Vanuatu,-15.3767,166.9592,7734,0,14,7720
5/8/22,Vanuatu,-15.3767,166.9592,7785,0,14,7771
5/9/22,Vanuatu,-15.3767,166.9592,8056,0,14,8042
5/10/22,Vanuatu,-15.3767,166.9592,8063,0,14,8049
5/11/22,Vanuatu,-15.3767,166.9592,8117,0,14,8103
5/12/22,Vanuatu,-15.3767,166.9592,8194,0,14,8180
5/13/22,Vanuatu,-15.3767,166.9592,8289,0,14,8275
5/14/22,Vanuatu,-15.3767,166.9592,8383,0,14,8369
5/15/22,Vanuatu,-15.3767,166.9592,8457,0,14,8443
5/16/22,Vanuatu,-15.3767,166.9592,8464,0,14,8450
5/17/22,Vanuatu,-15.3767,166.9592,8487,0,14,8473
5/18/22,Vanuatu,-15.3767,166.9592,8651,0,14,8637
5/19/22,Vanuatu,-15.3767,166.9592,8659,0,14,8645
5/20/22,Vanuatu,-15.3767,166.9592,8666,0,14,8652
5/21/22,Vanuatu,-15.3767,166.9592,8666,0,14,8652
5/22/22,Vanuatu,-15.3767,166.9592,8666,0,14,8652
5/23/22,Vanuatu,-15.3767,166.9592,8682,0,14,8668
5/24/22,Vanuatu,-15.3767,166.9592,8735,0,14,8721
5/25/22,Vanuatu,-15.3767,166.9592,8807,0,14,8793
5/26/22,Vanuatu,-15.3767,166.9592,8858,0,14,8844
5/27/22,Vanuatu,-15.3767,166.9592,8905,0,14,8891
5/28/22,Vanuatu,-15.3767,166.9592,8924,0,14,8910
5/29/22,Vanuatu,-15.3767,166.9592,9005,0,14,8991
5/30/22,Vanuatu,-15.3767,166.9592,9043,0,14,9029
5/31/22,Vanuatu,-15.3767,166.9592,9088,0,14,9074
6/1/22,Vanuatu,-15.3767,166.9592,9223,0,14,9209
6/2/22,Vanuatu,-15.3767,166.9592,9438,0,14,9424
6/3/22,Vanuatu,-15.3767,166.9592,9445,0,14,9431
6/4/22,Vanuatu,-15.3767,166.9592,9445,0,14,9431
6/5/22,Vanuatu,-15.3767,166.9592,9445,0,14,9431
6/6/22,Vanuatu,-15.3767,166.9592,10061,0,14,10047
6/7/22,Vanuatu,-15.3767,166.9592,10239,0,14,10225
6/8/22,Vanuatu,-15.3767,166.9592,10338,0,14,10324
6/9/22,Vanuatu,-15.3767,166.9592,10390,0,14,10376
6/10/22,Vanuatu,-15.3767,166.9592,10390,0,14,10376
6/11/22,Vanuatu,-15.3767,166.9592,10390,0,14,10376
6/12/22,Vanuatu,-15.3767,166.9592,10497,0,14,10483
6/13/22,Vanuatu,-15.3767,166.9592,10575,0,14,10561
6/14/22,Vanuatu,-15.3767,166.9592,10695,0,14,10681
6/15/22,Vanuatu,-15.3767,166.9592,10757,0,14,10743
6/16/22,Vanuatu,-15.3767,166.9592,10791,0,14,10777
6/17/22,Vanuatu,-15.3767,166.9592,10856,0,14,10842
6/18/22,Vanuatu,-15.3767,166.9592,10857,0,14,10843
6/19/22,Vanuatu,-15.3767,166.9592,10924,0,14,10910
6/20/22,Vanuatu,-15.3767,166.9592,10924,0,14,10910
6/21/22,Vanuatu,-15.3767,166.9592,10989,0,14,10975
6/22/22,Vanuatu,-15.3767,166.9592,11026,0,14,11012
6/23/22,Vanuatu,-15.3767,166.9592,11033,0,14,11019
6/24/22,Vanuatu,-15.3767,166.9592,11044,0,14,11030
6/25/22,Vanuatu,-15.3767,166.9592,11044,0,14,11030
6/26/22,Vanuatu,-15.3767,166.9592,11173,0,14,11159
6/27/22,Vanuatu,-15.3767,166.9592,11174,0,14,11160
6/28/22,Vanuatu,-15.3767,166.9592,11206,0,14,11192
6/29/22,Vanuatu,-15.3767,166.9592,11266,0,14,11252
6/30/22,Vanuatu,-15.3767,166.9592,11266,0,14,11252
7/1/22,Vanuatu,-15.3767,166.9592,11273,0,14,11259
7/2/22,Vanuatu,-15.3767,166.9592,11273,0,14,11259
7/3/22,Vanuatu,-15.3767,166.9592,11353,0,14,11339
7/4/22,Vanuatu,-15.3767,166.9592,11389,0,14,11375
7/5/22,Vanuatu,-15.3767,166.9592,11447,0,14,11433
7/6/22,Vanuatu,-15.3767,166.9592,11470,0,14,11456
7/7/22,Vanuatu,-15.3767,166.9592,11569,0,14,11555
7/8/22,Vanuatu,-15.3767,166.9592,11569,0,14,11555
7/9/22,Vanuatu,-15.3767,166.9592,11617,0,14,11603
7/10/22,Vanuatu,-15.3767,166.9592,11617,0,14,11603
7/11/22,Vanuatu,-15.3767,166.9592,11642,0,14,11628
7/12/22,Vanuatu,-15.3767,166.9592,11690,0,14,11676
7/13/22,Vanuatu,-15.3767,166.9592,11697,0,14,11683
7/14/22,Vanuatu,-15.3767,166.9592,11700,0,14,11686
7/15/22,Vanuatu,-15.3767,166.9592,11722,0,14,11708
7/16/22,Vanuatu,-15.3767,166.9592,11722,0,14,11708
7/17/22,Vanuatu,-15.3767,166.9592,11722,0,14,11708
7/18/22,Vanuatu,-15.3767,166.9592,11730,0,14,11716
7/19/22,Vanuatu,-15.3767,166.9592,11730,0,14,11716
7/20/22,Vanuatu,-15.3767,166.9592,11730,0,14,11716
7/21/22,Vanuatu,-15.3767,166.9592,11730,0,14,11716
7/22/22,Vanuatu,-15.3767,166.9592,11723,0,14,11709
7/23/22,Vanuatu,-15.3767,166.9592,11723,0,14,11709
7/24/22,Vanuatu,-15.3767,166.9592,11723,0,14,11709
7/25/22,Vanuatu,-15.3767,166.9592,11723,0,14,11709
7/26/22,Vanuatu,-15.3767,166.9592,11723,0,14,11709
7/27/22,Vanuatu,-15.3767,166.9592,11723,0,14,11709
7/28/22,Vanuatu,-15.3767,166.9592,11730,0,14,11716
7/29/22,Vanuatu,-15.3767,166.9592,11724,0,14,11710
7/30/22,Vanuatu,-15.3767,166.9592,11724,0,14,11710
7/31/22,Vanuatu,-15.3767,166.9592,11724,0,14,11710
8/1/22,Vanuatu,-15.3767,166.9592,11724,0,14,11710
8/2/22,Vanuatu,-15.3767,166.9592,11730,0,14,11716
8/3/22,Vanuatu,-15.3767,166.9592,11730,0,14,11716
8/4/22,Vanuatu,-15.3767,166.9592,11730,0,14,11716
8/5/22,Vanuatu,-15.3767,166.9592,11731,0,14,11717
8/6/22,Vanuatu,-15.3767,166.9592,11731,0,14,11717
8/7/22,Vanuatu,-15.3767,166.9592,11731,0,14,11717
8/8/22,Vanuatu,-15.3767,166.9592,11731,0,14,11717
8/9/22,Vanuatu,-15.3767,166.9592,11731,0,14,11717
8/10/22,Vanuatu,-15.3767,166.9592,11731,0,14,11717
8/11/22,Vanuatu,-15.3767,166.9592,11731,0,14,11717
8/12/22,Vanuatu,-15.3767,166.9592,11734,0,14,11720
8/13/22,Vanuatu,-15.3767,166.9592,11746,0,14,11732
8/14/22,Vanuatu,-15.3767,166.9592,11746,0,14,11732
8/15/22,Vanuatu,-15.3767,166.9592,11753,0,14,11739
8/16/22,Vanuatu,-15.3767,166.9592,11753,0,14,11739
8/17/22,Vanuatu,-15.3767,166.9592,11753,0,14,11739
8/18/22,Vanuatu,-15.3767,166.9592,11753,0,14,11739
8/19/22,Vanuatu,-15.3767,166.9592,11770,0,14,11756
8/20/22,Vanuatu,-15.3767,166.9592,11770,0,14,11756
8/21/22,Vanuatu,-15.3767,166.9592,11770,0,14,11756
8/22/22,Vanuatu,-15.3767,166.9592,11770,0,14,11756
8/23/22,Vanuatu,-15.3767,166.9592,11770,0,14,11756
8/24/22,Vanuatu,-15.3767,166.9592,11777,0,14,11763
8/25/22,Vanuatu,-15.3767,166.9592,11777,0,14,11763
8/26/22,Vanuatu,-15.3767,166.9592,11784,0,14,11770
8/27/22,Vanuatu,-15.3767,166.9592,11784,0,14,11770
8/28/22,Vanuatu,-15.3767,166.9592,11784,0,14,11770
8/29/22,Vanuatu,-15.3767,166.9592,11793,0,14,11779
8/30/22,Vanuatu,-15.3767,166.9592,11793,0,14,11779
8/31/22,Vanuatu,-15.3767,166.9592,11815,0,14,11801
9/1/22,Vanuatu,-15.3767,166.9592,11825,0,14,11811
9/2/22,Vanuatu,-15.3767,166.9592,11836,0,14,11822
9/3/22,Vanuatu,-15.3767,166.9592,11836,0,14,11822
9/4/22,Vanuatu,-15.3767,166.9592,11836,0,14,11822
9/5/22,Vanuatu,-15.3767,166.9592,11864,0,14,11850
9/6/22,Vanuatu,-15.3767,166.9592,11892,0,14,11878
9/7/22,Vanuatu,-15.3767,166.9592,11902,0,14,11888
9/8/22,Vanuatu,-15.3767,166.9592,11902,0,14,11888
9/9/22,Vanuatu,-15.3767,166.9592,11908,0,14,11894
9/10/22,Vanuatu,-15.3767,166.9592,11908,0,14,11894
9/11/22,Vanuatu,-15.3767,166.9592,11908,0,14,11894
9/12/22,Vanuatu,-15.3767,166.9592,11921,0,14,11907
9/13/22,Vanuatu,-15.3767,166.9592,11921,0,14,11907
9/14/22,Vanuatu,-15.3767,166.9592,11930,0,14,11916
9/15/22,Vanuatu,-15.3767,166.9592,11930,0,14,11916
9/16/22,Vanuatu,-15.3767,166.9592,11937,0,14,11923
9/17/22,Vanuatu,-15.3767,166.9592,11937,0,14,11923
9/18/22,Vanuatu,-15.3767,166.9592,11937,0,14,11923
9/19/22,Vanuatu,-15.3767,166.9592,11950,0,14,11936
9/20/22,Vanuatu,-15.3767,166.9592,11950,0,14,11936
9/21/22,Vanuatu,-15.3767,166.9592,11950,0,14,11936
9/22/22,Vanuatu,-15.3767,166.9592,11950,0,14,11936
9/23/22,Vanuatu,-15.3767,166.9592,11950,0,14,11936
9/24/22,Vanuatu,-15.3767,166.9592,11950,0,14,11936
9/25/22,Vanuatu,-15.3767,166.9592,11950,0,14,11936
9/26/22,Vanuatu,-15.3767,166.9592,11950,0,14,11936
9/27/22,Vanuatu,-15.3767,166.9592,11950,0,14,11936
9/28/22,Vanuatu,-15.3767,166.9592,11950,0,14,11936
9/29/22,Vanuatu,-15.3767,166.9592,11950,0,14,11936
9/30/22,Vanuatu,-15.3767,166.9592,11950,0,14,11936
10/1/22,Vanuatu,-15.3767,166.9592,11950,0,14,11936
10/2/22,Vanuatu,-15.3767,166.9592,11950,0,14,11936
10/3/22,Vanuatu,-15.3767,166.9592,11974,0,14,11960
10/4/22,Vanuatu,-15.3767,166.9592,11974,0,14,11960
10/5/22,Vanuatu,-15.3767,166.9592,11974,0,14,11960
10/6/22,Vanuatu,-15.3767,166.9592,11974,0,14,11960
10/7/22,Vanuatu,-15.3767,166.9592,11974,0,14,11960
10/8/22,Vanuatu,-15.3767,166.9592,11974,0,14,11960
10/9/22,Vanuatu,-15.3767,166.9592,11974,0,14,11960
10/10/22,Vanuatu,-15.3767,166.9592,11976,0,14,11962
10/11/22,Vanuatu,-15.3767,166.9592,11976,0,14,11962
10/12/22,Vanuatu,-15.3767,166.9592,11976,0,14,11962
10/13/22,Vanuatu,-15.3767,166.9592,11976,0,14,11962
10/14/22,Vanuatu,-15.3767,166.9592,11976,0,14,11962
10/15/22,Vanuatu,-15.3767,166.9592,11976,0,14,11962
10/16/22,Vanuatu,-15.3767,166.9592,11976,0,14,11962
10/17/22,Vanuatu,-15.3767,166.9592,11976,0,14,11962
10/18/22,Vanuatu,-15.3767,166.9592,11976,0,14,11962
10/19/22,Vanuatu,-15.3767,166.9592,11976,0,14,11962
10/20/22,Vanuatu,-15.3767,166.9592,11976,0,14,11962
10/21/22,Vanuatu,-15.3767,166.9592,11976,0,14,11962
10/22/22,Vanuatu,-15.3767,166.9592,11976,0,14,11962
10/23/22,Vanuatu,-15.3767,166.9592,11976,0,14,11962
10/24/22,Vanuatu,-15.3767,166.9592,11976,0,14,11962
10/25/22,Vanuatu,-15.3767,166.9592,11981,0,14,11967
10/26/22,Vanuatu,-15.3767,166.9592,11981,0,14,11967
10/27/22,Vanuatu,-15.3767,166.9592,11981,0,14,11967
10/28/22,Vanuatu,-15.3767,166.9592,11981,0,14,11967
10/29/22,Vanuatu,-15.3767,166.9592,11981,0,14,11967
10/30/22,Vanuatu,-15.3767,166.9592,11981,0,14,11967
10/31/22,Vanuatu,-15.3767,166.9592,11981,0,14,11967
11/1/22,Vanuatu,-15.3767,166.9592,11981,0,14,11967
11/2/22,Vanuatu,-15.3767,166.9592,11981,0,14,11967
11/3/22,Vanuatu,-15.3767,166.9592,11981,0,14,11967
11/4/22,Vanuatu,-15.3767,166.9592,11981,0,14,11967
11/5/22,Vanuatu,-15.3767,166.9592,11981,0,14,11967
11/6/22,Vanuatu,-15.3767,166.9592,11981,0,14,11967
11/7/22,Vanuatu,-15.3767,166.9592,11981,0,14,11967
11/8/22,Vanuatu,-15.3767,166.9592,11981,0,14,11967
11/9/22,Vanuatu,-15.3767,166.9592,11981,0,14,11967
11/10/22,Vanuatu,-15.3767,166.9592,11981,0,14,11967
11/11/22,Vanuatu,-15.3767,166.9592,11981,0,14,11967
11/12/22,Vanuatu,-15.3767,166.9592,11981,0,14,11967
11/13/22,Vanuatu,-15.3767,166.9592,11981,0,14,11967
11/14/22,Vanuatu,-15.3767,166.9592,11981,0,14,11967
11/15/22,Vanuatu,-15.3767,166.9592,11981,0,14,11967
11/16/22,Vanuatu,-15.3767,166.9592,11981,0,14,11967
11/17/22,Vanuatu,-15.3767,166.9592,11981,0,14,11967
11/18/22,Vanuatu,-15.3767,166.9592,11981,0,14,11967
11/19/22,Vanuatu,-15.3767,166.9592,11981,0,14,11967
11/20/22,Vanuatu,-15.3767,166.9592,11981,0,14,11967
11/21/22,Vanuatu,-15.3767,166.9592,11981,0,14,11967
11/22/22,Vanuatu,-15.3767,166.9592,11981,0,14,11967
11/23/22,Vanuatu,-15.3767,166.9592,11981,0,14,11967
11/24/22,Vanuatu,-15.3767,166.9592,11981,0,14,11967
11/25/22,Vanuatu,-15.3767,166.9592,11981,0,14,11967
11/26/22,Vanuatu,-15.3767,166.9592,11981,0,14,11967
11/27/22,Vanuatu,-15.3767,166.9592,11981,0,14,11967
11/28/22,Vanuatu,-15.3767,166.9592,11981,0,14,11967
11/29/22,Vanuatu,-15.3767,166.9592,11981,0,14,11967
11/30/22,Vanuatu,-15.3767,166.9592,11981,0,14,11967
12/1/22,Vanuatu,-15.3767,166.9592,11981,0,14,11967
12/2/22,Vanuatu,-15.3767,166.9592,11981,0,14,11967
12/3/22,Vanuatu,-15.3767,166.9592,11981,0,14,11967
12/4/22,Vanuatu,-15.3767,166.9592,11981,0,14,11967
12/5/22,Vanuatu,-15.3767,166.9592,11981,0,14,11967
12/6/22,Vanuatu,-15.3767,166.9592,11981,0,14,11967
12/7/22,Vanuatu,-15.3767,166.9592,11981,0,14,11967
12/8/22,Vanuatu,-15.3767,166.9592,11981,0,14,11967
12/9/22,Vanuatu,-15.3767,166.9592,11981,0,14,11967
12/10/22,Vanuatu,-15.3767,166.9592,11981,0,14,11967
12/11/22,Vanuatu,-15.3767,166.9592,11981,0,14,11967
12/12/22,Vanuatu,-15.3767,166.9592,11981,0,14,11967
12/13/22,Vanuatu,-15.3767,166.9592,11981,0,14,11967
12/14/22,Vanuatu,-15.3767,166.9592,11981,0,14,11967
12/15/22,Vanuatu,-15.3767,166.9592,11981,0,14,11967
12/16/22,Vanuatu,-15.3767,166.9592,11981,0,14,11967
12/17/22,Vanuatu,-15.3767,166.9592,11981,0,14,11967
1/1/22,Venezuela,6.4238,-66.5897,444828,0,5331,439497
1/2/22,Venezuela,6.4238,-66.5897,444972,0,5333,439639
1/3/22,Venezuela,6.4238,-66.5897,445082,0,5335,439747
1/4/22,Venezuela,6.4238,-66.5897,445369,0,5337,440032
1/5/22,Venezuela,6.4238,-66.5897,445680,0,5341,440339
1/6/22,Venezuela,6.4238,-66.5897,445680,0,5341,440339
1/7/22,Venezuela,6.4238,-66.5897,446026,0,5345,440681
1/8/22,Venezuela,6.4238,-66.5897,446427,0,5348,441079
1/9/22,Venezuela,6.4238,-66.5897,447288,0,5357,441931
1/10/22,Venezuela,6.4238,-66.5897,447288,0,5357,441931
1/11/22,Venezuela,6.4238,-66.5897,447865,0,5361,442504
1/12/22,Venezuela,6.4238,-66.5897,449730,0,5370,444360
1/13/22,Venezuela,6.4238,-66.5897,449730,0,5370,444360
1/14/22,Venezuela,6.4238,-66.5897,452430,0,5376,447054
1/15/22,Venezuela,6.4238,-66.5897,452430,0,5376,447054
1/16/22,Venezuela,6.4238,-66.5897,455023,0,5380,449643
1/17/22,Venezuela,6.4238,-66.5897,456641,0,5383,451258
1/18/22,Venezuela,6.4238,-66.5897,456641,0,5383,451258
1/19/22,Venezuela,6.4238,-66.5897,461059,0,5392,455667
1/20/22,Venezuela,6.4238,-66.5897,463145,0,5395,457750
1/21/22,Venezuela,6.4238,-66.5897,465463,0,5399,460064
1/22/22,Venezuela,6.4238,-66.5897,467864,0,5402,462462
1/23/22,Venezuela,6.4238,-66.5897,469566,0,5405,464161
1/24/22,Venezuela,6.4238,-66.5897,469566,0,5405,464161
1/25/22,Venezuela,6.4238,-66.5897,471389,0,5410,465979
1/26/22,Venezuela,6.4238,-66.5897,475135,0,5419,469716
1/27/22,Venezuela,6.4238,-66.5897,477022,0,5425,471597
1/28/22,Venezuela,6.4238,-66.5897,479011,0,5430,473581
1/29/22,Venezuela,6.4238,-66.5897,481375,0,5436,475939
1/30/22,Venezuela,6.4238,-66.5897,484021,0,5440,478581
1/31/22,Venezuela,6.4238,-66.5897,485974,0,5447,480527
2/1/22,Venezuela,6.4238,-66.5897,485974,0,5447,480527
2/2/22,Venezuela,6.4238,-66.5897,487775,0,5454,482321
2/3/22,Venezuela,6.4238,-66.5897,491016,0,5469,485547
2/4/22,Venezuela,6.4238,-66.5897,492678,0,5474,487204
2/5/22,Venezuela,6.4238,-66.5897,494835,0,5481,489354
2/6/22,Venezuela,6.4238,-66.5897,496283,0,5487,490796
2/7/22,Venezuela,6.4238,-66.5897,496283,0,5487,490796
2/8/22,Venezuela,6.4238,-66.5897,497977,0,5495,492482
2/9/22,Venezuela,6.4238,-66.5897,499537,0,5504,494033
2/10/22,Venezuela,6.4238,-66.5897,501586,0,5521,496065
2/11/22,Venezuela,6.4238,-66.5897,501586,0,5521,496065
2/12/22,Venezuela,6.4238,-66.5897,503162,0,5529,497633
2/13/22,Venezuela,6.4238,-66.5897,504719,0,5538,499181
2/14/22,Venezuela,6.4238,-66.5897,505947,0,5549,500398
2/15/22,Venezuela,6.4238,-66.5897,506977,0,5556,501421
2/16/22,Venezuela,6.4238,-66.5897,508042,0,5564,502478
2/17/22,Venezuela,6.4238,-66.5897,508968,0,5572,503396
2/18/22,Venezuela,6.4238,-66.5897,509947,0,5591,504356
2/19/22,Venezuela,6.4238,-66.5897,510553,0,5602,504951
2/20/22,Venezuela,6.4238,-66.5897,510553,0,5602,504951
2/21/22,Venezuela,6.4238,-66.5897,511073,0,5609,505464
2/22/22,Venezuela,6.4238,-66.5897,511772,0,5616,506156
2/23/22,Venezuela,6.4238,-66.5897,512560,0,5624,506936
2/24/22,Venezuela,6.4238,-66.5897,512947,0,5625,507322
2/25/22,Venezuela,6.4238,-66.5897,513427,0,5628,507799
2/26/22,Venezuela,6.4238,-66.5897,514315,0,5631,508684
2/27/22,Venezuela,6.4238,-66.5897,514315,0,5631,508684
2/28/22,Venezuela,6.4238,-66.5897,515124,0,5636,509488
3/1/22,Venezuela,6.4238,-66.5897,515124,0,5636,509488
3/2/22,Venezuela,6.4238,-66.5897,515582,0,5639,509943
3/3/22,Venezuela,6.4238,-66.5897,515943,0,5643,510300
3/4/22,Venezuela,6.4238,-66.5897,516236,0,5645,510591
3/5/22,Venezuela,6.4238,-66.5897,516578,0,5647,510931
3/6/22,Venezuela,6.4238,-66.5897,516817,0,5649,511168
3/7/22,Venezuela,6.4238,-66.5897,516817,0,5649,511168
3/8/22,Venezuela,6.4238,-66.5897,516966,0,5650,511316
3/9/22,Venezuela,6.4238,-66.5897,517164,0,5652,511512
3/10/22,Venezuela,6.4238,-66.5897,517720,0,5655,512065
3/11/22,Venezuela,6.4238,-66.5897,517720,0,5655,512065
3/12/22,Venezuela,6.4238,-66.5897,517999,0,5656,512343
3/13/22,Venezuela,6.4238,-66.5897,518410,0,5658,512752
3/14/22,Venezuela,6.4238,-66.5897,518410,0,5658,512752
3/15/22,Venezuela,6.4238,-66.5897,518460,0,5659,512801
3/16/22,Venezuela,6.4238,-66.5897,519059,0,5663,513396
3/17/22,Venezuela,6.4238,-66.5897,519059,0,5663,513396
3/18/22,Venezuela,6.4238,-66.5897,519245,0,5664,513581
3/19/22,Venezuela,6.4238,-66.5897,519420,0,5666,513754
3/20/22,Venezuela,6.4238,-66.5897,519670,0,5668,514002
3/21/22,Venezuela,6.4238,-66.5897,519724,0,5670,514054
3/22/22,Venezuela,6.4238,-66.5897,519797,0,5671,514126
3/23/22,Venezuela,6.4238,-66.5897,519797,0,5671,514126
3/24/22,Venezuela,6.4238,-66.5897,519872,0,5673,514199
3/25/22,Venezuela,6.4238,-66.5897,520038,0,5676,514362
3/26/22,Venezuela,6.4238,-66.5897,520077,0,5677,514400
3/27/22,Venezuela,6.4238,-66.5897,520113,0,5679,514434
3/28/22,Venezuela,6.4238,-66.5897,520169,0,5680,514489
3/29/22,Venezuela,6.4238,-66.5897,520169,0,5680,514489
3/30/22,Venezuela,6.4238,-66.5897,520373,0,5682,514691
3/31/22,Venezuela,6.4238,-66.5897,520373,0,5682,514691
4/1/22,Venezuela,6.4238,-66.5897,520497,0,5683,514814
4/2/22,Venezuela,6.4238,-66.5897,520708,0,5685,515023
4/3/22,Venezuela,6.4238,-66.5897,520843,0,5686,515157
4/4/22,Venezuela,6.4238,-66.5897,520905,0,5687,515218
4/5/22,Venezuela,6.4238,-66.5897,521030,0,5688,515342
4/6/22,Venezuela,6.4238,-66.5897,521105,0,5689,515416
4/7/22,Venezuela,6.4238,-66.5897,521186,0,5691,515495
4/8/22,Venezuela,6.4238,-66.5897,521325,0,5692,515633
4/9/22,Venezuela,6.4238,-66.5897,521373,0,5693,515680
4/10/22,Venezuela,6.4238,-66.5897,521471,0,5695,515776
4/11/22,Venezuela,6.4238,-66.5897,521471,0,5695,515776
4/12/22,Venezuela,6.4238,-66.5897,521546,0,5696,515850
4/13/22,Venezuela,6.4238,-66.5897,521714,0,5698,516016
4/14/22,Venezuela,6.4238,-66.5897,521880,0,5699,516181
4/15/22,Venezuela,6.4238,-66.5897,521946,0,5700,516246
4/16/22,Venezuela,6.4238,-66.5897,522034,0,5701,516333
4/17/22,Venezuela,6.4238,-66.5897,522042,0,5701,516341
4/18/22,Venezuela,6.4238,-66.5897,522049,0,5702,516347
4/19/22,Venezuela,6.4238,-66.5897,522055,0,5703,516352
4/20/22,Venezuela,6.4238,-66.5897,522056,0,5704,516352
4/21/22,Venezuela,6.4238,-66.5897,522056,0,5704,516352
4/22/22,Venezuela,6.4238,-66.5897,522088,0,5705,516383
4/23/22,Venezuela,6.4238,-66.5897,522121,0,5705,516416
4/24/22,Venezuela,6.4238,-66.5897,522176,0,5706,516470
4/25/22,Venezuela,6.4238,-66.5897,522234,0,5706,516528
4/26/22,Venezuela,6.4238,-66.5897,522243,0,5706,516537
4/27/22,Venezuela,6.4238,-66.5897,522263,0,5706,516557
4/28/22,Venezuela,6.4238,-66.5897,522263,0,5706,516557
4/29/22,Venezuela,6.4238,-66.5897,522305,0,5708,516597
4/30/22,Venezuela,6.4238,-66.5897,522325,0,5709,516616
5/1/22,Venezuela,6.4238,-66.5897,522434,0,5709,516725
5/2/22,Venezuela,6.4238,-66.5897,522434,0,5709,516725
5/3/22,Venezuela,6.4238,-66.5897,522514,0,5709,516805
5/4/22,Venezuela,6.4238,-66.5897,522564,0,5709,516855
5/5/22,Venezuela,6.4238,-66.5897,522587,0,5709,516878
5/6/22,Venezuela,6.4238,-66.5897,522625,0,5709,516916
5/7/22,Venezuela,6.4238,-66.5897,522672,0,5709,516963
5/8/22,Venezuela,6.4238,-66.5897,522749,0,5709,517040
5/9/22,Venezuela,6.4238,-66.5897,522749,0,5709,517040
5/10/22,Venezuela,6.4238,-66.5897,522749,0,5709,517040
5/11/22,Venezuela,6.4238,-66.5897,522840,0,5710,517130
5/12/22,Venezuela,6.4238,-66.5897,522840,0,5710,517130
5/13/22,Venezuela,6.4238,-66.5897,522921,0,5711,517210
5/14/22,Venezuela,6.4238,-66.5897,522921,0,5711,517210
5/15/22,Venezuela,6.4238,-66.5897,523020,0,5712,517308
5/16/22,Venezuela,6.4238,-66.5897,523059,0,5712,517347
5/17/22,Venezuela,6.4238,-66.5897,523059,0,5712,517347
5/18/22,Venezuela,6.4238,-66.5897,523119,0,5713,517406
5/19/22,Venezuela,6.4238,-66.5897,523174,0,5715,517459
5/20/22,Venezuela,6.4238,-66.5897,523238,0,5716,517522
5/21/22,Venezuela,6.4238,-66.5897,523266,0,5716,517550
5/22/22,Venezuela,6.4238,-66.5897,523343,0,5716,517627
5/23/22,Venezuela,6.4238,-66.5897,523377,0,5716,517661
5/24/22,Venezuela,6.4238,-66.5897,523411,0,5717,517694
5/25/22,Venezuela,6.4238,-66.5897,523411,0,5717,517694
5/26/22,Venezuela,6.4238,-66.5897,523444,0,5718,517726
5/27/22,Venezuela,6.4238,-66.5897,523540,0,5720,517820
5/28/22,Venezuela,6.4238,-66.5897,523593,0,5720,517873
5/29/22,Venezuela,6.4238,-66.5897,523618,0,5721,517897
5/30/22,Venezuela,6.4238,-66.5897,523618,0,5721,517897
5/31/22,Venezuela,6.4238,-66.5897,523654,0,5721,517933
6/1/22,Venezuela,6.4238,-66.5897,523710,0,5722,517988
6/2/22,Venezuela,6.4238,-66.5897,523710,0,5722,517988
6/3/22,Venezuela,6.4238,-66.5897,523769,0,5722,518047
6/4/22,Venezuela,6.4238,-66.5897,523833,0,5722,518111
6/5/22,Venezuela,6.4238,-66.5897,523901,0,5722,518179
6/6/22,Venezuela,6.4238,-66.5897,523937,0,5722,518215
6/7/22,Venezuela,6.4238,-66.5897,523969,0,5722,518247
6/8/22,Venezuela,6.4238,-66.5897,523969,0,5722,518247
6/9/22,Venezuela,6.4238,-66.5897,524085,0,5722,518363
6/10/22,Venezuela,6.4238,-66.5897,524152,0,5723,518429
6/11/22,Venezuela,6.4238,-66.5897,524152,0,5723,518429
6/12/22,Venezuela,6.4238,-66.5897,524291,0,5724,518567
6/13/22,Venezuela,6.4238,-66.5897,524321,0,5724,518597
6/14/22,Venezuela,6.4238,-66.5897,524321,0,5724,518597
6/15/22,Venezuela,6.4238,-66.5897,524370,0,5724,518646
6/16/22,Venezuela,6.4238,-66.5897,524488,0,5724,518764
6/17/22,Venezuela,6.4238,-66.5897,524718,0,5724,518994
6/18/22,Venezuela,6.4238,-66.5897,524823,0,5724,519099
6/19/22,Venezuela,6.4238,-66.5897,524911,0,5724,519187
6/20/22,Venezuela,6.4238,-66.5897,524978,0,5724,519254
6/21/22,Venezuela,6.4238,-66.5897,525105,0,5725,519380
6/22/22,Venezuela,6.4238,-66.5897,525105,0,5725,519380
6/23/22,Venezuela,6.4238,-66.5897,525340,0,5725,519615
6/24/22,Venezuela,6.4238,-66.5897,525539,0,5726,519813
6/25/22,Venezuela,6.4238,-66.5897,525716,0,5728,519988
6/26/22,Venezuela,6.4238,-66.5897,525782,0,5729,520053
6/27/22,Venezuela,6.4238,-66.5897,525827,0,5730,520097
6/28/22,Venezuela,6.4238,-66.5897,525827,0,5730,520097
6/29/22,Venezuela,6.4238,-66.5897,526022,0,5732,520290
6/30/22,Venezuela,6.4238,-66.5897,526022,0,5732,520290
7/1/22,Venezuela,6.4238,-66.5897,526454,0,5734,520720
7/2/22,Venezuela,6.4238,-66.5897,526688,0,5735,520953
7/3/22,Venezuela,6.4238,-66.5897,526688,0,5735,520953
7/4/22,Venezuela,6.4238,-66.5897,527074,0,5735,521339
7/5/22,Venezuela,6.4238,-66.5897,527074,0,5735,521339
7/6/22,Venezuela,6.4238,-66.5897,527241,0,5737,521504
7/7/22,Venezuela,6.4238,-66.5897,527347,0,5738,521609
7/8/22,Venezuela,6.4238,-66.5897,527789,0,5739,522050
7/9/22,Venezuela,6.4238,-66.5897,527964,0,5740,522224
7/10/22,Venezuela,6.4238,-66.5897,528292,0,5741,522551
7/11/22,Venezuela,6.4238,-66.5897,528429,0,5741,522688
7/12/22,Venezuela,6.4238,-66.5897,528566,0,5741,522825
7/13/22,Venezuela,6.4238,-66.5897,528785,0,5742,523043
7/14/22,Venezuela,6.4238,-66.5897,528994,0,5743,523251
7/15/22,Venezuela,6.4238,-66.5897,529384,0,5745,523639
7/16/22,Venezuela,6.4238,-66.5897,529730,0,5747,523983
7/17/22,Venezuela,6.4238,-66.5897,530402,0,5748,524654
7/18/22,Venezuela,6.4238,-66.5897,530649,0,5748,524901
7/19/22,Venezuela,6.4238,-66.5897,530649,0,5748,524901
7/20/22,Venezuela,6.4238,-66.5897,531094,0,5753,525341
7/21/22,Venezuela,6.4238,-66.5897,531657,0,5753,525904
7/22/22,Venezuela,6.4238,-66.5897,531963,0,5755,526208
7/23/22,Venezuela,6.4238,-66.5897,531963,0,5755,526208
7/24/22,Venezuela,6.4238,-66.5897,532902,0,5757,527145
7/25/22,Venezuela,6.4238,-66.5897,533195,0,5757,527438
7/26/22,Venezuela,6.4238,-66.5897,533195,0,5757,527438
7/27/22,Venezuela,6.4238,-66.5897,533379,0,5757,527622
7/28/22,Venezuela,6.4238,-66.5897,534451,0,5759,528692
7/29/22,Venezuela,6.4238,-66.5897,534906,0,5761,529145
7/30/22,Venezuela,6.4238,-66.5897,535277,0,5762,529515
7/31/22,Venezuela,6.4238,-66.5897,535836,0,5763,530073
8/1/22,Venezuela,6.4238,-66.5897,536086,0,5763,530323
8/2/22,Venezuela,6.4238,-66.5897,536086,0,5763,530323
8/3/22,Venezuela,6.4238,-66.5897,536586,0,5763,530823
8/4/22,Venezuela,6.4238,-66.5897,537177,0,5764,531413
8/5/22,Venezuela,6.4238,-66.5897,537487,0,5766,531721
8/6/22,Venezuela,6.4238,-66.5897,538155,0,5768,532387
8/7/22,Venezuela,6.4238,-66.5897,538435,0,5768,532667
8/8/22,Venezuela,6.4238,-66.5897,538631,0,5768,532863
8/9/22,Venezuela,6.4238,-66.5897,538631,0,5768,532863
8/10/22,Venezuela,6.4238,-66.5897,539205,0,5770,533435
8/11/22,Venezuela,6.4238,-66.5897,539205,0,5770,533435
8/12/22,Venezuela,6.4238,-66.5897,539205,0,5770,533435
8/13/22,Venezuela,6.4238,-66.5897,540102,0,5775,534327
8/14/22,Venezuela,6.4238,-66.5897,540222,0,5778,534444
8/15/22,Venezuela,6.4238,-66.5897,540222,0,5778,534444
8/16/22,Venezuela,6.4238,-66.5897,540681,0,5779,534902
8/17/22,Venezuela,6.4238,-66.5897,540796,0,5781,535015
8/18/22,Venezuela,6.4238,-66.5897,540796,0,5781,535015
8/19/22,Venezuela,6.4238,-66.5897,540977,0,5784,535193
8/20/22,Venezuela,6.4238,-66.5897,541322,0,5786,535536
8/21/22,Venezuela,6.4238,-66.5897,541405,0,5788,535617
8/22/22,Venezuela,6.4238,-66.5897,541600,0,5790,535810
8/23/22,Venezuela,6.4238,-66.5897,541708,0,5790,535918
8/24/22,Venezuela,6.4238,-66.5897,541708,0,5790,535918
8/25/22,Venezuela,6.4238,-66.5897,541807,0,5792,536015
8/26/22,Venezuela,6.4238,-66.5897,542039,0,5794,536245
8/27/22,Venezuela,6.4238,-66.5897,542199,0,5794,536405
8/28/22,Venezuela,6.4238,-66.5897,542252,0,5796,536456
8/29/22,Venezuela,6.4238,-66.5897,542281,0,5796,536485
8/30/22,Venezuela,6.4238,-66.5897,542281,0,5796,536485
8/31/22,Venezuela,6.4238,-66.5897,542508,0,5796,536712
9/1/22,Venezuela,6.4238,-66.5897,542508,0,5796,536712
9/2/22,Venezuela,6.4238,-66.5897,542508,0,5796,536712
9/3/22,Venezuela,6.4238,-66.5897,542874,0,5798,537076
9/4/22,Venezuela,6.4238,-66.5897,542874,0,5798,537076
9/5/22,Venezuela,6.4238,-66.5897,542952,0,5801,537151
9/6/22,Venezuela,6.4238,-66.5897,543123,0,5803,537320
9/7/22,Venezuela,6.4238,-66.5897,543204,0,5804,537400
9/8/22,Venezuela,6.4238,-66.5897,543204,0,5804,537400
9/9/22,Venezuela,6.4238,-66.5897,543204,0,5804,537400
9/10/22,Venezuela,6.4238,-66.5897,543759,0,5807,537952
9/11/22,Venezuela,6.4238,-66.5897,543811,0,5809,538002
9/12/22,Venezuela,6.4238,-66.5897,543832,0,5809,538023
9/13/22,Venezuela,6.4238,-66.5897,543832,0,5809,538023
9/14/22,Venezuela,6.4238,-66.5897,543930,0,5809,538121
9/15/22,Venezuela,6.4238,-66.5897,544057,0,5809,538248
9/16/22,Venezuela,6.4238,-66.5897,544090,0,5809,538281
9/17/22,Venezuela,6.4238,-66.5897,544090,0,5809,538281
9/18/22,Venezuela,6.4238,-66.5897,544210,0,5811,538399
9/19/22,Venezuela,6.4238,-66.5897,544248,0,5812,538436
9/20/22,Venezuela,6.4238,-66.5897,544270,0,5814,538456
9/21/22,Venezuela,6.4238,-66.5897,544310,0,5814,538496
9/22/22,Venezuela,6.4238,-66.5897,544310,0,5814,538496
9/23/22,Venezuela,6.4238,-66.5897,544355,0,5814,538541
9/24/22,Venezuela,6.4238,-66.5897,544450,0,5814,538636
9/25/22,Venezuela,6.4238,-66.5897,544450,0,5814,538636
9/26/22,Venezuela,6.4238,-66.5897,544531,0,5814,538717
9/27/22,Venezuela,6.4238,-66.5897,544620,0,5814,538806
9/28/22,Venezuela,6.4238,-66.5897,544687,0,5814,538873
9/29/22,Venezuela,6.4238,-66.5897,544687,0,5814,538873
9/30/22,Venezuela,6.4238,-66.5897,544803,0,5814,538989
10/1/22,Venezuela,6.4238,-66.5897,544860,0,5816,539044
10/2/22,Venezuela,6.4238,-66.5897,544874,0,5816,539058
10/3/22,Venezuela,6.4238,-66.5897,544884,0,5816,539068
10/4/22,Venezuela,6.4238,-66.5897,544884,0,5816,539068
10/5/22,Venezuela,6.4238,-66.5897,544907,0,5818,539089
10/6/22,Venezuela,6.4238,-66.5897,544921,0,5818,539103
10/7/22,Venezuela,6.4238,-66.5897,544921,0,5818,539103
10/8/22,Venezuela,6.4238,-66.5897,544950,0,5818,539132
10/9/22,Venezuela,6.4238,-66.5897,544950,0,5818,539132
10/10/22,Venezuela,6.4238,-66.5897,544964,0,5818,539146
10/11/22,Venezuela,6.4238,-66.5897,544966,0,5818,539148
10/12/22,Venezuela,6.4238,-66.5897,545013,0,5818,539195
10/13/22,Venezuela,6.4238,-66.5897,545159,0,5818,539341
10/14/22,Venezuela,6.4238,-66.5897,545193,0,5819,539374
10/15/22,Venezuela,6.4238,-66.5897,545231,0,5820,539411
10/16/22,Venezuela,6.4238,-66.5897,545323,0,5820,539503
10/17/22,Venezuela,6.4238,-66.5897,545323,0,5820,539503
10/18/22,Venezuela,6.4238,-66.5897,545377,0,5820,539557
10/19/22,Venezuela,6.4238,-66.5897,545469,0,5820,539649
10/20/22,Venezuela,6.4238,-66.5897,545469,0,5820,539649
10/21/22,Venezuela,6.4238,-66.5897,545523,0,5820,539703
10/22/22,Venezuela,6.4238,-66.5897,545523,0,5820,539703
10/23/22,Venezuela,6.4238,-66.5897,545593,0,5820,539773
10/24/22,Venezuela,6.4238,-66.5897,545616,0,5820,539796
10/25/22,Venezuela,6.4238,-66.5897,545616,0,5820,539796
10/26/22,Venezuela,6.4238,-66.5897,545665,0,5820,539845
10/27/22,Venezuela,6.4238,-66.5897,545777,0,5820,539957
10/28/22,Venezuela,6.4238,-66.5897,545777,0,5820,539957
10/29/22,Venezuela,6.4238,-66.5897,545839,0,5820,540019
10/30/22,Venezuela,6.4238,-66.5897,545878,0,5820,540058
10/31/22,Venezuela,6.4238,-66.5897,545899,0,5820,540079
11/1/22,Venezuela,6.4238,-66.5897,545899,0,5820,540079
11/2/22,Venezuela,6.4238,-66.5897,545926,0,5820,540106
11/3/22,Venezuela,6.4238,-66.5897,545951,0,5820,540131
11/4/22,Venezuela,6.4238,-66.5897,545963,0,5820,540143
11/5/22,Venezuela,6.4238,-66.5897,546047,0,5821,540226
11/6/22,Venezuela,6.4238,-66.5897,546110,0,5823,540287
11/7/22,Venezuela,6.4238,-66.5897,546110,0,5823,540287
11/8/22,Venezuela,6.4238,-66.5897,546122,0,5823,540299
11/9/22,Venezuela,6.4238,-66.5897,546202,0,5823,540379
11/10/22,Venezuela,6.4238,-66.5897,546202,0,5823,540379
11/11/22,Venezuela,6.4238,-66.5897,546262,0,5824,540438
11/12/22,Venezuela,6.4238,-66.5897,546384,0,5824,540560
11/13/22,Venezuela,6.4238,-66.5897,546384,0,5824,540560
11/14/22,Venezuela,6.4238,-66.5897,546461,0,5824,540637
11/15/22,Venezuela,6.4238,-66.5897,546489,0,5825,540664
11/16/22,Venezuela,6.4238,-66.5897,546534,0,5825,540709
11/17/22,Venezuela,6.4238,-66.5897,546534,0,5825,540709
11/18/22,Venezuela,6.4238,-66.5897,546733,0,5825,540908
11/19/22,Venezuela,6.4238,-66.5897,546733,0,5825,540908
11/20/22,Venezuela,6.4238,-66.5897,546839,0,5827,541012
11/21/22,Venezuela,6.4238,-66.5897,546839,0,5827,541012
11/22/22,Venezuela,6.4238,-66.5897,546890,0,5827,541063
11/23/22,Venezuela,6.4238,-66.5897,547049,0,5827,541222
11/24/22,Venezuela,6.4238,-66.5897,547049,0,5827,541222
11/25/22,Venezuela,6.4238,-66.5897,547112,0,5827,541285
11/26/22,Venezuela,6.4238,-66.5897,547301,0,5828,541473
11/27/22,Venezuela,6.4238,-66.5897,547351,0,5828,541523
11/28/22,Venezuela,6.4238,-66.5897,547351,0,5828,541523
11/29/22,Venezuela,6.4238,-66.5897,547396,0,5828,541568
11/30/22,Venezuela,6.4238,-66.5897,547396,0,5828,541568
12/1/22,Venezuela,6.4238,-66.5897,547631,0,5828,541803
12/2/22,Venezuela,6.4238,-66.5897,547631,0,5828,541803
12/3/22,Venezuela,6.4238,-66.5897,547772,0,5829,541943
12/4/22,Venezuela,6.4238,-66.5897,547772,0,5829,541943
12/5/22,Venezuela,6.4238,-66.5897,547891,0,5829,542062
12/6/22,Venezuela,6.4238,-66.5897,547891,0,5829,542062
12/7/22,Venezuela,6.4238,-66.5897,547962,0,5829,542133
12/8/22,Venezuela,6.4238,-66.5897,548061,0,5829,542232
12/9/22,Venezuela,6.4238,-66.5897,548150,0,5829,542321
12/10/22,Venezuela,6.4238,-66.5897,548150,0,5829,542321
12/11/22,Venezuela,6.4238,-66.5897,548348,0,5830,542518
12/12/22,Venezuela,6.4238,-66.5897,548455,0,5830,542625
12/13/22,Venezuela,6.4238,-66.5897,548570,0,5830,542740
12/14/22,Venezuela,6.4238,-66.5897,548570,0,5830,542740
12/15/22,Venezuela,6.4238,-66.5897,548570,0,5830,542740
12/16/22,Venezuela,6.4238,-66.5897,548800,0,5830,542970
12/17/22,Venezuela,6.4238,-66.5897,548965,0,5830,543135
1/1/22,Vietnam,14.058324,108.277199,1746092,0,32610,1713482
1/2/22,Vietnam,14.058324,108.277199,1763040,0,32831,1730209
1/3/22,Vietnam,14.058324,108.277199,1778976,0,33021,1745955
1/4/22,Vietnam,14.058324,108.277199,1800704,0,33245,1767459
1/5/22,Vietnam,14.058324,108.277199,1817721,0,33475,1784246
1/6/22,Vietnam,14.058324,108.277199,1843563,0,33644,1809919
1/7/22,Vietnam,14.058324,108.277199,1859841,0,33877,1825964
1/8/22,Vietnam,14.058324,108.277199,1876394,0,34117,1842277
1/9/22,Vietnam,14.058324,108.277199,1899575,0,34319,1865256
1/10/22,Vietnam,14.058324,108.277199,1914393,0,34531,1879862
1/11/22,Vietnam,14.058324,108.277199,1930428,0,34787,1895641
1/12/22,Vietnam,14.058324,108.277199,1958719,0,34964,1923755
1/13/22,Vietnam,14.058324,108.277199,1975444,0,35170,1940274
1/14/22,Vietnam,14.058324,108.277199,1991484,0,35341,1956143
1/15/22,Vietnam,14.058324,108.277199,2007862,0,35480,1972382
1/16/22,Vietnam,14.058324,108.277199,2023546,0,35609,1987937
1/17/22,Vietnam,14.058324,108.277199,2023546,0,35609,1987937
1/18/22,Vietnam,14.058324,108.277199,2062128,0,35972,2026156
1/19/22,Vietnam,14.058324,108.277199,2078087,0,36114,2041973
1/20/22,Vietnam,14.058324,108.277199,2094802,0,36266,2058536
1/21/22,Vietnam,14.058324,108.277199,2110737,0,36443,2074294
1/22/22,Vietnam,14.058324,108.277199,2126444,0,36596,2089848
1/23/22,Vietnam,14.058324,108.277199,2141422,0,36719,2104703
1/24/22,Vietnam,14.058324,108.277199,2155784,0,36884,2118900
1/25/22,Vietnam,14.058324,108.277199,2171527,0,37010,2134517
1/26/22,Vietnam,14.058324,108.277199,2187481,0,37165,2150316
1/27/22,Vietnam,14.058324,108.277199,2203208,0,37291,2165917
1/28/22,Vietnam,14.058324,108.277199,2218137,0,37432,2180705
1/29/22,Vietnam,14.058324,108.277199,2233287,0,37547,2195740
1/30/22,Vietnam,14.058324,108.277199,2263053,0,37668,2225385
1/31/22,Vietnam,14.058324,108.277199,2275727,0,37777,2237950
2/1/22,Vietnam,14.058324,108.277199,2286750,0,37777,2248973
2/2/22,Vietnam,14.058324,108.277199,2295494,0,37777,2257717
2/3/22,Vietnam,14.058324,108.277199,2304095,0,38063,2266032
2/4/22,Vietnam,14.058324,108.277199,2315689,0,38147,2277542
2/5/22,Vietnam,14.058324,108.277199,2327859,0,38261,2289598
2/6/22,Vietnam,14.058324,108.277199,2341971,0,38324,2303647
2/7/22,Vietnam,14.058324,108.277199,2358786,0,38424,2320362
2/8/22,Vietnam,14.058324,108.277199,2380695,0,38521,2342174
2/9/22,Vietnam,14.058324,108.277199,2404651,0,38614,2366037
2/10/22,Vietnam,14.058324,108.277199,2430683,0,38688,2391995
2/11/22,Vietnam,14.058324,108.277199,2457170,0,38784,2418386
2/12/22,Vietnam,14.058324,108.277199,2484481,0,38862,2445619
2/13/22,Vietnam,14.058324,108.277199,2510860,0,38946,2471914
2/14/22,Vietnam,14.058324,108.277199,2540273,0,39037,2501236
2/15/22,Vietnam,14.058324,108.277199,2572087,0,39122,2532965
2/16/22,Vietnam,14.058324,108.277199,2606824,0,39188,2567636
2/17/22,Vietnam,14.058324,108.277199,2643024,0,39278,2603746
2/18/22,Vietnam,14.058324,108.277199,2685463,0,39358,2646105
2/19/22,Vietnam,14.058324,108.277199,2740293,0,39423,2700870
2/20/22,Vietnam,14.058324,108.277199,2787493,0,39501,2747992
2/21/22,Vietnam,14.058324,108.277199,2834373,0,39605,2794768
2/22/22,Vietnam,14.058324,108.277199,2890522,0,39682,2850840
2/23/22,Vietnam,14.058324,108.277199,2972378,0,39773,2932605
2/24/22,Vietnam,14.058324,108.277199,3041506,0,39884,3001622
2/25/22,Vietnam,14.058324,108.277199,3120301,0,39962,3080339
2/26/22,Vietnam,14.058324,108.277199,3219177,0,40050,3179127
2/27/22,Vietnam,14.058324,108.277199,3321005,0,40144,3280861
2/28/22,Vietnam,14.058324,108.277199,3443485,0,40252,3403233
3/1/22,Vietnam,14.058324,108.277199,3557629,0,40338,3517291
3/2/22,Vietnam,14.058324,108.277199,3709481,0,40452,3669029
3/3/22,Vietnam,14.058324,108.277199,3885631,0,40547,3845084
3/4/22,Vietnam,14.058324,108.277199,4059262,0,40644,4018618
3/5/22,Vietnam,14.058324,108.277199,4232520,0,40726,4191794
3/6/22,Vietnam,14.058324,108.277199,4434700,0,40813,4393887
3/7/22,Vietnam,14.058324,108.277199,4582058,0,40891,4541167
3/8/22,Vietnam,14.058324,108.277199,4776873,0,40977,4735896
3/9/22,Vietnam,14.058324,108.277199,5042036,0,41086,5000950
3/10/22,Vietnam,14.058324,108.277199,5260495,0,41157,5219338
3/11/22,Vietnam,14.058324,108.277199,5448935,0,41228,5407707
3/12/22,Vietnam,14.058324,108.277199,5903147,0,41290,5861857
3/13/22,Vietnam,14.058324,108.277199,6112648,0,41385,6071263
3/14/22,Vietnam,14.058324,108.277199,6377438,0,41477,6335961
3/15/22,Vietnam,14.058324,108.277199,6552918,0,41545,6511373
3/16/22,Vietnam,14.058324,108.277199,6820458,0,41607,6778851
3/17/22,Vietnam,14.058324,108.277199,7174423,0,41683,7132740
3/18/22,Vietnam,14.058324,108.277199,7367112,0,41740,7325372
3/19/22,Vietnam,14.058324,108.277199,7791841,0,41817,7750024
3/20/22,Vietnam,14.058324,108.277199,7958048,0,41880,7916168
3/21/22,Vietnam,14.058324,108.277199,8089761,0,41949,8047812
3/22/22,Vietnam,14.058324,108.277199,8338914,0,42014,8296900
3/23/22,Vietnam,14.058324,108.277199,8479751,0,42075,8437676
3/24/22,Vietnam,14.058324,108.277199,8599751,0,42145,8557606
3/25/22,Vietnam,14.058324,108.277199,8761252,0,42196,8719056
3/26/22,Vietnam,14.058324,108.277199,8919557,0,42258,8877299
3/27/22,Vietnam,14.058324,108.277199,9011473,0,42306,8969167
3/28/22,Vietnam,14.058324,108.277199,9274849,0,42358,9232491
3/29/22,Vietnam,14.058324,108.277199,9386489,0,42413,9344076
3/30/22,Vietnam,14.058324,108.277199,9472254,0,42454,9429800
3/31/22,Vietnam,14.058324,108.277199,9564609,0,42493,9522116
4/1/22,Vietnam,14.058324,108.277199,9650663,0,42526,9608137
4/2/22,Vietnam,14.058324,108.277199,9716282,0,42563,9673719
4/3/22,Vietnam,14.058324,108.277199,9818328,0,42600,9775728
4/4/22,Vietnam,14.058324,108.277199,9867045,0,42642,9824403
4/5/22,Vietnam,14.058324,108.277199,9922040,0,42681,9879359
4/6/22,Vietnam,14.058324,108.277199,9980464,0,42712,9937752
4/7/22,Vietnam,14.058324,108.277199,10070692,0,42733,10027959
4/8/22,Vietnam,14.058324,108.277199,10135789,0,42768,10093021
4/9/22,Vietnam,14.058324,108.277199,10169929,0,42794,10127135
4/10/22,Vietnam,14.058324,108.277199,10198236,0,42813,10155423
4/11/22,Vietnam,14.058324,108.277199,10250160,0,42830,10207330
4/12/22,Vietnam,14.058324,108.277199,10272964,0,42858,10230106
4/13/22,Vietnam,14.058324,108.277199,10297587,0,42878,10254709
4/14/22,Vietnam,14.058324,108.277199,10320599,0,42901,10277698
4/15/22,Vietnam,14.058324,108.277199,10394533,0,42924,10351609
4/16/22,Vietnam,14.058324,108.277199,10417887,0,42934,10374953
4/17/22,Vietnam,14.058324,108.277199,10432547,0,42944,10389603
4/18/22,Vietnam,14.058324,108.277199,10475819,0,42957,10432862
4/19/22,Vietnam,14.058324,108.277199,10489319,0,42975,10446344
4/20/22,Vietnam,14.058324,108.277199,10502590,0,42982,10459608
4/21/22,Vietnam,14.058324,108.277199,10533164,0,42991,10490173
4/22/22,Vietnam,14.058324,108.277199,10544324,0,42998,10501326
4/23/22,Vietnam,14.058324,108.277199,10554689,0,43004,10511685
4/24/22,Vietnam,14.058324,108.277199,10563502,0,43013,10520489
4/25/22,Vietnam,14.058324,108.277199,10571772,0,43021,10528751
4/26/22,Vietnam,14.058324,108.277199,10620203,0,43029,10577174
4/27/22,Vietnam,14.058324,108.277199,10631516,0,43034,10588482
4/28/22,Vietnam,14.058324,108.277199,10638632,0,43037,10595595
4/29/22,Vietnam,14.058324,108.277199,10644700,0,43038,10601662
4/30/22,Vietnam,14.058324,108.277199,10649809,0,43041,10606768
5/1/22,Vietnam,14.058324,108.277199,10653526,0,43042,10610484
5/2/22,Vietnam,14.058324,108.277199,10656649,0,43044,10613605
5/3/22,Vietnam,14.058324,108.277199,10659358,0,43044,10616314
5/4/22,Vietnam,14.058324,108.277199,10662446,0,43047,10619399
5/5/22,Vietnam,14.058324,108.277199,10666751,0,43049,10623702
5/6/22,Vietnam,14.058324,108.277199,10670570,0,43055,10627515
5/7/22,Vietnam,14.058324,108.277199,10673915,0,43055,10630860
5/8/22,Vietnam,14.058324,108.277199,10676184,0,43056,10633128
5/9/22,Vietnam,14.058324,108.277199,10678359,0,43057,10635302
5/10/22,Vietnam,14.058324,108.277199,10681214,0,43058,10638156
5/11/22,Vietnam,14.058324,108.277199,10683972,0,43060,10640912
5/12/22,Vietnam,14.058324,108.277199,10690471,0,43063,10647408
5/13/22,Vietnam,14.058324,108.277199,10693141,0,43063,10650078
5/14/22,Vietnam,14.058324,108.277199,10695036,0,43065,10651971
5/15/22,Vietnam,14.058324,108.277199,10696630,0,43065,10653565
5/16/22,Vietnam,14.058324,108.277199,10698180,0,43067,10655113
5/17/22,Vietnam,14.058324,108.277199,10699965,0,43071,10656894
5/18/22,Vietnam,14.058324,108.277199,10701796,0,43072,10658724
5/19/22,Vietnam,14.058324,108.277199,10704524,0,43073,10661451
5/20/22,Vietnam,14.058324,108.277199,10706111,0,43075,10663036
5/21/22,Vietnam,14.058324,108.277199,10707568,0,43075,10664493
5/22/22,Vietnam,14.058324,108.277199,10708887,0,43075,10665812
5/23/22,Vietnam,14.058324,108.277199,10710066,0,43076,10666990
5/24/22,Vietnam,14.058324,108.277199,10711389,0,43076,10668313
5/25/22,Vietnam,14.058324,108.277199,10712733,0,43078,10669655
5/26/22,Vietnam,14.058324,108.277199,10714008,0,43078,10670930
5/27/22,Vietnam,14.058324,108.277199,10715247,0,43078,10672169
5/28/22,Vietnam,14.058324,108.277199,10716361,0,43078,10673283
5/29/22,Vietnam,14.058324,108.277199,10717251,0,43078,10674173
5/30/22,Vietnam,14.058324,108.277199,10718369,0,43078,10675291
5/31/22,Vietnam,14.058324,108.277199,10719379,0,43079,10676300
6/1/22,Vietnam,14.058324,108.277199,10720426,0,43079,10677347
6/2/22,Vietnam,14.058324,108.277199,10722634,0,43080,10679554
6/3/22,Vietnam,14.058324,108.277199,10723673,0,43080,10680593
6/4/22,Vietnam,14.058324,108.277199,10724554,0,43080,10681474
6/5/22,Vietnam,14.058324,108.277199,10725239,0,43080,10682159
6/6/22,Vietnam,14.058324,108.277199,10726045,0,43081,10682964
6/7/22,Vietnam,14.058324,108.277199,10727005,0,43081,10683924
6/8/22,Vietnam,14.058324,108.277199,10727918,0,43081,10684837
6/9/22,Vietnam,14.058324,108.277199,10728720,0,43081,10685639
6/10/22,Vietnam,14.058324,108.277199,10729681,0,43082,10686599
6/11/22,Vietnam,14.058324,108.277199,10731244,0,43083,10688161
6/12/22,Vietnam,14.058324,108.277199,10731812,0,43083,10688729
6/13/22,Vietnam,14.058324,108.277199,10732429,0,43083,10689346
6/14/22,Vietnam,14.058324,108.277199,10733285,0,43083,10690202
6/15/22,Vietnam,14.058324,108.277199,10734151,0,43083,10691068
6/16/22,Vietnam,14.058324,108.277199,10734925,0,43083,10691842
6/17/22,Vietnam,14.058324,108.277199,10736408,0,43083,10693325
6/18/22,Vietnam,14.058324,108.277199,10737107,0,43083,10694024
6/19/22,Vietnam,14.058324,108.277199,10737640,0,43083,10694557
6/20/22,Vietnam,14.058324,108.277199,10738161,0,43083,10695078
6/21/22,Vietnam,14.058324,108.277199,10738909,0,43083,10695826
6/22/22,Vietnam,14.058324,108.277199,10739855,0,43084,10696771
6/23/22,Vietnam,14.058324,108.277199,10740595,0,43084,10697511
6/24/22,Vietnam,14.058324,108.277199,10742234,0,43084,10699150
6/25/22,Vietnam,14.058324,108.277199,10742891,0,43084,10699807
6/26/22,Vietnam,14.058324,108.277199,10743448,0,43084,10700364
6/27/22,Vietnam,14.058324,108.277199,10744085,0,43084,10701001
6/28/22,Vietnam,14.058324,108.277199,10744854,0,43087,10701767
6/29/22,Vietnam,14.058324,108.277199,10745631,0,43087,10702544
6/30/22,Vietnam,14.058324,108.277199,10746470,0,43087,10703383
7/1/22,Vietnam,14.058324,108.277199,10747397,0,43087,10704310
7/2/22,Vietnam,14.058324,108.277199,10748127,0,43087,10705040
7/3/22,Vietnam,14.058324,108.277199,10748639,0,43087,10705552
7/4/22,Vietnam,14.058324,108.277199,10749324,0,43088,10706236
7/5/22,Vietnam,14.058324,108.277199,10750313,0,43089,10707224
7/6/22,Vietnam,14.058324,108.277199,10751227,0,43089,10708138
7/7/22,Vietnam,14.058324,108.277199,10752140,0,43089,10709051
7/8/22,Vietnam,14.058324,108.277199,10752942,0,43089,10709853
7/9/22,Vietnam,14.058324,108.277199,10754348,0,43089,10711259
7/10/22,Vietnam,14.058324,108.277199,10754813,0,43089,10711724
7/11/22,Vietnam,14.058324,108.277199,10755381,0,43089,10712292
7/12/22,Vietnam,14.058324,108.277199,10756254,0,43090,10713164
7/13/22,Vietnam,14.058324,108.277199,10757257,0,43090,10714167
7/14/22,Vietnam,14.058324,108.277199,10758189,0,43090,10715099
7/15/22,Vietnam,14.058324,108.277199,10759145,0,43090,10716055
7/16/22,Vietnam,14.058324,108.277199,10759850,0,43091,10716759
7/17/22,Vietnam,14.058324,108.277199,10760595,0,43091,10717504
7/18/22,Vietnam,14.058324,108.277199,10761435,0,43091,10718344
7/19/22,Vietnam,14.058324,108.277199,10762532,0,43091,10719441
7/20/22,Vietnam,14.058324,108.277199,10763694,0,43091,10720603
7/21/22,Vietnam,14.058324,108.277199,10764986,0,43091,10721895
7/22/22,Vietnam,14.058324,108.277199,10766128,0,43092,10723036
7/23/22,Vietnam,14.058324,108.277199,10767200,0,43092,10724108
7/24/22,Vietnam,14.058324,108.277199,10767948,0,43092,10724856
7/25/22,Vietnam,14.058324,108.277199,10768844,0,43092,10725752
7/26/22,Vietnam,14.058324,108.277199,10770304,0,43092,10727212
7/27/22,Vietnam,14.058324,108.277199,10772980,0,43092,10729888
7/28/22,Vietnam,14.058324,108.277199,10774679,0,43092,10731587
7/29/22,Vietnam,14.058324,108.277199,10776484,0,43093,10733391
7/30/22,Vietnam,14.058324,108.277199,10778154,0,43093,10735061
7/31/22,Vietnam,14.058324,108.277199,10779632,0,43093,10736539
8/1/22,Vietnam,14.058324,108.277199,10781009,0,43093,10737916
8/2/22,Vietnam,14.058324,108.277199,10783026,0,43094,10739932
8/3/22,Vietnam,14.058324,108.277199,10785122,0,43094,10742028
8/4/22,Vietnam,14.058324,108.277199,11189968,0,43094,11146874
8/5/22,Vietnam,14.058324,108.277199,11192043,0,43094,11148949
8/6/22,Vietnam,14.058324,108.277199,11346137,0,43094,11303043
8/7/22,Vietnam,14.058324,108.277199,11347518,0,43094,11304424
8/8/22,Vietnam,14.058324,108.277199,11349223,0,43094,11306129
8/9/22,Vietnam,14.058324,108.277199,11351563,0,43094,11308469
8/10/22,Vietnam,14.058324,108.277199,11353573,0,43095,11310478
8/11/22,Vietnam,14.058324,108.277199,11360348,0,43095,11317253
8/12/22,Vietnam,14.058324,108.277199,11362540,0,43096,11319444
8/13/22,Vietnam,14.058324,108.277199,11364355,0,43097,11321258
8/14/22,Vietnam,14.058324,108.277199,11365784,0,43098,11322686
8/15/22,Vietnam,14.058324,108.277199,11367479,0,43098,11324381
8/16/22,Vietnam,14.058324,108.277199,11370462,0,43100,11327362
8/17/22,Vietnam,14.058324,108.277199,11373276,0,43103,11330173
8/18/22,Vietnam,14.058324,108.277199,11376571,0,43103,11333468
8/19/22,Vietnam,14.058324,108.277199,11379554,0,43103,11336451
8/20/22,Vietnam,14.058324,108.277199,11382258,0,43104,11339154
8/21/22,Vietnam,14.058324,108.277199,11383819,0,43105,11340714
8/22/22,Vietnam,14.058324,108.277199,11386016,0,43106,11342910
8/23/22,Vietnam,14.058324,108.277199,11389268,0,43106,11346162
8/24/22,Vietnam,14.058324,108.277199,11392859,0,43108,11349751
8/25/22,Vietnam,14.058324,108.277199,11396205,0,43110,11353095
8/26/22,Vietnam,14.058324,108.277199,11399400,0,43110,11356290
8/27/22,Vietnam,14.058324,108.277199,11401597,0,43111,11358486
8/28/22,Vietnam,14.058324,108.277199,11403302,0,43112,11360190
8/29/22,Vietnam,14.058324,108.277199,11405711,0,43113,11362598
8/30/22,Vietnam,14.058324,108.277199,11408952,0,43117,11365835
8/31/22,Vietnam,14.058324,108.277199,11411679,0,43117,11368562
9/1/22,Vietnam,14.058324,108.277199,11414359,0,43117,11371242
9/2/22,Vietnam,14.058324,108.277199,11415907,0,43118,11372789
9/3/22,Vietnam,14.058324,108.277199,11417503,0,43119,11374384
9/4/22,Vietnam,14.058324,108.277199,11418894,0,43120,11375774
9/5/22,Vietnam,14.058324,108.277199,11421055,0,43122,11377933
9/6/22,Vietnam,14.058324,108.277199,11424754,0,43123,11381631
9/7/22,Vietnam,14.058324,108.277199,11428632,0,43125,11385507
9/8/22,Vietnam,14.058324,108.277199,11431823,0,43126,11388697
9/9/22,Vietnam,14.058324,108.277199,11435472,0,43126,11392346
9/10/22,Vietnam,14.058324,108.277199,11437970,0,43126,11394844
9/11/22,Vietnam,14.058324,108.277199,11439613,0,43129,11396484
9/12/22,Vietnam,14.058324,108.277199,11441626,0,43130,11398496
9/13/22,Vietnam,14.058324,108.277199,11444927,0,43132,11401795
9/14/22,Vietnam,14.058324,108.277199,11448034,0,43132,11404902
9/15/22,Vietnam,14.058324,108.277199,11450999,0,43137,11407862
9/16/22,Vietnam,14.058324,108.277199,11454079,0,43137,11410942
9/17/22,Vietnam,14.058324,108.277199,11456558,0,43138,11413420
9/18/22,Vietnam,14.058324,108.277199,11458449,0,43139,11415310
9/19/22,Vietnam,14.058324,108.277199,11460227,0,43141,11417086
9/20/22,Vietnam,14.058324,108.277199,11463404,0,43142,11420262
9/21/22,Vietnam,14.058324,108.277199,11465691,0,43146,11422545
9/22/22,Vietnam,14.058324,108.277199,11467619,0,43146,11424473
9/23/22,Vietnam,14.058324,108.277199,11470164,0,43146,11427018
9/24/22,Vietnam,14.058324,108.277199,11471340,0,43146,11428194
9/25/22,Vietnam,14.058324,108.277199,11472301,0,43146,11429155
9/26/22,Vietnam,14.058324,108.277199,11473733,0,43146,11430587
9/27/22,Vietnam,14.058324,108.277199,11475321,0,43147,11432174
9/28/22,Vietnam,14.058324,108.277199,11476908,0,43147,11433761
9/29/22,Vietnam,14.058324,108.277199,11477886,0,43148,11434738
9/30/22,Vietnam,14.058324,108.277199,11479356,0,43148,11436208
10/1/22,Vietnam,14.058324,108.277199,11480028,0,43149,11436879
10/2/22,Vietnam,14.058324,108.277199,11480518,0,43149,11437369
10/3/22,Vietnam,14.058324,108.277199,11481314,0,43149,11438165
10/4/22,Vietnam,14.058324,108.277199,11482334,0,43151,11439183
10/5/22,Vietnam,14.058324,108.277199,11483529,0,43151,11440378
10/6/22,Vietnam,14.058324,108.277199,11484659,0,43151,11441508
10/7/22,Vietnam,14.058324,108.277199,11485361,0,43152,11442209
10/8/22,Vietnam,14.058324,108.277199,11486043,0,43153,11442890
10/9/22,Vietnam,14.058324,108.277199,11486414,0,43153,11443261
10/10/22,Vietnam,14.058324,108.277199,11487459,0,43153,11444306
10/11/22,Vietnam,14.058324,108.277199,11488685,0,43154,11445531
10/12/22,Vietnam,14.058324,108.277199,11489881,0,43155,11446726
10/13/22,Vietnam,14.058324,108.277199,11490951,0,43155,11447796
10/14/22,Vietnam,14.058324,108.277199,11491541,0,43155,11448386
10/15/22,Vietnam,14.058324,108.277199,11492273,0,43155,11449118
10/16/22,Vietnam,14.058324,108.277199,11492598,0,43155,11449443
10/17/22,Vietnam,14.058324,108.277199,11493271,0,43157,11450114
10/18/22,Vietnam,14.058324,108.277199,11493894,0,43158,11450736
10/19/22,Vietnam,14.058324,108.277199,11495231,0,43159,11452072
10/20/22,Vietnam,14.058324,108.277199,11495772,0,43159,11452613
10/21/22,Vietnam,14.058324,108.277199,11496354,0,43159,11453195
10/22/22,Vietnam,14.058324,108.277199,11496829,0,43159,11453670
10/23/22,Vietnam,14.058324,108.277199,11496987,0,43159,11453828
10/24/22,Vietnam,14.058324,108.277199,11497533,0,43161,11454372
10/25/22,Vietnam,14.058324,108.277199,11498047,0,43161,11454886
10/26/22,Vietnam,14.058324,108.277199,11498873,0,43162,11455711
10/27/22,Vietnam,14.058324,108.277199,11499357,0,43165,11456192
10/28/22,Vietnam,14.058324,108.277199,11501906,0,43162,11458744
10/29/22,Vietnam,14.058324,108.277199,11502169,0,43163,11459006
10/30/22,Vietnam,14.058324,108.277199,11502474,0,43163,11459311
10/31/22,Vietnam,14.058324,108.277199,11502885,0,43163,11459722
11/1/22,Vietnam,14.058324,108.277199,11503334,0,43164,11460170
11/2/22,Vietnam,14.058324,108.277199,11504091,0,43165,11460926
11/3/22,Vietnam,14.058324,108.277199,11504910,0,43165,11461745
11/4/22,Vietnam,14.058324,108.277199,11505249,0,43165,11462084
11/5/22,Vietnam,14.058324,108.277199,11505608,0,43165,11462443
11/6/22,Vietnam,14.058324,108.277199,11505849,0,43166,11462683
11/7/22,Vietnam,14.058324,108.277199,11506214,0,43166,11463048
11/8/22,Vietnam,14.058324,108.277199,11506656,0,43166,11463490
11/9/22,Vietnam,14.058324,108.277199,11507124,0,43166,11463958
11/10/22,Vietnam,14.058324,108.277199,11507540,0,43166,11464374
11/11/22,Vietnam,14.058324,108.277199,11508170,0,43166,11465004
11/12/22,Vietnam,14.058324,108.277199,11508447,0,43166,11465281
11/13/22,Vietnam,14.058324,108.277199,11508689,0,43166,11465523
11/14/22,Vietnam,14.058324,108.277199,11508893,0,43166,11465727
11/15/22,Vietnam,14.058324,108.277199,11509473,0,43166,11466307
11/16/22,Vietnam,14.058324,108.277199,11509975,0,43167,11466808
11/17/22,Vietnam,14.058324,108.277199,11510484,0,43167,11467317
11/18/22,Vietnam,14.058324,108.277199,11510919,0,43168,11467751
11/19/22,Vietnam,14.058324,108.277199,11511178,0,43169,11468009
11/20/22,Vietnam,14.058324,108.277199,11511452,0,43169,11468283
11/21/22,Vietnam,14.058324,108.277199,11511822,0,43169,11468653
11/22/22,Vietnam,14.058324,108.277199,11512138,0,43169,11468969
11/23/22,Vietnam,14.058324,108.277199,11512684,0,43169,11469515
11/24/22,Vietnam,14.058324,108.277199,11513173,0,43170,11470003
11/25/22,Vietnam,14.058324,108.277199,11513747,0,43170,11470577
11/26/22,Vietnam,14.058324,108.277199,11514174,0,43170,11471004
11/27/22,Vietnam,14.058324,108.277199,11514532,0,43170,11471362
11/28/22,Vietnam,14.058324,108.277199,11514865,0,43170,11471695
11/29/22,Vietnam,14.058324,108.277199,11515423,0,43172,11472251
11/30/22,Vietnam,14.058324,108.277199,11515908,0,43175,11472733
12/1/22,Vietnam,14.058324,108.277199,11516489,0,43176,11473313
12/2/22,Vietnam,14.058324,108.277199,11517124,0,43176,11473948
12/3/22,Vietnam,14.058324,108.277199,11517517,0,43177,11474340
12/4/22,Vietnam,14.058324,108.277199,11517722,0,43177,11474545
12/5/22,Vietnam,14.058324,108.277199,11518149,0,43177,11474972
12/6/22,Vietnam,14.058324,108.277199,11518511,0,43178,11475333
12/7/22,Vietnam,14.058324,108.277199,11519011,0,43178,11475833
12/8/22,Vietnam,14.058324,108.277199,11519539,0,43178,11476361
12/9/22,Vietnam,14.058324,108.277199,11520037,0,43178,11476859
12/10/22,Vietnam,14.058324,108.277199,11520445,0,43178,11477267
12/11/22,Vietnam,14.058324,108.277199,11520639,0,43178,11477461
12/12/22,Vietnam,14.058324,108.277199,11529639,0,43178,11486461
12/13/22,Vietnam,14.058324,108.277199,11521388,0,43179,11478209
12/14/22,Vietnam,14.058324,108.277199,11521708,0,43179,11478529
12/15/22,Vietnam,14.058324,108.277199,11522097,0,43179,11478918
12/16/22,Vietnam,14.058324,108.277199,11522431,0,43179,11479252
12/17/22,Vietnam,14.058324,108.277199,11522750,0,43179,11479571
1/1/22,West Bank and Gaza,31.9522,35.2332,469748,0,4919,464829
1/2/22,West Bank and Gaza,31.9522,35.2332,469748,0,4919,464829
1/3/22,West Bank and Gaza,31.9522,35.2332,469748,0,4919,464829
1/4/22,West Bank and Gaza,31.9522,35.2332,471090,0,4947,466143
1/5/22,West Bank and Gaza,31.9522,35.2332,471414,0,4954,466460
1/6/22,West Bank and Gaza,31.9522,35.2332,471414,0,4954,466460
1/7/22,West Bank and Gaza,31.9522,35.2332,471414,0,4954,466460
1/8/22,West Bank and Gaza,31.9522,35.2332,471414,0,4954,466460
1/9/22,West Bank and Gaza,31.9522,35.2332,471414,0,4954,466460
1/10/22,West Bank and Gaza,31.9522,35.2332,472910,0,4987,467923
1/11/22,West Bank and Gaza,31.9522,35.2332,473302,0,4993,468309
1/12/22,West Bank and Gaza,31.9522,35.2332,473302,0,4993,468309
1/13/22,West Bank and Gaza,31.9522,35.2332,474234,0,5005,469229
1/14/22,West Bank and Gaza,31.9522,35.2332,474234,0,5005,469229
1/15/22,West Bank and Gaza,31.9522,35.2332,474234,0,5005,469229
1/16/22,West Bank and Gaza,31.9522,35.2332,474234,0,5005,469229
1/17/22,West Bank and Gaza,31.9522,35.2332,476328,0,5019,471309
1/18/22,West Bank and Gaza,31.9522,35.2332,477151,0,5027,472124
1/19/22,West Bank and Gaza,31.9522,35.2332,478084,0,5031,473053
1/20/22,West Bank and Gaza,31.9522,35.2332,479343,0,5036,474307
1/21/22,West Bank and Gaza,31.9522,35.2332,480583,0,5042,475541
1/22/22,West Bank and Gaza,31.9522,35.2332,480583,0,5042,475541
1/23/22,West Bank and Gaza,31.9522,35.2332,480583,0,5042,475541
1/24/22,West Bank and Gaza,31.9522,35.2332,484979,0,5056,479923
1/25/22,West Bank and Gaza,31.9522,35.2332,488599,0,5061,483538
1/26/22,West Bank and Gaza,31.9522,35.2332,492694,0,5072,487622
1/27/22,West Bank and Gaza,31.9522,35.2332,500444,0,5074,495370
1/28/22,West Bank and Gaza,31.9522,35.2332,504992,0,5076,499916
1/29/22,West Bank and Gaza,31.9522,35.2332,504992,0,5076,499916
1/30/22,West Bank and Gaza,31.9522,35.2332,504992,0,5076,499916
1/31/22,West Bank and Gaza,31.9522,35.2332,524716,0,5098,519618
2/1/22,West Bank and Gaza,31.9522,35.2332,535160,0,5104,530056
2/2/22,West Bank and Gaza,31.9522,35.2332,546176,0,5116,541060
2/3/22,West Bank and Gaza,31.9522,35.2332,556550,0,5128,551422
2/4/22,West Bank and Gaza,31.9522,35.2332,556550,0,5128,551422
2/5/22,West Bank and Gaza,31.9522,35.2332,556550,0,5128,551422
2/6/22,West Bank and Gaza,31.9522,35.2332,556550,0,5128,551422
2/7/22,West Bank and Gaza,31.9522,35.2332,578424,0,5166,573258
2/8/22,West Bank and Gaza,31.9522,35.2332,586355,0,5181,581174
2/9/22,West Bank and Gaza,31.9522,35.2332,594037,0,5196,588841
2/10/22,West Bank and Gaza,31.9522,35.2332,600128,0,5215,594913
2/11/22,West Bank and Gaza,31.9522,35.2332,600128,0,5215,594913
2/12/22,West Bank and Gaza,31.9522,35.2332,600128,0,5215,594913
2/13/22,West Bank and Gaza,31.9522,35.2332,600128,0,5215,594913
2/14/22,West Bank and Gaza,31.9522,35.2332,613846,0,5283,608563
2/15/22,West Bank and Gaza,31.9522,35.2332,618527,0,5296,613231
2/16/22,West Bank and Gaza,31.9522,35.2332,622175,0,5320,616855
2/17/22,West Bank and Gaza,31.9522,35.2332,625028,0,5339,619689
2/18/22,West Bank and Gaza,31.9522,35.2332,627956,0,5357,622599
2/19/22,West Bank and Gaza,31.9522,35.2332,627956,0,5357,622599
2/20/22,West Bank and Gaza,31.9522,35.2332,627956,0,5357,622599
2/21/22,West Bank and Gaza,31.9522,35.2332,633684,0,5406,628278
2/22/22,West Bank and Gaza,31.9522,35.2332,636055,0,5425,630630
2/23/22,West Bank and Gaza,31.9522,35.2332,638172,0,5439,632733
2/24/22,West Bank and Gaza,31.9522,35.2332,640214,0,5458,634756
2/25/22,West Bank and Gaza,31.9522,35.2332,640214,0,5458,634756
2/26/22,West Bank and Gaza,31.9522,35.2332,640214,0,5458,634756
2/27/22,West Bank and Gaza,31.9522,35.2332,640214,0,5458,634756
2/28/22,West Bank and Gaza,31.9522,35.2332,645947,0,5501,640446
3/1/22,West Bank and Gaza,31.9522,35.2332,647203,0,5513,641690
3/2/22,West Bank and Gaza,31.9522,35.2332,648039,0,5532,642507
3/3/22,West Bank and Gaza,31.9522,35.2332,649110,0,5542,643568
3/4/22,West Bank and Gaza,31.9522,35.2332,649971,0,5557,644414
3/5/22,West Bank and Gaza,31.9522,35.2332,649971,0,5557,644414
3/6/22,West Bank and Gaza,31.9522,35.2332,649971,0,5557,644414
3/7/22,West Bank and Gaza,31.9522,35.2332,651700,0,5581,646119
3/8/22,West Bank and Gaza,31.9522,35.2332,652298,0,5583,646715
3/9/22,West Bank and Gaza,31.9522,35.2332,652763,0,5588,647175
3/10/22,West Bank and Gaza,31.9522,35.2332,652966,0,5594,647372
3/11/22,West Bank and Gaza,31.9522,35.2332,653293,0,5603,647690
3/12/22,West Bank and Gaza,31.9522,35.2332,653293,0,5603,647690
3/13/22,West Bank and Gaza,31.9522,35.2332,653293,0,5603,647690
3/14/22,West Bank and Gaza,31.9522,35.2332,653854,0,5616,648238
3/15/22,West Bank and Gaza,31.9522,35.2332,654068,0,5622,648446
3/16/22,West Bank and Gaza,31.9522,35.2332,654068,0,5622,648446
3/17/22,West Bank and Gaza,31.9522,35.2332,654380,0,5628,648752
3/18/22,West Bank and Gaza,31.9522,35.2332,654380,0,5628,648752
3/19/22,West Bank and Gaza,31.9522,35.2332,654380,0,5628,648752
3/20/22,West Bank and Gaza,31.9522,35.2332,654380,0,5628,648752
3/21/22,West Bank and Gaza,31.9522,35.2332,654954,0,5641,649313
3/22/22,West Bank and Gaza,31.9522,35.2332,654954,0,5641,649313
3/23/22,West Bank and Gaza,31.9522,35.2332,654954,0,5641,649313
3/24/22,West Bank and Gaza,31.9522,35.2332,655468,0,5649,649819
3/25/22,West Bank and Gaza,31.9522,35.2332,655468,0,5649,649819
3/26/22,West Bank and Gaza,31.9522,35.2332,655468,0,5649,649819
3/27/22,West Bank and Gaza,31.9522,35.2332,655468,0,5649,649819
3/28/22,West Bank and Gaza,31.9522,35.2332,655750,0,5655,650095
3/29/22,West Bank and Gaza,31.9522,35.2332,655750,0,5655,650095
3/30/22,West Bank and Gaza,31.9522,35.2332,655750,0,5655,650095
3/31/22,West Bank and Gaza,31.9522,35.2332,655750,0,5655,650095
4/1/22,West Bank and Gaza,31.9522,35.2332,655750,0,5655,650095
4/2/22,West Bank and Gaza,31.9522,35.2332,655750,0,5655,650095
4/3/22,West Bank and Gaza,31.9522,35.2332,655750,0,5655,650095
4/4/22,West Bank and Gaza,31.9522,35.2332,656287,0,5655,650632
4/5/22,West Bank and Gaza,31.9522,35.2332,656287,0,5655,650632
4/6/22,West Bank and Gaza,31.9522,35.2332,656287,0,5655,650632
4/7/22,West Bank and Gaza,31.9522,35.2332,656287,0,5655,650632
4/8/22,West Bank and Gaza,31.9522,35.2332,656287,0,5655,650632
4/9/22,West Bank and Gaza,31.9522,35.2332,656287,0,5655,650632
4/10/22,West Bank and Gaza,31.9522,35.2332,656287,0,5655,650632
4/11/22,West Bank and Gaza,31.9522,35.2332,656287,0,5655,650632
4/12/22,West Bank and Gaza,31.9522,35.2332,656617,0,5656,650961
4/13/22,West Bank and Gaza,31.9522,35.2332,656617,0,5656,650961
4/14/22,West Bank and Gaza,31.9522,35.2332,656617,0,5656,650961
4/15/22,West Bank and Gaza,31.9522,35.2332,656617,0,5656,650961
4/16/22,West Bank and Gaza,31.9522,35.2332,656617,0,5656,650961
4/17/22,West Bank and Gaza,31.9522,35.2332,656617,0,5656,650961
4/18/22,West Bank and Gaza,31.9522,35.2332,656617,0,5656,650961
4/19/22,West Bank and Gaza,31.9522,35.2332,656876,0,5657,651219
4/20/22,West Bank and Gaza,31.9522,35.2332,656876,0,5657,651219
4/21/22,West Bank and Gaza,31.9522,35.2332,656876,0,5657,651219
4/22/22,West Bank and Gaza,31.9522,35.2332,656876,0,5657,651219
4/23/22,West Bank and Gaza,31.9522,35.2332,656876,0,5657,651219
4/24/22,West Bank and Gaza,31.9522,35.2332,656876,0,5657,651219
4/25/22,West Bank and Gaza,31.9522,35.2332,656876,0,5657,651219
4/26/22,West Bank and Gaza,31.9522,35.2332,657060,0,5657,651403
4/27/22,West Bank and Gaza,31.9522,35.2332,657060,0,5657,651403
4/28/22,West Bank and Gaza,31.9522,35.2332,657060,0,5657,651403
4/29/22,West Bank and Gaza,31.9522,35.2332,657060,0,5657,651403
4/30/22,West Bank and Gaza,31.9522,35.2332,657060,0,5657,651403
5/1/22,West Bank and Gaza,31.9522,35.2332,657060,0,5657,651403
5/2/22,West Bank and Gaza,31.9522,35.2332,657060,0,5657,651403
5/3/22,West Bank and Gaza,31.9522,35.2332,657060,0,5657,651403
5/4/22,West Bank and Gaza,31.9522,35.2332,657060,0,5657,651403
5/5/22,West Bank and Gaza,31.9522,35.2332,657060,0,5657,651403
5/6/22,West Bank and Gaza,31.9522,35.2332,657060,0,5657,651403
5/7/22,West Bank and Gaza,31.9522,35.2332,657060,0,5657,651403
5/8/22,West Bank and Gaza,31.9522,35.2332,657060,0,5657,651403
5/9/22,West Bank and Gaza,31.9522,35.2332,657193,0,5657,651536
5/10/22,West Bank and Gaza,31.9522,35.2332,657193,0,5657,651536
5/11/22,West Bank and Gaza,31.9522,35.2332,657193,0,5657,651536
5/12/22,West Bank and Gaza,31.9522,35.2332,657193,0,5657,651536
5/13/22,West Bank and Gaza,31.9522,35.2332,657193,0,5657,651536
5/14/22,West Bank and Gaza,31.9522,35.2332,657193,0,5657,651536
5/15/22,West Bank and Gaza,31.9522,35.2332,657193,0,5657,651536
5/16/22,West Bank and Gaza,31.9522,35.2332,657329,0,5657,651672
5/17/22,West Bank and Gaza,31.9522,35.2332,657456,0,5659,651797
5/18/22,West Bank and Gaza,31.9522,35.2332,657456,0,5659,651797
5/19/22,West Bank and Gaza,31.9522,35.2332,657456,0,5659,651797
5/20/22,West Bank and Gaza,31.9522,35.2332,657456,0,5659,651797
5/21/22,West Bank and Gaza,31.9522,35.2332,657456,0,5659,651797
5/22/22,West Bank and Gaza,31.9522,35.2332,657456,0,5659,651797
5/23/22,West Bank and Gaza,31.9522,35.2332,657573,0,5660,651913
5/24/22,West Bank and Gaza,31.9522,35.2332,657573,0,5660,651913
5/25/22,West Bank and Gaza,31.9522,35.2332,657573,0,5660,651913
5/26/22,West Bank and Gaza,31.9522,35.2332,657573,0,5660,651913
5/27/22,West Bank and Gaza,31.9522,35.2332,657573,0,5660,651913
5/28/22,West Bank and Gaza,31.9522,35.2332,657573,0,5660,651913
5/29/22,West Bank and Gaza,31.9522,35.2332,657573,0,5660,651913
5/30/22,West Bank and Gaza,31.9522,35.2332,657573,0,5660,651913
5/31/22,West Bank and Gaza,31.9522,35.2332,657705,0,5660,652045
6/1/22,West Bank and Gaza,31.9522,35.2332,657705,0,5660,652045
6/2/22,West Bank and Gaza,31.9522,35.2332,657705,0,5660,652045
6/3/22,West Bank and Gaza,31.9522,35.2332,657705,0,5660,652045
6/4/22,West Bank and Gaza,31.9522,35.2332,657705,0,5660,652045
6/5/22,West Bank and Gaza,31.9522,35.2332,657705,0,5660,652045
6/6/22,West Bank and Gaza,31.9522,35.2332,657705,0,5660,652045
6/7/22,West Bank and Gaza,31.9522,35.2332,657879,0,5660,652219
6/8/22,West Bank and Gaza,31.9522,35.2332,657879,0,5660,652219
6/9/22,West Bank and Gaza,31.9522,35.2332,657879,0,5660,652219
6/10/22,West Bank and Gaza,31.9522,35.2332,657879,0,5660,652219
6/11/22,West Bank and Gaza,31.9522,35.2332,657879,0,5660,652219
6/12/22,West Bank and Gaza,31.9522,35.2332,657879,0,5660,652219
6/13/22,West Bank and Gaza,31.9522,35.2332,657879,0,5660,652219
6/14/22,West Bank and Gaza,31.9522,35.2332,657879,0,5660,652219
6/15/22,West Bank and Gaza,31.9522,35.2332,658100,0,5660,652440
6/16/22,West Bank and Gaza,31.9522,35.2332,658100,0,5660,652440
6/17/22,West Bank and Gaza,31.9522,35.2332,658100,0,5660,652440
6/18/22,West Bank and Gaza,31.9522,35.2332,658100,0,5660,652440
6/19/22,West Bank and Gaza,31.9522,35.2332,658100,0,5660,652440
6/20/22,West Bank and Gaza,31.9522,35.2332,658503,0,5660,652843
6/21/22,West Bank and Gaza,31.9522,35.2332,658503,0,5660,652843
6/22/22,West Bank and Gaza,31.9522,35.2332,658503,0,5660,652843
6/23/22,West Bank and Gaza,31.9522,35.2332,658503,0,5660,652843
6/24/22,West Bank and Gaza,31.9522,35.2332,658503,0,5660,652843
6/25/22,West Bank and Gaza,31.9522,35.2332,658503,0,5660,652843
6/26/22,West Bank and Gaza,31.9522,35.2332,658503,0,5660,652843
6/27/22,West Bank and Gaza,31.9522,35.2332,659853,0,5660,654193
6/28/22,West Bank and Gaza,31.9522,35.2332,659853,0,5660,654193
6/29/22,West Bank and Gaza,31.9522,35.2332,659853,0,5660,654193
6/30/22,West Bank and Gaza,31.9522,35.2332,659853,0,5660,654193
7/1/22,West Bank and Gaza,31.9522,35.2332,659853,0,5660,654193
7/2/22,West Bank and Gaza,31.9522,35.2332,659853,0,5660,654193
7/3/22,West Bank and Gaza,31.9522,35.2332,659853,0,5660,654193
7/4/22,West Bank and Gaza,31.9522,35.2332,662490,0,5662,656828
7/5/22,West Bank and Gaza,31.9522,35.2332,662490,0,5662,656828
7/6/22,West Bank and Gaza,31.9522,35.2332,662490,0,5662,656828
7/7/22,West Bank and Gaza,31.9522,35.2332,662490,0,5662,656828
7/8/22,West Bank and Gaza,31.9522,35.2332,662490,0,5662,656828
7/9/22,West Bank and Gaza,31.9522,35.2332,662490,0,5662,656828
7/10/22,West Bank and Gaza,31.9522,35.2332,662490,0,5662,656828
7/11/22,West Bank and Gaza,31.9522,35.2332,662490,0,5662,656828
7/12/22,West Bank and Gaza,31.9522,35.2332,662588,0,5662,656926
7/13/22,West Bank and Gaza,31.9522,35.2332,662588,0,5662,656926
7/14/22,West Bank and Gaza,31.9522,35.2332,662588,0,5662,656926
7/15/22,West Bank and Gaza,31.9522,35.2332,662588,0,5662,656926
7/16/22,West Bank and Gaza,31.9522,35.2332,662588,0,5662,656926
7/17/22,West Bank and Gaza,31.9522,35.2332,662588,0,5662,656926
7/18/22,West Bank and Gaza,31.9522,35.2332,669542,0,5663,663879
7/19/22,West Bank and Gaza,31.9522,35.2332,672039,0,5664,666375
7/20/22,West Bank and Gaza,31.9522,35.2332,672039,0,5664,666375
7/21/22,West Bank and Gaza,31.9522,35.2332,672039,0,5664,666375
7/22/22,West Bank and Gaza,31.9522,35.2332,672039,0,5664,666375
7/23/22,West Bank and Gaza,31.9522,35.2332,672039,0,5664,666375
7/24/22,West Bank and Gaza,31.9522,35.2332,672039,0,5664,666375
7/25/22,West Bank and Gaza,31.9522,35.2332,672039,0,5664,666375
7/26/22,West Bank and Gaza,31.9522,35.2332,682096,0,5678,676418
7/27/22,West Bank and Gaza,31.9522,35.2332,682096,0,5678,676418
7/28/22,West Bank and Gaza,31.9522,35.2332,682096,0,5678,676418
7/29/22,West Bank and Gaza,31.9522,35.2332,682096,0,5678,676418
7/30/22,West Bank and Gaza,31.9522,35.2332,682096,0,5678,676418
7/31/22,West Bank and Gaza,31.9522,35.2332,682096,0,5678,676418
8/1/22,West Bank and Gaza,31.9522,35.2332,682096,0,5678,676418
8/2/22,West Bank and Gaza,31.9522,35.2332,691065,0,5688,685377
8/3/22,West Bank and Gaza,31.9522,35.2332,691065,0,5688,685377
8/4/22,West Bank and Gaza,31.9522,35.2332,691065,0,5688,685377
8/5/22,West Bank and Gaza,31.9522,35.2332,691065,0,5688,685377
8/6/22,West Bank and Gaza,31.9522,35.2332,691065,0,5688,685377
8/7/22,West Bank and Gaza,31.9522,35.2332,691065,0,5688,685377
8/8/22,West Bank and Gaza,31.9522,35.2332,697447,0,5691,691756
8/9/22,West Bank and Gaza,31.9522,35.2332,697447,0,5691,691756
8/10/22,West Bank and Gaza,31.9522,35.2332,697447,0,5691,691756
8/11/22,West Bank and Gaza,31.9522,35.2332,697447,0,5691,691756
8/12/22,West Bank and Gaza,31.9522,35.2332,697447,0,5691,691756
8/13/22,West Bank and Gaza,31.9522,35.2332,697447,0,5691,691756
8/14/22,West Bank and Gaza,31.9522,35.2332,697447,0,5691,691756
8/15/22,West Bank and Gaza,31.9522,35.2332,697447,0,5691,691756
8/16/22,West Bank and Gaza,31.9522,35.2332,697447,0,5691,691756
8/17/22,West Bank and Gaza,31.9522,35.2332,697447,0,5691,691756
8/18/22,West Bank and Gaza,31.9522,35.2332,697447,0,5691,691756
8/19/22,West Bank and Gaza,31.9522,35.2332,697447,0,5691,691756
8/20/22,West Bank and Gaza,31.9522,35.2332,697447,0,5691,691756
8/21/22,West Bank and Gaza,31.9522,35.2332,697447,0,5691,691756
8/22/22,West Bank and Gaza,31.9522,35.2332,698384,0,5694,692690
8/23/22,West Bank and Gaza,31.9522,35.2332,698384,0,5694,692690
8/24/22,West Bank and Gaza,31.9522,35.2332,698384,0,5694,692690
8/25/22,West Bank and Gaza,31.9522,35.2332,698384,0,5694,692690
8/26/22,West Bank and Gaza,31.9522,35.2332,698384,0,5694,692690
8/27/22,West Bank and Gaza,31.9522,35.2332,698384,0,5694,692690
8/28/22,West Bank and Gaza,31.9522,35.2332,698384,0,5694,692690
8/29/22,West Bank and Gaza,31.9522,35.2332,698384,0,5694,692690
8/30/22,West Bank and Gaza,31.9522,35.2332,701739,0,5700,696039
8/31/22,West Bank and Gaza,31.9522,35.2332,702332,0,5704,696628
9/1/22,West Bank and Gaza,31.9522,35.2332,702332,0,5704,696628
9/2/22,West Bank and Gaza,31.9522,35.2332,702332,0,5704,696628
9/3/22,West Bank and Gaza,31.9522,35.2332,702332,0,5704,696628
9/4/22,West Bank and Gaza,31.9522,35.2332,702332,0,5704,696628
9/5/22,West Bank and Gaza,31.9522,35.2332,702332,0,5704,696628
9/6/22,West Bank and Gaza,31.9522,35.2332,702591,0,5706,696885
9/7/22,West Bank and Gaza,31.9522,35.2332,702591,0,5706,696885
9/8/22,West Bank and Gaza,31.9522,35.2332,702591,0,5706,696885
9/9/22,West Bank and Gaza,31.9522,35.2332,702591,0,5706,696885
9/10/22,West Bank and Gaza,31.9522,35.2332,702591,0,5706,696885
9/11/22,West Bank and Gaza,31.9522,35.2332,702591,0,5706,696885
9/12/22,West Bank and Gaza,31.9522,35.2332,702591,0,5706,696885
9/13/22,West Bank and Gaza,31.9522,35.2332,702591,0,5706,696885
9/14/22,West Bank and Gaza,31.9522,35.2332,702591,0,5706,696885
9/15/22,West Bank and Gaza,31.9522,35.2332,702768,0,5707,697061
9/16/22,West Bank and Gaza,31.9522,35.2332,702768,0,5707,697061
9/17/22,West Bank and Gaza,31.9522,35.2332,702768,0,5707,697061
9/18/22,West Bank and Gaza,31.9522,35.2332,702768,0,5707,697061
9/19/22,West Bank and Gaza,31.9522,35.2332,702768,0,5707,697061
9/20/22,West Bank and Gaza,31.9522,35.2332,702768,0,5707,697061
9/21/22,West Bank and Gaza,31.9522,35.2332,702768,0,5707,697061
9/22/22,West Bank and Gaza,31.9522,35.2332,702768,0,5707,697061
9/23/22,West Bank and Gaza,31.9522,35.2332,702768,0,5707,697061
9/24/22,West Bank and Gaza,31.9522,35.2332,702768,0,5707,697061
9/25/22,West Bank and Gaza,31.9522,35.2332,702768,0,5707,697061
9/26/22,West Bank and Gaza,31.9522,35.2332,702768,0,5707,697061
9/27/22,West Bank and Gaza,31.9522,35.2332,702768,0,5707,697061
9/28/22,West Bank and Gaza,31.9522,35.2332,702768,0,5707,697061
9/29/22,West Bank and Gaza,31.9522,35.2332,702768,0,5707,697061
9/30/22,West Bank and Gaza,31.9522,35.2332,702768,0,5707,697061
10/1/22,West Bank and Gaza,31.9522,35.2332,702768,0,5707,697061
10/2/22,West Bank and Gaza,31.9522,35.2332,702768,0,5707,697061
10/3/22,West Bank and Gaza,31.9522,35.2332,702768,0,5707,697061
10/4/22,West Bank and Gaza,31.9522,35.2332,702768,0,5707,697061
10/5/22,West Bank and Gaza,31.9522,35.2332,702804,0,5707,697097
10/6/22,West Bank and Gaza,31.9522,35.2332,702804,0,5707,697097
10/7/22,West Bank and Gaza,31.9522,35.2332,702804,0,5707,697097
10/8/22,West Bank and Gaza,31.9522,35.2332,702804,0,5707,697097
10/9/22,West Bank and Gaza,31.9522,35.2332,702804,0,5707,697097
10/10/22,West Bank and Gaza,31.9522,35.2332,702804,0,5707,697097
10/11/22,West Bank and Gaza,31.9522,35.2332,702804,0,5707,697097
10/12/22,West Bank and Gaza,31.9522,35.2332,702804,0,5707,697097
10/13/22,West Bank and Gaza,31.9522,35.2332,702804,0,5707,697097
10/14/22,West Bank and Gaza,31.9522,35.2332,702804,0,5707,697097
10/15/22,West Bank and Gaza,31.9522,35.2332,702804,0,5707,697097
10/16/22,West Bank and Gaza,31.9522,35.2332,702804,0,5707,697097
10/17/22,West Bank and Gaza,31.9522,35.2332,702804,0,5707,697097
10/18/22,West Bank and Gaza,31.9522,35.2332,702804,0,5707,697097
10/19/22,West Bank and Gaza,31.9522,35.2332,702804,0,5707,697097
10/20/22,West Bank and Gaza,31.9522,35.2332,702804,0,5707,697097
10/21/22,West Bank and Gaza,31.9522,35.2332,702804,0,5707,697097
10/22/22,West Bank and Gaza,31.9522,35.2332,702804,0,5707,697097
10/23/22,West Bank and Gaza,31.9522,35.2332,702804,0,5707,697097
10/24/22,West Bank and Gaza,31.9522,35.2332,703014,0,5708,697306
10/25/22,West Bank and Gaza,31.9522,35.2332,703014,0,5708,697306
10/26/22,West Bank and Gaza,31.9522,35.2332,703014,0,5708,697306
10/27/22,West Bank and Gaza,31.9522,35.2332,703014,0,5708,697306
10/28/22,West Bank and Gaza,31.9522,35.2332,703014,0,5708,697306
10/29/22,West Bank and Gaza,31.9522,35.2332,703014,0,5708,697306
10/30/22,West Bank and Gaza,31.9522,35.2332,703014,0,5708,697306
10/31/22,West Bank and Gaza,31.9522,35.2332,703036,0,5708,697328
11/1/22,West Bank and Gaza,31.9522,35.2332,703036,0,5708,697328
11/2/22,West Bank and Gaza,31.9522,35.2332,703036,0,5708,697328
11/3/22,West Bank and Gaza,31.9522,35.2332,703036,0,5708,697328
11/4/22,West Bank and Gaza,31.9522,35.2332,703036,0,5708,697328
11/5/22,West Bank and Gaza,31.9522,35.2332,703036,0,5708,697328
11/6/22,West Bank and Gaza,31.9522,35.2332,703036,0,5708,697328
11/7/22,West Bank and Gaza,31.9522,35.2332,703036,0,5708,697328
11/8/22,West Bank and Gaza,31.9522,35.2332,703036,0,5708,697328
11/9/22,West Bank and Gaza,31.9522,35.2332,703036,0,5708,697328
11/10/22,West Bank and Gaza,31.9522,35.2332,703036,0,5708,697328
11/11/22,West Bank and Gaza,31.9522,35.2332,703036,0,5708,697328
11/12/22,West Bank and Gaza,31.9522,35.2332,703036,0,5708,697328
11/13/22,West Bank and Gaza,31.9522,35.2332,703036,0,5708,697328
11/14/22,West Bank and Gaza,31.9522,35.2332,703036,0,5708,697328
11/15/22,West Bank and Gaza,31.9522,35.2332,703036,0,5708,697328
11/16/22,West Bank and Gaza,31.9522,35.2332,703036,0,5708,697328
11/17/22,West Bank and Gaza,31.9522,35.2332,703036,0,5708,697328
11/18/22,West Bank and Gaza,31.9522,35.2332,703036,0,5708,697328
11/19/22,West Bank and Gaza,31.9522,35.2332,703036,0,5708,697328
11/20/22,West Bank and Gaza,31.9522,35.2332,703036,0,5708,697328
11/21/22,West Bank and Gaza,31.9522,35.2332,703036,0,5708,697328
11/22/22,West Bank and Gaza,31.9522,35.2332,703036,0,5708,697328
11/23/22,West Bank and Gaza,31.9522,35.2332,703036,0,5708,697328
11/24/22,West Bank and Gaza,31.9522,35.2332,703036,0,5708,697328
11/25/22,West Bank and Gaza,31.9522,35.2332,703036,0,5708,697328
11/26/22,West Bank and Gaza,31.9522,35.2332,703036,0,5708,697328
11/27/22,West Bank and Gaza,31.9522,35.2332,703036,0,5708,697328
11/28/22,West Bank and Gaza,31.9522,35.2332,703036,0,5708,697328
11/29/22,West Bank and Gaza,31.9522,35.2332,703036,0,5708,697328
11/30/22,West Bank and Gaza,31.9522,35.2332,703036,0,5708,697328
12/1/22,West Bank and Gaza,31.9522,35.2332,703036,0,5708,697328
12/2/22,West Bank and Gaza,31.9522,35.2332,703036,0,5708,697328
12/3/22,West Bank and Gaza,31.9522,35.2332,703036,0,5708,697328
12/4/22,West Bank and Gaza,31.9522,35.2332,703036,0,5708,697328
12/5/22,West Bank and Gaza,31.9522,35.2332,703036,0,5708,697328
12/6/22,West Bank and Gaza,31.9522,35.2332,703036,0,5708,697328
12/7/22,West Bank and Gaza,31.9522,35.2332,703036,0,5708,697328
12/8/22,West Bank and Gaza,31.9522,35.2332,703036,0,5708,697328
12/9/22,West Bank and Gaza,31.9522,35.2332,703036,0,5708,697328
12/10/22,West Bank and Gaza,31.9522,35.2332,703036,0,5708,697328
12/11/22,West Bank and Gaza,31.9522,35.2332,703036,0,5708,697328
12/12/22,West Bank and Gaza,31.9522,35.2332,703228,0,5708,697520
12/13/22,West Bank and Gaza,31.9522,35.2332,703228,0,5708,697520
12/14/22,West Bank and Gaza,31.9522,35.2332,703228,0,5708,697520
12/15/22,West Bank and Gaza,31.9522,35.2332,703228,0,5708,697520
12/16/22,West Bank and Gaza,31.9522,35.2332,703228,0,5708,697520
12/17/22,West Bank and Gaza,31.9522,35.2332,703228,0,5708,697520
1/1/22,Winter Olympics 2022,39.9042,116.4074,0,0,0,0
1/2/22,Winter Olympics 2022,39.9042,116.4074,0,0,0,0
1/3/22,Winter Olympics 2022,39.9042,116.4074,0,0,0,0
1/4/22,Winter Olympics 2022,39.9042,116.4074,0,0,0,0
1/5/22,Winter Olympics 2022,39.9042,116.4074,0,0,0,0
1/6/22,Winter Olympics 2022,39.9042,116.4074,0,0,0,0
1/7/22,Winter Olympics 2022,39.9042,116.4074,0,0,0,0
1/8/22,Winter Olympics 2022,39.9042,116.4074,0,0,0,0
1/9/22,Winter Olympics 2022,39.9042,116.4074,0,0,0,0
1/10/22,Winter Olympics 2022,39.9042,116.4074,0,0,0,0
1/11/22,Winter Olympics 2022,39.9042,116.4074,0,0,0,0
1/12/22,Winter Olympics 2022,39.9042,116.4074,0,0,0,0
1/13/22,Winter Olympics 2022,39.9042,116.4074,0,0,0,0
1/14/22,Winter Olympics 2022,39.9042,116.4074,0,0,0,0
1/15/22,Winter Olympics 2022,39.9042,116.4074,0,0,0,0
1/16/22,Winter Olympics 2022,39.9042,116.4074,0,0,0,0
1/17/22,Winter Olympics 2022,39.9042,116.4074,0,0,0,0
1/18/22,Winter Olympics 2022,39.9042,116.4074,0,0,0,0
1/19/22,Winter Olympics 2022,39.9042,116.4074,0,0,0,0
1/20/22,Winter Olympics 2022,39.9042,116.4074,0,0,0,0
1/21/22,Winter Olympics 2022,39.9042,116.4074,0,0,0,0
1/22/22,Winter Olympics 2022,39.9042,116.4074,0,0,0,0
1/23/22,Winter Olympics 2022,39.9042,116.4074,72,0,0,72
1/24/22,Winter Olympics 2022,39.9042,116.4074,78,0,0,78
1/25/22,Winter Olympics 2022,39.9042,116.4074,93,0,0,93
1/26/22,Winter Olympics 2022,39.9042,116.4074,106,0,0,106
1/27/22,Winter Olympics 2022,39.9042,116.4074,129,0,0,129
1/28/22,Winter Olympics 2022,39.9042,116.4074,141,0,0,141
1/29/22,Winter Olympics 2022,39.9042,116.4074,177,0,0,177
1/30/22,Winter Olympics 2022,39.9042,116.4074,211,0,0,211
1/31/22,Winter Olympics 2022,39.9042,116.4074,248,0,0,248
2/1/22,Winter Olympics 2022,39.9042,116.4074,272,0,0,272
2/2/22,Winter Olympics 2022,39.9042,116.4074,304,0,0,304
2/3/22,Winter Olympics 2022,39.9042,116.4074,359,0,0,359
2/4/22,Winter Olympics 2022,39.9042,116.4074,380,0,0,380
2/5/22,Winter Olympics 2022,39.9042,116.4074,425,0,0,425
2/6/22,Winter Olympics 2022,39.9042,116.4074,435,0,0,435
2/7/22,Winter Olympics 2022,39.9042,116.4074,459,0,0,459
2/8/22,Winter Olympics 2022,39.9042,116.4074,465,0,0,465
2/9/22,Winter Olympics 2022,39.9042,116.4074,465,0,0,465
2/10/22,Winter Olympics 2022,39.9042,116.4074,465,0,0,465
2/11/22,Winter Olympics 2022,39.9042,116.4074,490,0,0,490
2/12/22,Winter Olympics 2022,39.9042,116.4074,498,0,0,498
2/13/22,Winter Olympics 2022,39.9042,116.4074,501,0,0,501
2/14/22,Winter Olympics 2022,39.9042,116.4074,501,0,0,501
2/15/22,Winter Olympics 2022,39.9042,116.4074,505,0,0,505
2/16/22,Winter Olympics 2022,39.9042,116.4074,507,0,0,507
2/17/22,Winter Olympics 2022,39.9042,116.4074,507,0,0,507
2/18/22,Winter Olympics 2022,39.9042,116.4074,508,0,0,508
2/19/22,Winter Olympics 2022,39.9042,116.4074,508,0,0,508
2/20/22,Winter Olympics 2022,39.9042,116.4074,509,0,0,509
2/21/22,Winter Olympics 2022,39.9042,116.4074,509,0,0,509
2/22/22,Winter Olympics 2022,39.9042,116.4074,509,0,0,509
2/23/22,Winter Olympics 2022,39.9042,116.4074,510,0,0,510
2/24/22,Winter Olympics 2022,39.9042,116.4074,510,0,0,510
2/25/22,Winter Olympics 2022,39.9042,116.4074,514,0,0,514
2/26/22,Winter Olympics 2022,39.9042,116.4074,514,0,0,514
2/27/22,Winter Olympics 2022,39.9042,116.4074,518,0,0,518
2/28/22,Winter Olympics 2022,39.9042,116.4074,521,0,0,521
3/1/22,Winter Olympics 2022,39.9042,116.4074,524,0,0,524
3/2/22,Winter Olympics 2022,39.9042,116.4074,524,0,0,524
3/3/22,Winter Olympics 2022,39.9042,116.4074,526,0,0,526
3/4/22,Winter Olympics 2022,39.9042,116.4074,530,0,0,530
3/5/22,Winter Olympics 2022,39.9042,116.4074,530,0,0,530
3/6/22,Winter Olympics 2022,39.9042,116.4074,532,0,0,532
3/7/22,Winter Olympics 2022,39.9042,116.4074,532,0,0,532
3/8/22,Winter Olympics 2022,39.9042,116.4074,533,0,0,533
3/9/22,Winter Olympics 2022,39.9042,116.4074,533,0,0,533
3/10/22,Winter Olympics 2022,39.9042,116.4074,535,0,0,535
3/11/22,Winter Olympics 2022,39.9042,116.4074,535,0,0,535
3/12/22,Winter Olympics 2022,39.9042,116.4074,535,0,0,535
3/13/22,Winter Olympics 2022,39.9042,116.4074,535,0,0,535
3/14/22,Winter Olympics 2022,39.9042,116.4074,535,0,0,535
3/15/22,Winter Olympics 2022,39.9042,116.4074,535,0,0,535
3/16/22,Winter Olympics 2022,39.9042,116.4074,535,0,0,535
3/17/22,Winter Olympics 2022,39.9042,116.4074,535,0,0,535
3/18/22,Winter Olympics 2022,39.9042,116.4074,535,0,0,535
3/19/22,Winter Olympics 2022,39.9042,116.4074,535,0,0,535
3/20/22,Winter Olympics 2022,39.9042,116.4074,535,0,0,535
3/21/22,Winter Olympics 2022,39.9042,116.4074,535,0,0,535
3/22/22,Winter Olympics 2022,39.9042,116.4074,535,0,0,535
3/23/22,Winter Olympics 2022,39.9042,116.4074,535,0,0,535
3/24/22,Winter Olympics 2022,39.9042,116.4074,535,0,0,535
3/25/22,Winter Olympics 2022,39.9042,116.4074,535,0,0,535
3/26/22,Winter Olympics 2022,39.9042,116.4074,535,0,0,535
3/27/22,Winter Olympics 2022,39.9042,116.4074,535,0,0,535
3/28/22,Winter Olympics 2022,39.9042,116.4074,535,0,0,535
3/29/22,Winter Olympics 2022,39.9042,116.4074,535,0,0,535
3/30/22,Winter Olympics 2022,39.9042,116.4074,535,0,0,535
3/31/22,Winter Olympics 2022,39.9042,116.4074,535,0,0,535
4/1/22,Winter Olympics 2022,39.9042,116.4074,535,0,0,535
4/2/22,Winter Olympics 2022,39.9042,116.4074,535,0,0,535
4/3/22,Winter Olympics 2022,39.9042,116.4074,535,0,0,535
4/4/22,Winter Olympics 2022,39.9042,116.4074,535,0,0,535
4/5/22,Winter Olympics 2022,39.9042,116.4074,535,0,0,535
4/6/22,Winter Olympics 2022,39.9042,116.4074,535,0,0,535
4/7/22,Winter Olympics 2022,39.9042,116.4074,535,0,0,535
4/8/22,Winter Olympics 2022,39.9042,116.4074,535,0,0,535
4/9/22,Winter Olympics 2022,39.9042,116.4074,535,0,0,535
4/10/22,Winter Olympics 2022,39.9042,116.4074,535,0,0,535
4/11/22,Winter Olympics 2022,39.9042,116.4074,535,0,0,535
4/12/22,Winter Olympics 2022,39.9042,116.4074,535,0,0,535
4/13/22,Winter Olympics 2022,39.9042,116.4074,535,0,0,535
4/14/22,Winter Olympics 2022,39.9042,116.4074,535,0,0,535
4/15/22,Winter Olympics 2022,39.9042,116.4074,535,0,0,535
4/16/22,Winter Olympics 2022,39.9042,116.4074,535,0,0,535
4/17/22,Winter Olympics 2022,39.9042,116.4074,535,0,0,535
4/18/22,Winter Olympics 2022,39.9042,116.4074,535,0,0,535
4/19/22,Winter Olympics 2022,39.9042,116.4074,535,0,0,535
4/20/22,Winter Olympics 2022,39.9042,116.4074,535,0,0,535
4/21/22,Winter Olympics 2022,39.9042,116.4074,535,0,0,535
4/22/22,Winter Olympics 2022,39.9042,116.4074,535,0,0,535
4/23/22,Winter Olympics 2022,39.9042,116.4074,535,0,0,535
4/24/22,Winter Olympics 2022,39.9042,116.4074,535,0,0,535
4/25/22,Winter Olympics 2022,39.9042,116.4074,535,0,0,535
4/26/22,Winter Olympics 2022,39.9042,116.4074,535,0,0,535
4/27/22,Winter Olympics 2022,39.9042,116.4074,535,0,0,535
4/28/22,Winter Olympics 2022,39.9042,116.4074,535,0,0,535
4/29/22,Winter Olympics 2022,39.9042,116.4074,535,0,0,535
4/30/22,Winter Olympics 2022,39.9042,116.4074,535,0,0,535
5/1/22,Winter Olympics 2022,39.9042,116.4074,535,0,0,535
5/2/22,Winter Olympics 2022,39.9042,116.4074,535,0,0,535
5/3/22,Winter Olympics 2022,39.9042,116.4074,535,0,0,535
5/4/22,Winter Olympics 2022,39.9042,116.4074,535,0,0,535
5/5/22,Winter Olympics 2022,39.9042,116.4074,535,0,0,535
5/6/22,Winter Olympics 2022,39.9042,116.4074,535,0,0,535
5/7/22,Winter Olympics 2022,39.9042,116.4074,535,0,0,535
5/8/22,Winter Olympics 2022,39.9042,116.4074,535,0,0,535
5/9/22,Winter Olympics 2022,39.9042,116.4074,535,0,0,535
5/10/22,Winter Olympics 2022,39.9042,116.4074,535,0,0,535
5/11/22,Winter Olympics 2022,39.9042,116.4074,535,0,0,535
5/12/22,Winter Olympics 2022,39.9042,116.4074,535,0,0,535
5/13/22,Winter Olympics 2022,39.9042,116.4074,535,0,0,535
5/14/22,Winter Olympics 2022,39.9042,116.4074,535,0,0,535
5/15/22,Winter Olympics 2022,39.9042,116.4074,535,0,0,535
5/16/22,Winter Olympics 2022,39.9042,116.4074,535,0,0,535
5/17/22,Winter Olympics 2022,39.9042,116.4074,535,0,0,535
5/18/22,Winter Olympics 2022,39.9042,116.4074,535,0,0,535
5/19/22,Winter Olympics 2022,39.9042,116.4074,535,0,0,535
5/20/22,Winter Olympics 2022,39.9042,116.4074,535,0,0,535
5/21/22,Winter Olympics 2022,39.9042,116.4074,535,0,0,535
5/22/22,Winter Olympics 2022,39.9042,116.4074,535,0,0,535
5/23/22,Winter Olympics 2022,39.9042,116.4074,535,0,0,535
5/24/22,Winter Olympics 2022,39.9042,116.4074,535,0,0,535
5/25/22,Winter Olympics 2022,39.9042,116.4074,535,0,0,535
5/26/22,Winter Olympics 2022,39.9042,116.4074,535,0,0,535
5/27/22,Winter Olympics 2022,39.9042,116.4074,535,0,0,535
5/28/22,Winter Olympics 2022,39.9042,116.4074,535,0,0,535
5/29/22,Winter Olympics 2022,39.9042,116.4074,535,0,0,535
5/30/22,Winter Olympics 2022,39.9042,116.4074,535,0,0,535
5/31/22,Winter Olympics 2022,39.9042,116.4074,535,0,0,535
6/1/22,Winter Olympics 2022,39.9042,116.4074,535,0,0,535
6/2/22,Winter Olympics 2022,39.9042,116.4074,535,0,0,535
6/3/22,Winter Olympics 2022,39.9042,116.4074,535,0,0,535
6/4/22,Winter Olympics 2022,39.9042,116.4074,535,0,0,535
6/5/22,Winter Olympics 2022,39.9042,116.4074,535,0,0,535
6/6/22,Winter Olympics 2022,39.9042,116.4074,535,0,0,535
6/7/22,Winter Olympics 2022,39.9042,116.4074,535,0,0,535
6/8/22,Winter Olympics 2022,39.9042,116.4074,535,0,0,535
6/9/22,Winter Olympics 2022,39.9042,116.4074,535,0,0,535
6/10/22,Winter Olympics 2022,39.9042,116.4074,535,0,0,535
6/11/22,Winter Olympics 2022,39.9042,116.4074,535,0,0,535
6/12/22,Winter Olympics 2022,39.9042,116.4074,535,0,0,535
6/13/22,Winter Olympics 2022,39.9042,116.4074,535,0,0,535
6/14/22,Winter Olympics 2022,39.9042,116.4074,535,0,0,535
6/15/22,Winter Olympics 2022,39.9042,116.4074,535,0,0,535
6/16/22,Winter Olympics 2022,39.9042,116.4074,535,0,0,535
6/17/22,Winter Olympics 2022,39.9042,116.4074,535,0,0,535
6/18/22,Winter Olympics 2022,39.9042,116.4074,535,0,0,535
6/19/22,Winter Olympics 2022,39.9042,116.4074,535,0,0,535
6/20/22,Winter Olympics 2022,39.9042,116.4074,535,0,0,535
6/21/22,Winter Olympics 2022,39.9042,116.4074,535,0,0,535
6/22/22,Winter Olympics 2022,39.9042,116.4074,535,0,0,535
6/23/22,Winter Olympics 2022,39.9042,116.4074,535,0,0,535
6/24/22,Winter Olympics 2022,39.9042,116.4074,535,0,0,535
6/25/22,Winter Olympics 2022,39.9042,116.4074,535,0,0,535
6/26/22,Winter Olympics 2022,39.9042,116.4074,535,0,0,535
6/27/22,Winter Olympics 2022,39.9042,116.4074,535,0,0,535
6/28/22,Winter Olympics 2022,39.9042,116.4074,535,0,0,535
6/29/22,Winter Olympics 2022,39.9042,116.4074,535,0,0,535
6/30/22,Winter Olympics 2022,39.9042,116.4074,535,0,0,535
7/1/22,Winter Olympics 2022,39.9042,116.4074,535,0,0,535
7/2/22,Winter Olympics 2022,39.9042,116.4074,535,0,0,535
7/3/22,Winter Olympics 2022,39.9042,116.4074,535,0,0,535
7/4/22,Winter Olympics 2022,39.9042,116.4074,535,0,0,535
7/5/22,Winter Olympics 2022,39.9042,116.4074,535,0,0,535
7/6/22,Winter Olympics 2022,39.9042,116.4074,535,0,0,535
7/7/22,Winter Olympics 2022,39.9042,116.4074,535,0,0,535
7/8/22,Winter Olympics 2022,39.9042,116.4074,535,0,0,535
7/9/22,Winter Olympics 2022,39.9042,116.4074,535,0,0,535
7/10/22,Winter Olympics 2022,39.9042,116.4074,535,0,0,535
7/11/22,Winter Olympics 2022,39.9042,116.4074,535,0,0,535
7/12/22,Winter Olympics 2022,39.9042,116.4074,535,0,0,535
7/13/22,Winter Olympics 2022,39.9042,116.4074,535,0,0,535
7/14/22,Winter Olympics 2022,39.9042,116.4074,535,0,0,535
7/15/22,Winter Olympics 2022,39.9042,116.4074,535,0,0,535
7/16/22,Winter Olympics 2022,39.9042,116.4074,535,0,0,535
7/17/22,Winter Olympics 2022,39.9042,116.4074,535,0,0,535
7/18/22,Winter Olympics 2022,39.9042,116.4074,535,0,0,535
7/19/22,Winter Olympics 2022,39.9042,116.4074,535,0,0,535
7/20/22,Winter Olympics 2022,39.9042,116.4074,535,0,0,535
7/21/22,Winter Olympics 2022,39.9042,116.4074,535,0,0,535
7/22/22,Winter Olympics 2022,39.9042,116.4074,535,0,0,535
7/23/22,Winter Olympics 2022,39.9042,116.4074,535,0,0,535
7/24/22,Winter Olympics 2022,39.9042,116.4074,535,0,0,535
7/25/22,Winter Olympics 2022,39.9042,116.4074,535,0,0,535
7/26/22,Winter Olympics 2022,39.9042,116.4074,535,0,0,535
7/27/22,Winter Olympics 2022,39.9042,116.4074,535,0,0,535
7/28/22,Winter Olympics 2022,39.9042,116.4074,535,0,0,535
7/29/22,Winter Olympics 2022,39.9042,116.4074,535,0,0,535
7/30/22,Winter Olympics 2022,39.9042,116.4074,535,0,0,535
7/31/22,Winter Olympics 2022,39.9042,116.4074,535,0,0,535
8/1/22,Winter Olympics 2022,39.9042,116.4074,535,0,0,535
8/2/22,Winter Olympics 2022,39.9042,116.4074,535,0,0,535
8/3/22,Winter Olympics 2022,39.9042,116.4074,535,0,0,535
8/4/22,Winter Olympics 2022,39.9042,116.4074,535,0,0,535
8/5/22,Winter Olympics 2022,39.9042,116.4074,535,0,0,535
8/6/22,Winter Olympics 2022,39.9042,116.4074,535,0,0,535
8/7/22,Winter Olympics 2022,39.9042,116.4074,535,0,0,535
8/8/22,Winter Olympics 2022,39.9042,116.4074,535,0,0,535
8/9/22,Winter Olympics 2022,39.9042,116.4074,535,0,0,535
8/10/22,Winter Olympics 2022,39.9042,116.4074,535,0,0,535
8/11/22,Winter Olympics 2022,39.9042,116.4074,535,0,0,535
8/12/22,Winter Olympics 2022,39.9042,116.4074,535,0,0,535
8/13/22,Winter Olympics 2022,39.9042,116.4074,535,0,0,535
8/14/22,Winter Olympics 2022,39.9042,116.4074,535,0,0,535
8/15/22,Winter Olympics 2022,39.9042,116.4074,535,0,0,535
8/16/22,Winter Olympics 2022,39.9042,116.4074,535,0,0,535
8/17/22,Winter Olympics 2022,39.9042,116.4074,535,0,0,535
8/18/22,Winter Olympics 2022,39.9042,116.4074,535,0,0,535
8/19/22,Winter Olympics 2022,39.9042,116.4074,535,0,0,535
8/20/22,Winter Olympics 2022,39.9042,116.4074,535,0,0,535
8/21/22,Winter Olympics 2022,39.9042,116.4074,535,0,0,535
8/22/22,Winter Olympics 2022,39.9042,116.4074,535,0,0,535
8/23/22,Winter Olympics 2022,39.9042,116.4074,535,0,0,535
8/24/22,Winter Olympics 2022,39.9042,116.4074,535,0,0,535
8/25/22,Winter Olympics 2022,39.9042,116.4074,535,0,0,535
8/26/22,Winter Olympics 2022,39.9042,116.4074,535,0,0,535
8/27/22,Winter Olympics 2022,39.9042,116.4074,535,0,0,535
8/28/22,Winter Olympics 2022,39.9042,116.4074,535,0,0,535
8/29/22,Winter Olympics 2022,39.9042,116.4074,535,0,0,535
8/30/22,Winter Olympics 2022,39.9042,116.4074,535,0,0,535
8/31/22,Winter Olympics 2022,39.9042,116.4074,535,0,0,535
9/1/22,Winter Olympics 2022,39.9042,116.4074,535,0,0,535
9/2/22,Winter Olympics 2022,39.9042,116.4074,535,0,0,535
9/3/22,Winter Olympics 2022,39.9042,116.4074,535,0,0,535
9/4/22,Winter Olympics 2022,39.9042,116.4074,535,0,0,535
9/5/22,Winter Olympics 2022,39.9042,116.4074,535,0,0,535
9/6/22,Winter Olympics 2022,39.9042,116.4074,535,0,0,535
9/7/22,Winter Olympics 2022,39.9042,116.4074,535,0,0,535
9/8/22,Winter Olympics 2022,39.9042,116.4074,535,0,0,535
9/9/22,Winter Olympics 2022,39.9042,116.4074,535,0,0,535
9/10/22,Winter Olympics 2022,39.9042,116.4074,535,0,0,535
9/11/22,Winter Olympics 2022,39.9042,116.4074,535,0,0,535
9/12/22,Winter Olympics 2022,39.9042,116.4074,535,0,0,535
9/13/22,Winter Olympics 2022,39.9042,116.4074,535,0,0,535
9/14/22,Winter Olympics 2022,39.9042,116.4074,535,0,0,535
9/15/22,Winter Olympics 2022,39.9042,116.4074,535,0,0,535
9/16/22,Winter Olympics 2022,39.9042,116.4074,535,0,0,535
9/17/22,Winter Olympics 2022,39.9042,116.4074,535,0,0,535
9/18/22,Winter Olympics 2022,39.9042,116.4074,535,0,0,535
9/19/22,Winter Olympics 2022,39.9042,116.4074,535,0,0,535
9/20/22,Winter Olympics 2022,39.9042,116.4074,535,0,0,535
9/21/22,Winter Olympics 2022,39.9042,116.4074,535,0,0,535
9/22/22,Winter Olympics 2022,39.9042,116.4074,535,0,0,535
9/23/22,Winter Olympics 2022,39.9042,116.4074,535,0,0,535
9/24/22,Winter Olympics 2022,39.9042,116.4074,535,0,0,535
9/25/22,Winter Olympics 2022,39.9042,116.4074,535,0,0,535
9/26/22,Winter Olympics 2022,39.9042,116.4074,535,0,0,535
9/27/22,Winter Olympics 2022,39.9042,116.4074,535,0,0,535
9/28/22,Winter Olympics 2022,39.9042,116.4074,535,0,0,535
9/29/22,Winter Olympics 2022,39.9042,116.4074,535,0,0,535
9/30/22,Winter Olympics 2022,39.9042,116.4074,535,0,0,535
10/1/22,Winter Olympics 2022,39.9042,116.4074,535,0,0,535
10/2/22,Winter Olympics 2022,39.9042,116.4074,535,0,0,535
10/3/22,Winter Olympics 2022,39.9042,116.4074,535,0,0,535
10/4/22,Winter Olympics 2022,39.9042,116.4074,535,0,0,535
10/5/22,Winter Olympics 2022,39.9042,116.4074,535,0,0,535
10/6/22,Winter Olympics 2022,39.9042,116.4074,535,0,0,535
10/7/22,Winter Olympics 2022,39.9042,116.4074,535,0,0,535
10/8/22,Winter Olympics 2022,39.9042,116.4074,535,0,0,535
10/9/22,Winter Olympics 2022,39.9042,116.4074,535,0,0,535
10/10/22,Winter Olympics 2022,39.9042,116.4074,535,0,0,535
10/11/22,Winter Olympics 2022,39.9042,116.4074,535,0,0,535
10/12/22,Winter Olympics 2022,39.9042,116.4074,535,0,0,535
10/13/22,Winter Olympics 2022,39.9042,116.4074,535,0,0,535
10/14/22,Winter Olympics 2022,39.9042,116.4074,535,0,0,535
10/15/22,Winter Olympics 2022,39.9042,116.4074,535,0,0,535
10/16/22,Winter Olympics 2022,39.9042,116.4074,535,0,0,535
10/17/22,Winter Olympics 2022,39.9042,116.4074,535,0,0,535
10/18/22,Winter Olympics 2022,39.9042,116.4074,535,0,0,535
10/19/22,Winter Olympics 2022,39.9042,116.4074,535,0,0,535
10/20/22,Winter Olympics 2022,39.9042,116.4074,535,0,0,535
10/21/22,Winter Olympics 2022,39.9042,116.4074,535,0,0,535
10/22/22,Winter Olympics 2022,39.9042,116.4074,535,0,0,535
10/23/22,Winter Olympics 2022,39.9042,116.4074,535,0,0,535
10/24/22,Winter Olympics 2022,39.9042,116.4074,535,0,0,535
10/25/22,Winter Olympics 2022,39.9042,116.4074,535,0,0,535
10/26/22,Winter Olympics 2022,39.9042,116.4074,535,0,0,535
10/27/22,Winter Olympics 2022,39.9042,116.4074,535,0,0,535
10/28/22,Winter Olympics 2022,39.9042,116.4074,535,0,0,535
10/29/22,Winter Olympics 2022,39.9042,116.4074,535,0,0,535
10/30/22,Winter Olympics 2022,39.9042,116.4074,535,0,0,535
10/31/22,Winter Olympics 2022,39.9042,116.4074,535,0,0,535
11/1/22,Winter Olympics 2022,39.9042,116.4074,535,0,0,535
11/2/22,Winter Olympics 2022,39.9042,116.4074,535,0,0,535
11/3/22,Winter Olympics 2022,39.9042,116.4074,535,0,0,535
11/4/22,Winter Olympics 2022,39.9042,116.4074,535,0,0,535
11/5/22,Winter Olympics 2022,39.9042,116.4074,535,0,0,535
11/6/22,Winter Olympics 2022,39.9042,116.4074,535,0,0,535
11/7/22,Winter Olympics 2022,39.9042,116.4074,535,0,0,535
11/8/22,Winter Olympics 2022,39.9042,116.4074,535,0,0,535
11/9/22,Winter Olympics 2022,39.9042,116.4074,535,0,0,535
11/10/22,Winter Olympics 2022,39.9042,116.4074,535,0,0,535
11/11/22,Winter Olympics 2022,39.9042,116.4074,535,0,0,535
11/12/22,Winter Olympics 2022,39.9042,116.4074,535,0,0,535
11/13/22,Winter Olympics 2022,39.9042,116.4074,535,0,0,535
11/14/22,Winter Olympics 2022,39.9042,116.4074,535,0,0,535
11/15/22,Winter Olympics 2022,39.9042,116.4074,535,0,0,535
11/16/22,Winter Olympics 2022,39.9042,116.4074,535,0,0,535
11/17/22,Winter Olympics 2022,39.9042,116.4074,535,0,0,535
11/18/22,Winter Olympics 2022,39.9042,116.4074,535,0,0,535
11/19/22,Winter Olympics 2022,39.9042,116.4074,535,0,0,535
11/20/22,Winter Olympics 2022,39.9042,116.4074,535,0,0,535
11/21/22,Winter Olympics 2022,39.9042,116.4074,535,0,0,535
11/22/22,Winter Olympics 2022,39.9042,116.4074,535,0,0,535
11/23/22,Winter Olympics 2022,39.9042,116.4074,535,0,0,535
11/24/22,Winter Olympics 2022,39.9042,116.4074,535,0,0,535
11/25/22,Winter Olympics 2022,39.9042,116.4074,535,0,0,535
11/26/22,Winter Olympics 2022,39.9042,116.4074,535,0,0,535
11/27/22,Winter Olympics 2022,39.9042,116.4074,535,0,0,535
11/28/22,Winter Olympics 2022,39.9042,116.4074,535,0,0,535
11/29/22,Winter Olympics 2022,39.9042,116.4074,535,0,0,535
11/30/22,Winter Olympics 2022,39.9042,116.4074,535,0,0,535
12/1/22,Winter Olympics 2022,39.9042,116.4074,535,0,0,535
12/2/22,Winter Olympics 2022,39.9042,116.4074,535,0,0,535
12/3/22,Winter Olympics 2022,39.9042,116.4074,535,0,0,535
12/4/22,Winter Olympics 2022,39.9042,116.4074,535,0,0,535
12/5/22,Winter Olympics 2022,39.9042,116.4074,535,0,0,535
12/6/22,Winter Olympics 2022,39.9042,116.4074,535,0,0,535
12/7/22,Winter Olympics 2022,39.9042,116.4074,535,0,0,535
12/8/22,Winter Olympics 2022,39.9042,116.4074,535,0,0,535
12/9/22,Winter Olympics 2022,39.9042,116.4074,535,0,0,535
12/10/22,Winter Olympics 2022,39.9042,116.4074,535,0,0,535
12/11/22,Winter Olympics 2022,39.9042,116.4074,535,0,0,535
12/12/22,Winter Olympics 2022,39.9042,116.4074,535,0,0,535
12/13/22,Winter Olympics 2022,39.9042,116.4074,535,0,0,535
12/14/22,Winter Olympics 2022,39.9042,116.4074,535,0,0,535
12/15/22,Winter Olympics 2022,39.9042,116.4074,535,0,0,535
12/16/22,Winter Olympics 2022,39.9042,116.4074,535,0,0,535
12/17/22,Winter Olympics 2022,39.9042,116.4074,535,0,0,535
1/1/22,Yemen,15.552727,48.516388,10127,0,1984,8143
1/2/22,Yemen,15.552727,48.516388,10130,0,1984,8146
1/3/22,Yemen,15.552727,48.516388,10138,0,1984,8154
1/4/22,Yemen,15.552727,48.516388,10143,0,1984,8159
1/5/22,Yemen,15.552727,48.516388,10146,0,1985,8161
1/6/22,Yemen,15.552727,48.516388,10152,0,1986,8166
1/7/22,Yemen,15.552727,48.516388,10159,0,1986,8173
1/8/22,Yemen,15.552727,48.516388,10178,0,1986,8192
1/9/22,Yemen,15.552727,48.516388,10197,0,1986,8211
1/10/22,Yemen,15.552727,48.516388,10197,0,1986,8211
1/11/22,Yemen,15.552727,48.516388,10208,0,1987,8221
1/12/22,Yemen,15.552727,48.516388,10220,0,1987,8233
1/13/22,Yemen,15.552727,48.516388,10233,0,1987,8246
1/14/22,Yemen,15.552727,48.516388,10233,0,1988,8245
1/15/22,Yemen,15.552727,48.516388,10233,0,1988,8245
1/16/22,Yemen,15.552727,48.516388,10252,0,1990,8262
1/17/22,Yemen,15.552727,48.516388,10352,0,1991,8361
1/18/22,Yemen,15.552727,48.516388,10408,0,1992,8416
1/19/22,Yemen,15.552727,48.516388,10449,0,1994,8455
1/20/22,Yemen,15.552727,48.516388,10507,0,1995,8512
1/21/22,Yemen,15.552727,48.516388,10585,0,1995,8590
1/22/22,Yemen,15.552727,48.516388,10585,0,1995,8590
1/23/22,Yemen,15.552727,48.516388,10585,0,1995,8590
1/24/22,Yemen,15.552727,48.516388,10585,0,1995,8590
1/25/22,Yemen,15.552727,48.516388,10585,0,1995,8590
1/26/22,Yemen,15.552727,48.516388,10821,0,2003,8818
1/27/22,Yemen,15.552727,48.516388,10888,0,2005,8883
1/28/22,Yemen,15.552727,48.516388,10942,0,2006,8936
1/29/22,Yemen,15.552727,48.516388,10942,0,2007,8935
1/30/22,Yemen,15.552727,48.516388,10942,0,2011,8931
1/31/22,Yemen,15.552727,48.516388,11019,0,2012,9007
2/1/22,Yemen,15.552727,48.516388,11061,0,2013,9048
2/2/22,Yemen,15.552727,48.516388,11113,0,2018,9095
2/3/22,Yemen,15.552727,48.516388,11145,0,2020,9125
2/4/22,Yemen,15.552727,48.516388,11145,0,2022,9123
2/5/22,Yemen,15.552727,48.516388,11149,0,2026,9123
2/6/22,Yemen,15.552727,48.516388,11166,0,2028,9138
2/7/22,Yemen,15.552727,48.516388,11266,0,2028,9238
2/8/22,Yemen,15.552727,48.516388,11553,0,2088,9465
2/9/22,Yemen,15.552727,48.516388,11579,0,2090,9489
2/10/22,Yemen,15.552727,48.516388,11604,0,2093,9511
2/11/22,Yemen,15.552727,48.516388,11659,0,2100,9559
2/12/22,Yemen,15.552727,48.516388,11664,0,2102,9562
2/13/22,Yemen,15.552727,48.516388,11671,0,2103,9568
2/14/22,Yemen,15.552727,48.516388,11679,0,2107,9572
2/15/22,Yemen,15.552727,48.516388,11699,0,2107,9592
2/16/22,Yemen,15.552727,48.516388,11707,0,2113,9594
2/17/22,Yemen,15.552727,48.516388,11718,0,2114,9604
2/18/22,Yemen,15.552727,48.516388,11731,0,2115,9616
2/19/22,Yemen,15.552727,48.516388,11731,0,2120,9611
2/20/22,Yemen,15.552727,48.516388,11736,0,2122,9614
2/21/22,Yemen,15.552727,48.516388,11741,0,2123,9618
2/22/22,Yemen,15.552727,48.516388,11746,0,2124,9622
2/23/22,Yemen,15.552727,48.516388,11751,0,2130,9621
2/24/22,Yemen,15.552727,48.516388,11751,0,2130,9621
2/25/22,Yemen,15.552727,48.516388,11759,0,2131,9628
2/26/22,Yemen,15.552727,48.516388,11760,0,2133,9627
2/27/22,Yemen,15.552727,48.516388,11769,0,2134,9635
2/28/22,Yemen,15.552727,48.516388,11771,0,2135,9636
3/1/22,Yemen,15.552727,48.516388,11771,0,2135,9636
3/2/22,Yemen,15.552727,48.516388,11771,0,2135,9636
3/3/22,Yemen,15.552727,48.516388,11772,0,2135,9637
3/4/22,Yemen,15.552727,48.516388,11774,0,2135,9639
3/5/22,Yemen,15.552727,48.516388,11775,0,2135,9640
3/6/22,Yemen,15.552727,48.516388,11777,0,2138,9639
3/7/22,Yemen,15.552727,48.516388,11781,0,2138,9643
3/8/22,Yemen,15.552727,48.516388,11781,0,2138,9643
3/9/22,Yemen,15.552727,48.516388,11781,0,2138,9643
3/10/22,Yemen,15.552727,48.516388,11783,0,2139,9644
3/11/22,Yemen,15.552727,48.516388,11783,0,2139,9644
3/12/22,Yemen,15.552727,48.516388,11784,0,2139,9645
3/13/22,Yemen,15.552727,48.516388,11784,0,2139,9645
3/14/22,Yemen,15.552727,48.516388,11793,0,2139,9654
3/15/22,Yemen,15.552727,48.516388,11793,0,2139,9654
3/16/22,Yemen,15.552727,48.516388,11797,0,2140,9657
3/17/22,Yemen,15.552727,48.516388,11797,0,2140,9657
3/18/22,Yemen,15.552727,48.516388,11797,0,2140,9657
3/19/22,Yemen,15.552727,48.516388,11799,0,2140,9659
3/20/22,Yemen,15.552727,48.516388,11801,0,2140,9661
3/21/22,Yemen,15.552727,48.516388,11801,0,2142,9659
3/22/22,Yemen,15.552727,48.516388,11802,0,2142,9660
3/23/22,Yemen,15.552727,48.516388,11802,0,2142,9660
3/24/22,Yemen,15.552727,48.516388,11803,0,2142,9661
3/25/22,Yemen,15.552727,48.516388,11803,0,2142,9661
3/26/22,Yemen,15.552727,48.516388,11803,0,2142,9661
3/27/22,Yemen,15.552727,48.516388,11803,0,2142,9661
3/28/22,Yemen,15.552727,48.516388,11803,0,2142,9661
3/29/22,Yemen,15.552727,48.516388,11803,0,2143,9660
3/30/22,Yemen,15.552727,48.516388,11805,0,2143,9662
3/31/22,Yemen,15.552727,48.516388,11806,0,2143,9663
4/1/22,Yemen,15.552727,48.516388,11806,0,2143,9663
4/2/22,Yemen,15.552727,48.516388,11806,0,2143,9663
4/3/22,Yemen,15.552727,48.516388,11806,0,2143,9663
4/4/22,Yemen,15.552727,48.516388,11808,0,2144,9664
4/5/22,Yemen,15.552727,48.516388,11812,0,2144,9668
4/6/22,Yemen,15.552727,48.516388,11812,0,2144,9668
4/7/22,Yemen,15.552727,48.516388,11812,0,2145,9667
4/8/22,Yemen,15.552727,48.516388,11812,0,2146,9666
4/9/22,Yemen,15.552727,48.516388,11813,0,2147,9666
4/10/22,Yemen,15.552727,48.516388,11813,0,2147,9666
4/11/22,Yemen,15.552727,48.516388,11814,0,2147,9667
4/12/22,Yemen,15.552727,48.516388,11814,0,2147,9667
4/13/22,Yemen,15.552727,48.516388,11815,0,2147,9668
4/14/22,Yemen,15.552727,48.516388,11815,0,2147,9668
4/15/22,Yemen,15.552727,48.516388,11817,0,2148,9669
4/16/22,Yemen,15.552727,48.516388,11817,0,2148,9669
4/17/22,Yemen,15.552727,48.516388,11817,0,2148,9669
4/18/22,Yemen,15.552727,48.516388,11818,0,2148,9670
4/19/22,Yemen,15.552727,48.516388,11818,0,2148,9670
4/20/22,Yemen,15.552727,48.516388,11818,0,2148,9670
4/21/22,Yemen,15.552727,48.516388,11818,0,2148,9670
4/22/22,Yemen,15.552727,48.516388,11818,0,2148,9670
4/23/22,Yemen,15.552727,48.516388,11818,0,2148,9670
4/24/22,Yemen,15.552727,48.516388,11818,0,2149,9669
4/25/22,Yemen,15.552727,48.516388,11818,0,2149,9669
4/26/22,Yemen,15.552727,48.516388,11818,0,2149,9669
4/27/22,Yemen,15.552727,48.516388,11818,0,2149,9669
4/28/22,Yemen,15.552727,48.516388,11818,0,2149,9669
4/29/22,Yemen,15.552727,48.516388,11818,0,2149,9669
4/30/22,Yemen,15.552727,48.516388,11818,0,2149,9669
5/1/22,Yemen,15.552727,48.516388,11818,0,2149,9669
5/2/22,Yemen,15.552727,48.516388,11819,0,2149,9670
5/3/22,Yemen,15.552727,48.516388,11819,0,2149,9670
5/4/22,Yemen,15.552727,48.516388,11819,0,2149,9670
5/5/22,Yemen,15.552727,48.516388,11819,0,2149,9670
5/6/22,Yemen,15.552727,48.516388,11819,0,2149,9670
5/7/22,Yemen,15.552727,48.516388,11819,0,2149,9670
5/8/22,Yemen,15.552727,48.516388,11819,0,2149,9670
5/9/22,Yemen,15.552727,48.516388,11819,0,2149,9670
5/10/22,Yemen,15.552727,48.516388,11819,0,2149,9670
5/11/22,Yemen,15.552727,48.516388,11819,0,2149,9670
5/12/22,Yemen,15.552727,48.516388,11819,0,2149,9670
5/13/22,Yemen,15.552727,48.516388,11819,0,2149,9670
5/14/22,Yemen,15.552727,48.516388,11819,0,2149,9670
5/15/22,Yemen,15.552727,48.516388,11819,0,2149,9670
5/16/22,Yemen,15.552727,48.516388,11819,0,2149,9670
5/17/22,Yemen,15.552727,48.516388,11819,0,2149,9670
5/18/22,Yemen,15.552727,48.516388,11819,0,2149,9670
5/19/22,Yemen,15.552727,48.516388,11819,0,2149,9670
5/20/22,Yemen,15.552727,48.516388,11819,0,2149,9670
5/21/22,Yemen,15.552727,48.516388,11819,0,2149,9670
5/22/22,Yemen,15.552727,48.516388,11819,0,2149,9670
5/23/22,Yemen,15.552727,48.516388,11819,0,2149,9670
5/24/22,Yemen,15.552727,48.516388,11819,0,2149,9670
5/25/22,Yemen,15.552727,48.516388,11819,0,2149,9670
5/26/22,Yemen,15.552727,48.516388,11819,0,2149,9670
5/27/22,Yemen,15.552727,48.516388,11819,0,2149,9670
5/28/22,Yemen,15.552727,48.516388,11819,0,2149,9670
5/29/22,Yemen,15.552727,48.516388,11819,0,2149,9670
5/30/22,Yemen,15.552727,48.516388,11822,0,2149,9673
5/31/22,Yemen,15.552727,48.516388,11822,0,2149,9673
6/1/22,Yemen,15.552727,48.516388,11822,0,2149,9673
6/2/22,Yemen,15.552727,48.516388,11822,0,2149,9673
6/3/22,Yemen,15.552727,48.516388,11822,0,2149,9673
6/4/22,Yemen,15.552727,48.516388,11822,0,2149,9673
6/5/22,Yemen,15.552727,48.516388,11822,0,2149,9673
6/6/22,Yemen,15.552727,48.516388,11822,0,2149,9673
6/7/22,Yemen,15.552727,48.516388,11822,0,2149,9673
6/8/22,Yemen,15.552727,48.516388,11822,0,2149,9673
6/9/22,Yemen,15.552727,48.516388,11822,0,2149,9673
6/10/22,Yemen,15.552727,48.516388,11822,0,2149,9673
6/11/22,Yemen,15.552727,48.516388,11822,0,2149,9673
6/12/22,Yemen,15.552727,48.516388,11822,0,2149,9673
6/13/22,Yemen,15.552727,48.516388,11822,0,2149,9673
6/14/22,Yemen,15.552727,48.516388,11822,0,2149,9673
6/15/22,Yemen,15.552727,48.516388,11822,0,2149,9673
6/16/22,Yemen,15.552727,48.516388,11822,0,2149,9673
6/17/22,Yemen,15.552727,48.516388,11823,0,2149,9674
6/18/22,Yemen,15.552727,48.516388,11823,0,2149,9674
6/19/22,Yemen,15.552727,48.516388,11823,0,2149,9674
6/20/22,Yemen,15.552727,48.516388,11823,0,2149,9674
6/21/22,Yemen,15.552727,48.516388,11824,0,2149,9675
6/22/22,Yemen,15.552727,48.516388,11824,0,2149,9675
6/23/22,Yemen,15.552727,48.516388,11824,0,2149,9675
6/24/22,Yemen,15.552727,48.516388,11824,0,2149,9675
6/25/22,Yemen,15.552727,48.516388,11824,0,2149,9675
6/26/22,Yemen,15.552727,48.516388,11824,0,2149,9675
6/27/22,Yemen,15.552727,48.516388,11824,0,2149,9675
6/28/22,Yemen,15.552727,48.516388,11824,0,2149,9675
6/29/22,Yemen,15.552727,48.516388,11824,0,2149,9675
6/30/22,Yemen,15.552727,48.516388,11824,0,2149,9675
7/1/22,Yemen,15.552727,48.516388,11824,0,2149,9675
7/2/22,Yemen,15.552727,48.516388,11824,0,2149,9675
7/3/22,Yemen,15.552727,48.516388,11824,0,2149,9675
7/4/22,Yemen,15.552727,48.516388,11832,0,2149,9683
7/5/22,Yemen,15.552727,48.516388,11832,0,2149,9683
7/6/22,Yemen,15.552727,48.516388,11832,0,2149,9683
7/7/22,Yemen,15.552727,48.516388,11832,0,2149,9683
7/8/22,Yemen,15.552727,48.516388,11832,0,2149,9683
7/9/22,Yemen,15.552727,48.516388,11832,0,2149,9683
7/10/22,Yemen,15.552727,48.516388,11832,0,2149,9683
7/11/22,Yemen,15.552727,48.516388,11832,0,2149,9683
7/12/22,Yemen,15.552727,48.516388,11832,0,2149,9683
7/13/22,Yemen,15.552727,48.516388,11832,0,2149,9683
7/14/22,Yemen,15.552727,48.516388,11832,0,2149,9683
7/15/22,Yemen,15.552727,48.516388,11832,0,2149,9683
7/16/22,Yemen,15.552727,48.516388,11848,0,2149,9699
7/17/22,Yemen,15.552727,48.516388,11848,0,2149,9699
7/18/22,Yemen,15.552727,48.516388,11848,0,2149,9699
7/19/22,Yemen,15.552727,48.516388,11849,0,2149,9700
7/20/22,Yemen,15.552727,48.516388,11849,0,2149,9700
7/21/22,Yemen,15.552727,48.516388,11849,0,2149,9700
7/22/22,Yemen,15.552727,48.516388,11849,0,2149,9700
7/23/22,Yemen,15.552727,48.516388,11849,0,2149,9700
7/24/22,Yemen,15.552727,48.516388,11849,0,2149,9700
7/25/22,Yemen,15.552727,48.516388,11849,0,2149,9700
7/26/22,Yemen,15.552727,48.516388,11849,0,2149,9700
7/27/22,Yemen,15.552727,48.516388,11849,0,2149,9700
7/28/22,Yemen,15.552727,48.516388,11849,0,2149,9700
7/29/22,Yemen,15.552727,48.516388,11849,0,2149,9700
7/30/22,Yemen,15.552727,48.516388,11877,0,2151,9726
7/31/22,Yemen,15.552727,48.516388,11877,0,2151,9726
8/1/22,Yemen,15.552727,48.516388,11877,0,2151,9726
8/2/22,Yemen,15.552727,48.516388,11877,0,2151,9726
8/3/22,Yemen,15.552727,48.516388,11877,0,2151,9726
8/4/22,Yemen,15.552727,48.516388,11895,0,2152,9743
8/5/22,Yemen,15.552727,48.516388,11895,0,2152,9743
8/6/22,Yemen,15.552727,48.516388,11895,0,2152,9743
8/7/22,Yemen,15.552727,48.516388,11895,0,2152,9743
8/8/22,Yemen,15.552727,48.516388,11903,0,2152,9751
8/9/22,Yemen,15.552727,48.516388,11903,0,2152,9751
8/10/22,Yemen,15.552727,48.516388,11903,0,2152,9751
8/11/22,Yemen,15.552727,48.516388,11903,0,2152,9751
8/12/22,Yemen,15.552727,48.516388,11903,0,2152,9751
8/13/22,Yemen,15.552727,48.516388,11903,0,2152,9751
8/14/22,Yemen,15.552727,48.516388,11903,0,2152,9751
8/15/22,Yemen,15.552727,48.516388,11903,0,2152,9751
8/16/22,Yemen,15.552727,48.516388,11903,0,2152,9751
8/17/22,Yemen,15.552727,48.516388,11903,0,2152,9751
8/18/22,Yemen,15.552727,48.516388,11914,0,2152,9762
8/19/22,Yemen,15.552727,48.516388,11915,0,2153,9762
8/20/22,Yemen,15.552727,48.516388,11915,0,2153,9762
8/21/22,Yemen,15.552727,48.516388,11915,0,2154,9761
8/22/22,Yemen,15.552727,48.516388,11915,0,2154,9761
8/23/22,Yemen,15.552727,48.516388,11917,0,2154,9763
8/24/22,Yemen,15.552727,48.516388,11919,0,2155,9764
8/25/22,Yemen,15.552727,48.516388,11922,0,2155,9767
8/26/22,Yemen,15.552727,48.516388,11922,0,2155,9767
8/27/22,Yemen,15.552727,48.516388,11925,0,2155,9770
8/28/22,Yemen,15.552727,48.516388,11925,0,2155,9770
8/29/22,Yemen,15.552727,48.516388,11925,0,2155,9770
8/30/22,Yemen,15.552727,48.516388,11926,0,2155,9771
8/31/22,Yemen,15.552727,48.516388,11926,0,2155,9771
9/1/22,Yemen,15.552727,48.516388,11926,0,2155,9771
9/2/22,Yemen,15.552727,48.516388,11926,0,2155,9771
9/3/22,Yemen,15.552727,48.516388,11926,0,2155,9771
9/4/22,Yemen,15.552727,48.516388,11931,0,2155,9776
9/5/22,Yemen,15.552727,48.516388,11931,0,2155,9776
9/6/22,Yemen,15.552727,48.516388,11931,0,2155,9776
9/7/22,Yemen,15.552727,48.516388,11931,0,2155,9776
9/8/22,Yemen,15.552727,48.516388,11932,0,2155,9777
9/9/22,Yemen,15.552727,48.516388,11932,0,2155,9777
9/10/22,Yemen,15.552727,48.516388,11932,0,2155,9777
9/11/22,Yemen,15.552727,48.516388,11932,0,2155,9777
9/12/22,Yemen,15.552727,48.516388,11932,0,2155,9777
9/13/22,Yemen,15.552727,48.516388,11932,0,2155,9777
9/14/22,Yemen,15.552727,48.516388,11932,0,2155,9777
9/15/22,Yemen,15.552727,48.516388,11932,0,2155,9777
9/16/22,Yemen,15.552727,48.516388,11932,0,2155,9777
9/17/22,Yemen,15.552727,48.516388,11932,0,2155,9777
9/18/22,Yemen,15.552727,48.516388,11932,0,2155,9777
9/19/22,Yemen,15.552727,48.516388,11932,0,2155,9777
9/20/22,Yemen,15.552727,48.516388,11932,0,2155,9777
9/21/22,Yemen,15.552727,48.516388,11932,0,2155,9777
9/22/22,Yemen,15.552727,48.516388,11934,0,2157,9777
9/23/22,Yemen,15.552727,48.516388,11934,0,2157,9777
9/24/22,Yemen,15.552727,48.516388,11935,0,2157,9778
9/25/22,Yemen,15.552727,48.516388,11935,0,2157,9778
9/26/22,Yemen,15.552727,48.516388,11935,0,2157,9778
9/27/22,Yemen,15.552727,48.516388,11935,0,2157,9778
9/28/22,Yemen,15.552727,48.516388,11935,0,2157,9778
9/29/22,Yemen,15.552727,48.516388,11935,0,2157,9778
9/30/22,Yemen,15.552727,48.516388,11935,0,2157,9778
10/1/22,Yemen,15.552727,48.516388,11935,0,2157,9778
10/2/22,Yemen,15.552727,48.516388,11935,0,2157,9778
10/3/22,Yemen,15.552727,48.516388,11935,0,2157,9778
10/4/22,Yemen,15.552727,48.516388,11935,0,2157,9778
10/5/22,Yemen,15.552727,48.516388,11939,0,2158,9781
10/6/22,Yemen,15.552727,48.516388,11939,0,2158,9781
10/7/22,Yemen,15.552727,48.516388,11939,0,2158,9781
10/8/22,Yemen,15.552727,48.516388,11939,0,2158,9781
10/9/22,Yemen,15.552727,48.516388,11939,0,2158,9781
10/10/22,Yemen,15.552727,48.516388,11939,0,2158,9781
10/11/22,Yemen,15.552727,48.516388,11939,0,2158,9781
10/12/22,Yemen,15.552727,48.516388,11939,0,2158,9781
10/13/22,Yemen,15.552727,48.516388,11939,0,2158,9781
10/14/22,Yemen,15.552727,48.516388,11939,0,2158,9781
10/15/22,Yemen,15.552727,48.516388,11939,0,2158,9781
10/16/22,Yemen,15.552727,48.516388,11939,0,2158,9781
10/17/22,Yemen,15.552727,48.516388,11939,0,2158,9781
10/18/22,Yemen,15.552727,48.516388,11939,0,2158,9781
10/19/22,Yemen,15.552727,48.516388,11939,0,2158,9781
10/20/22,Yemen,15.552727,48.516388,11939,0,2158,9781
10/21/22,Yemen,15.552727,48.516388,11939,0,2158,9781
10/22/22,Yemen,15.552727,48.516388,11939,0,2158,9781
10/23/22,Yemen,15.552727,48.516388,11939,0,2158,9781
10/24/22,Yemen,15.552727,48.516388,11939,0,2158,9781
10/25/22,Yemen,15.552727,48.516388,11939,0,2158,9781
10/26/22,Yemen,15.552727,48.516388,11939,0,2158,9781
10/27/22,Yemen,15.552727,48.516388,11939,0,2158,9781
10/28/22,Yemen,15.552727,48.516388,11939,0,2158,9781
10/29/22,Yemen,15.552727,48.516388,11939,0,2158,9781
10/30/22,Yemen,15.552727,48.516388,11939,0,2158,9781
10/31/22,Yemen,15.552727,48.516388,11939,0,2158,9781
11/1/22,Yemen,15.552727,48.516388,11939,0,2158,9781
11/2/22,Yemen,15.552727,48.516388,11944,0,2158,9786
11/3/22,Yemen,15.552727,48.516388,11944,0,2158,9786
11/4/22,Yemen,15.552727,48.516388,11945,0,2159,9786
11/5/22,Yemen,15.552727,48.516388,11945,0,2159,9786
11/6/22,Yemen,15.552727,48.516388,11945,0,2159,9786
11/7/22,Yemen,15.552727,48.516388,11945,0,2159,9786
11/8/22,Yemen,15.552727,48.516388,11945,0,2159,9786
11/9/22,Yemen,15.552727,48.516388,11945,0,2159,9786
11/10/22,Yemen,15.552727,48.516388,11945,0,2159,9786
11/11/22,Yemen,15.552727,48.516388,11945,0,2159,9786
11/12/22,Yemen,15.552727,48.516388,11945,0,2159,9786
11/13/22,Yemen,15.552727,48.516388,11945,0,2159,9786
11/14/22,Yemen,15.552727,48.516388,11945,0,2159,9786
11/15/22,Yemen,15.552727,48.516388,11945,0,2159,9786
11/16/22,Yemen,15.552727,48.516388,11945,0,2159,9786
11/17/22,Yemen,15.552727,48.516388,11945,0,2159,9786
11/18/22,Yemen,15.552727,48.516388,11945,0,2159,9786
11/19/22,Yemen,15.552727,48.516388,11945,0,2159,9786
11/20/22,Yemen,15.552727,48.516388,11945,0,2159,9786
11/21/22,Yemen,15.552727,48.516388,11945,0,2159,9786
11/22/22,Yemen,15.552727,48.516388,11945,0,2159,9786
11/23/22,Yemen,15.552727,48.516388,11945,0,2159,9786
11/24/22,Yemen,15.552727,48.516388,11945,0,2159,9786
11/25/22,Yemen,15.552727,48.516388,11945,0,2159,9786
11/26/22,Yemen,15.552727,48.516388,11945,0,2159,9786
11/27/22,Yemen,15.552727,48.516388,11945,0,2159,9786
11/28/22,Yemen,15.552727,48.516388,11945,0,2159,9786
11/29/22,Yemen,15.552727,48.516388,11945,0,2159,9786
11/30/22,Yemen,15.552727,48.516388,11945,0,2159,9786
12/1/22,Yemen,15.552727,48.516388,11945,0,2159,9786
12/2/22,Yemen,15.552727,48.516388,11945,0,2159,9786
12/3/22,Yemen,15.552727,48.516388,11945,0,2159,9786
12/4/22,Yemen,15.552727,48.516388,11945,0,2159,9786
12/5/22,Yemen,15.552727,48.516388,11945,0,2159,9786
12/6/22,Yemen,15.552727,48.516388,11945,0,2159,9786
12/7/22,Yemen,15.552727,48.516388,11945,0,2159,9786
12/8/22,Yemen,15.552727,48.516388,11945,0,2159,9786
12/9/22,Yemen,15.552727,48.516388,11945,0,2159,9786
12/10/22,Yemen,15.552727,48.516388,11945,0,2159,9786
12/11/22,Yemen,15.552727,48.516388,11945,0,2159,9786
12/12/22,Yemen,15.552727,48.516388,11945,0,2159,9786
12/13/22,Yemen,15.552727,48.516388,11945,0,2159,9786
12/14/22,Yemen,15.552727,48.516388,11945,0,2159,9786
12/15/22,Yemen,15.552727,48.516388,11945,0,2159,9786
12/16/22,Yemen,15.552727,48.516388,11945,0,2159,9786
12/17/22,Yemen,15.552727,48.516388,11945,0,2159,9786
1/1/22,Zambia,-13.133897,27.849332,257948,0,3740,254208
1/2/22,Zambia,-13.133897,27.849332,259677,0,3743,255934
1/3/22,Zambia,-13.133897,27.849332,261221,0,3753,257468
1/4/22,Zambia,-13.133897,27.849332,265479,0,3762,261717
1/5/22,Zambia,-13.133897,27.849332,269991,0,3772,266219
1/6/22,Zambia,-13.133897,27.849332,274087,0,3782,270305
1/7/22,Zambia,-13.133897,27.849332,278276,0,3790,274486
1/8/22,Zambia,-13.133897,27.849332,281576,0,3798,277778
1/9/22,Zambia,-13.133897,27.849332,282904,0,3812,279092
1/10/22,Zambia,-13.133897,27.849332,284389,0,3817,280572
1/11/22,Zambia,-13.133897,27.849332,287110,0,3825,283285
1/12/22,Zambia,-13.133897,27.849332,289415,0,3830,285585
1/13/22,Zambia,-13.133897,27.849332,291582,0,3834,287748
1/14/22,Zambia,-13.133897,27.849332,293695,0,3844,289851
1/15/22,Zambia,-13.133897,27.849332,295028,0,3852,291176
1/16/22,Zambia,-13.133897,27.849332,296132,0,3860,292272
1/17/22,Zambia,-13.133897,27.849332,296817,0,3866,292951
1/18/22,Zambia,-13.133897,27.849332,298032,0,3873,294159
1/19/22,Zambia,-13.133897,27.849332,299172,0,3877,295295
1/20/22,Zambia,-13.133897,27.849332,299971,0,3879,296092
1/21/22,Zambia,-13.133897,27.849332,300587,0,3885,296702
1/22/22,Zambia,-13.133897,27.849332,301203,0,3890,297313
1/23/22,Zambia,-13.133897,27.849332,301630,0,3895,297735
1/24/22,Zambia,-13.133897,27.849332,301924,0,3900,298024
1/25/22,Zambia,-13.133897,27.849332,302569,0,3905,298664
1/26/22,Zambia,-13.133897,27.849332,303266,0,3906,299360
1/27/22,Zambia,-13.133897,27.849332,304002,0,3907,300095
1/28/22,Zambia,-13.133897,27.849332,304353,0,3910,300443
1/29/22,Zambia,-13.133897,27.849332,304656,0,3914,300742
1/30/22,Zambia,-13.133897,27.849332,304922,0,3915,301007
1/31/22,Zambia,-13.133897,27.849332,305047,0,3917,301130
2/1/22,Zambia,-13.133897,27.849332,305557,0,3920,301637
2/2/22,Zambia,-13.133897,27.849332,305959,0,3921,302038
2/3/22,Zambia,-13.133897,27.849332,306347,0,3925,302422
2/4/22,Zambia,-13.133897,27.849332,306777,0,3928,302849
2/5/22,Zambia,-13.133897,27.849332,306777,0,3928,302849
2/6/22,Zambia,-13.133897,27.849332,307206,0,3930,303276
2/7/22,Zambia,-13.133897,27.849332,307317,0,3933,303384
2/8/22,Zambia,-13.133897,27.849332,307636,0,3933,303703
2/9/22,Zambia,-13.133897,27.849332,308050,0,3934,304116
2/10/22,Zambia,-13.133897,27.849332,308556,0,3935,304621
2/11/22,Zambia,-13.133897,27.849332,309013,0,3936,305077
2/12/22,Zambia,-13.133897,27.849332,309293,0,3937,305356
2/13/22,Zambia,-13.133897,27.849332,309502,0,3937,305565
2/14/22,Zambia,-13.133897,27.849332,309579,0,3938,305641
2/15/22,Zambia,-13.133897,27.849332,309870,0,3939,305931
2/16/22,Zambia,-13.133897,27.849332,310155,0,3939,306216
2/17/22,Zambia,-13.133897,27.849332,310474,0,3941,306533
2/18/22,Zambia,-13.133897,27.849332,310764,0,3942,306822
2/19/22,Zambia,-13.133897,27.849332,311016,0,3943,307073
2/20/22,Zambia,-13.133897,27.849332,311194,0,3943,307251
2/21/22,Zambia,-13.133897,27.849332,311264,0,3945,307319
2/22/22,Zambia,-13.133897,27.849332,311592,0,3946,307646
2/23/22,Zambia,-13.133897,27.849332,311888,0,3947,307941
2/24/22,Zambia,-13.133897,27.849332,312118,0,3947,308171
2/25/22,Zambia,-13.133897,27.849332,312374,0,3947,308427
2/26/22,Zambia,-13.133897,27.849332,312611,0,3951,308660
2/27/22,Zambia,-13.133897,27.849332,312707,0,3952,308755
2/28/22,Zambia,-13.133897,27.849332,312750,0,3952,308798
3/1/22,Zambia,-13.133897,27.849332,312970,0,3953,309017
3/2/22,Zambia,-13.133897,27.849332,313203,0,3955,309248
3/3/22,Zambia,-13.133897,27.849332,313394,0,3957,309437
3/4/22,Zambia,-13.133897,27.849332,313613,0,3958,309655
3/5/22,Zambia,-13.133897,27.849332,313744,0,3958,309786
3/6/22,Zambia,-13.133897,27.849332,313821,0,3959,309862
3/7/22,Zambia,-13.133897,27.849332,313910,0,3959,309951
3/8/22,Zambia,-13.133897,27.849332,314159,0,3959,310200
3/9/22,Zambia,-13.133897,27.849332,314641,0,3960,310681
3/10/22,Zambia,-13.133897,27.849332,314850,0,3960,310890
3/11/22,Zambia,-13.133897,27.849332,314986,0,3960,311026
3/12/22,Zambia,-13.133897,27.849332,315148,0,3960,311188
3/13/22,Zambia,-13.133897,27.849332,315202,0,3960,311242
3/14/22,Zambia,-13.133897,27.849332,315202,0,3960,311242
3/15/22,Zambia,-13.133897,27.849332,315202,0,3960,311242
3/16/22,Zambia,-13.133897,27.849332,315496,0,3961,311535
3/17/22,Zambia,-13.133897,27.849332,315623,0,3962,311661
3/18/22,Zambia,-13.133897,27.849332,315623,0,3962,311661
3/19/22,Zambia,-13.133897,27.849332,315623,0,3962,311661
3/20/22,Zambia,-13.133897,27.849332,315623,0,3962,311661
3/21/22,Zambia,-13.133897,27.849332,315892,0,3963,311929
3/22/22,Zambia,-13.133897,27.849332,316088,0,3963,312125
3/23/22,Zambia,-13.133897,27.849332,316190,0,3964,312226
3/24/22,Zambia,-13.133897,27.849332,316312,0,3965,312347
3/25/22,Zambia,-13.133897,27.849332,316422,0,3966,312456
3/26/22,Zambia,-13.133897,27.849332,316501,0,3966,312535
3/27/22,Zambia,-13.133897,27.849332,316550,0,3966,312584
3/28/22,Zambia,-13.133897,27.849332,316550,0,3966,312584
3/29/22,Zambia,-13.133897,27.849332,316550,0,3966,312584
3/30/22,Zambia,-13.133897,27.849332,316550,0,3966,312584
3/31/22,Zambia,-13.133897,27.849332,316850,0,3966,312884
4/1/22,Zambia,-13.133897,27.849332,316941,0,3966,312975
4/2/22,Zambia,-13.133897,27.849332,317031,0,3967,313064
4/3/22,Zambia,-13.133897,27.849332,317031,0,3967,313064
4/4/22,Zambia,-13.133897,27.849332,317110,0,3967,313143
4/5/22,Zambia,-13.133897,27.849332,317221,0,3967,313254
4/6/22,Zambia,-13.133897,27.849332,317358,0,3967,313391
4/7/22,Zambia,-13.133897,27.849332,317483,0,3967,313516
4/8/22,Zambia,-13.133897,27.849332,317483,0,3967,313516
4/9/22,Zambia,-13.133897,27.849332,317483,0,3967,313516
4/10/22,Zambia,-13.133897,27.849332,317483,0,3967,313516
4/11/22,Zambia,-13.133897,27.849332,317804,0,3967,313837
4/12/22,Zambia,-13.133897,27.849332,317804,0,3968,313836
4/13/22,Zambia,-13.133897,27.849332,318113,0,3969,314144
4/14/22,Zambia,-13.133897,27.849332,318229,0,3969,314260
4/15/22,Zambia,-13.133897,27.849332,318404,0,3970,314434
4/16/22,Zambia,-13.133897,27.849332,318467,0,3973,314494
4/17/22,Zambia,-13.133897,27.849332,318515,0,3973,314542
4/18/22,Zambia,-13.133897,27.849332,318515,0,3973,314542
4/19/22,Zambia,-13.133897,27.849332,318640,0,3973,314667
4/20/22,Zambia,-13.133897,27.849332,318640,0,3973,314667
4/21/22,Zambia,-13.133897,27.849332,318984,0,3974,315010
4/22/22,Zambia,-13.133897,27.849332,318984,0,3974,315010
4/23/22,Zambia,-13.133897,27.849332,318984,0,3974,315010
4/24/22,Zambia,-13.133897,27.849332,318984,0,3974,315010
4/25/22,Zambia,-13.133897,27.849332,319316,0,3976,315340
4/26/22,Zambia,-13.133897,27.849332,319431,0,3976,315455
4/27/22,Zambia,-13.133897,27.849332,319431,0,3976,315455
4/28/22,Zambia,-13.133897,27.849332,319594,0,3976,315618
4/29/22,Zambia,-13.133897,27.849332,319594,0,3976,315618
4/30/22,Zambia,-13.133897,27.849332,319594,0,3976,315618
5/1/22,Zambia,-13.133897,27.849332,319733,0,3976,315757
5/2/22,Zambia,-13.133897,27.849332,319755,0,3976,315779
5/3/22,Zambia,-13.133897,27.849332,319755,0,3976,315779
5/4/22,Zambia,-13.133897,27.849332,319755,0,3976,315779
5/5/22,Zambia,-13.133897,27.849332,319755,0,3976,315779
5/6/22,Zambia,-13.133897,27.849332,319755,0,3976,315779
5/7/22,Zambia,-13.133897,27.849332,320099,0,3982,316117
5/8/22,Zambia,-13.133897,27.849332,320099,0,3982,316117
5/9/22,Zambia,-13.133897,27.849332,320157,0,3982,316175
5/10/22,Zambia,-13.133897,27.849332,320226,0,3983,316243
5/11/22,Zambia,-13.133897,27.849332,320303,0,3983,316320
5/12/22,Zambia,-13.133897,27.849332,320412,0,3983,316429
5/13/22,Zambia,-13.133897,27.849332,320481,0,3983,316498
5/14/22,Zambia,-13.133897,27.849332,320591,0,3983,316608
5/15/22,Zambia,-13.133897,27.849332,320627,0,3983,316644
5/16/22,Zambia,-13.133897,27.849332,320680,0,3983,316697
5/17/22,Zambia,-13.133897,27.849332,320680,0,3983,316697
5/18/22,Zambia,-13.133897,27.849332,320680,0,3983,316697
5/19/22,Zambia,-13.133897,27.849332,320945,0,3984,316961
5/20/22,Zambia,-13.133897,27.849332,320945,0,3984,316961
5/21/22,Zambia,-13.133897,27.849332,321099,0,3984,317115
5/22/22,Zambia,-13.133897,27.849332,321146,0,3985,317161
5/23/22,Zambia,-13.133897,27.849332,321195,0,3985,317210
5/24/22,Zambia,-13.133897,27.849332,321268,0,3985,317283
5/25/22,Zambia,-13.133897,27.849332,321342,0,3985,317357
5/26/22,Zambia,-13.133897,27.849332,321399,0,3985,317414
5/27/22,Zambia,-13.133897,27.849332,321503,0,3985,317518
5/28/22,Zambia,-13.133897,27.849332,321503,0,3985,317518
5/29/22,Zambia,-13.133897,27.849332,321503,0,3985,317518
5/30/22,Zambia,-13.133897,27.849332,321503,0,3985,317518
5/31/22,Zambia,-13.133897,27.849332,321779,0,3987,317792
6/1/22,Zambia,-13.133897,27.849332,321915,0,3987,317928
6/2/22,Zambia,-13.133897,27.849332,321915,0,3987,317928
6/3/22,Zambia,-13.133897,27.849332,322207,0,3988,318219
6/4/22,Zambia,-13.133897,27.849332,322207,0,3988,318219
6/5/22,Zambia,-13.133897,27.849332,322207,0,3988,318219
6/6/22,Zambia,-13.133897,27.849332,322207,0,3988,318219
6/7/22,Zambia,-13.133897,27.849332,322562,0,3988,318574
6/8/22,Zambia,-13.133897,27.849332,322790,0,3988,318802
6/9/22,Zambia,-13.133897,27.849332,322919,0,3989,318930
6/10/22,Zambia,-13.133897,27.849332,323058,0,3989,319069
6/11/22,Zambia,-13.133897,27.849332,323058,0,3989,319069
6/12/22,Zambia,-13.133897,27.849332,323058,0,3989,319069
6/13/22,Zambia,-13.133897,27.849332,323283,0,3989,319294
6/14/22,Zambia,-13.133897,27.849332,323337,0,3989,319348
6/15/22,Zambia,-13.133897,27.849332,323654,0,3990,319664
6/16/22,Zambia,-13.133897,27.849332,323654,0,3990,319664
6/17/22,Zambia,-13.133897,27.849332,324025,0,3992,320033
6/18/22,Zambia,-13.133897,27.849332,324025,0,3992,320033
6/19/22,Zambia,-13.133897,27.849332,324288,0,3994,320294
6/20/22,Zambia,-13.133897,27.849332,324344,0,3997,320347
6/21/22,Zambia,-13.133897,27.849332,324558,0,3998,320560
6/22/22,Zambia,-13.133897,27.849332,324558,0,3998,320560
6/23/22,Zambia,-13.133897,27.849332,324922,0,4000,320922
6/24/22,Zambia,-13.133897,27.849332,325110,0,4003,321107
6/25/22,Zambia,-13.133897,27.849332,325110,0,4003,321107
6/26/22,Zambia,-13.133897,27.849332,325110,0,4003,321107
6/27/22,Zambia,-13.133897,27.849332,325348,0,4003,321345
6/28/22,Zambia,-13.133897,27.849332,325498,0,4003,321495
6/29/22,Zambia,-13.133897,27.849332,325498,0,4003,321495
6/30/22,Zambia,-13.133897,27.849332,325857,0,4006,321851
7/1/22,Zambia,-13.133897,27.849332,325857,0,4006,321851
7/2/22,Zambia,-13.133897,27.849332,325857,0,4006,321851
7/3/22,Zambia,-13.133897,27.849332,326259,0,4007,322252
7/4/22,Zambia,-13.133897,27.849332,326259,0,4007,322252
7/5/22,Zambia,-13.133897,27.849332,326259,0,4007,322252
7/6/22,Zambia,-13.133897,27.849332,326408,0,4008,322400
7/7/22,Zambia,-13.133897,27.849332,326651,0,4008,322643
7/8/22,Zambia,-13.133897,27.849332,326794,0,4008,322786
7/9/22,Zambia,-13.133897,27.849332,326794,0,4008,322786
7/10/22,Zambia,-13.133897,27.849332,327052,0,4008,323044
7/11/22,Zambia,-13.133897,27.849332,327102,0,4008,323094
7/12/22,Zambia,-13.133897,27.849332,327102,0,4008,323094
7/13/22,Zambia,-13.133897,27.849332,327102,0,4008,323094
7/14/22,Zambia,-13.133897,27.849332,327102,0,4008,323094
7/15/22,Zambia,-13.133897,27.849332,327994,0,4009,323985
7/16/22,Zambia,-13.133897,27.849332,327994,0,4009,323985
7/17/22,Zambia,-13.133897,27.849332,327994,0,4009,323985
7/18/22,Zambia,-13.133897,27.849332,327994,0,4009,323985
7/19/22,Zambia,-13.133897,27.849332,328550,0,4013,324537
7/20/22,Zambia,-13.133897,27.849332,328550,0,4013,324537
7/21/22,Zambia,-13.133897,27.849332,328550,0,4013,324537
7/22/22,Zambia,-13.133897,27.849332,328550,0,4013,324537
7/23/22,Zambia,-13.133897,27.849332,328550,0,4013,324537
7/24/22,Zambia,-13.133897,27.849332,328550,0,4013,324537
7/25/22,Zambia,-13.133897,27.849332,329483,0,4015,325468
7/26/22,Zambia,-13.133897,27.849332,329483,0,4015,325468
7/27/22,Zambia,-13.133897,27.849332,329483,0,4015,325468
7/28/22,Zambia,-13.133897,27.849332,329483,0,4015,325468
7/29/22,Zambia,-13.133897,27.849332,329483,0,4015,325468
7/30/22,Zambia,-13.133897,27.849332,329483,0,4015,325468
7/31/22,Zambia,-13.133897,27.849332,329483,0,4015,325468
8/1/22,Zambia,-13.133897,27.849332,329483,0,4015,325468
8/2/22,Zambia,-13.133897,27.849332,330575,0,4015,326560
8/3/22,Zambia,-13.133897,27.849332,330575,0,4015,326560
8/4/22,Zambia,-13.133897,27.849332,330575,0,4015,326560
8/5/22,Zambia,-13.133897,27.849332,331074,0,4015,327059
8/6/22,Zambia,-13.133897,27.849332,331074,0,4016,327058
8/7/22,Zambia,-13.133897,27.849332,331358,0,4016,327342
8/8/22,Zambia,-13.133897,27.849332,331358,0,4016,327342
8/9/22,Zambia,-13.133897,27.849332,331568,0,4016,327552
8/10/22,Zambia,-13.133897,27.849332,331568,0,4016,327552
8/11/22,Zambia,-13.133897,27.849332,331568,0,4016,327552
8/12/22,Zambia,-13.133897,27.849332,331925,0,4016,327909
8/13/22,Zambia,-13.133897,27.849332,331925,0,4016,327909
8/14/22,Zambia,-13.133897,27.849332,331925,0,4016,327909
8/15/22,Zambia,-13.133897,27.849332,332014,0,4016,327998
8/16/22,Zambia,-13.133897,27.849332,332014,0,4016,327998
8/17/22,Zambia,-13.133897,27.849332,332264,0,4016,328248
8/18/22,Zambia,-13.133897,27.849332,332264,0,4016,328248
8/19/22,Zambia,-13.133897,27.849332,332264,0,4016,328248
8/20/22,Zambia,-13.133897,27.849332,332264,0,4016,328248
8/21/22,Zambia,-13.133897,27.849332,332264,0,4016,328248
8/22/22,Zambia,-13.133897,27.849332,332527,0,4016,328511
8/23/22,Zambia,-13.133897,27.849332,332527,0,4016,328511
8/24/22,Zambia,-13.133897,27.849332,332648,0,4016,328632
8/25/22,Zambia,-13.133897,27.849332,332710,0,4016,328694
8/26/22,Zambia,-13.133897,27.849332,332710,0,4016,328694
8/27/22,Zambia,-13.133897,27.849332,332710,0,4016,328694
8/28/22,Zambia,-13.133897,27.849332,332710,0,4016,328694
8/29/22,Zambia,-13.133897,27.849332,332822,0,4016,328806
8/30/22,Zambia,-13.133897,27.849332,332822,0,4016,328806
8/31/22,Zambia,-13.133897,27.849332,332822,0,4016,328806
9/1/22,Zambia,-13.133897,27.849332,332822,0,4016,328806
9/2/22,Zambia,-13.133897,27.849332,332822,0,4016,328806
9/3/22,Zambia,-13.133897,27.849332,332822,0,4016,328806
9/4/22,Zambia,-13.133897,27.849332,333074,0,4017,329057
9/5/22,Zambia,-13.133897,27.849332,333086,0,4017,329069
9/6/22,Zambia,-13.133897,27.849332,333124,0,4017,329107
9/7/22,Zambia,-13.133897,27.849332,333150,0,4017,329133
9/8/22,Zambia,-13.133897,27.849332,333180,0,4017,329163
9/9/22,Zambia,-13.133897,27.849332,333204,0,4017,329187
9/10/22,Zambia,-13.133897,27.849332,333220,0,4017,329203
9/11/22,Zambia,-13.133897,27.849332,333229,0,4017,329212
9/12/22,Zambia,-13.133897,27.849332,333234,0,4017,329217
9/13/22,Zambia,-13.133897,27.849332,333274,0,4017,329257
9/14/22,Zambia,-13.133897,27.849332,333313,0,4017,329296
9/15/22,Zambia,-13.133897,27.849332,333337,0,4017,329320
9/16/22,Zambia,-13.133897,27.849332,333363,0,4017,329346
9/17/22,Zambia,-13.133897,27.849332,333375,0,4017,329358
9/18/22,Zambia,-13.133897,27.849332,333382,0,4017,329365
9/19/22,Zambia,-13.133897,27.849332,333387,0,4017,329370
9/20/22,Zambia,-13.133897,27.849332,333387,0,4017,329370
9/21/22,Zambia,-13.133897,27.849332,333439,0,4017,329422
9/22/22,Zambia,-13.133897,27.849332,333439,0,4017,329422
9/23/22,Zambia,-13.133897,27.849332,333439,0,4017,329422
9/24/22,Zambia,-13.133897,27.849332,333439,0,4017,329422
9/25/22,Zambia,-13.133897,27.849332,333439,0,4017,329422
9/26/22,Zambia,-13.133897,27.849332,333439,0,4017,329422
9/27/22,Zambia,-13.133897,27.849332,333503,0,4017,329486
9/28/22,Zambia,-13.133897,27.849332,333503,0,4017,329486
9/29/22,Zambia,-13.133897,27.849332,333531,0,4017,329514
9/30/22,Zambia,-13.133897,27.849332,333531,0,4017,329514
10/1/22,Zambia,-13.133897,27.849332,333549,0,4017,329532
10/2/22,Zambia,-13.133897,27.849332,333549,0,4017,329532
10/3/22,Zambia,-13.133897,27.849332,333555,0,4017,329538
10/4/22,Zambia,-13.133897,27.849332,333555,0,4017,329538
10/5/22,Zambia,-13.133897,27.849332,333555,0,4017,329538
10/6/22,Zambia,-13.133897,27.849332,333555,0,4017,329538
10/7/22,Zambia,-13.133897,27.849332,333555,0,4017,329538
10/8/22,Zambia,-13.133897,27.849332,333555,0,4017,329538
10/9/22,Zambia,-13.133897,27.849332,333555,0,4017,329538
10/10/22,Zambia,-13.133897,27.849332,333624,0,4017,329607
10/11/22,Zambia,-13.133897,27.849332,333624,0,4017,329607
10/12/22,Zambia,-13.133897,27.849332,333624,0,4017,329607
10/13/22,Zambia,-13.133897,27.849332,333624,0,4017,329607
10/14/22,Zambia,-13.133897,27.849332,333624,0,4017,329607
10/15/22,Zambia,-13.133897,27.849332,333624,0,4017,329607
10/16/22,Zambia,-13.133897,27.849332,333624,0,4017,329607
10/17/22,Zambia,-13.133897,27.849332,333644,0,4017,329627
10/18/22,Zambia,-13.133897,27.849332,333644,0,4017,329627
10/19/22,Zambia,-13.133897,27.849332,333644,0,4017,329627
10/20/22,Zambia,-13.133897,27.849332,333644,0,4017,329627
10/21/22,Zambia,-13.133897,27.849332,333644,0,4017,329627
10/22/22,Zambia,-13.133897,27.849332,333644,0,4017,329627
10/23/22,Zambia,-13.133897,27.849332,333644,0,4017,329627
10/24/22,Zambia,-13.133897,27.849332,333644,0,4017,329627
10/25/22,Zambia,-13.133897,27.849332,333644,0,4017,329627
10/26/22,Zambia,-13.133897,27.849332,333644,0,4017,329627
10/27/22,Zambia,-13.133897,27.849332,333674,0,4017,329657
10/28/22,Zambia,-13.133897,27.849332,333674,0,4017,329657
10/29/22,Zambia,-13.133897,27.849332,333674,0,4017,329657
10/30/22,Zambia,-13.133897,27.849332,333681,0,4017,329664
10/31/22,Zambia,-13.133897,27.849332,333681,0,4017,329664
11/1/22,Zambia,-13.133897,27.849332,333681,0,4017,329664
11/2/22,Zambia,-13.133897,27.849332,333684,0,4017,329667
11/3/22,Zambia,-13.133897,27.849332,333685,0,4017,329668
11/4/22,Zambia,-13.133897,27.849332,333685,0,4017,329668
11/5/22,Zambia,-13.133897,27.849332,333685,0,4017,329668
11/6/22,Zambia,-13.133897,27.849332,333685,0,4017,329668
11/7/22,Zambia,-13.133897,27.849332,333685,0,4017,329668
11/8/22,Zambia,-13.133897,27.849332,333685,0,4017,329668
11/9/22,Zambia,-13.133897,27.849332,333685,0,4017,329668
11/10/22,Zambia,-13.133897,27.849332,333685,0,4017,329668
11/11/22,Zambia,-13.133897,27.849332,333685,0,4017,329668
11/12/22,Zambia,-13.133897,27.849332,333685,0,4017,329668
11/13/22,Zambia,-13.133897,27.849332,333685,0,4017,329668
11/14/22,Zambia,-13.133897,27.849332,333685,0,4017,329668
11/15/22,Zambia,-13.133897,27.849332,333685,0,4017,329668
11/16/22,Zambia,-13.133897,27.849332,333685,0,4017,329668
11/17/22,Zambia,-13.133897,27.849332,333685,0,4017,329668
11/18/22,Zambia,-13.133897,27.849332,333685,0,4017,329668
11/19/22,Zambia,-13.133897,27.849332,333685,0,4017,329668
11/20/22,Zambia,-13.133897,27.849332,333685,0,4017,329668
11/21/22,Zambia,-13.133897,27.849332,333685,0,4017,329668
11/22/22,Zambia,-13.133897,27.849332,333721,0,4019,329702
11/23/22,Zambia,-13.133897,27.849332,333721,0,4019,329702
11/24/22,Zambia,-13.133897,27.849332,333721,0,4019,329702
11/25/22,Zambia,-13.133897,27.849332,333721,0,4019,329702
11/26/22,Zambia,-13.133897,27.849332,333721,0,4019,329702
11/27/22,Zambia,-13.133897,27.849332,333721,0,4019,329702
11/28/22,Zambia,-13.133897,27.849332,333721,0,4019,329702
11/29/22,Zambia,-13.133897,27.849332,333746,0,4019,329727
11/30/22,Zambia,-13.133897,27.849332,333746,0,4019,329727
12/1/22,Zambia,-13.133897,27.849332,333746,0,4019,329727
12/2/22,Zambia,-13.133897,27.849332,333746,0,4019,329727
12/3/22,Zambia,-13.133897,27.849332,333746,0,4019,329727
12/4/22,Zambia,-13.133897,27.849332,333746,0,4019,329727
12/5/22,Zambia,-13.133897,27.849332,333746,0,4019,329727
12/6/22,Zambia,-13.133897,27.849332,333746,0,4019,329727
12/7/22,Zambia,-13.133897,27.849332,333746,0,4019,329727
12/8/22,Zambia,-13.133897,27.849332,333746,0,4019,329727
12/9/22,Zambia,-13.133897,27.849332,333746,0,4019,329727
12/10/22,Zambia,-13.133897,27.849332,333746,0,4019,329727
12/11/22,Zambia,-13.133897,27.849332,333746,0,4019,329727
12/12/22,Zambia,-13.133897,27.849332,333746,0,4019,329727
12/13/22,Zambia,-13.133897,27.849332,333746,0,4019,329727
12/14/22,Zambia,-13.133897,27.849332,333746,0,4019,329727
12/15/22,Zambia,-13.133897,27.849332,333746,0,4019,329727
12/16/22,Zambia,-13.133897,27.849332,333746,0,4019,329727
12/17/22,Zambia,-13.133897,27.849332,333746,0,4019,329727
1/1/22,Zimbabwe,-19.015438,29.154857,214214,0,5017,209197
1/2/22,Zimbabwe,-19.015438,29.154857,214214,0,5017,209197
1/3/22,Zimbabwe,-19.015438,29.154857,216087,0,5047,211040
1/4/22,Zimbabwe,-19.015438,29.154857,217678,0,5078,212600
1/5/22,Zimbabwe,-19.015438,29.154857,219057,0,5092,213965
1/6/22,Zimbabwe,-19.015438,29.154857,220178,0,5108,215070
1/7/22,Zimbabwe,-19.015438,29.154857,221282,0,5136,216146
1/8/22,Zimbabwe,-19.015438,29.154857,221918,0,5148,216770
1/9/22,Zimbabwe,-19.015438,29.154857,221918,0,5148,216770
1/10/22,Zimbabwe,-19.015438,29.154857,223000,0,5180,217820
1/11/22,Zimbabwe,-19.015438,29.154857,223000,0,5180,217820
1/12/22,Zimbabwe,-19.015438,29.154857,224433,0,5215,219218
1/13/22,Zimbabwe,-19.015438,29.154857,225084,0,5222,219862
1/14/22,Zimbabwe,-19.015438,29.154857,225637,0,5238,220399
1/15/22,Zimbabwe,-19.015438,29.154857,225637,0,5238,220399
1/16/22,Zimbabwe,-19.015438,29.154857,226078,0,5247,220831
1/17/22,Zimbabwe,-19.015438,29.154857,226460,0,5258,221202
1/18/22,Zimbabwe,-19.015438,29.154857,226460,0,5258,221202
1/19/22,Zimbabwe,-19.015438,29.154857,226887,0,5266,221621
1/20/22,Zimbabwe,-19.015438,29.154857,227552,0,5276,222276
1/21/22,Zimbabwe,-19.015438,29.154857,227961,0,5288,222673
1/22/22,Zimbabwe,-19.015438,29.154857,228179,0,5292,222887
1/23/22,Zimbabwe,-19.015438,29.154857,228254,0,5294,222960
1/24/22,Zimbabwe,-19.015438,29.154857,228541,0,5305,223236
1/25/22,Zimbabwe,-19.015438,29.154857,228776,0,5316,223460
1/26/22,Zimbabwe,-19.015438,29.154857,228943,0,5321,223622
1/27/22,Zimbabwe,-19.015438,29.154857,229096,0,5324,223772
1/28/22,Zimbabwe,-19.015438,29.154857,229333,0,5333,224000
1/29/22,Zimbabwe,-19.015438,29.154857,229415,0,5333,224082
1/30/22,Zimbabwe,-19.015438,29.154857,229460,0,5337,224123
1/31/22,Zimbabwe,-19.015438,29.154857,229666,0,5338,224328
2/1/22,Zimbabwe,-19.015438,29.154857,229851,0,5350,224501
2/2/22,Zimbabwe,-19.015438,29.154857,230012,0,5352,224660
2/3/22,Zimbabwe,-19.015438,29.154857,230170,0,5357,224813
2/4/22,Zimbabwe,-19.015438,29.154857,230170,0,5357,224813
2/5/22,Zimbabwe,-19.015438,29.154857,230402,0,5362,225040
2/6/22,Zimbabwe,-19.015438,29.154857,230402,0,5362,225040
2/7/22,Zimbabwe,-19.015438,29.154857,230402,0,5362,225040
2/8/22,Zimbabwe,-19.015438,29.154857,230603,0,5366,225237
2/9/22,Zimbabwe,-19.015438,29.154857,230740,0,5367,225373
2/10/22,Zimbabwe,-19.015438,29.154857,231040,0,5373,225667
2/11/22,Zimbabwe,-19.015438,29.154857,231214,0,5374,225840
2/12/22,Zimbabwe,-19.015438,29.154857,231299,0,5374,225925
2/13/22,Zimbabwe,-19.015438,29.154857,231381,0,5374,226007
2/14/22,Zimbabwe,-19.015438,29.154857,231603,0,5374,226229
2/15/22,Zimbabwe,-19.015438,29.154857,231603,0,5374,226229
2/16/22,Zimbabwe,-19.015438,29.154857,232213,0,5379,226834
2/17/22,Zimbabwe,-19.015438,29.154857,232598,0,5381,227217
2/18/22,Zimbabwe,-19.015438,29.154857,233030,0,5385,227645
2/19/22,Zimbabwe,-19.015438,29.154857,233224,0,5386,227838
2/20/22,Zimbabwe,-19.015438,29.154857,233352,0,5386,227966
2/21/22,Zimbabwe,-19.015438,29.154857,233571,0,5386,228185
2/22/22,Zimbabwe,-19.015438,29.154857,233980,0,5388,228592
2/23/22,Zimbabwe,-19.015438,29.154857,234589,0,5388,229201
2/24/22,Zimbabwe,-19.015438,29.154857,234967,0,5390,229577
2/25/22,Zimbabwe,-19.015438,29.154857,235467,0,5392,230075
2/26/22,Zimbabwe,-19.015438,29.154857,235803,0,5393,230410
2/27/22,Zimbabwe,-19.015438,29.154857,235803,0,5393,230410
2/28/22,Zimbabwe,-19.015438,29.154857,236380,0,5395,230985
3/1/22,Zimbabwe,-19.015438,29.154857,236871,0,5395,231476
3/2/22,Zimbabwe,-19.015438,29.154857,237503,0,5396,232107
3/3/22,Zimbabwe,-19.015438,29.154857,237503,0,5396,232107
3/4/22,Zimbabwe,-19.015438,29.154857,238739,0,5397,233342
3/5/22,Zimbabwe,-19.015438,29.154857,239019,0,5397,233622
3/6/22,Zimbabwe,-19.015438,29.154857,239209,0,5399,233810
3/7/22,Zimbabwe,-19.015438,29.154857,239710,0,5399,234311
3/8/22,Zimbabwe,-19.015438,29.154857,240343,0,5400,234943
3/9/22,Zimbabwe,-19.015438,29.154857,240343,0,5400,234943
3/10/22,Zimbabwe,-19.015438,29.154857,241548,0,5408,236140
3/11/22,Zimbabwe,-19.015438,29.154857,241548,0,5408,236140
3/12/22,Zimbabwe,-19.015438,29.154857,242069,0,5412,236657
3/13/22,Zimbabwe,-19.015438,29.154857,242515,0,5414,237101
3/14/22,Zimbabwe,-19.015438,29.154857,242909,0,5416,237493
3/15/22,Zimbabwe,-19.015438,29.154857,242909,0,5416,237493
3/16/22,Zimbabwe,-19.015438,29.154857,243650,0,5418,238232
3/17/22,Zimbabwe,-19.015438,29.154857,243650,0,5418,238232
3/18/22,Zimbabwe,-19.015438,29.154857,244012,0,5420,238592
3/19/22,Zimbabwe,-19.015438,29.154857,244452,0,5426,239026
3/20/22,Zimbabwe,-19.015438,29.154857,244452,0,5426,239026
3/21/22,Zimbabwe,-19.015438,29.154857,244685,0,5429,239256
3/22/22,Zimbabwe,-19.015438,29.154857,244685,0,5429,239256
3/23/22,Zimbabwe,-19.015438,29.154857,244958,0,5432,239526
3/24/22,Zimbabwe,-19.015438,29.154857,245194,0,5432,239762
3/25/22,Zimbabwe,-19.015438,29.154857,245645,0,5436,240209
3/26/22,Zimbabwe,-19.015438,29.154857,245645,0,5436,240209
3/27/22,Zimbabwe,-19.015438,29.154857,245820,0,5438,240382
3/28/22,Zimbabwe,-19.015438,29.154857,245927,0,5438,240489
3/29/22,Zimbabwe,-19.015438,29.154857,246042,0,5439,240603
3/30/22,Zimbabwe,-19.015438,29.154857,246182,0,5440,240742
3/31/22,Zimbabwe,-19.015438,29.154857,246286,0,5444,240842
4/1/22,Zimbabwe,-19.015438,29.154857,246414,0,5444,240970
4/2/22,Zimbabwe,-19.015438,29.154857,246481,0,5446,241035
4/3/22,Zimbabwe,-19.015438,29.154857,246525,0,5446,241079
4/4/22,Zimbabwe,-19.015438,29.154857,246612,0,5451,241161
4/5/22,Zimbabwe,-19.015438,29.154857,246744,0,5451,241293
4/6/22,Zimbabwe,-19.015438,29.154857,246803,0,5453,241350
4/7/22,Zimbabwe,-19.015438,29.154857,246870,0,5455,241415
4/8/22,Zimbabwe,-19.015438,29.154857,246925,0,5457,241468
4/9/22,Zimbabwe,-19.015438,29.154857,246925,0,5457,241468
4/10/22,Zimbabwe,-19.015438,29.154857,246958,0,5457,241501
4/11/22,Zimbabwe,-19.015438,29.154857,247010,0,5460,241550
4/12/22,Zimbabwe,-19.015438,29.154857,247094,0,5460,241634
4/13/22,Zimbabwe,-19.015438,29.154857,247160,0,5460,241700
4/14/22,Zimbabwe,-19.015438,29.154857,247208,0,5462,241746
4/15/22,Zimbabwe,-19.015438,29.154857,247237,0,5462,241775
4/16/22,Zimbabwe,-19.015438,29.154857,247237,0,5462,241775
4/17/22,Zimbabwe,-19.015438,29.154857,247278,0,5463,241815
4/18/22,Zimbabwe,-19.015438,29.154857,247297,0,5464,241833
4/19/22,Zimbabwe,-19.015438,29.154857,247297,0,5464,241833
4/20/22,Zimbabwe,-19.015438,29.154857,247336,0,5466,241870
4/21/22,Zimbabwe,-19.015438,29.154857,247383,0,5467,241916
4/22/22,Zimbabwe,-19.015438,29.154857,247488,0,5468,242020
4/23/22,Zimbabwe,-19.015438,29.154857,247524,0,5468,242056
4/24/22,Zimbabwe,-19.015438,29.154857,247524,0,5468,242056
4/25/22,Zimbabwe,-19.015438,29.154857,247598,0,5468,242130
4/26/22,Zimbabwe,-19.015438,29.154857,247667,0,5469,242198
4/27/22,Zimbabwe,-19.015438,29.154857,247729,0,5469,242260
4/28/22,Zimbabwe,-19.015438,29.154857,247784,0,5469,242315
4/29/22,Zimbabwe,-19.015438,29.154857,247842,0,5469,242373
4/30/22,Zimbabwe,-19.015438,29.154857,247875,0,5469,242406
5/1/22,Zimbabwe,-19.015438,29.154857,247911,0,5469,242442
5/2/22,Zimbabwe,-19.015438,29.154857,247935,0,5470,242465
5/3/22,Zimbabwe,-19.015438,29.154857,247990,0,5470,242520
5/4/22,Zimbabwe,-19.015438,29.154857,248050,0,5471,242579
5/5/22,Zimbabwe,-19.015438,29.154857,248050,0,5471,242579
5/6/22,Zimbabwe,-19.015438,29.154857,248214,0,5473,242741
5/7/22,Zimbabwe,-19.015438,29.154857,248214,0,5473,242741
5/8/22,Zimbabwe,-19.015438,29.154857,248352,0,5476,242876
5/9/22,Zimbabwe,-19.015438,29.154857,248536,0,5479,243057
5/10/22,Zimbabwe,-19.015438,29.154857,248642,0,5481,243161
5/11/22,Zimbabwe,-19.015438,29.154857,248642,0,5481,243161
5/12/22,Zimbabwe,-19.015438,29.154857,248943,0,5481,243462
5/13/22,Zimbabwe,-19.015438,29.154857,249131,0,5482,243649
5/14/22,Zimbabwe,-19.015438,29.154857,249206,0,5482,243724
5/15/22,Zimbabwe,-19.015438,29.154857,249206,0,5482,243724
5/16/22,Zimbabwe,-19.015438,29.154857,249431,0,5484,243947
5/17/22,Zimbabwe,-19.015438,29.154857,249748,0,5484,244264
5/18/22,Zimbabwe,-19.015438,29.154857,250007,0,5486,244521
5/19/22,Zimbabwe,-19.015438,29.154857,250206,0,5487,244719
5/20/22,Zimbabwe,-19.015438,29.154857,250469,0,5489,244980
5/21/22,Zimbabwe,-19.015438,29.154857,250469,0,5489,244980
5/22/22,Zimbabwe,-19.015438,29.154857,250642,0,5494,245148
5/23/22,Zimbabwe,-19.015438,29.154857,250702,0,5495,245207
5/24/22,Zimbabwe,-19.015438,29.154857,250929,0,5496,245433
5/25/22,Zimbabwe,-19.015438,29.154857,251228,0,5496,245732
5/26/22,Zimbabwe,-19.015438,29.154857,251646,0,5498,246148
5/27/22,Zimbabwe,-19.015438,29.154857,251959,0,5500,246459
5/28/22,Zimbabwe,-19.015438,29.154857,251959,0,5500,246459
5/29/22,Zimbabwe,-19.015438,29.154857,252092,0,5500,246592
5/30/22,Zimbabwe,-19.015438,29.154857,252092,0,5500,246592
5/31/22,Zimbabwe,-19.015438,29.154857,252398,0,5503,246895
6/1/22,Zimbabwe,-19.015438,29.154857,252874,0,5507,247367
6/2/22,Zimbabwe,-19.015438,29.154857,253051,0,5508,247543
6/3/22,Zimbabwe,-19.015438,29.154857,253236,0,5509,247727
6/4/22,Zimbabwe,-19.015438,29.154857,253236,0,5509,247727
6/5/22,Zimbabwe,-19.015438,29.154857,253338,0,5510,247828
6/6/22,Zimbabwe,-19.015438,29.154857,253508,0,5513,247995
6/7/22,Zimbabwe,-19.015438,29.154857,253637,0,5515,248122
6/8/22,Zimbabwe,-19.015438,29.154857,253779,0,5515,248264
6/9/22,Zimbabwe,-19.015438,29.154857,253779,0,5515,248264
6/10/22,Zimbabwe,-19.015438,29.154857,254031,0,5518,248513
6/11/22,Zimbabwe,-19.015438,29.154857,254031,0,5518,248513
6/12/22,Zimbabwe,-19.015438,29.154857,254098,0,5521,248577
6/13/22,Zimbabwe,-19.015438,29.154857,254155,0,5521,248634
6/14/22,Zimbabwe,-19.015438,29.154857,254155,0,5521,248634
6/15/22,Zimbabwe,-19.015438,29.154857,254387,0,5525,248862
6/16/22,Zimbabwe,-19.015438,29.154857,254502,0,5526,248976
6/17/22,Zimbabwe,-19.015438,29.154857,254753,0,5533,249220
6/18/22,Zimbabwe,-19.015438,29.154857,254753,0,5533,249220
6/19/22,Zimbabwe,-19.015438,29.154857,254801,0,5534,249267
6/20/22,Zimbabwe,-19.015438,29.154857,254831,0,5534,249297
6/21/22,Zimbabwe,-19.015438,29.154857,254919,0,5536,249383
6/22/22,Zimbabwe,-19.015438,29.154857,255049,0,5541,249508
6/23/22,Zimbabwe,-19.015438,29.154857,255136,0,5542,249594
6/24/22,Zimbabwe,-19.015438,29.154857,255309,0,5549,249760
6/25/22,Zimbabwe,-19.015438,29.154857,255309,0,5549,249760
6/26/22,Zimbabwe,-19.015438,29.154857,255355,0,5549,249806
6/27/22,Zimbabwe,-19.015438,29.154857,255383,0,5549,249834
6/28/22,Zimbabwe,-19.015438,29.154857,255383,0,5549,249834
6/29/22,Zimbabwe,-19.015438,29.154857,255520,0,5553,249967
6/30/22,Zimbabwe,-19.015438,29.154857,255586,0,5555,250031
7/1/22,Zimbabwe,-19.015438,29.154857,255586,0,5555,250031
7/2/22,Zimbabwe,-19.015438,29.154857,255586,0,5555,250031
7/3/22,Zimbabwe,-19.015438,29.154857,255586,0,5555,250031
7/4/22,Zimbabwe,-19.015438,29.154857,255726,0,5558,250168
7/5/22,Zimbabwe,-19.015438,29.154857,255755,0,5558,250197
7/6/22,Zimbabwe,-19.015438,29.154857,255805,0,5560,250245
7/7/22,Zimbabwe,-19.015438,29.154857,255805,0,5560,250245
7/8/22,Zimbabwe,-19.015438,29.154857,255891,0,5562,250329
7/9/22,Zimbabwe,-19.015438,29.154857,255924,0,5563,250361
7/10/22,Zimbabwe,-19.015438,29.154857,255939,0,5564,250375
7/11/22,Zimbabwe,-19.015438,29.154857,255953,0,5565,250388
7/12/22,Zimbabwe,-19.015438,29.154857,255981,0,5565,250416
7/13/22,Zimbabwe,-19.015438,29.154857,255981,0,5565,250416
7/14/22,Zimbabwe,-19.015438,29.154857,256047,0,5566,250481
7/15/22,Zimbabwe,-19.015438,29.154857,256083,0,5566,250517
7/16/22,Zimbabwe,-19.015438,29.154857,256083,0,5566,250517
7/17/22,Zimbabwe,-19.015438,29.154857,256083,0,5566,250517
7/18/22,Zimbabwe,-19.015438,29.154857,256083,0,5566,250517
7/19/22,Zimbabwe,-19.015438,29.154857,256187,0,5568,250619
7/20/22,Zimbabwe,-19.015438,29.154857,256187,0,5568,250619
7/21/22,Zimbabwe,-19.015438,29.154857,256217,0,5570,250647
7/22/22,Zimbabwe,-19.015438,29.154857,256217,0,5570,250647
7/23/22,Zimbabwe,-19.015438,29.154857,256246,0,5572,250674
7/24/22,Zimbabwe,-19.015438,29.154857,256254,0,5572,250682
7/25/22,Zimbabwe,-19.015438,29.154857,256270,0,5572,250698
7/26/22,Zimbabwe,-19.015438,29.154857,256284,0,5574,250710
7/27/22,Zimbabwe,-19.015438,29.154857,256315,0,5574,250741
7/28/22,Zimbabwe,-19.015438,29.154857,256336,0,5576,250760
7/29/22,Zimbabwe,-19.015438,29.154857,256376,0,5577,250799
7/30/22,Zimbabwe,-19.015438,29.154857,256376,0,5577,250799
7/31/22,Zimbabwe,-19.015438,29.154857,256378,0,5577,250801
8/1/22,Zimbabwe,-19.015438,29.154857,256382,0,5577,250805
8/2/22,Zimbabwe,-19.015438,29.154857,256403,0,5578,250825
8/3/22,Zimbabwe,-19.015438,29.154857,256423,0,5579,250844
8/4/22,Zimbabwe,-19.015438,29.154857,256444,0,5581,250863
8/5/22,Zimbabwe,-19.015438,29.154857,256444,0,5581,250863
8/6/22,Zimbabwe,-19.015438,29.154857,256444,0,5581,250863
8/7/22,Zimbabwe,-19.015438,29.154857,256447,0,5584,250863
8/8/22,Zimbabwe,-19.015438,29.154857,256487,0,5584,250903
8/9/22,Zimbabwe,-19.015438,29.154857,256490,0,5586,250904
8/10/22,Zimbabwe,-19.015438,29.154857,256492,0,5587,250905
8/11/22,Zimbabwe,-19.015438,29.154857,256513,0,5587,250926
8/12/22,Zimbabwe,-19.015438,29.154857,256522,0,5587,250935
8/13/22,Zimbabwe,-19.015438,29.154857,256522,0,5587,250935
8/14/22,Zimbabwe,-19.015438,29.154857,256539,0,5588,250951
8/15/22,Zimbabwe,-19.015438,29.154857,256544,0,5588,250956
8/16/22,Zimbabwe,-19.015438,29.154857,256561,0,5588,250973
8/17/22,Zimbabwe,-19.015438,29.154857,256565,0,5588,250977
8/18/22,Zimbabwe,-19.015438,29.154857,256579,0,5589,250990
8/19/22,Zimbabwe,-19.015438,29.154857,256596,0,5589,251007
8/20/22,Zimbabwe,-19.015438,29.154857,256616,0,5592,251024
8/21/22,Zimbabwe,-19.015438,29.154857,256624,0,5592,251032
8/22/22,Zimbabwe,-19.015438,29.154857,256628,0,5592,251036
8/23/22,Zimbabwe,-19.015438,29.154857,256628,0,5592,251036
8/24/22,Zimbabwe,-19.015438,29.154857,256628,0,5592,251036
8/25/22,Zimbabwe,-19.015438,29.154857,256675,0,5593,251082
8/26/22,Zimbabwe,-19.015438,29.154857,256682,0,5593,251089
8/27/22,Zimbabwe,-19.015438,29.154857,256682,0,5593,251089
8/28/22,Zimbabwe,-19.015438,29.154857,256699,0,5593,251106
8/29/22,Zimbabwe,-19.015438,29.154857,256704,0,5593,251111
8/30/22,Zimbabwe,-19.015438,29.154857,256708,0,5593,251115
8/31/22,Zimbabwe,-19.015438,29.154857,256726,0,5596,251130
9/1/22,Zimbabwe,-19.015438,29.154857,256738,0,5596,251142
9/2/22,Zimbabwe,-19.015438,29.154857,256744,0,5596,251148
9/3/22,Zimbabwe,-19.015438,29.154857,256755,0,5596,251159
9/4/22,Zimbabwe,-19.015438,29.154857,256763,0,5596,251167
9/5/22,Zimbabwe,-19.015438,29.154857,256769,0,5596,251173
9/6/22,Zimbabwe,-19.015438,29.154857,256782,0,5596,251186
9/7/22,Zimbabwe,-19.015438,29.154857,256825,0,5596,251229
9/8/22,Zimbabwe,-19.015438,29.154857,256834,0,5596,251238
9/9/22,Zimbabwe,-19.015438,29.154857,256859,0,5596,251263
9/10/22,Zimbabwe,-19.015438,29.154857,256870,0,5596,251274
9/11/22,Zimbabwe,-19.015438,29.154857,256870,0,5596,251274
9/12/22,Zimbabwe,-19.015438,29.154857,256888,0,5596,251292
9/13/22,Zimbabwe,-19.015438,29.154857,256904,0,5596,251308
9/14/22,Zimbabwe,-19.015438,29.154857,256939,0,5596,251343
9/15/22,Zimbabwe,-19.015438,29.154857,256939,0,5596,251343
9/16/22,Zimbabwe,-19.015438,29.154857,256939,0,5596,251343
9/17/22,Zimbabwe,-19.015438,29.154857,256988,0,5598,251390
9/18/22,Zimbabwe,-19.015438,29.154857,256996,0,5598,251398
9/19/22,Zimbabwe,-19.015438,29.154857,257090,0,5598,251492
9/20/22,Zimbabwe,-19.015438,29.154857,257156,0,5598,251558
9/21/22,Zimbabwe,-19.015438,29.154857,257156,0,5598,251558
9/22/22,Zimbabwe,-19.015438,29.154857,257259,0,5598,251661
9/23/22,Zimbabwe,-19.015438,29.154857,257289,0,5599,251690
9/24/22,Zimbabwe,-19.015438,29.154857,257318,0,5599,251719
9/25/22,Zimbabwe,-19.015438,29.154857,257340,0,5599,251741
9/26/22,Zimbabwe,-19.015438,29.154857,257342,0,5599,251743
9/27/22,Zimbabwe,-19.015438,29.154857,257376,0,5599,251777
9/28/22,Zimbabwe,-19.015438,29.154857,257409,0,5602,251807
9/29/22,Zimbabwe,-19.015438,29.154857,257409,0,5602,251807
9/30/22,Zimbabwe,-19.015438,29.154857,257465,0,5602,251863
10/1/22,Zimbabwe,-19.015438,29.154857,257465,0,5602,251863
10/2/22,Zimbabwe,-19.015438,29.154857,257517,0,5602,251915
10/3/22,Zimbabwe,-19.015438,29.154857,257538,0,5603,251935
10/4/22,Zimbabwe,-19.015438,29.154857,257568,0,5603,251965
10/5/22,Zimbabwe,-19.015438,29.154857,257568,0,5603,251965
10/6/22,Zimbabwe,-19.015438,29.154857,257655,0,5604,252051
10/7/22,Zimbabwe,-19.015438,29.154857,257655,0,5604,252051
10/8/22,Zimbabwe,-19.015438,29.154857,257655,0,5604,252051
10/9/22,Zimbabwe,-19.015438,29.154857,257655,0,5604,252051
10/10/22,Zimbabwe,-19.015438,29.154857,257749,0,5604,252145
10/11/22,Zimbabwe,-19.015438,29.154857,257749,0,5604,252145
10/12/22,Zimbabwe,-19.015438,29.154857,257798,0,5604,252194
10/13/22,Zimbabwe,-19.015438,29.154857,257827,0,5605,252222
10/14/22,Zimbabwe,-19.015438,29.154857,257827,0,5605,252222
10/15/22,Zimbabwe,-19.015438,29.154857,257827,0,5605,252222
10/16/22,Zimbabwe,-19.015438,29.154857,257893,0,5606,252287
10/17/22,Zimbabwe,-19.015438,29.154857,257893,0,5606,252287
10/18/22,Zimbabwe,-19.015438,29.154857,257893,0,5606,252287
10/19/22,Zimbabwe,-19.015438,29.154857,257893,0,5606,252287
10/20/22,Zimbabwe,-19.015438,29.154857,257893,0,5606,252287
10/21/22,Zimbabwe,-19.015438,29.154857,257893,0,5606,252287
10/22/22,Zimbabwe,-19.015438,29.154857,257893,0,5606,252287
10/23/22,Zimbabwe,-19.015438,29.154857,257893,0,5606,252287
10/24/22,Zimbabwe,-19.015438,29.154857,257893,0,5606,252287
10/25/22,Zimbabwe,-19.015438,29.154857,257893,0,5606,252287
10/26/22,Zimbabwe,-19.015438,29.154857,257893,0,5606,252287
10/27/22,Zimbabwe,-19.015438,29.154857,257893,0,5606,252287
10/28/22,Zimbabwe,-19.015438,29.154857,257893,0,5606,252287
10/29/22,Zimbabwe,-19.015438,29.154857,257893,0,5606,252287
10/30/22,Zimbabwe,-19.015438,29.154857,257893,0,5606,252287
10/31/22,Zimbabwe,-19.015438,29.154857,257893,0,5606,252287
11/1/22,Zimbabwe,-19.015438,29.154857,257893,0,5606,252287
11/2/22,Zimbabwe,-19.015438,29.154857,257893,0,5606,252287
11/3/22,Zimbabwe,-19.015438,29.154857,257893,0,5606,252287
11/4/22,Zimbabwe,-19.015438,29.154857,257893,0,5606,252287
11/5/22,Zimbabwe,-19.015438,29.154857,257893,0,5606,252287
11/6/22,Zimbabwe,-19.015438,29.154857,257893,0,5606,252287
11/7/22,Zimbabwe,-19.015438,29.154857,257893,0,5606,252287
11/8/22,Zimbabwe,-19.015438,29.154857,257893,0,5606,252287
11/9/22,Zimbabwe,-19.015438,29.154857,257893,0,5606,252287
11/10/22,Zimbabwe,-19.015438,29.154857,257893,0,5606,252287
11/11/22,Zimbabwe,-19.015438,29.154857,257893,0,5606,252287
11/12/22,Zimbabwe,-19.015438,29.154857,257893,0,5606,252287
11/13/22,Zimbabwe,-19.015438,29.154857,257893,0,5606,252287
11/14/22,Zimbabwe,-19.015438,29.154857,257893,0,5606,252287
11/15/22,Zimbabwe,-19.015438,29.154857,257893,0,5606,252287
11/16/22,Zimbabwe,-19.015438,29.154857,257893,0,5606,252287
11/17/22,Zimbabwe,-19.015438,29.154857,257893,0,5606,252287
11/18/22,Zimbabwe,-19.015438,29.154857,257893,0,5606,252287
11/19/22,Zimbabwe,-19.015438,29.154857,257893,0,5606,252287
11/20/22,Zimbabwe,-19.015438,29.154857,257893,0,5606,252287
11/21/22,Zimbabwe,-19.015438,29.154857,257893,0,5606,252287
11/22/22,Zimbabwe,-19.015438,29.154857,257893,0,5606,252287
11/23/22,Zimbabwe,-19.015438,29.154857,257893,0,5606,252287
11/24/22,Zimbabwe,-19.015438,29.154857,257893,0,5606,252287
11/25/22,Zimbabwe,-19.015438,29.154857,257893,0,5606,252287
11/26/22,Zimbabwe,-19.015438,29.154857,257893,0,5606,252287
11/27/22,Zimbabwe,-19.015438,29.154857,257893,0,5606,252287
11/28/22,Zimbabwe,-19.015438,29.154857,257893,0,5606,252287
11/29/22,Zimbabwe,-19.015438,29.154857,257893,0,5606,252287
11/30/22,Zimbabwe,-19.015438,29.154857,259164,0,5620,253544
12/1/22,Zimbabwe,-19.015438,29.154857,259164,0,5620,253544
12/2/22,Zimbabwe,-19.015438,29.154857,259164,0,5620,253544
12/3/22,Zimbabwe,-19.015438,29.154857,259164,0,5620,253544
12/4/22,Zimbabwe,-19.015438,29.154857,259164,0,5620,253544
12/5/22,Zimbabwe,-19.015438,29.154857,259164,0,5620,253544
12/6/22,Zimbabwe,-19.015438,29.154857,259356,0,5622,253734
12/7/22,Zimbabwe,-19.015438,29.154857,259356,0,5622,253734
12/8/22,Zimbabwe,-19.015438,29.154857,259356,0,5622,253734
12/9/22,Zimbabwe,-19.015438,29.154857,259356,0,5622,253734
12/10/22,Zimbabwe,-19.015438,29.154857,259356,0,5622,253734
12/11/22,Zimbabwe,-19.015438,29.154857,259356,0,5622,253734
12/12/22,Zimbabwe,-19.015438,29.154857,259356,0,5622,253734
12/13/22,Zimbabwe,-19.015438,29.154857,259356,0,5622,253734
12/14/22,Zimbabwe,-19.015438,29.154857,259356,0,5622,253734
12/15/22,Zimbabwe,-19.015438,29.154857,259356,0,5622,253734
12/16/22,Zimbabwe,-19.015438,29.154857,259356,0,5622,253734
12/17/22,Zimbabwe,-19.015438,29.154857,259356,0,5622,253734